SK_ID_CURR,TARGET,NAME_CONTRACT_TYPE,CODE_GENDER,FLAG_OWN_CAR,FLAG_OWN_REALTY,CNT_CHILDREN,AMT_INCOME_TOTAL,AMT_CREDIT,AMT_ANNUITY,AMT_GOODS_PRICE,REGION_POPULATION_RELATIVE,DAYS_BIRTH,DAYS_EMPLOYED,DAYS_REGISTRATION,DAYS_ID_PUBLISH,OWN_CAR_AGE,CNT_FAM_MEMBERS,REGION_RATING_CLIENT,REGION_RATING_CLIENT_W_CITY,HOUR_APPR_PROCESS_START,EXT_SOURCE_1,EXT_SOURCE_2,EXT_SOURCE_3,APARTMENTS_AVG,BASEMENTAREA_AVG,YEARS_BEGINEXPLUATATION_AVG,YEARS_BUILD_AVG,COMMONAREA_AVG,ELEVATORS_AVG,ENTRANCES_AVG,FLOORSMAX_AVG,FLOORSMIN_AVG,LANDAREA_AVG,LIVINGAPARTMENTS_AVG,LIVINGAREA_AVG,NONLIVINGAPARTMENTS_AVG,NONLIVINGAREA_AVG,APARTMENTS_MODE,BASEMENTAREA_MODE,YEARS_BEGINEXPLUATATION_MODE,YEARS_BUILD_MODE,COMMONAREA_MODE,ELEVATORS_MODE,ENTRANCES_MODE,FLOORSMAX_MODE,FLOORSMIN_MODE,LANDAREA_MODE,LIVINGAPARTMENTS_MODE,LIVINGAREA_MODE,NONLIVINGAPARTMENTS_MODE,NONLIVINGAREA_MODE,APARTMENTS_MEDI,BASEMENTAREA_MEDI,YEARS_BEGINEXPLUATATION_MEDI,YEARS_BUILD_MEDI,COMMONAREA_MEDI,ELEVATORS_MEDI,ENTRANCES_MEDI,FLOORSMAX_MEDI,FLOORSMIN_MEDI,LANDAREA_MEDI,LIVINGAPARTMENTS_MEDI,LIVINGAREA_MEDI,NONLIVINGAPARTMENTS_MEDI,NONLIVINGAREA_MEDI,TOTALAREA_MODE,EMERGENCYSTATE_MODE,OBS_30_CNT_SOCIAL_CIRCLE,DEF_30_CNT_SOCIAL_CIRCLE,OBS_60_CNT_SOCIAL_CIRCLE,DEF_60_CNT_SOCIAL_CIRCLE,DAYS_LAST_PHONE_CHANGE,AMT_REQ_CREDIT_BUREAU_HOUR,AMT_REQ_CREDIT_BUREAU_DAY,AMT_REQ_CREDIT_BUREAU_WEEK,AMT_REQ_CREDIT_BUREAU_MON,AMT_REQ_CREDIT_BUREAU_QRT,AMT_REQ_CREDIT_BUREAU_YEAR,FLAG_MOBIL,FLAG_EMP_PHONE,FLAG_WORK_PHONE,FLAG_CONT_MOBILE,FLAG_PHONE,FLAG_EMAIL,REG_REGION_NOT_LIVE_REGION,REG_REGION_NOT_WORK_REGION,LIVE_REGION_NOT_WORK_REGION,REG_CITY_NOT_LIVE_CITY,REG_CITY_NOT_WORK_CITY,LIVE_CITY_NOT_WORK_CITY,FLAG_DOCUMENT_2,FLAG_DOCUMENT_3,FLAG_DOCUMENT_4,FLAG_DOCUMENT_5,FLAG_DOCUMENT_6,FLAG_DOCUMENT_7,FLAG_DOCUMENT_8,FLAG_DOCUMENT_9,FLAG_DOCUMENT_10,FLAG_DOCUMENT_11,FLAG_DOCUMENT_12,FLAG_DOCUMENT_13,FLAG_DOCUMENT_14,FLAG_DOCUMENT_15,FLAG_DOCUMENT_16,FLAG_DOCUMENT_17,FLAG_DOCUMENT_18,FLAG_DOCUMENT_19,FLAG_DOCUMENT_20,FLAG_DOCUMENT_21,COUNT(bureau),MEDIAN(bureau.AMT_ANNUITY),MEDIAN(bureau.AMT_CREDIT_MAX_OVERDUE),MEDIAN(bureau.AMT_CREDIT_SUM),MEDIAN(bureau.AMT_CREDIT_SUM_DEBT),MEDIAN(bureau.AMT_CREDIT_SUM_LIMIT),MEDIAN(bureau.AMT_CREDIT_SUM_OVERDUE),MEDIAN(bureau.CNT_CREDIT_PROLONG),MEDIAN(bureau.CREDIT_DAY_OVERDUE),MEDIAN(bureau.DAYS_CREDIT),MEDIAN(bureau.DAYS_CREDIT_ENDDATE),MEDIAN(bureau.DAYS_CREDIT_UPDATE),MEDIAN(bureau.DAYS_ENDDATE_FACT),COUNT(bureau_balance),MEDIAN(bureau_balance.MONTHS_BALANCE),COUNT(prev_app),MEDIAN(prev_app.AMT_ANNUITY),MEDIAN(prev_app.AMT_APPLICATION),MEDIAN(prev_app.AMT_CREDIT),MEDIAN(prev_app.AMT_DOWN_PAYMENT),MEDIAN(prev_app.AMT_GOODS_PRICE),MEDIAN(prev_app.CNT_PAYMENT),MEDIAN(prev_app.DAYS_DECISION),MEDIAN(prev_app.DAYS_FIRST_DRAWING),MEDIAN(prev_app.DAYS_FIRST_DUE),MEDIAN(prev_app.DAYS_LAST_DUE),MEDIAN(prev_app.DAYS_LAST_DUE_1ST_VERSION),MEDIAN(prev_app.DAYS_TERMINATION),MEDIAN(prev_app.HOUR_APPR_PROCESS_START),MEDIAN(prev_app.NFLAG_INSURED_ON_APPROVAL),MEDIAN(prev_app.RATE_DOWN_PAYMENT),MEDIAN(prev_app.SELLERPLACE_AREA),COUNT(cash_balance),MEDIAN(cash_balance.CNT_INSTALMENT),MEDIAN(cash_balance.CNT_INSTALMENT_FUTURE),MEDIAN(cash_balance.MONTHS_BALANCE),MEDIAN(cash_balance.SK_DPD),MEDIAN(cash_balance.SK_DPD_DEF),COUNT(payments),MEDIAN(payments.AMT_INSTALMENT),MEDIAN(payments.AMT_PAYMENT),MEDIAN(payments.DAYS_ENTRY_PAYMENT),MEDIAN(payments.DAYS_INSTALMENT),MEDIAN(payments.NUM_INSTALMENT_NUMBER),MEDIAN(payments.NUM_INSTALMENT_VERSION),COUNT(card_balance),MEDIAN(card_balance.AMT_BALANCE),MEDIAN(card_balance.AMT_CREDIT_LIMIT_ACTUAL),MEDIAN(card_balance.AMT_DRAWINGS_ATM_CURRENT),MEDIAN(card_balance.AMT_DRAWINGS_CURRENT),MEDIAN(card_balance.AMT_DRAWINGS_OTHER_CURRENT),MEDIAN(card_balance.AMT_DRAWINGS_POS_CURRENT),MEDIAN(card_balance.AMT_INST_MIN_REGULARITY),MEDIAN(card_balance.AMT_PAYMENT_CURRENT),MEDIAN(card_balance.AMT_PAYMENT_TOTAL_CURRENT),MEDIAN(card_balance.AMT_RECEIVABLE_PRINCIPAL),MEDIAN(card_balance.AMT_RECIVABLE),MEDIAN(card_balance.AMT_TOTAL_RECEIVABLE),MEDIAN(card_balance.CNT_DRAWINGS_ATM_CURRENT),MEDIAN(card_balance.CNT_DRAWINGS_CURRENT),MEDIAN(card_balance.CNT_DRAWINGS_OTHER_CURRENT),MEDIAN(card_balance.CNT_DRAWINGS_POS_CURRENT),MEDIAN(card_balance.CNT_INSTALMENT_MATURE_CUM),MEDIAN(card_balance.MONTHS_BALANCE),MEDIAN(card_balance.SK_DPD),MEDIAN(card_balance.SK_DPD_DEF),CUM_SUM(AMT_ANNUITY),CUM_SUM(AMT_CREDIT),CUM_SUM(AMT_GOODS_PRICE),CUM_SUM(AMT_INCOME_TOTAL),CUM_SUM(AMT_REQ_CREDIT_BUREAU_DAY),CUM_SUM(AMT_REQ_CREDIT_BUREAU_HOUR),CUM_SUM(AMT_REQ_CREDIT_BUREAU_MON),CUM_SUM(AMT_REQ_CREDIT_BUREAU_QRT),CUM_SUM(AMT_REQ_CREDIT_BUREAU_WEEK),CUM_SUM(AMT_REQ_CREDIT_BUREAU_YEAR),CUM_SUM(APARTMENTS_AVG),CUM_SUM(APARTMENTS_MEDI),CUM_SUM(APARTMENTS_MODE),CUM_SUM(BASEMENTAREA_AVG),CUM_SUM(BASEMENTAREA_MEDI),CUM_SUM(BASEMENTAREA_MODE),CUM_SUM(CNT_CHILDREN),CUM_SUM(CNT_FAM_MEMBERS),CUM_SUM(COMMONAREA_AVG),CUM_SUM(COMMONAREA_MEDI),CUM_SUM(COMMONAREA_MODE),CUM_SUM(DAYS_BIRTH),CUM_SUM(DAYS_EMPLOYED),CUM_SUM(DAYS_ID_PUBLISH),CUM_SUM(DAYS_LAST_PHONE_CHANGE),CUM_SUM(DAYS_REGISTRATION),CUM_SUM(DEF_30_CNT_SOCIAL_CIRCLE),CUM_SUM(DEF_60_CNT_SOCIAL_CIRCLE),CUM_SUM(ELEVATORS_AVG),CUM_SUM(ELEVATORS_MEDI),CUM_SUM(ELEVATORS_MODE),CUM_SUM(ENTRANCES_AVG),CUM_SUM(ENTRANCES_MEDI),CUM_SUM(ENTRANCES_MODE),CUM_SUM(EXT_SOURCE_1),CUM_SUM(EXT_SOURCE_2),CUM_SUM(EXT_SOURCE_3),CUM_SUM(FLOORSMAX_AVG),CUM_SUM(FLOORSMAX_MEDI),CUM_SUM(FLOORSMAX_MODE),CUM_SUM(FLOORSMIN_AVG),CUM_SUM(FLOORSMIN_MEDI),CUM_SUM(FLOORSMIN_MODE),CUM_SUM(HOUR_APPR_PROCESS_START),CUM_SUM(LANDAREA_AVG),CUM_SUM(LANDAREA_MEDI),CUM_SUM(LANDAREA_MODE),CUM_SUM(LIVINGAPARTMENTS_AVG),CUM_SUM(LIVINGAPARTMENTS_MEDI),CUM_SUM(LIVINGAPARTMENTS_MODE),CUM_SUM(LIVINGAREA_AVG),CUM_SUM(LIVINGAREA_MEDI),CUM_SUM(LIVINGAREA_MODE),CUM_SUM(NONLIVINGAPARTMENTS_AVG),CUM_SUM(NONLIVINGAPARTMENTS_MEDI),CUM_SUM(NONLIVINGAPARTMENTS_MODE),CUM_SUM(NONLIVINGAREA_AVG),CUM_SUM(NONLIVINGAREA_MEDI),CUM_SUM(NONLIVINGAREA_MODE),CUM_SUM(OBS_30_CNT_SOCIAL_CIRCLE),CUM_SUM(OBS_60_CNT_SOCIAL_CIRCLE),CUM_SUM(OWN_CAR_AGE),CUM_SUM(REGION_POPULATION_RELATIVE),CUM_SUM(REGION_RATING_CLIENT),CUM_SUM(REGION_RATING_CLIENT_W_CITY),CUM_SUM(TARGET),CUM_SUM(TOTALAREA_MODE),CUM_SUM(YEARS_BEGINEXPLUATATION_AVG),CUM_SUM(YEARS_BEGINEXPLUATATION_MEDI),CUM_SUM(YEARS_BEGINEXPLUATATION_MODE),CUM_SUM(YEARS_BUILD_AVG),CUM_SUM(YEARS_BUILD_MEDI),CUM_SUM(YEARS_BUILD_MODE),MEDIAN(bureau.COUNT(bureau_balance)),MEDIAN(bureau.CUM_SUM(AMT_ANNUITY)),MEDIAN(bureau.CUM_SUM(AMT_CREDIT_MAX_OVERDUE)),MEDIAN(bureau.CUM_SUM(AMT_CREDIT_SUM)),MEDIAN(bureau.CUM_SUM(AMT_CREDIT_SUM_DEBT)),MEDIAN(bureau.CUM_SUM(AMT_CREDIT_SUM_LIMIT)),MEDIAN(bureau.CUM_SUM(AMT_CREDIT_SUM_OVERDUE)),MEDIAN(bureau.CUM_SUM(CNT_CREDIT_PROLONG)),MEDIAN(bureau.CUM_SUM(CREDIT_DAY_OVERDUE)),MEDIAN(bureau.CUM_SUM(DAYS_CREDIT)),MEDIAN(bureau.CUM_SUM(DAYS_CREDIT_ENDDATE)),MEDIAN(bureau.CUM_SUM(DAYS_CREDIT_UPDATE)),MEDIAN(bureau.CUM_SUM(DAYS_ENDDATE_FACT)),MEDIAN(bureau.MEDIAN(bureau_balance.MONTHS_BALANCE)),MEDIAN(bureau_balance.bureau.AMT_ANNUITY),MEDIAN(bureau_balance.bureau.AMT_CREDIT_MAX_OVERDUE),MEDIAN(bureau_balance.bureau.AMT_CREDIT_SUM),MEDIAN(bureau_balance.bureau.AMT_CREDIT_SUM_DEBT),MEDIAN(bureau_balance.bureau.AMT_CREDIT_SUM_LIMIT),MEDIAN(bureau_balance.bureau.AMT_CREDIT_SUM_OVERDUE),MEDIAN(bureau_balance.bureau.CNT_CREDIT_PROLONG),MEDIAN(bureau_balance.bureau.CREDIT_DAY_OVERDUE),MEDIAN(bureau_balance.bureau.DAYS_CREDIT),MEDIAN(bureau_balance.bureau.DAYS_CREDIT_ENDDATE),MEDIAN(bureau_balance.bureau.DAYS_CREDIT_UPDATE),MEDIAN(bureau_balance.bureau.DAYS_ENDDATE_FACT),MEDIAN(prev_app.CUM_SUM(AMT_ANNUITY)),MEDIAN(prev_app.CUM_SUM(AMT_APPLICATION)),MEDIAN(prev_app.CUM_SUM(AMT_CREDIT)),MEDIAN(prev_app.CUM_SUM(AMT_DOWN_PAYMENT)),MEDIAN(prev_app.CUM_SUM(AMT_GOODS_PRICE)),MEDIAN(prev_app.CUM_SUM(CNT_PAYMENT)),MEDIAN(prev_app.CUM_SUM(DAYS_DECISION)),MEDIAN(prev_app.CUM_SUM(DAYS_FIRST_DRAWING)),MEDIAN(prev_app.CUM_SUM(DAYS_FIRST_DUE)),MEDIAN(prev_app.CUM_SUM(DAYS_LAST_DUE)),MEDIAN(prev_app.CUM_SUM(DAYS_LAST_DUE_1ST_VERSION)),MEDIAN(prev_app.CUM_SUM(DAYS_TERMINATION)),MEDIAN(prev_app.CUM_SUM(HOUR_APPR_PROCESS_START)),MEDIAN(prev_app.CUM_SUM(NFLAG_INSURED_ON_APPROVAL)),MEDIAN(prev_app.CUM_SUM(RATE_DOWN_PAYMENT)),MEDIAN(prev_app.CUM_SUM(SELLERPLACE_AREA)),MEDIAN(cash_balance.CUM_SUM(CNT_INSTALMENT)),MEDIAN(cash_balance.CUM_SUM(CNT_INSTALMENT_FUTURE)),MEDIAN(cash_balance.CUM_SUM(MONTHS_BALANCE)),MEDIAN(cash_balance.CUM_SUM(SK_DPD)),MEDIAN(cash_balance.CUM_SUM(SK_DPD_DEF)),MEDIAN(payments.CUM_SUM(AMT_INSTALMENT)),MEDIAN(payments.CUM_SUM(AMT_PAYMENT)),MEDIAN(payments.CUM_SUM(DAYS_ENTRY_PAYMENT)),MEDIAN(payments.CUM_SUM(DAYS_INSTALMENT)),MEDIAN(payments.CUM_SUM(NUM_INSTALMENT_NUMBER)),MEDIAN(payments.CUM_SUM(NUM_INSTALMENT_VERSION)),MEDIAN(card_balance.CUM_SUM(AMT_BALANCE)),MEDIAN(card_balance.CUM_SUM(AMT_CREDIT_LIMIT_ACTUAL)),MEDIAN(card_balance.CUM_SUM(AMT_DRAWINGS_ATM_CURRENT)),MEDIAN(card_balance.CUM_SUM(AMT_DRAWINGS_CURRENT)),MEDIAN(card_balance.CUM_SUM(AMT_DRAWINGS_OTHER_CURRENT)),MEDIAN(card_balance.CUM_SUM(AMT_DRAWINGS_POS_CURRENT)),MEDIAN(card_balance.CUM_SUM(AMT_INST_MIN_REGULARITY)),MEDIAN(card_balance.CUM_SUM(AMT_PAYMENT_CURRENT)),MEDIAN(card_balance.CUM_SUM(AMT_PAYMENT_TOTAL_CURRENT)),MEDIAN(card_balance.CUM_SUM(AMT_RECEIVABLE_PRINCIPAL)),MEDIAN(card_balance.CUM_SUM(AMT_RECIVABLE)),MEDIAN(card_balance.CUM_SUM(AMT_TOTAL_RECEIVABLE)),MEDIAN(card_balance.CUM_SUM(CNT_DRAWINGS_ATM_CURRENT)),MEDIAN(card_balance.CUM_SUM(CNT_DRAWINGS_CURRENT)),MEDIAN(card_balance.CUM_SUM(CNT_DRAWINGS_OTHER_CURRENT)),MEDIAN(card_balance.CUM_SUM(CNT_DRAWINGS_POS_CURRENT)),MEDIAN(card_balance.CUM_SUM(CNT_INSTALMENT_MATURE_CUM)),MEDIAN(card_balance.CUM_SUM(MONTHS_BALANCE)),MEDIAN(card_balance.CUM_SUM(SK_DPD)),MEDIAN(card_balance.CUM_SUM(SK_DPD_DEF)),CUM_SUM(COUNT(bureau)),CUM_SUM(COUNT(bureau_balance)),CUM_SUM(COUNT(card_balance)),CUM_SUM(COUNT(cash_balance)),CUM_SUM(COUNT(payments)),CUM_SUM(COUNT(prev_app)),CUM_SUM(MEDIAN(bureau.AMT_ANNUITY)),CUM_SUM(MEDIAN(bureau.AMT_CREDIT_MAX_OVERDUE)),CUM_SUM(MEDIAN(bureau.AMT_CREDIT_SUM)),CUM_SUM(MEDIAN(bureau.AMT_CREDIT_SUM_DEBT)),CUM_SUM(MEDIAN(bureau.AMT_CREDIT_SUM_LIMIT)),CUM_SUM(MEDIAN(bureau.AMT_CREDIT_SUM_OVERDUE)),CUM_SUM(MEDIAN(bureau.CNT_CREDIT_PROLONG)),CUM_SUM(MEDIAN(bureau.CREDIT_DAY_OVERDUE)),CUM_SUM(MEDIAN(bureau.DAYS_CREDIT)),CUM_SUM(MEDIAN(bureau.DAYS_CREDIT_ENDDATE)),CUM_SUM(MEDIAN(bureau.DAYS_CREDIT_UPDATE)),CUM_SUM(MEDIAN(bureau.DAYS_ENDDATE_FACT)),CUM_SUM(MEDIAN(bureau_balance.MONTHS_BALANCE)),CUM_SUM(MEDIAN(card_balance.AMT_BALANCE)),CUM_SUM(MEDIAN(card_balance.AMT_CREDIT_LIMIT_ACTUAL)),CUM_SUM(MEDIAN(card_balance.AMT_DRAWINGS_ATM_CURRENT)),CUM_SUM(MEDIAN(card_balance.AMT_DRAWINGS_CURRENT)),CUM_SUM(MEDIAN(card_balance.AMT_DRAWINGS_OTHER_CURRENT)),CUM_SUM(MEDIAN(card_balance.AMT_DRAWINGS_POS_CURRENT)),CUM_SUM(MEDIAN(card_balance.AMT_INST_MIN_REGULARITY)),CUM_SUM(MEDIAN(card_balance.AMT_PAYMENT_CURRENT)),CUM_SUM(MEDIAN(card_balance.AMT_PAYMENT_TOTAL_CURRENT)),CUM_SUM(MEDIAN(card_balance.AMT_RECEIVABLE_PRINCIPAL)),CUM_SUM(MEDIAN(card_balance.AMT_RECIVABLE)),CUM_SUM(MEDIAN(card_balance.AMT_TOTAL_RECEIVABLE)),CUM_SUM(MEDIAN(card_balance.CNT_DRAWINGS_ATM_CURRENT)),CUM_SUM(MEDIAN(card_balance.CNT_DRAWINGS_CURRENT)),CUM_SUM(MEDIAN(card_balance.CNT_DRAWINGS_OTHER_CURRENT)),CUM_SUM(MEDIAN(card_balance.CNT_DRAWINGS_POS_CURRENT)),CUM_SUM(MEDIAN(card_balance.CNT_INSTALMENT_MATURE_CUM)),CUM_SUM(MEDIAN(card_balance.MONTHS_BALANCE)),CUM_SUM(MEDIAN(card_balance.SK_DPD)),CUM_SUM(MEDIAN(card_balance.SK_DPD_DEF)),CUM_SUM(MEDIAN(cash_balance.CNT_INSTALMENT)),CUM_SUM(MEDIAN(cash_balance.CNT_INSTALMENT_FUTURE)),CUM_SUM(MEDIAN(cash_balance.MONTHS_BALANCE)),CUM_SUM(MEDIAN(cash_balance.SK_DPD)),CUM_SUM(MEDIAN(cash_balance.SK_DPD_DEF)),CUM_SUM(MEDIAN(payments.AMT_INSTALMENT)),CUM_SUM(MEDIAN(payments.AMT_PAYMENT)),CUM_SUM(MEDIAN(payments.DAYS_ENTRY_PAYMENT)),CUM_SUM(MEDIAN(payments.DAYS_INSTALMENT)),CUM_SUM(MEDIAN(payments.NUM_INSTALMENT_NUMBER)),CUM_SUM(MEDIAN(payments.NUM_INSTALMENT_VERSION)),CUM_SUM(MEDIAN(prev_app.AMT_ANNUITY)),CUM_SUM(MEDIAN(prev_app.AMT_APPLICATION)),CUM_SUM(MEDIAN(prev_app.AMT_CREDIT)),CUM_SUM(MEDIAN(prev_app.AMT_DOWN_PAYMENT)),CUM_SUM(MEDIAN(prev_app.AMT_GOODS_PRICE)),CUM_SUM(MEDIAN(prev_app.CNT_PAYMENT)),CUM_SUM(MEDIAN(prev_app.DAYS_DECISION)),CUM_SUM(MEDIAN(prev_app.DAYS_FIRST_DRAWING)),CUM_SUM(MEDIAN(prev_app.DAYS_FIRST_DUE)),CUM_SUM(MEDIAN(prev_app.DAYS_LAST_DUE)),CUM_SUM(MEDIAN(prev_app.DAYS_LAST_DUE_1ST_VERSION)),CUM_SUM(MEDIAN(prev_app.DAYS_TERMINATION)),CUM_SUM(MEDIAN(prev_app.HOUR_APPR_PROCESS_START)),CUM_SUM(MEDIAN(prev_app.NFLAG_INSURED_ON_APPROVAL)),CUM_SUM(MEDIAN(prev_app.RATE_DOWN_PAYMENT)),CUM_SUM(MEDIAN(prev_app.SELLERPLACE_AREA)),PROPORTION_LIFE_EMPLOYED,CREDIT_TO_INCOME_RATIO,INCOME_TO_ANNUITY_RATIO,INCOME_TO_ANNUITY_RATIO_BY_AGE,CREDIT_TO_ANNUITY_RATIO,CREDIT_TO_ANNUITY_RATIO_BY_AGE,INCOME_TO_FAMILYSIZE_RATIO,WEEKDAY_APPR_PROCESS_START_1,WEEKDAY_APPR_PROCESS_START_2,NAME_TYPE_SUITE_Children,NAME_TYPE_SUITE_Family,NAME_TYPE_SUITE_Group of people,NAME_TYPE_SUITE_Other_A,NAME_TYPE_SUITE_Other_B,"NAME_TYPE_SUITE_Spouse, partner",NAME_TYPE_SUITE_Unaccompanied,NAME_INCOME_TYPE_Businessman,NAME_INCOME_TYPE_Commercial associate,NAME_INCOME_TYPE_Pensioner,NAME_INCOME_TYPE_State servant,NAME_INCOME_TYPE_Student,NAME_INCOME_TYPE_Unemployed,NAME_INCOME_TYPE_Working,NAME_EDUCATION_TYPE_Academic degree,NAME_EDUCATION_TYPE_Higher education,NAME_EDUCATION_TYPE_Incomplete higher,NAME_EDUCATION_TYPE_Lower secondary,NAME_EDUCATION_TYPE_Secondary / secondary special,NAME_FAMILY_STATUS_Civil marriage,NAME_FAMILY_STATUS_Married,NAME_FAMILY_STATUS_Separated,NAME_FAMILY_STATUS_Single / not married,NAME_FAMILY_STATUS_Widow,NAME_HOUSING_TYPE_Co-op apartment,NAME_HOUSING_TYPE_House / apartment,NAME_HOUSING_TYPE_Municipal apartment,NAME_HOUSING_TYPE_Office apartment,NAME_HOUSING_TYPE_Rented apartment,NAME_HOUSING_TYPE_With parents,OCCUPATION_TYPE_Accountants,OCCUPATION_TYPE_Cleaning staff,OCCUPATION_TYPE_Cooking staff,OCCUPATION_TYPE_Core staff,OCCUPATION_TYPE_Drivers,OCCUPATION_TYPE_HR staff,OCCUPATION_TYPE_High skill tech staff,OCCUPATION_TYPE_IT staff,OCCUPATION_TYPE_Laborers,OCCUPATION_TYPE_Low-skill Laborers,OCCUPATION_TYPE_Managers,OCCUPATION_TYPE_Medicine staff,OCCUPATION_TYPE_Private service staff,OCCUPATION_TYPE_Realty agents,OCCUPATION_TYPE_Sales staff,OCCUPATION_TYPE_Secretaries,OCCUPATION_TYPE_Security staff,OCCUPATION_TYPE_Waiters/barmen staff,ORGANIZATION_TYPE_Advertising,ORGANIZATION_TYPE_Agriculture,ORGANIZATION_TYPE_Bank,ORGANIZATION_TYPE_Business Entity Type 1,ORGANIZATION_TYPE_Business Entity Type 2,ORGANIZATION_TYPE_Business Entity Type 3,ORGANIZATION_TYPE_Cleaning,ORGANIZATION_TYPE_Construction,ORGANIZATION_TYPE_Culture,ORGANIZATION_TYPE_Electricity,ORGANIZATION_TYPE_Emergency,ORGANIZATION_TYPE_Government,ORGANIZATION_TYPE_Hotel,ORGANIZATION_TYPE_Housing,ORGANIZATION_TYPE_Industry: type 1,ORGANIZATION_TYPE_Industry: type 10,ORGANIZATION_TYPE_Industry: type 11,ORGANIZATION_TYPE_Industry: type 12,ORGANIZATION_TYPE_Industry: type 13,ORGANIZATION_TYPE_Industry: type 2,ORGANIZATION_TYPE_Industry: type 3,ORGANIZATION_TYPE_Industry: type 4,ORGANIZATION_TYPE_Industry: type 5,ORGANIZATION_TYPE_Industry: type 6,ORGANIZATION_TYPE_Industry: type 7,ORGANIZATION_TYPE_Industry: type 8,ORGANIZATION_TYPE_Industry: type 9,ORGANIZATION_TYPE_Insurance,ORGANIZATION_TYPE_Kindergarten,ORGANIZATION_TYPE_Legal Services,ORGANIZATION_TYPE_Medicine,ORGANIZATION_TYPE_Military,ORGANIZATION_TYPE_Mobile,ORGANIZATION_TYPE_Other,ORGANIZATION_TYPE_Police,ORGANIZATION_TYPE_Postal,ORGANIZATION_TYPE_Realtor,ORGANIZATION_TYPE_Religion,ORGANIZATION_TYPE_Restaurant,ORGANIZATION_TYPE_School,ORGANIZATION_TYPE_Security,ORGANIZATION_TYPE_Security Ministries,ORGANIZATION_TYPE_Self-employed,ORGANIZATION_TYPE_Services,ORGANIZATION_TYPE_Telecom,ORGANIZATION_TYPE_Trade: type 1,ORGANIZATION_TYPE_Trade: type 2,ORGANIZATION_TYPE_Trade: type 3,ORGANIZATION_TYPE_Trade: type 4,ORGANIZATION_TYPE_Trade: type 5,ORGANIZATION_TYPE_Trade: type 6,ORGANIZATION_TYPE_Trade: type 7,ORGANIZATION_TYPE_Transport: type 1,ORGANIZATION_TYPE_Transport: type 2,ORGANIZATION_TYPE_Transport: type 3,ORGANIZATION_TYPE_Transport: type 4,ORGANIZATION_TYPE_University,ORGANIZATION_TYPE_XNA,FONDKAPREMONT_MODE_not specified,FONDKAPREMONT_MODE_org spec account,FONDKAPREMONT_MODE_reg oper account,FONDKAPREMONT_MODE_reg oper spec account,HOUSETYPE_MODE_block of flats,HOUSETYPE_MODE_specific housing,HOUSETYPE_MODE_terraced house,WALLSMATERIAL_MODE_Block,WALLSMATERIAL_MODE_Mixed,WALLSMATERIAL_MODE_Monolithic,WALLSMATERIAL_MODE_Others,WALLSMATERIAL_MODE_Panel,"WALLSMATERIAL_MODE_Stone, brick",WALLSMATERIAL_MODE_Wooden
100001,0,0.0,0.0,0.0,1.0,0.0,135000.0,568800.0,20560.5,450000.0,0.01885,52.71506849315068,-2329.0,-5170.0,-812.0,,2.0,2.0,2.0,18.0,0.7526144906031748,0.7896543511176771,0.1595195404777181,0.066,0.059,0.9732,,,,0.1379,0.125,,,,0.0505,,,0.0672,0.0612,0.9732,,,,0.1379,0.125,,,,0.0526,,,0.0666,0.059,0.9732,,,,0.1379,0.125,,,,0.0514,,,0.0392,1.0,0.0,0.0,0.0,0.0,-1740.0,0.0,0.0,0.0,0.0,0.0,0.0,1.0,1.0,0.0,1.0,0.0,1.0,0.0,0.0,0.0,0.0,0.0,0.0,0.0,1.0,0.0,0.0,0.0,0.0,0.0,0.0,0.0,0.0,0.0,0.0,0.0,0.0,0.0,0.0,0.0,0.0,0.0,0.0,7.0,0.0,,168345.0,0.0,0.0,0.0,0.0,0.0,-857.0,-179.0,-155.0,-715.0,172.0,-14.0,1.0,3951.0,24835.5,23787.0,2520.0,24835.5,8.0,-1740.0,365243.0,-1709.0,-1619.0,-1499.0,-1612.0,13.0,0.0,0.1043261904021397,23.0,9.0,4.0,1.0,-57.0,0.0,0.0,7.0,3980.925,3980.925,-1715.0,-1709.0,3.0,1.0,0.0,,,,,,,,,,,,,,,,,,,,,8335552122.0,184201046995.5,165408095997.0,51905250460.935,1862.0,1703.0,71122.0,70613.0,9140.0,505363.0,17785.978100002303,17847.981099999117,17299.893099998102,11282.090500000088,11219.918400000091,11167.394400000056,128238.0,661938.0,,,,13510734.339725625,-601108691.0,-920718386.0,-296081974.0,-1533247048.0416667,43951.0,30658.0,,,,22859.99790000959,22781.84110000955,22168.036800008107,67348.57867849358,157836.4668366884,125947.01957716393,34957.309700027865,34897.781700028296,34344.4656000287,,,,3709496.0,,,,,,,16448.96779999975,16633.9359999997,16230.855399999708,,,,,,,435875.0,430679.0,,6416.911186002898,631134.0,624694.0,,16312.7802999998,153992.22159999062,153994.9630999901,153886.77499998722,,,,29.0,0.0,,569340.0,0.0,0.0,0.0,0.0,0.0,-4217.0,-671.0,-620.0,-1702.0,-14.0,0.0,,112500.0,0.0,0.0,0.0,0.0,0.0,-879.0,-492.0,-155.0,-877.0,3951.0,24835.5,23787.0,2520.0,24835.5,8.0,-1740.0,365243.0,-1709.0,-1619.0,-1499.0,-1612.0,13.0,0.0,0.1043261904021397,23.0,20.0,10.0,-275.0,0.0,0.0,29250.9,29250.9,-6718.0,-6656.0,10.0,5.0,,,,,,,,,,,,,,,,,,,,,1465296.0,14701784.0,3227923.0,8543019.0,11591179.0,1413631.0,1056351330.0720012,,72012198508.9871,21651264633.397617,581629070.546999,5792395.7475,689.5,94245.0,-276567526.0,21850815.5,-123633656.0,-218427895.0,-2012085.0,,,,,,,,,,,,,,,,,,,,,4267097.0,2475887.5,-8991641.0,921269.0,37582.5,3728443108.117464,3653009462.587461,-260288965.5,-256982559.0,2523133.0,268846.5,3920983619.647455,33214285414.77841,36639390549.08264,1727436837.2400494,48023123200.62822,3982807.5,-247269428.0,102949434917.0,1052350945.5,17255670780.0,3499505052.0,18868951235.5,3667308.0,71820.5,20847.535535291285,89666165.5,-44.1809157528195,4.213333333333333,6.5659881812212735,346.12651669829734,27.664696870212303,1458.3463903554928,67500.0,0.6234898018587336,0.7818314824680298,0.0,0.0,0.0,0.0,0.0,0.0,1.0,0.0,0.0,0.0,0.0,0.0,0.0,1.0,0.0,1.0,0.0,0.0,0.0,0.0,1.0,0.0,0.0,0.0,0.0,1.0,0.0,0.0,0.0,0.0,0.0,0.0,0.0,0.0,0.0,0.0,0.0,0.0,0.0,0.0,0.0,0.0,0.0,0.0,0.0,0.0,0.0,0.0,0.0,0.0,0.0,0.0,0.0,0.0,0.0,0.0,0.0,0.0,0.0,0.0,0.0,0.0,0.0,0.0,0.0,0.0,0.0,0.0,0.0,0.0,0.0,0.0,0.0,0.0,0.0,0.0,1.0,0.0,0.0,0.0,0.0,0.0,0.0,0.0,0.0,0.0,0.0,0.0,0.0,0.0,0.0,0.0,0.0,0.0,0.0,0.0,0.0,0.0,0.0,0.0,0.0,0.0,0.0,0.0,0.0,0.0,0.0,0.0,0.0,0.0,1.0,0.0,0.0,0.0,0.0,0.0,0.0,0.0,1.0,0.0
100005,0,0.0,1.0,0.0,1.0,0.0,99000.0,222768.0,17370.0,180000.0,0.035792,49.490410958904114,-4469.0,-9118.0,-1623.0,,2.0,2.0,2.0,9.0,0.5649902017969249,0.2916555320093651,0.4329616670974407,,,,,,,,,,,,,,,,,,,,,,,,,,,,,,,,,,,,,,,,,,,,,0.0,0.0,0.0,0.0,0.0,0.0,0.0,0.0,0.0,0.0,3.0,1.0,1.0,0.0,1.0,0.0,0.0,0.0,0.0,0.0,0.0,0.0,0.0,0.0,1.0,0.0,0.0,0.0,0.0,0.0,0.0,0.0,0.0,0.0,0.0,0.0,0.0,0.0,0.0,0.0,0.0,0.0,0.0,3.0,0.0,0.0,58500.0,25321.5,0.0,0.0,0.0,0.0,-137.0,122.0,-31.0,-123.0,21.0,-3.0,2.0,4813.2,22308.75,20076.75,4464.0,44617.5,12.0,-536.0,365243.0,-706.0,-466.0,-376.0,-460.0,10.5,0.0,0.1089640122862512,18.0,11.0,12.0,7.5,-20.0,0.0,0.0,9.0,4813.2,4813.2,-585.0,-586.0,5.0,1.0,0.0,,,,,,,,,,,,,,,,,,,,,8335569492.0,184201269763.5,165408275997.0,51905349460.935,1862.0,1703.0,71122.0,70613.0,9140.0,505366.0,,,,,,,128238.0,661940.0,,,,13510783.830136584,-601113160.0,-920720009.0,-296081974.0,-1533256166.0416667,43951.0,30658.0,,,,,,,67349.14366869537,157836.7584922204,125947.452538831,,,,,,,3709505.0,,,,,,,,,,,,,,,,435875.0,430679.0,,6416.946978002898,631136.0,624696.0,,,,,,,,,5.0,24817.5,8405.145,4152158.865,1385554.5,841988.565,0.0,0.0,0.0,-19984.0,-3476.0,-9111.0,-11967.0,-2.0,0.0,0.0,58500.0,0.0,0.0,0.0,0.0,0.0,-373.0,-128.0,-121.0,-123.0,193035.195,1556790.75,1695597.75,18729.0,1579099.5,78.0,-7769.5,2556701.0,-7587.0,-5997.0,-5457.0,-5945.0,86.5,2.0,0.5253584008983977,2169.5,856.0,520.5,-2304.0,7.0,7.0,1937883.780000001,1937883.780000001,-61396.0,-60655.0,364.0,64.0,,,,,,,,,,,,,,,,,,,,,1465299.0,14701805.0,3227923.0,8543030.0,11591188.0,1413633.0,1056351330.0720012,800957528.212495,72012257008.9871,21651289954.897617,581629070.546999,5792395.7475,689.5,94245.0,-276567663.0,21850937.5,-123633687.0,-218428018.0,-2012088.0,,,,,,,,,,,,,,,,,,,,,4267109.0,2475895.0,-8991661.0,921269.0,37582.5,3728447921.317464,3653014275.787461,-260289550.5,-256983145.0,2523138.0,268847.5,3920988432.847454,33214307723.52841,36639410625.83264,1727441301.2400494,48023167818.12822,3982819.5,-247269964.0,102949800160.0,1052350239.5,17255670314.0,3499504676.0,18868950775.5,3667318.5,71820.5,20847.64449930357,89666183.5,-90.3003210806023,2.2501818181818183,5.699481865284973,282.0696997657747,12.824870466321244,634.7081098729503,49500.0,-0.9009688679024191,-0.433883739117558,0.0,0.0,0.0,0.0,0.0,0.0,1.0,0.0,0.0,0.0,0.0,0.0,0.0,1.0,0.0,0.0,0.0,0.0,1.0,0.0,1.0,0.0,0.0,0.0,0.0,1.0,0.0,0.0,0.0,0.0,0.0,0.0,0.0,0.0,0.0,0.0,0.0,0.0,0.0,1.0,0.0,0.0,0.0,0.0,0.0,0.0,0.0,0.0,0.0,0.0,0.0,0.0,0.0,0.0,0.0,0.0,0.0,0.0,0.0,0.0,0.0,0.0,0.0,0.0,0.0,0.0,0.0,0.0,0.0,0.0,0.0,0.0,0.0,0.0,0.0,0.0,0.0,0.0,0.0,0.0,0.0,0.0,0.0,0.0,0.0,0.0,0.0,0.0,0.0,0.0,1.0,0.0,0.0,0.0,0.0,0.0,0.0,0.0,0.0,0.0,0.0,0.0,0.0,0.0,0.0,0.0,0.0,0.0,0.0,0.0,0.0,0.0,0.0,0.0,0.0,0.0,0.0,0.0,0.0,0.0
100013,0,0.0,1.0,1.0,1.0,0.0,202500.0,663264.0,69777.0,630000.0,0.019101,54.89863013698629,-4458.0,-2175.0,-3503.0,5.0,2.0,2.0,2.0,14.0,,0.6997868302051784,0.6109913280868294,,,,,,,,,,,,,,,,,,,,,,,,,,,,,,,,,,,,,,,,,,,,,0.0,0.0,0.0,0.0,-856.0,0.0,0.0,0.0,0.0,1.0,4.0,1.0,1.0,0.0,1.0,0.0,0.0,0.0,0.0,0.0,0.0,0.0,0.0,0.0,0.0,0.0,0.0,0.0,0.0,1.0,0.0,0.0,0.0,0.0,0.0,0.0,0.0,0.0,0.0,0.0,0.0,0.0,0.0,4.0,0.0,19305.0,391770.0,0.0,,0.0,0.0,0.0,-1835.0,-999.0,-882.0,-1168.0,230.0,-28.0,4.0,6538.185,36742.5,36083.25,3375.0,51030.0,10.0,-564.5,365243.0,-826.0,-346.0,-92.0,-344.0,14.0,0.0,0.0672167694057094,14.5,36.0,13.0,9.0,-21.5,0.0,0.0,155.0,1125.0,688.545,-1383.0,-1383.0,37.0,0.0,96.0,0.0,157500.0,0.0,0.0,0.0,0.0,0.0,274.32,0.0,0.0,0.0,0.0,0.0,0.0,0.0,0.0,22.0,-48.5,0.0,0.0,8335639269.0,184201933027.5,165408905997.0,51905551960.935,1862.0,1703.0,71122.0,70614.0,9140.0,505370.0,,,,,,,128238.0,661942.0,,,,13510838.72876672,-601117618.0,-920723512.0,-296082830.0,-1533258341.0416667,43951.0,30658.0,,,,,,,,157837.4582790506,125948.06353015908,,,,,,,3709519.0,,,,,,,,,,,,,,,,435875.0,430679.0,1261349.0,6416.966079002898,631138.0,624698.0,,,,,,,,,60.5,29079.0,37857.375,11775375.225,3076290.0,,0.0,0.0,0.0,-61437.5,-26521.5,-35555.5,-39688.5,-29.75,0.0,19305.0,688500.0,0.0,,0.0,0.0,0.0,-2005.0,-909.0,-1215.0,-1218.0,676285.605,7797129.84,8530636.5,193227.84,8022129.84,600.0,-41182.0,12781228.0,328915.0,1434834.0,709723.0,1803825.0,607.0,11.0,2.443810891379226,24589.5,6480.0,3242.0,-15630.0,43608.0,33.0,8913962.74500005,8450075.205000035,-506733.0,-504298.0,7860.0,453.0,5265179.235,19552500.0,598500.0,598500.0,0.0,0.0,360435.24,563314.7249999992,523485.0,5051109.555000002,5259844.845,5259844.845,19.0,19.0,0.0,0.0,2730.0,-5047.0,1.0,1.0,1465303.0,14702035.0,3228019.0,8543066.0,11591343.0,1413637.0,1056351330.0720012,800976833.212495,72012648778.9871,21651289954.897617,,5792395.7475,689.5,94245.0,-276569498.0,21849938.5,-123634569.0,-218429186.0,-2012116.0,5914346851.597462,18692907750.0,198601820.325,447309095.96249765,1948107.735,256425689.1375008,308695141.95749867,635496980.107498,458371114.6724992,5699823431.445028,5877706652.437498,5877949835.182499,13363.0,80713.5,44.0,70241.0,970241.5,-1696054.0,177364.0,6755.0,4267122.0,2475904.0,-8991682.5,921269.0,37582.5,3728449046.317464,3653014964.332461,-260290933.5,-256984528.0,2523175.0,268847.5,3920994971.032454,33214344466.02841,36639446709.08264,1727444676.2400494,48023218848.12822,3982829.5,-247270528.5,102950165403.0,1052349413.5,17255669968.0,3499504584.0,18868950431.5,3667332.5,71820.5,20847.711716072976,89666198.0,-81.20421199720532,3.2753777777777784,2.90210241196956,159.32144693437272,9.505481749000388,521.8379268122459,101250.0,1.0,0.0,0.0,0.0,0.0,0.0,0.0,0.0,0.0,0.0,0.0,0.0,0.0,0.0,0.0,1.0,0.0,1.0,0.0,0.0,0.0,0.0,1.0,0.0,0.0,0.0,0.0,1.0,0.0,0.0,0.0,0.0,0.0,0.0,0.0,0.0,1.0,0.0,0.0,0.0,0.0,0.0,0.0,0.0,0.0,0.0,0.0,0.0,0.0,0.0,0.0,0.0,0.0,0.0,0.0,0.0,0.0,0.0,0.0,0.0,0.0,0.0,0.0,0.0,0.0,0.0,0.0,0.0,0.0,0.0,0.0,0.0,0.0,0.0,0.0,0.0,0.0,0.0,0.0,0.0,0.0,0.0,0.0,0.0,0.0,0.0,0.0,0.0,0.0,0.0,0.0,0.0,0.0,0.0,0.0,0.0,0.0,0.0,0.0,0.0,0.0,0.0,0.0,0.0,1.0,0.0,0.0,0.0,0.0,0.0,0.0,0.0,0.0,0.0,0.0,0.0,0.0,0.0,0.0,0.0,0.0,0.0
100028,0,0.0,0.0,0.0,1.0,2.0,315000.0,1575000.0,49018.5,1575000.0,0.026392,38.29041095890411,-1866.0,-2000.0,-4208.0,,4.0,2.0,2.0,11.0,0.5257339776824489,0.5096770801723647,0.6127042441012546,0.3052,0.1974,0.997,0.9592,0.1165,0.32,0.2759,0.375,0.0417,0.2042,0.2404,0.3673,0.0386,0.08,0.3109,0.2049,0.997,0.9608,0.1176,0.3222,0.2759,0.375,0.0417,0.2089,0.2626,0.3827,0.0389,0.0847,0.3081,0.1974,0.997,0.9597,0.1173,0.32,0.2759,0.375,0.0417,0.2078,0.2446,0.3739,0.0388,0.0817,0.37,1.0,0.0,0.0,0.0,0.0,-1805.0,0.0,0.0,0.0,0.0,0.0,3.0,1.0,1.0,0.0,1.0,1.0,0.0,0.0,0.0,0.0,0.0,0.0,0.0,0.0,1.0,0.0,0.0,0.0,0.0,0.0,0.0,0.0,0.0,0.0,0.0,0.0,0.0,0.0,0.0,0.0,0.0,0.0,0.0,12.0,0.0,0.0,129614.04,0.0,0.0,0.0,0.0,0.0,-1612.0,-896.5,-683.5,-1375.0,560.0,-25.5,5.0,6996.735,49315.5,59521.5,0.0,65956.5,10.0,-998.0,365243.0,-1274.0,-646.0,-496.0,-614.0,11.0,0.0,0.0,50.0,31.0,24.0,9.0,-44.0,0.0,0.0,113.0,5897.52,4650.3,-812.0,-812.0,26.0,0.0,49.0,7431.3,225000.0,0.0,5021.01,0.0,5388.637500000002,7134.5475000000015,7200.0,6750.0,6750.0,7311.33,7311.33,0.0,2.0,0.0,2.0,19.5,-25.0,0.0,0.0,8335688287.5,184203508027.5,165410480997.0,51905866960.935,1862.0,1703.0,71122.0,70614.0,9140.0,505373.0,17786.283300002302,17848.289199999115,17300.2039999981,11282.287900000088,11220.115800000092,11167.599300000056,128240.0,661946.0,4134.033900000122,4131.661500000017,3942.482000000096,13510877.01917768,-601119484.0,-920727720.0,-296084635.0,-1533260341.0416667,43951.0,30658.0,11337.499999999169,11213.459999998962,10698.135299997302,22860.27380000959,22782.11700000955,22168.312700008104,67349.66940267307,157837.96795613074,125948.6762344032,34957.684700027865,34898.156700028296,34344.8406000287,22926.53679999593,22899.984299995507,22547.373399995744,3709530.0,8286.462600000175,8390.843100000078,8114.63510000023,9806.666300000725,9921.46650000216,10280.590299999643,16449.33509999975,16634.3098999997,16231.238099999708,828.0235000001754,813.2042000000458,759.1912000000133,3908.589200000125,3891.79810000016,3724.531200000155,435875.0,430679.0,,6416.992471002896,631140.0,624700.0,,16313.1502999998,153993.21859999062,153995.9600999901,153887.77199998722,77519.54439999627,77856.9190000066,78257.76930000643,53.5,84703.5,73508.04,30457384.245,10433394.27,1111988.565,0.0,0.0,0.0,-125793.0,-9627.0,-72854.0,-80361.0,-26.25,0.0,0.0,130257.0,0.0,0.0,0.0,0.0,0.0,-1821.0,-1375.0,-913.0,-1375.0,1415756.7450000003,14912706.96,16963804.62,432087.84,14912706.96,1098.0,-85356.0,25563410.0,1387860.0,5059569.0,1782102.0,5063249.0,1217.0,22.0,4.587671399776443,54820.0,11437.0,6187.0,-28596.0,43621.0,46.0,16474288.995000048,15552120.780000046,-1004977.0,-999362.0,16476.0,781.0,5944720.544999997,44595000.0,760500.0,869259.375,0.0,108759.375,544438.26,1182440.5199999977,1120196.4299999997,5694569.909999997,5932777.994999997,5932777.994999997,28.0,67.0,0.0,39.0,3989.5,-8373.0,1.0,1.0,1465315.0,14702595.0,3228068.0,8543097.0,11591456.0,1413642.0,1056351330.0720012,800976833.212495,72012778393.0271,21651289954.897617,581629070.546999,5792395.7475,689.5,94245.0,-276571110.0,21849042.0,-123635252.5,-218430561.0,-2012141.5,5914354282.897462,18693132750.0,198601820.325,447314116.9724976,1948107.735,256431077.7750008,308702276.50499874,635504180.107498,458377864.6724992,5699830181.445028,5877713963.767498,5877957146.512499,13363.0,80715.5,44.0,70243.0,970261.0,-1696079.0,177364.0,6755.0,4267146.0,2475913.0,-8991726.5,921269.0,37582.5,3728454943.837464,3653019614.632461,-260291745.5,-256985340.0,2523201.0,268847.5,3921001967.7674537,33214393781.52841,36639506230.58264,1727444676.2400494,48023284804.62822,3982839.5,-247271526.5,102950530646.0,1052348139.5,17255669322.0,3499504088.0,18868949817.5,3667343.5,71820.5,20847.711716072976,89666248.0,-48.73282770463653,5.0,6.426145230882218,246.05974177208188,32.13072615441109,1230.2987088604095,78750.0,-0.2225209339563143,0.9749279121818236,0.0,0.0,0.0,0.0,0.0,0.0,1.0,0.0,0.0,0.0,0.0,0.0,0.0,1.0,0.0,0.0,0.0,0.0,1.0,0.0,1.0,0.0,0.0,0.0,0.0,1.0,0.0,0.0,0.0,0.0,0.0,0.0,0.0,0.0,0.0,0.0,0.0,0.0,0.0,0.0,0.0,0.0,0.0,0.0,1.0,0.0,0.0,0.0,0.0,0.0,0.0,0.0,0.0,1.0,0.0,0.0,0.0,0.0,0.0,0.0,0.0,0.0,0.0,0.0,0.0,0.0,0.0,0.0,0.0,0.0,0.0,0.0,0.0,0.0,0.0,0.0,0.0,0.0,0.0,0.0,0.0,0.0,0.0,0.0,0.0,0.0,0.0,0.0,0.0,0.0,0.0,0.0,0.0,0.0,0.0,0.0,0.0,0.0,0.0,0.0,0.0,0.0,0.0,0.0,0.0,0.0,0.0,0.0,1.0,0.0,1.0,0.0,0.0,0.0,0.0,0.0,0.0,1.0,0.0,0.0
100038,0,0.0,1.0,1.0,0.0,1.0,180000.0,625500.0,32067.0,625500.0,0.010032,35.726027397260275,-2191.0,-4000.0,-4262.0,16.0,3.0,2.0,2.0,5.0,0.202144992067999,0.4256872940912229,,,,,,,,,,,,,,,,,,,,,,,,,,,,,,,,,,,,,,,,,,,,,,0.0,0.0,0.0,0.0,-821.0,,,,,,,1.0,1.0,1.0,1.0,0.0,0.0,0.0,0.0,0.0,0.0,1.0,1.0,0.0,1.0,0.0,0.0,0.0,0.0,0.0,0.0,0.0,0.0,0.0,0.0,0.0,0.0,0.0,0.0,0.0,0.0,0.0,0.0,0.0,,,,,,,,,,,,,0.0,,2.0,17782.155,267727.5,300550.5,8095.5,267727.5,24.0,-466.0,365243.0,-787.0,-457.0,-457.0,-449.0,5.5,0.0,0.0875536037829361,13.0,13.0,12.0,6.0,-21.0,0.0,0.0,12.0,11100.6,11100.6,-634.0,-622.0,6.5,1.0,0.0,,,,,,,,,,,,,,,,,,,,,8335720354.5,184204133527.5,165411106497.0,51906046960.935,,,,,,,,,,,,,128241.0,661949.0,,,,13510912.745205076,-601121675.0,-920731982.0,-296085456.0,-1533264341.0416667,43951.0,30658.0,,,,,,,67349.87154766514,157838.39364342488,,,,,,,,3709535.0,,,,,,,,,,,,,,,,435875.0,430679.0,1261365.0,6417.002503002896,631142.0,624702.0,,,,,,,,,,,,,,,,,,,,,,,,,,,,,,,,,,,1887689.5200000005,21198068.685,23491880.595000006,524657.34,21198068.685,1627.0,-135531.5,33598756.0,1728699.0,5404938.0,2129571.0,5408944.0,1886.0,29.0,6.1364394383261285,94263.5,13545.0,7336.0,-35250.0,43653.0,49.0,20120185.800000027,19047099.37500002,-1220233.5,-1213141.5,20036.5,1100.5,,,,,,,,,,,,,,,,,,,,,1465315.0,14702595.0,3228068.0,8543110.0,11591468.0,1413644.0,,,,,,,,,,,,,,,,,,,,,,,,,,,,,,,,,,4267158.0,2475919.0,-8991747.5,921269.0,37582.5,3728466044.437464,3653030715.232461,-260292379.5,-256985962.0,2523207.5,268848.5,3921019749.922455,33214661509.02841,36639806781.08264,1727452771.7400494,48023552532.12822,3982863.5,-247271992.5,102950895889.0,1052347352.5,17255668865.0,3499503631.0,18868949368.5,3667349.0,71820.5,20847.79926967676,89666261.0,-61.32783742331289,3.475,5.613247263541959,200.53902552489632,19.506034240808308,696.8731136990148,60000.0,-0.9009688679024191,-0.433883739117558,0.0,0.0,0.0,0.0,0.0,0.0,1.0,0.0,0.0,0.0,0.0,0.0,0.0,1.0,0.0,0.0,0.0,0.0,1.0,0.0,1.0,0.0,0.0,0.0,0.0,1.0,0.0,0.0,0.0,0.0,0.0,0.0,0.0,0.0,0.0,0.0,0.0,0.0,0.0,0.0,0.0,0.0,0.0,0.0,0.0,0.0,0.0,0.0,0.0,0.0,0.0,0.0,0.0,1.0,0.0,0.0,0.0,0.0,0.0,0.0,0.0,0.0,0.0,0.0,0.0,0.0,0.0,0.0,0.0,0.0,0.0,0.0,0.0,0.0,0.0,0.0,0.0,0.0,0.0,0.0,0.0,0.0,0.0,0.0,0.0,0.0,0.0,0.0,0.0,0.0,0.0,0.0,0.0,0.0,0.0,0.0,0.0,0.0,0.0,0.0,0.0,0.0,0.0,0.0,0.0,0.0,0.0,0.0,0.0,0.0,0.0,0.0,0.0,0.0,0.0,0.0,0.0,0.0,0.0,0.0
100042,0,0.0,0.0,1.0,1.0,0.0,270000.0,959688.0,34600.5,810000.0,0.025164,50.96986301369864,-12009.0,-6116.0,-2027.0,10.0,2.0,2.0,2.0,15.0,,0.6289043246811542,0.3927738606031339,0.2412,0.0084,0.9821,0.7552,0.0452,0.16,0.1379,0.3333,0.375,0.1683,0.1942,0.2218,0.0116,0.0731,0.2458,0.0088,0.9821,0.7648,0.0457,0.1611,0.1379,0.3333,0.375,0.1721,0.2121,0.2311,0.0117,0.0774,0.2436,0.0084,0.9821,0.7585,0.0455,0.16,0.1379,0.3333,0.375,0.1712,0.1975,0.2258,0.0116,0.0746,0.2151,1.0,0.0,0.0,0.0,0.0,-1705.0,0.0,0.0,0.0,0.0,1.0,2.0,1.0,1.0,0.0,1.0,1.0,0.0,0.0,0.0,0.0,0.0,0.0,0.0,0.0,0.0,0.0,0.0,0.0,0.0,1.0,0.0,0.0,0.0,0.0,0.0,0.0,0.0,0.0,0.0,0.0,0.0,0.0,0.0,14.0,15052.5,0.0,562500.0,32980.5,0.0,0.0,0.0,0.0,-1382.5,263.0,-346.0,-1312.5,615.0,-26.0,9.0,19148.985,225000.0,247275.0,0.0,270000.0,18.0,-1931.0,365243.0,-1901.0,-1356.0,-985.0,-1338.0,13.0,1.0,0.0,-1.0,65.0,11.0,10.0,-55.0,0.0,0.0,182.0,4500.0,4500.0,-1612.0,-1605.5,29.5,0.0,84.0,0.0,90000.0,0.0,0.0,0.0,0.0,0.0,32.85,0.0,0.0,0.0,0.0,0.0,0.0,0.0,0.0,39.0,-42.5,0.0,0.0,8335754955.0,184205093215.5,165411916497.0,51906316960.935,1862.0,1703.0,71122.0,70615.0,9140.0,505375.0,17786.524500002302,17848.532799999117,17300.4497999981,11282.296300000087,11220.124200000091,11167.608100000056,128241.0,661951.0,4134.079100000122,4131.707000000018,3942.527700000096,13510963.71506809,-601133684.0,-920734009.0,-296087161.0,-1533270457.0416667,43951.0,30658.0,11337.659999999169,11213.619999998962,10698.296399997302,22860.411700009598,22782.25490000956,22168.450600008106,,157839.02254774954,125949.0690082638,34958.018000027856,34898.490000028294,34345.1739000287,22926.91179999593,22900.359299995507,22547.748399995744,3709550.0,8286.630900000173,8391.014300000079,8114.807200000229,9806.860500000725,9921.66400000216,10280.802399999646,16449.556899999752,16634.5356999997,16231.469199999709,828.0351000001756,813.2158000000458,759.2029000000133,3908.662300000125,3891.87270000016,3724.608600000157,435875.0,430679.0,1261375.0,6417.027667002897,631144.0,624704.0,,16313.3653999998,153994.20069999062,153996.9421999901,153888.7540999872,77520.29959999627,77857.6775000066,78258.53410000644,46.0,224481.825,136241.955,59568904.125,21120348.375000004,1239035.355,0.0,0.0,0.0,-212607.5,-30481.0,-127998.0,-134487.5,-22.5,0.0,999.0,450000.0,0.0,0.0,0.0,0.0,0.0,-2000.0,-910.0,-887.0,-1931.0,2087613.450000001,24725874.78,27277129.845000006,534457.9349999999,24568374.78,1829.0,-156158.0,37248639.0,1710145.0,5389024.0,2119870.0,5398172.0,2043.0,36.0,6.238003428977707,108430.0,15178.0,8274.0,-41593.0,43678.0,49.0,24086743.02000003,23451360.615000047,-1487114.5,-1478033.5,23604.0,1273.0,7776584.279999997,54225000.0,956250.0,1355471.01,101124.0,298097.0100000001,770702.2650000001,1671532.6049999995,1598705.0099999998,7444923.479999998,7757529.929999998,7757529.929999998,41.0,164.0,2.0,121.0,5625.0,-10824.5,2.0,1.0,1465329.0,14703210.0,3228152.0,8543175.0,11591650.0,1413653.0,1056366382.5720012,800976833.212495,72013340893.0271,21651322935.397617,581629070.546999,5792395.7475,689.5,94245.0,-276572492.5,21849305.0,-123635598.5,-218431873.5,-2012167.5,5914354282.897462,18693222750.0,198601820.325,447314116.9724976,1948107.735,256431077.7750008,308702276.50499874,635504212.9574982,458377864.6724992,5699830181.445028,5877713963.767498,5877957146.512499,13363.0,80715.5,44.0,70243.0,970300.0,-1696121.5,177364.0,6755.0,4267169.0,2475929.0,-8991802.5,921269.0,37582.5,3728470544.437464,3653035215.232461,-260293991.5,-256987567.5,2523237.0,268848.5,3921038898.907455,33214886509.02841,36640054056.08264,1727452771.7400494,48023822532.12822,3982881.5,-247273923.5,102951261132.0,1052345451.5,17255667509.0,3499502646.0,18868948030.5,3667362.0,71821.5,20847.79926967676,89666260.0,-235.60981509352828,3.5544,7.803355442840421,397.7359579687758,27.73624658603199,1413.7126890042166,135000.0,1.0,0.0,0.0,0.0,0.0,0.0,0.0,0.0,1.0,0.0,0.0,0.0,1.0,0.0,0.0,0.0,0.0,0.0,0.0,0.0,1.0,0.0,1.0,0.0,0.0,0.0,0.0,1.0,0.0,0.0,0.0,0.0,0.0,0.0,0.0,0.0,1.0,0.0,0.0,0.0,0.0,0.0,0.0,0.0,0.0,0.0,0.0,0.0,0.0,0.0,0.0,0.0,0.0,0.0,0.0,0.0,0.0,0.0,0.0,0.0,0.0,1.0,0.0,0.0,0.0,0.0,0.0,0.0,0.0,0.0,0.0,0.0,0.0,0.0,0.0,0.0,0.0,0.0,0.0,0.0,0.0,0.0,0.0,0.0,0.0,0.0,0.0,0.0,0.0,0.0,0.0,0.0,0.0,0.0,0.0,0.0,0.0,0.0,0.0,0.0,0.0,0.0,0.0,0.0,0.0,0.0,0.0,0.0,1.0,0.0,0.0,0.0,1.0,0.0,0.0,1.0,0.0,0.0,0.0,0.0,0.0,0.0
100057,0,0.0,1.0,1.0,1.0,2.0,180000.0,499221.0,22117.5,373500.0,0.0228,45.71232876712329,-2580.0,-10125.0,-241.0,3.0,4.0,2.0,2.0,9.0,0.7608510178380521,0.57108420610083,0.6512602186973006,,,,,,,,,,,,,,,,,,,,,,,,,,,,,,,,,,,,,,,,,,,,,1.0,0.0,1.0,0.0,-1182.0,0.0,0.0,0.0,0.0,0.0,1.0,1.0,1.0,0.0,1.0,0.0,0.0,0.0,0.0,0.0,0.0,1.0,1.0,0.0,1.0,0.0,0.0,0.0,0.0,0.0,0.0,0.0,0.0,0.0,0.0,0.0,0.0,0.0,0.0,0.0,0.0,0.0,0.0,8.0,0.0,0.0,74359.8,0.0,0.0,0.0,0.0,0.0,-1487.0,-44.0,-650.5,-443.0,367.0,-26.0,4.0,6357.24,45280.35,39400.875,2882.25,45280.35,9.0,-736.0,365243.0,-252.0,-162.0,78.0,-158.0,14.0,0.0,0.105964260560949,59.0,13.0,6.5,6.0,-9.0,0.0,0.0,10.0,6357.24,6357.24,-259.0,-237.0,2.0,1.0,0.0,,,,,,,,,,,,,,,,,,,,,8335777072.5,184205592436.5,165412289997.0,51906496960.935,1862.0,1703.0,71122.0,70615.0,9140.0,505376.0,,,,,,,128243.0,661955.0,,,,13511009.427396858,-601136264.0,-920734250.0,-296088343.0,-1533280582.0416667,43951.0,30658.0,,,,,,,67350.63239868298,157839.59363195568,125949.72026848247,,,,,,,3709559.0,,,,,,,,,,,,,,,,435876.0,430680.0,1261378.0,6417.050467002897,631146.0,624706.0,,,,,,,,,49.5,348720.075,203065.065,97541352.72,29625482.385,1914063.48,0.0,0.0,0.0,-299898.5,-39006.0,-170047.5,-177448.0,-24.25,0.0,0.0,67500.0,0.0,0.0,0.0,0.0,0.0,-1542.0,-2312.0,-1089.0,-2312.0,3235014.8550000004,43952073.48,48911995.845,1267731.135,43952073.48,2912.0,-216282.0,52221462.0,2392593.0,9373546.0,4284699.0,9744841.0,2808.0,54.0,8.328345346790321,115856.0,27771.5,15912.5,-60225.0,43690.0,61.0,38372825.542499706,37075432.88249978,-2210122.5,-2194539.0,35784.5,1819.5,,,,,,,,,,,,,,,,,,,,,1465337.0,14703577.0,3228152.0,8543188.0,11591660.0,1413657.0,1056366382.5720012,800976833.212495,72013415252.8271,21651322935.397617,581629070.546999,5792395.7475,689.5,94245.0,-276573979.5,21849261.0,-123636249.0,-218432316.5,-2012193.5,,,,,,,,,,,,,,,,,,,,,4267175.5,2475935.0,-8991811.5,921269.0,37582.5,3728476901.677464,3653041572.4724607,-260294250.5,-256987804.5,2523239.0,268849.5,3921045256.147455,33214931789.37841,36640093456.957634,1727455653.9900494,48023867812.47822,3982890.5,-247274659.5,102951626375.0,1052345199.5,17255667347.0,3499502724.0,18868947872.5,3667376.0,71821.5,20847.90523393732,89666319.0,-56.43991609229847,2.77345,8.138351983723298,372.0230215025292,22.57131230925737,1031.78724898619,45000.0,-0.9009688679024191,0.4338837391175582,0.0,0.0,0.0,0.0,0.0,0.0,1.0,0.0,0.0,0.0,0.0,0.0,0.0,1.0,0.0,1.0,0.0,0.0,0.0,0.0,1.0,0.0,0.0,0.0,0.0,1.0,0.0,0.0,0.0,0.0,0.0,0.0,0.0,0.0,0.0,0.0,1.0,0.0,0.0,0.0,0.0,0.0,0.0,0.0,0.0,0.0,0.0,0.0,0.0,0.0,0.0,0.0,0.0,0.0,0.0,0.0,0.0,0.0,0.0,0.0,0.0,0.0,0.0,0.0,0.0,0.0,0.0,0.0,0.0,0.0,0.0,0.0,0.0,0.0,1.0,0.0,0.0,0.0,0.0,0.0,0.0,0.0,0.0,0.0,0.0,0.0,0.0,0.0,0.0,0.0,0.0,0.0,0.0,0.0,0.0,0.0,0.0,0.0,0.0,0.0,0.0,0.0,0.0,0.0,0.0,0.0,0.0,0.0,0.0,0.0,0.0,0.0,0.0,0.0,0.0,0.0,0.0,0.0,0.0,0.0
100065,0,0.0,1.0,0.0,1.0,0.0,166500.0,180000.0,14220.0,180000.0,0.005144,26.07123287671233,-1387.0,-5063.0,-2055.0,,1.0,2.0,2.0,7.0,0.5652899888198399,0.6130330592407085,0.3123653692278984,,,,,,,,,,,,,,,,,,,,,,,,,,,,,,,,,,,,,,,,,,,,,0.0,0.0,0.0,0.0,-1182.0,0.0,0.0,0.0,0.0,0.0,2.0,1.0,1.0,1.0,1.0,1.0,0.0,0.0,0.0,0.0,0.0,0.0,0.0,0.0,0.0,0.0,0.0,0.0,0.0,1.0,0.0,0.0,0.0,0.0,0.0,0.0,0.0,0.0,0.0,0.0,0.0,0.0,0.0,13.0,0.0,0.0,90805.5,0.0,1390.6125,0.0,0.0,0.0,-717.0,-414.0,-480.0,-519.0,310.0,-13.0,2.0,18150.705,58590.0,41013.0,35154.0,117180.0,5.0,-888.0,365243.0,-1151.0,-1031.0,-1031.0,-1027.0,14.5,0.0,0.3267272727272727,77.5,6.0,5.0,2.5,-36.5,0.0,0.0,5.0,18150.705,18150.705,-1105.0,-1091.0,3.0,1.0,0.0,,,,,,,,,,,,,,,,,,,,,8335791292.5,184205772436.5,165412469997.0,51906663460.935,1862.0,1703.0,71122.0,70615.0,9140.0,505378.0,,,,,,,128243.0,661956.0,,,,13511035.498629736,-601137651.0,-920736305.0,-296089525.0,-1533285645.0416667,43951.0,30658.0,,,,,,,67351.1976886718,157840.2066650149,125950.03263385172,,,,,,,3709566.0,,,,,,,,,,,,,,,,435876.0,430680.0,,6417.0556110028965,631148.0,624708.0,,,,,,,,,24.0,464931.585,222655.005,107925009.48,32672384.505,1916844.705,0.0,0.0,0.0,-351925.0,-24758.0,-197086.0,-206233.0,-11.5,0.0,0.0,70425.945,0.0,0.0,0.0,0.0,0.0,-939.0,-533.0,-516.0,-595.0,4116614.580000002,56091816.54,62263560.645,1479034.395,56150406.54,3629.0,-256206.0,59891565.0,2739606.0,10456868.0,4642874.0,10462865.0,3492.5,58.0,10.05259886942893,140115.0,32190.5,18896.0,-64252.0,43739.0,85.0,45304209.04499958,44141579.50499965,-2326229.0,-2308842.0,37573.0,2095.0,,,,,,,,,,,,,,,,,,,,,1465350.0,14703887.0,3228152.0,8543194.0,11591665.0,1413659.0,1056366382.5720012,800976833.212495,72013506058.3271,21651322935.397617,581630461.1594988,5792395.7475,689.5,94245.0,-276574696.5,21848847.0,-123636729.0,-218432835.5,-2012206.5,,,,,,,,,,,,,,,,,,,,,4267180.5,2475937.5,-8991848.0,921269.0,37582.5,3728495052.382464,3653059723.177461,-260295355.5,-256988895.5,2523242.0,268850.5,3921063406.8524537,33214990379.37841,36640134469.957634,1727490807.9900494,48023984992.47822,3982895.5,-247275547.5,102951991618.0,1052344048.5,17255666316.0,3499501693.0,18868946845.5,3667390.5,71821.5,20848.231961210047,89666396.5,-53.20039932744851,1.0810810810810811,11.708860759493673,305.26443558175833,12.658227848101266,330.0156060343333,166500.0,-0.9009688679024191,-0.433883739117558,0.0,0.0,0.0,0.0,0.0,0.0,1.0,0.0,0.0,0.0,0.0,0.0,0.0,1.0,0.0,1.0,0.0,0.0,0.0,0.0,0.0,0.0,1.0,0.0,0.0,0.0,0.0,0.0,0.0,1.0,0.0,0.0,0.0,1.0,0.0,0.0,0.0,0.0,0.0,0.0,0.0,0.0,0.0,0.0,0.0,0.0,0.0,0.0,0.0,0.0,0.0,0.0,0.0,0.0,0.0,0.0,0.0,0.0,0.0,0.0,0.0,0.0,0.0,0.0,0.0,0.0,0.0,0.0,0.0,0.0,0.0,0.0,0.0,0.0,0.0,0.0,0.0,0.0,0.0,0.0,0.0,0.0,0.0,0.0,0.0,0.0,0.0,0.0,0.0,0.0,1.0,0.0,0.0,0.0,0.0,0.0,0.0,0.0,0.0,0.0,0.0,0.0,0.0,0.0,0.0,0.0,0.0,0.0,0.0,0.0,0.0,0.0,0.0,0.0,0.0,0.0,0.0,0.0,0.0,0.0
100066,0,0.0,0.0,0.0,1.0,0.0,315000.0,364896.0,28957.5,315000.0,0.04622,34.915068493150685,-1013.0,-1686.0,-3171.0,,2.0,1.0,1.0,18.0,0.7185074765991686,0.8087877917779122,0.5226973172821112,0.1031,0.1115,0.9781,,,0.0,0.2069,0.1667,,,,,,,0.105,0.1157,0.9782,,,0.0,0.2069,0.1667,,,,,,,0.1041,0.1115,0.9781,,,0.0,0.2069,0.1667,,,,,,,0.0702,1.0,0.0,0.0,0.0,0.0,-829.0,0.0,0.0,0.0,0.0,0.0,5.0,1.0,1.0,0.0,1.0,0.0,0.0,0.0,0.0,0.0,0.0,0.0,0.0,0.0,1.0,0.0,0.0,0.0,0.0,0.0,0.0,0.0,0.0,0.0,0.0,0.0,0.0,0.0,0.0,0.0,0.0,0.0,0.0,3.0,0.0,,297000.0,0.0,0.0,0.0,0.0,0.0,-491.0,1152.0,-201.0,-315.0,56.0,-9.0,9.0,10064.745,68791.5,76054.5,0.0,96131.25,12.0,-324.0,365243.0,-420.0,-90.0,-90.0,-88.0,13.0,0.0,0.0,-1.0,49.0,12.0,8.0,-13.0,0.0,0.0,45.0,10729.44,10729.44,-388.0,-378.0,6.0,1.0,15.0,0.0,45000.0,,0.0,,,0.0,,0.0,0.0,0.0,0.0,,0.0,,,0.0,-8.0,0.0,0.0,8335820250.0,184206137332.5,165412784997.0,51906978460.935,1862.0,1703.0,71122.0,70615.0,9140.0,505383.0,17786.627600002306,17848.636899999117,17300.5547999981,11282.407800000088,11220.235700000096,11167.723800000056,128243.0,661958.0,,,,13511070.413698224,-601138664.0,-920739476.0,-296090354.0,-1533287331.0416667,43951.0,30658.0,11337.659999999169,11213.619999998962,10698.296399997302,22860.618600009595,22782.461800009554,22168.65750000811,67351.91619614839,157841.0154528067,125950.555331169,34958.184700027865,34898.656700028296,34345.3406000287,,,,3709584.0,,,,,,,,,,,,,,,,435876.0,430680.0,,6417.101831002897,631149.0,624709.0,,16313.4355999998,153995.17879999062,153997.9202999901,153889.7322999872,,,,17.0,503208.585,,109918672.425,33152439.24,1920013.47,0.0,0.0,0.0,-355185.0,4145.0,-198598.0,-207695.5,-8.0,0.0,,297000.0,0.0,0.0,0.0,0.0,0.0,-491.0,1152.0,-201.0,-307.0,4143537.180000001,57103308.54,63369507.645,1479034.395,56504808.54,3675.5,-259145.0,60987294.0,3102734.0,10821553.0,5007559.0,10827554.0,3570.0,59.0,10.05259886942893,140226.0,32503.0,19052.0,-64729.0,43739.0,85.0,45567758.56499953,44405129.0249996,-2338863.0,-2321230.0,37735.0,2120.0,18336521.61,89374500.0,,2682567.8550000004,,,1331409.4650000003,,2918552.76,17725671.855,18315334.17,18315334.17,,221.0,,,7667.0,-14734.0,3.0,1.0,1465353.0,14703943.0,3228167.0,8543243.0,11591710.0,1413668.0,1056366382.5720012,,72013803058.3271,21651322935.397617,581630461.1594988,5792395.7475,689.5,94245.0,-276575187.5,21849999.0,-123636930.0,-218433150.5,-2012215.5,5914354282.897462,18693267750.0,,447314116.9724976,,,308702276.50499874,,458377864.6724992,5699830181.445028,5877713963.767498,5877957146.512499,,80715.5,,,970300.0,-1696129.5,177364.0,6755.0,4267192.5,2475945.5,-8991861.0,921269.0,37582.5,3728505781.822464,3653070452.6174607,-260295743.5,-256989273.5,2523248.0,268851.5,3921073471.597454,33215059170.87841,36640210524.457634,1727490807.9900494,48024081123.72822,3982907.5,-247275871.5,102952356861.0,1052343628.5,17255666226.0,3499501603.0,18868946757.5,3667403.5,71821.5,20848.231961210047,89666395.5,-29.01326114249844,1.1584,10.878010878010876,379.806494874988,12.601087801087802,439.9678436631861,157500.0,-0.9009688679024191,0.4338837391175582,0.0,0.0,0.0,0.0,0.0,0.0,1.0,0.0,0.0,0.0,1.0,0.0,0.0,0.0,0.0,1.0,0.0,0.0,0.0,0.0,1.0,0.0,0.0,0.0,0.0,1.0,0.0,0.0,0.0,0.0,0.0,0.0,0.0,1.0,0.0,0.0,0.0,0.0,0.0,0.0,0.0,0.0,0.0,0.0,0.0,0.0,0.0,0.0,0.0,0.0,0.0,0.0,0.0,0.0,0.0,0.0,0.0,0.0,0.0,0.0,0.0,0.0,0.0,0.0,0.0,0.0,0.0,0.0,0.0,0.0,0.0,0.0,0.0,0.0,0.0,0.0,0.0,0.0,0.0,0.0,0.0,0.0,0.0,0.0,0.0,0.0,0.0,1.0,0.0,0.0,0.0,0.0,0.0,0.0,0.0,0.0,0.0,0.0,0.0,0.0,0.0,0.0,0.0,0.0,0.0,0.0,0.0,0.0,0.0,0.0,1.0,0.0,0.0,0.0,0.0,0.0,0.0,0.0,1.0,0.0
100067,0,0.0,0.0,1.0,1.0,1.0,162000.0,45000.0,5337.0,45000.0,0.018634,28.47945205479452,-2625.0,-8124.0,-3041.0,5.0,3.0,2.0,2.0,14.0,0.2105622076337031,0.4448475614048825,0.1940678276718812,,,,,,,,,,,,,,,,,,,,,,,,,,,,,,,,,,,,,,,,,,,,,4.0,0.0,4.0,0.0,-1423.0,0.0,0.0,0.0,0.0,0.0,2.0,1.0,1.0,1.0,1.0,1.0,0.0,0.0,0.0,0.0,0.0,0.0,0.0,0.0,1.0,0.0,0.0,0.0,0.0,0.0,0.0,0.0,0.0,0.0,0.0,0.0,0.0,0.0,0.0,0.0,0.0,0.0,0.0,17.0,0.0,0.0,53955.0,0.0,0.0,0.0,0.0,0.0,-539.0,-27.0,-160.0,-212.5,331.0,-11.0,23.0,9071.6175,63639.0,50908.5,12730.5,90000.0,12.0,-502.0,365243.0,-991.0,-603.0,-363.0,-597.0,11.0,0.0,0.2178643884753345,4.0,49.0,10.0,7.0,-31.0,0.0,0.0,161.0,2250.0,2250.0,-1134.0,-1134.0,37.0,0.0,87.0,35033.94,45000.0,0.0,0.0,0.0,0.0,2250.0,2250.0,2250.0,33753.6,35033.94,35033.94,0.0,0.0,0.0,0.0,40.0,-44.0,0.0,0.0,8335825587.0,184206182332.5,165412829997.0,51907140460.935,1862.0,1703.0,71122.0,70615.0,9140.0,505385.0,,,,,,,128244.0,661961.0,,,,13511098.89315028,-601141289.0,-920742517.0,-296091777.0,-1533295455.0416667,43951.0,30658.0,,,,,,,67352.12675835604,157841.4603003681,125950.74939899668,,,,,,,3709598.0,,,,,,,,,,,,,,,,435880.0,430684.0,1261383.0,6417.120465002897,631151.0,624711.0,,,,,,,,,18.0,515169.585,222655.005,111718735.425,33334126.74,1920013.47,0.0,0.0,0.0,-361388.0,35084.5,-201056.0,-209750.5,-8.5,0.0,0.0,48559.5,0.0,0.0,0.0,0.0,0.0,-763.0,198.0,-253.0,-256.0,4276094.8950000005,58933670.04,65235981.645,1518688.395,58933670.04,4010.0,-271399.0,63178752.0,3096775.0,11546490.0,5003856.0,11552514.0,3758.0,59.0,10.866591470766986,140478.0,33369.0,19684.0,-66733.0,43748.0,94.0,46217716.69499946,45055087.15499953,-2456729.0,-2438182.0,40150.0,2189.0,19601554.77,91831500.0,1328850.0,2843761.995,207931.5,1306980.4950000006,1406441.3400000003,3443228.910000004,3089903.76,18940911.79500001,19579608.989999995,19579608.989999995,64.0,256.0,5.0,187.0,9101.0,-16840.0,4.0,2.0,1465370.0,14704274.0,3228254.0,8543292.0,11591871.0,1413691.0,1056366382.5720012,800976833.212495,72013857013.3271,21651322935.397617,581630461.1594988,5792395.7475,689.5,94245.0,-276575726.5,21849972.0,-123637090.0,-218433363.0,-2012226.5,5914389316.8374605,18693312750.0,198601820.325,447314116.9724976,1948107.735,256431077.7750008,308704526.50499874,635506462.9574982,458380114.6724992,5699863935.045029,5877748997.707498,5877992180.4524975,13363.0,80715.5,44.0,70243.0,970340.0,-1696173.5,177364.0,6755.0,4267202.5,2475952.5,-8991892.0,921269.0,37582.5,3728508031.822464,3653072702.6174607,-260296877.5,-256990407.5,2523285.0,268851.5,3921082543.214954,33215122809.87841,36640261432.957634,1727503538.4900494,48024171123.72822,3982919.5,-247276373.5,102952722104.0,1052342637.5,17255665623.0,3499501240.0,18868946160.5,3667414.5,71821.5,20848.449825598524,89666399.5,-92.1717171717172,0.2777777777777778,30.354131534569984,864.4690337037123,8.431703204047217,240.13028713992009,54000.0,0.6234898018587336,0.7818314824680298,0.0,1.0,0.0,0.0,0.0,0.0,0.0,0.0,0.0,0.0,0.0,0.0,0.0,1.0,0.0,1.0,0.0,0.0,0.0,1.0,0.0,0.0,0.0,0.0,0.0,1.0,0.0,0.0,0.0,0.0,0.0,0.0,0.0,0.0,0.0,0.0,0.0,0.0,0.0,0.0,0.0,0.0,0.0,0.0,1.0,0.0,0.0,0.0,0.0,0.0,0.0,0.0,0.0,0.0,0.0,0.0,0.0,0.0,0.0,0.0,0.0,0.0,0.0,0.0,0.0,0.0,0.0,0.0,0.0,0.0,0.0,0.0,0.0,0.0,0.0,0.0,0.0,0.0,0.0,0.0,0.0,0.0,0.0,0.0,0.0,0.0,0.0,0.0,0.0,0.0,0.0,0.0,0.0,0.0,1.0,0.0,0.0,0.0,0.0,0.0,0.0,0.0,0.0,0.0,0.0,0.0,0.0,0.0,0.0,0.0,0.0,0.0,0.0,0.0,0.0,0.0,0.0,0.0,0.0,0.0
100074,0,0.0,0.0,0.0,1.0,0.0,67500.0,675000.0,25447.5,675000.0,0.0031219999999999,64.84931506849314,,-7490.0,-4136.0,,2.0,3.0,3.0,11.0,,0.6600149063064604,0.2985949897873972,0.0216,0.0545,0.9781,,,0.0,0.1034,0.0417,,0.0095,,0.0113,,,0.0221,0.0566,0.9782,,,0.0,0.1034,0.0417,,0.0097,,0.0117,,,0.0219,0.0545,0.9781,,,0.0,0.1034,0.0417,,0.0096,,0.0115,,,0.0136,1.0,0.0,0.0,0.0,0.0,-1671.0,0.0,0.0,0.0,0.0,0.0,0.0,1.0,0.0,0.0,1.0,1.0,0.0,0.0,0.0,0.0,0.0,0.0,0.0,0.0,1.0,0.0,0.0,0.0,0.0,0.0,0.0,0.0,0.0,0.0,0.0,0.0,0.0,0.0,0.0,0.0,0.0,0.0,0.0,3.0,0.0,2005.785,43785.0,0.0,0.0,0.0,0.0,0.0,-1307.0,-1002.0,-1002.0,-1005.0,146.0,-24.0,2.0,6247.62,62482.5,56234.25,6248.25,62482.5,10.0,-2193.0,365243.0,-2159.0,-1889.0,-1889.0,-1884.5,9.5,0.0,0.1089090909090909,220.0,22.0,10.0,5.0,-67.5,0.0,0.0,20.0,6240.2175,6240.2175,-2032.5,-2024.0,5.5,1.0,0.0,,,,,,,,,,,,,,,,,,,,,8335851034.5,184206857332.5,165413504997.0,51907207960.935,1862.0,1703.0,71122.0,70615.0,9140.0,505385.0,17786.649200002306,17848.658799999117,17300.576899998097,11282.462300000088,11220.290200000096,11167.780400000056,128244.0,661963.0,,,,13511163.742465349,,-920746653.0,-296093448.0,-1533302945.0416667,43951.0,30658.0,11337.659999999169,11213.619999998962,10698.296399997302,22860.722000009595,22782.565200009554,22168.76090000811,,157842.12031527446,125951.04799398645,34958.22640002786,34898.6984000283,34345.3823000287,,,,3709609.0,8286.640400000173,8391.023900000078,8114.81690000023,,,,16449.56819999975,16634.5471999997,16231.480899999708,,,,,,,435880.0,430684.0,,6417.123587002897,631154.0,624714.0,,16313.4491999998,153996.15689999063,153998.8983999901,153890.7104999872,,,,43.0,633653.595,295850.115,132925101.885,42249153.24,2409285.15,0.0,0.0,0.0,-400320.0,37245.0,-219735.0,-230335.0,-21.0,0.0,4011.57,43785.0,0.0,0.0,0.0,0.0,0.0,-1307.0,-1002.0,-1002.0,-1005.0,5019114.352499997,68923227.10499999,75314881.395,1838593.71,68923227.10499999,4579.0,-308901.5,70663605.5,3072095.0,12991513.0,5354496.0,12997633.5,4297.5,64.0,12.996457349239082,151880.0,37364.0,21922.5,-74440.0,43778.0,104.0,52376446.91249935,50740786.68749944,-2765601.0,-2745123.0,46874.5,2431.5,,,,,,,,,,,,,,,,,,,,,1465373.0,14704420.0,3228254.0,8543314.0,11591891.0,1413693.0,1056366382.5720012,800978838.9974949,72013900798.3271,21651322935.397617,581630461.1594988,5792395.7475,689.5,94245.0,-276577033.5,21848970.0,-123638092.0,-218434368.0,-2012250.5,,,,,,,,,,,,,,,,,,,,,4267212.5,2475957.5,-8991959.5,921269.0,37582.5,3728514272.039964,3653078942.834961,-260298910.0,-256992431.5,2523290.5,268852.5,3921088790.834954,33215185292.37841,36640317667.207634,1727509786.7400494,48024233606.22822,3982929.5,-247278566.5,102953087347.0,1052340478.5,17255663734.0,3499499351.0,18868944276.0,3667424.0,71821.5,20848.55873468943,89666619.5,,10.0,2.6525198938992043,172.01409832491555,26.52519893899204,1720.1409832491552,33750.0,0.6234898018587336,0.7818314824680298,0.0,0.0,0.0,0.0,0.0,0.0,1.0,0.0,0.0,1.0,0.0,0.0,0.0,0.0,0.0,0.0,0.0,0.0,1.0,0.0,1.0,0.0,0.0,0.0,0.0,1.0,0.0,0.0,0.0,0.0,0.0,0.0,0.0,0.0,0.0,0.0,0.0,0.0,0.0,0.0,0.0,0.0,0.0,0.0,0.0,0.0,0.0,0.0,0.0,0.0,0.0,0.0,0.0,0.0,0.0,0.0,0.0,0.0,0.0,0.0,0.0,0.0,0.0,0.0,0.0,0.0,0.0,0.0,0.0,0.0,0.0,0.0,0.0,0.0,0.0,0.0,0.0,0.0,0.0,0.0,0.0,0.0,0.0,0.0,0.0,0.0,0.0,0.0,0.0,0.0,0.0,0.0,0.0,0.0,0.0,0.0,0.0,0.0,0.0,0.0,0.0,0.0,0.0,0.0,0.0,1.0,0.0,0.0,0.0,0.0,1.0,0.0,0.0,0.0,0.0,0.0,0.0,0.0,1.0,0.0
100090,0,0.0,0.0,0.0,1.0,0.0,135000.0,261621.0,16848.0,216000.0,0.008019,42.53150684931507,-3555.0,-7833.0,-3985.0,,1.0,2.0,2.0,17.0,0.7567222383896386,0.3937146969745023,0.4365064990977374,,,,,,,,,,,,,,,,,,,,,,,,,,,,,,,,,,,,,,,,,,,,,0.0,0.0,0.0,0.0,-1097.0,0.0,0.0,0.0,0.0,0.0,5.0,1.0,1.0,0.0,1.0,0.0,0.0,0.0,0.0,0.0,0.0,1.0,1.0,0.0,1.0,0.0,0.0,0.0,0.0,0.0,0.0,0.0,0.0,0.0,0.0,0.0,0.0,0.0,0.0,0.0,0.0,0.0,0.0,2.0,,,56520.9,31085.415,,0.0,0.0,0.0,-261.5,103.5,-15.0,,18.0,-4.0,12.0,18489.69,85128.75,177185.25,0.0,229500.0,18.0,-409.0,365243.0,-557.0,-227.0,-227.0,-222.0,13.0,0.0,0.0,-1.0,58.0,24.0,9.0,-19.5,0.0,0.0,62.0,7543.8,7543.8,-543.5,-541.5,7.0,1.0,28.0,0.0,450000.0,,0.0,,,0.0,,0.0,0.0,0.0,0.0,,0.0,,,0.0,-14.5,0.0,0.0,8335867882.5,184207118953.5,165413720997.0,51907342960.935,1862.0,1703.0,71122.0,70615.0,9140.0,505390.0,,,,,,,128244.0,661964.0,,,,13511206.273972198,-601144844.0,-920750638.0,-296094545.0,-1533310778.0416667,43951.0,30658.0,,,,,,,67352.88348059444,157842.5140299714,125951.48450048556,,,,,,,3709626.0,,,,,,,,,,,,,,,,435880.0,430684.0,,6417.131606002897,631156.0,624716.0,,,,,,,,,9.0,,,158066557.73999998,52176801.35249999,,0.0,1.0,0.0,-459048.0,71497.5,-243746.5,,-4.0,,,51957.0,21648.555,,0.0,0.0,0.0,-315.0,50.0,-15.0,,6198060.2174999975,90227505.555,98317363.095,2141783.46,89773005.55499999,6050.0,-384794.0,84354782.0,3756258.0,15515132.0,7156132.0,16254467.0,5707.5,80.0,16.438778406388206,162779.5,48069.0,28347.0,-89860.5,43800.0,113.0,61292738.02499911,59614279.51499919,-3476447.0,-3453111.0,60735.5,2978.0,27037017.63000001,122364000.0,,3977649.944999999,,,1935662.445000001,,4425041.475,25919568.31500001,26924816.51999999,26930130.92999999,,345.0,,,15591.0,-26848.5,884.0,24.0,1465375.0,14704438.0,3228282.0,8543372.0,11591953.0,1413705.0,,,72013957319.2271,21651354020.81262,,5792395.7475,689.5,94245.0,-276577295.0,21849073.5,-123638107.0,,-2012254.5,5914389316.8374605,18693762750.0,,447314116.9724976,,,308704526.50499874,,458380114.6724992,5699863935.045029,5877748997.707498,5877992180.4524975,,80715.5,,,970340.0,-1696188.0,177364.0,6755.0,4267236.5,2475966.5,-8991979.0,921269.0,37582.5,3728521815.839964,3653086486.634961,-260299453.5,-256992973.0,2523297.5,268853.5,3921107280.524954,33215270421.12841,36640494852.457634,1727509786.7400494,48024463106.22822,3982947.5,-247278975.5,102953452590.0,1052339921.5,17255663507.0,3499499124.0,18868944054.0,3667437.0,71821.5,20848.55873468943,89666618.5,-83.58509404792578,1.9379333333333333,8.012820512820513,340.797330523358,15.528311965811966,660.4425067322327,135000.0,-0.9009688679024191,-0.433883739117558,0.0,0.0,0.0,0.0,0.0,0.0,1.0,0.0,0.0,0.0,0.0,0.0,0.0,1.0,0.0,0.0,0.0,0.0,1.0,0.0,0.0,0.0,0.0,1.0,0.0,1.0,0.0,0.0,0.0,0.0,0.0,0.0,0.0,0.0,0.0,0.0,0.0,0.0,1.0,0.0,0.0,0.0,0.0,0.0,0.0,0.0,0.0,0.0,0.0,0.0,0.0,0.0,0.0,0.0,0.0,0.0,0.0,0.0,0.0,0.0,0.0,0.0,0.0,0.0,0.0,0.0,0.0,0.0,0.0,0.0,0.0,0.0,0.0,0.0,0.0,0.0,0.0,0.0,0.0,0.0,0.0,0.0,0.0,0.0,0.0,0.0,0.0,0.0,0.0,0.0,1.0,0.0,0.0,0.0,0.0,0.0,0.0,0.0,0.0,0.0,0.0,0.0,0.0,0.0,0.0,0.0,0.0,0.0,0.0,0.0,0.0,0.0,0.0,0.0,0.0,0.0,0.0,0.0,0.0,0.0
100091,0,0.0,0.0,0.0,1.0,0.0,247500.0,296280.0,23539.5,225000.0,0.018634,33.63835616438356,-929.0,-6031.0,-4586.0,,2.0,2.0,2.0,17.0,0.2632375980136291,0.4700355103285236,0.41534714488434,,,,,,,,,,,,,,,,,,,,,,,,,,,,,,,,,,,,,,,,,,,,,1.0,1.0,1.0,0.0,-619.0,0.0,0.0,0.0,0.0,1.0,3.0,1.0,1.0,0.0,1.0,0.0,0.0,0.0,0.0,0.0,0.0,0.0,0.0,0.0,1.0,0.0,0.0,0.0,0.0,0.0,0.0,0.0,0.0,0.0,0.0,0.0,0.0,0.0,0.0,0.0,0.0,0.0,0.0,3.0,0.0,,450000.0,0.0,0.0,0.0,0.0,0.0,-363.0,368.0,-7.0,-398.0,63.0,-15.0,6.0,8601.975,39330.0,39330.0,0.0,154665.0,3.0,-299.0,365243.0,-588.0,-468.0,-438.0,-466.0,10.0,0.0,0.0,-1.0,6.0,6.0,3.5,-17.5,0.0,0.0,5.0,7078.95,7078.95,-543.0,-528.0,3.0,1.0,0.0,,,,,,,,,,,,,,,,,,,,,8335891422.0,184207415233.5,165413945997.0,51907590460.935,1862.0,1703.0,71122.0,70616.0,9140.0,505393.0,,,,,,,128244.0,661966.0,,,,13511239.912328362,-601145773.0,-920755224.0,-296095164.0,-1533316809.0416667,43952.0,30658.0,,,,,,,67353.14671819245,157842.98406548175,125951.89984763046,,,,,,,3709643.0,,,,,,,,,,,,,,,,435881.0,430685.0,,6417.150240002897,631158.0,624718.0,,,,,,,,,12.0,926063.595,,158642279.64,52197062.48999999,2428940.115,0.0,1.0,0.0,-460924.0,71266.0,-243768.0,-257107.0,-5.5,0.0,,95179.5,0.0,0.0,0.0,0.0,0.0,-1409.0,-678.0,-7.0,-678.0,6278499.854999998,91251147.555,99873368.595,2141783.46,91251147.555,6152.0,-389110.5,85450511.0,4118722.0,15879531.0,7520561.0,16618875.0,5827.0,80.0,16.438778406388206,171120.5,48899.0,28852.0,-90530.0,43800.0,113.0,61714639.12499911,60293614.90499919,-3496677.0,-3473072.0,61059.0,3037.0,,,,,,,,,,,,,,,,,,,,,1465378.0,14704501.0,3228282.0,8543378.0,11591958.0,1413711.0,1056366382.5720012,,72014407319.2271,21651354020.81262,581630461.1594988,5792395.7475,689.5,94245.0,-276577658.0,21849441.5,-123638114.0,-218434766.0,-2012269.5,,,,,,,,,,,,,,,,,,,,,4267242.5,2475970.0,-8991996.5,921269.0,37582.5,3728528894.789964,3653093565.584961,-260299996.5,-256993501.0,2523300.5,268854.5,3921115882.499953,33215309751.12841,36640534182.457634,1727509786.7400494,48024617771.22822,3982950.5,-247279274.5,102953817833.0,1052339333.5,17255663039.0,3499498686.0,18868943588.0,3667447.0,71821.5,20848.55873468943,89666617.5,-27.61728294510507,1.1970909090909092,10.514242018734468,353.6818178247172,12.58650353660868,423.3892888287161,123750.0,-0.9009688679024191,0.4338837391175582,0.0,0.0,0.0,0.0,0.0,0.0,1.0,0.0,0.0,0.0,0.0,0.0,0.0,1.0,0.0,0.0,0.0,0.0,1.0,1.0,0.0,0.0,0.0,0.0,0.0,1.0,0.0,0.0,0.0,0.0,0.0,0.0,0.0,0.0,0.0,0.0,0.0,0.0,0.0,0.0,0.0,0.0,0.0,0.0,0.0,0.0,0.0,0.0,0.0,0.0,0.0,0.0,0.0,0.0,0.0,0.0,0.0,0.0,0.0,0.0,0.0,0.0,0.0,0.0,0.0,0.0,0.0,0.0,0.0,0.0,0.0,0.0,0.0,0.0,0.0,0.0,0.0,0.0,0.0,0.0,0.0,0.0,0.0,0.0,0.0,0.0,0.0,0.0,0.0,0.0,1.0,0.0,0.0,0.0,0.0,0.0,0.0,0.0,0.0,0.0,0.0,0.0,0.0,0.0,0.0,0.0,0.0,0.0,0.0,0.0,0.0,0.0,0.0,0.0,0.0,0.0,0.0,0.0,0.0,0.0
100092,0,0.0,0.0,1.0,1.0,0.0,90000.0,360000.0,18535.5,360000.0,0.0145199999999999,53.936986301369856,-3578.0,-10673.0,-3183.0,3.0,2.0,2.0,2.0,7.0,0.3049397660767501,0.2702553559832115,0.375711009574066,,,,,,,,,,,,,,,,,,,,,,,,,,,,,,,,,,,,,,,,,,,,,5.0,0.0,5.0,0.0,-1414.0,0.0,0.0,0.0,0.0,1.0,1.0,1.0,1.0,0.0,1.0,0.0,0.0,0.0,0.0,0.0,0.0,1.0,1.0,0.0,1.0,0.0,0.0,0.0,0.0,0.0,0.0,0.0,0.0,0.0,0.0,0.0,0.0,0.0,0.0,0.0,0.0,0.0,0.0,13.0,8874.0,5849.28,135000.0,50483.25,0.0,0.0,0.0,0.0,-1163.0,-232.0,-363.0,-1163.0,518.0,-24.0,6.0,5197.005,32325.75,32325.75,0.0,32325.75,10.0,-1084.5,365243.0,-1331.0,-1001.0,-1001.0,-982.0,9.5,0.0,0.0,384.0,59.0,10.0,5.0,-44.0,0.0,0.0,57.0,5197.005,5197.005,-1361.0,-1331.0,5.0,1.0,0.0,,,,,,,,,,,,,,,,,,,,,8335909957.5,184207775233.5,165414305997.0,51907680460.935,1862.0,1703.0,71122.0,70617.0,9140.0,505394.0,,,,,,,128244.0,661968.0,,,,13511293.849314664,-601149351.0,-920758407.0,-296096578.0,-1533327482.0416667,43952.0,30658.0,,,,,,,67353.45165795853,157843.25432083773,125952.27555864002,,,,,,,3709650.0,,,,,,,,,,,,,,,,435886.0,430690.0,1261386.0,6417.164760002896,631160.0,624720.0,,,,,,,,,39.0,948977.595,420172.965,160964671.14,53905208.48999999,2428940.115,0.0,1.0,0.0,-467675.0,72154.0,-245681.0,-260516.5,-19.0,0.0,5849.28,135000.0,0.0,0.0,0.0,0.0,0.0,-1770.0,-587.0,-912.0,-1163.0,6305412.509999998,91542497.805,100139460.345,2141783.46,91542497.805,6190.0,-394897.5,86546240.0,4114313.0,15875992.0,7517022.0,16615362.0,5889.0,80.0,16.438778406388206,172076.0,49266.0,29029.0,-92455.0,43851.0,134.0,61892336.74499915,60466290.07499921,-3553503.0,-3529303.0,61272.0,3069.0,,,,,,,,,,,,,,,,,,,,,1465391.0,14705019.0,3228282.0,8543437.0,11592015.0,1413717.0,1056375256.5720012,800984688.2774949,72014542319.2271,21651404504.06262,581630461.1594988,5792395.7475,689.5,94245.0,-276578821.0,21849209.5,-123638477.0,-218435929.0,-2012293.5,,,,,,,,,,,,,,,,,,,,,4267252.5,2475975.0,-8992040.5,921269.0,37582.5,3728534091.794964,3653098762.589961,-260301357.5,-256994832.0,2523305.5,268855.5,3921121079.504954,33215342076.87841,36640566508.207634,1727509786.7400494,48024650096.97822,3982960.5,-247280359.0,102954183076.0,1052338002.5,17255662038.0,3499497685.0,18868942606.0,3667456.5,71821.5,20848.55873468943,89667001.5,-66.33666886778077,4.0,4.855547462976451,261.893596996212,19.4221898519058,1047.574387984848,45000.0,0.6234898018587336,0.7818314824680298,0.0,0.0,0.0,0.0,0.0,0.0,1.0,0.0,0.0,0.0,0.0,0.0,0.0,1.0,0.0,0.0,0.0,0.0,1.0,0.0,1.0,0.0,0.0,0.0,0.0,1.0,0.0,0.0,0.0,0.0,0.0,0.0,0.0,1.0,0.0,0.0,0.0,0.0,0.0,0.0,0.0,0.0,0.0,0.0,0.0,0.0,0.0,0.0,0.0,0.0,0.0,0.0,0.0,0.0,0.0,0.0,0.0,0.0,0.0,1.0,0.0,0.0,0.0,0.0,0.0,0.0,0.0,0.0,0.0,0.0,0.0,0.0,0.0,0.0,0.0,0.0,0.0,0.0,0.0,0.0,0.0,0.0,0.0,0.0,0.0,0.0,0.0,0.0,0.0,0.0,0.0,0.0,0.0,0.0,0.0,0.0,0.0,0.0,0.0,0.0,0.0,0.0,0.0,0.0,0.0,0.0,0.0,0.0,0.0,0.0,0.0,0.0,0.0,0.0,0.0,0.0,0.0,0.0,0.0,0.0
100106,0,1.0,1.0,0.0,1.0,0.0,180000.0,157500.0,7875.0,157500.0,0.031329,33.12602739726027,-1830.0,-1042.0,-4221.0,,2.0,2.0,2.0,9.0,,0.4857699312968558,0.5797274227921155,,,,,,,,,,,,,,,,,,,,,,,,,,,,,,,,,,,,,,,,,,,,,0.0,0.0,0.0,0.0,-765.0,0.0,0.0,0.0,1.0,0.0,0.0,1.0,1.0,0.0,0.0,0.0,0.0,0.0,0.0,0.0,1.0,1.0,0.0,0.0,0.0,0.0,0.0,0.0,0.0,0.0,0.0,0.0,0.0,0.0,0.0,0.0,0.0,0.0,0.0,0.0,0.0,0.0,0.0,1.0,,,225000.0,,,0.0,0.0,0.0,-1070.0,,-809.0,-809.0,36.0,-17.5,5.0,18281.88,56916.0,32539.5,14229.0,105682.5,6.0,-404.0,365243.0,-552.0,-522.0,-492.0,-520.0,16.0,0.0,0.2540542570671675,-1.0,23.0,18.0,7.0,-13.0,0.0,0.0,21.0,18281.88,18281.88,-304.0,-284.0,5.0,2.0,0.0,,,,,,,,,,,,,,,,,,,,,8335917832.5,184207932733.5,165414463497.0,51907860460.935,1862.0,1703.0,71123.0,70617.0,9140.0,505394.0,,,,,,,128244.0,661970.0,,,,13511326.97534206,-601151181.0,-920762628.0,-296097343.0,-1533328524.0416667,43952.0,30658.0,,,,,,,,157843.74009076902,125952.8552860628,,,,,,,3709659.0,,,,,,,,,,,,,,,,435886.0,430690.0,,6417.196089002897,631162.0,624722.0,,,,,,,,,36.0,,,174020045.44499996,,,0.0,1.0,0.0,-521171.0,,-272171.0,-286595.0,-17.5,,,225000.0,,,0.0,0.0,0.0,-1070.0,,-809.0,-809.0,7292592.359999998,105236563.41,114804940.095,2326005.315,105236563.41,7095.0,-457501.0,101517930.0,4434941.0,17668905.0,8582911.0,19142146.0,6709.0,88.0,19.136389682244968,214579.0,54284.0,31466.0,-107201.0,126085.0,146.0,68790243.6449992,67169851.60499944,-4089169.0,-4059890.0,71514.0,3519.0,,,,,,,,,,,,,,,,,,,,,1465392.0,14705055.0,3228282.0,8543460.0,11592036.0,1413722.0,,,72014767319.2271,,,5792395.7475,689.5,94245.0,-276579891.0,,-123639286.0,-218436738.0,-2012311.0,,,,,,,,,,,,,,,,,,,,,4267270.5,2475982.0,-8992053.5,921269.0,37582.5,3728552373.674964,3653117044.469961,-260301661.5,-256995116.0,2523310.5,268857.5,3921139361.384954,33215398992.87841,36640599047.707634,1727524015.7400494,48024755779.47822,3982966.5,-247280763.0,102954548319.0,1052337450.5,17255661516.0,3499497193.0,18868942086.0,3667472.5,71821.5,20848.8127889465,89667000.5,-55.24356959722108,0.875,22.85714285714285,757.1663405088063,20.0,662.5205479452054,90000.0,0.6234898018587336,0.7818314824680298,0.0,0.0,0.0,0.0,0.0,1.0,0.0,0.0,0.0,0.0,0.0,0.0,0.0,1.0,0.0,0.0,0.0,0.0,1.0,1.0,0.0,0.0,0.0,0.0,0.0,1.0,0.0,0.0,0.0,0.0,0.0,0.0,0.0,0.0,0.0,0.0,0.0,0.0,1.0,0.0,0.0,0.0,0.0,0.0,0.0,0.0,0.0,0.0,0.0,0.0,0.0,0.0,0.0,1.0,0.0,0.0,0.0,0.0,0.0,0.0,0.0,0.0,0.0,0.0,0.0,0.0,0.0,0.0,0.0,0.0,0.0,0.0,0.0,0.0,0.0,0.0,0.0,0.0,0.0,0.0,0.0,0.0,0.0,0.0,0.0,0.0,0.0,0.0,0.0,0.0,0.0,0.0,0.0,0.0,0.0,0.0,0.0,0.0,0.0,0.0,0.0,0.0,0.0,0.0,0.0,0.0,0.0,0.0,0.0,0.0,0.0,0.0,0.0,0.0,0.0,0.0,0.0,0.0,0.0,0.0
100107,0,0.0,1.0,1.0,1.0,0.0,180000.0,296280.0,21690.0,225000.0,0.032561,37.15890410958904,-1007.0,-5719.0,-4044.0,14.0,2.0,1.0,1.0,15.0,0.3441652580978948,0.6844067238529257,0.2636468134452008,0.0371,0.0361,0.9513,0.3336,0.0132,0.0,0.1379,0.125,0.1667,0.032,0.0286,0.0613,0.0077,0.0007,0.0378,0.0375,0.9513,0.3597,0.0134,0.0,0.1379,0.125,0.1667,0.0327,0.0312,0.0639,0.0078,0.0008,0.0375,0.0361,0.9513,0.3425,0.0133,0.0,0.1379,0.125,0.1667,0.0326,0.0291,0.0624,0.0078,0.0007,0.0484,1.0,2.0,0.0,2.0,0.0,-317.0,0.0,0.0,0.0,0.0,1.0,3.0,1.0,1.0,0.0,1.0,0.0,1.0,0.0,0.0,0.0,0.0,0.0,0.0,0.0,0.0,0.0,0.0,0.0,0.0,1.0,0.0,0.0,0.0,0.0,0.0,0.0,0.0,0.0,0.0,0.0,0.0,0.0,0.0,1.0,10031.76,0.0,124195.68,124195.68,0.0,0.0,0.0,0.0,-17.0,349.0,-17.0,,1.0,0.0,2.0,4689.7425,51500.25,56094.75,0.0,51500.25,6.0,-318.0,182480.5,-266.0,182612.5,182642.5,182617.0,19.5,0.5,0.0,100.0,11.0,12.0,7.0,-6.0,0.0,0.0,40.0,5078.969999999998,5078.969999999998,-156.0,-154.0,9.5,0.0,11.0,86821.47,135000.0,0.0,6446.655,0.0,10820.0025,2250.0,8322.8175,4806.675,86651.865,86821.47,86821.47,0.0,4.0,0.0,4.5,3.0,-6.0,0.0,0.0,8335939522.5,184208229013.5,165414688497.0,51908040460.935,1862.0,1703.0,71123.0,70618.0,9140.0,505397.0,17786.686300002304,17848.696299999116,17300.614699998096,11282.498400000088,11220.326300000092,11167.817900000056,128244.0,661972.0,4134.092300000122,4131.720300000017,3942.541100000096,13511364.13424617,-601152188.0,-920766672.0,-296097660.0,-1533334243.0416667,43952.0,30658.0,11337.659999999169,11213.619999998962,10698.296399997302,22860.8599000096,22782.70310000956,22168.89880000811,67353.79582321663,157844.42449749287,125953.11893287626,34958.35140002786,34898.8234000283,34345.5073000287,22927.07849999593,22900.52599999551,22547.915099995746,3709674.0,8286.672400000172,8391.056500000079,8114.84960000023,9806.88910000072,9921.69310000216,10280.833599999643,16449.62949999975,16634.609599999698,16231.544799999709,828.0428000001756,813.2236000000457,759.2107000000133,3908.663000000125,3891.87340000016,3724.609400000155,435888.0,430692.0,1261400.0,6417.228650002897,631163.0,624723.0,,16313.4975999998,153997.10819999062,153999.8496999901,153891.6617999872,77520.63319999629,77858.0200000066,78258.89380000644,1.0,1037342.34,450772.965,174144241.12499997,56235022.24499998,2673195.84,0.0,1.0,0.0,-521188.0,57809.0,-272188.0,,0.0,10031.76,0.0,124195.68,124195.68,0.0,0.0,0.0,0.0,-17.0,349.0,-17.0,,7316688.982499997,105562563.66,115155991.845,2340234.315,105562563.66,7119.0,-458786.0,102065512.5,4434179.0,18398860.0,8948175.0,19872107.5,6771.5,89.5,19.390443939312128,214728.0,54552.0,31646.0,-107333.0,126085.0,146.0,69069742.13249916,67449220.5374994,-4094337.0,-4064910.0,71865.0,3539.0,33757636.00499999,140904000.0,3185325.0,5862016.349999999,230431.5,2453856.5250000004,2311874.5050000018,6323460.749999985,5848587.089999999,32397395.93999999,33621098.66999997,33626413.07999997,159.0,562.0,6.0,397.5,19290.0,-31632.0,896.0,36.0,1465393.0,14705056.0,3228293.0,8543471.0,11592076.0,1413724.0,1056385288.3320012,800984688.2774949,72014891514.90709,21651528699.74262,581630461.1594988,5792395.7475,689.5,94245.0,-276579908.0,21849558.5,-123639303.0,,-2012311.0,5914476138.307462,18693897750.0,198601820.325,447320563.6274977,1948107.735,256441897.7775008,308706776.50499874,635514785.7749982,458384921.3474992,5699950586.910028,5877835819.177498,5878079001.9225,13363.0,80719.5,44.0,70247.5,970343.0,-1696194.0,177364.0,6755.0,4267282.5,2475989.0,-8992059.5,921269.0,37582.5,3728557452.644964,3653122123.439961,-260301817.5,-256995270.0,2523320.0,268857.5,3921144051.127454,33215450493.12841,36640655142.457634,1727524015.7400494,48024807279.72822,3982972.5,-247281081.0,102954730799.5,1052337184.5,17255844128.5,3499679835.5,18869124703.0,3667492.0,71822.0,20848.8127889465,89667100.5,-27.099830420998305,1.646,8.298755186721992,308.3726482123572,13.659751037344398,507.5813789575399,90000.0,0.6234898018587336,0.7818314824680298,0.0,0.0,0.0,0.0,0.0,0.0,1.0,0.0,0.0,0.0,0.0,0.0,0.0,1.0,0.0,0.0,0.0,0.0,1.0,1.0,0.0,0.0,0.0,0.0,0.0,1.0,0.0,0.0,0.0,0.0,0.0,0.0,0.0,0.0,0.0,0.0,0.0,0.0,1.0,0.0,0.0,0.0,0.0,0.0,0.0,0.0,0.0,0.0,0.0,0.0,0.0,0.0,0.0,1.0,0.0,0.0,0.0,0.0,0.0,0.0,0.0,0.0,0.0,0.0,0.0,0.0,0.0,0.0,0.0,0.0,0.0,0.0,0.0,0.0,0.0,0.0,0.0,0.0,0.0,0.0,0.0,0.0,0.0,0.0,0.0,0.0,0.0,0.0,0.0,0.0,0.0,0.0,0.0,0.0,0.0,0.0,0.0,0.0,0.0,0.0,0.0,0.0,0.0,0.0,0.0,0.0,0.0,0.0,1.0,0.0,1.0,0.0,0.0,0.0,0.0,0.0,0.0,0.0,1.0,0.0
100109,0,0.0,0.0,1.0,1.0,0.0,202500.0,407520.0,26041.5,360000.0,0.00702,53.08219178082192,-4739.0,-3035.0,-2895.0,11.0,1.0,2.0,2.0,15.0,0.5831178293057412,0.6350278467719062,0.3062022983135042,,,,,,,,,,,,,,,,,,,,,,,,,,,,,,,,,,,,,,,,,,,,,0.0,0.0,0.0,0.0,-2154.0,0.0,0.0,0.0,0.0,0.0,3.0,1.0,1.0,1.0,1.0,0.0,0.0,0.0,0.0,0.0,0.0,0.0,0.0,0.0,1.0,0.0,0.0,0.0,0.0,0.0,0.0,0.0,0.0,0.0,0.0,0.0,0.0,0.0,0.0,0.0,0.0,0.0,0.0,13.0,0.0,0.0,68400.0,0.0,0.0,0.0,0.0,0.0,-1065.0,-708.0,-611.0,-1181.5,502.0,-25.0,9.0,11261.25,65322.0,139230.0,0.0,182115.0,13.0,-527.0,181439.5,-2499.5,-1801.5,181378.5,-1415.5,16.0,0.5,0.0,22.0,8.0,7.0,3.5,-85.5,0.0,0.0,88.0,7370.685,7370.685,-1410.0,-1407.5,37.5,0.0,79.0,0.0,180000.0,0.0,0.0,0.0,0.0,1201.545,72.36,0.0,0.0,0.0,0.0,0.0,0.0,0.0,0.0,33.0,-43.0,0.0,0.0,8335965564.0,184208636533.5,165415048497.0,51908242960.935,1862.0,1703.0,71123.0,70618.0,9140.0,505400.0,,,,,,,128244.0,661973.0,,,,13511417.21643795,-601156927.0,-920769567.0,-296099814.0,-1533337278.0416667,43952.0,30658.0,,,,,,,67354.37894104593,157845.05952533966,125953.42513517456,,,,,,,3709689.0,,,,,,,,,,,,,,,,435888.0,430692.0,1261411.0,6417.235670002897,631165.0,624725.0,,,,,,,,,36.0,1037342.34,498114.09,175360738.14,56347453.79999998,2673195.84,0.0,1.0,0.0,-536321.0,79031.0,-278255.0,-296150.5,-17.5,0.0,0.0,60246.99,0.0,0.0,0.0,0.0,0.0,-2043.0,-1184.0,-937.0,-1818.0,7371731.227499997,106597070.91,116372033.595,2362734.315,106527455.91,7171.0,-466272.0,102793634.5,4429890.0,18396162.0,9311852.0,19870189.0,6866.0,90.5,19.558981684451552,215134.0,54685.5,31709.0,-107855.0,126085.0,146.0,69661622.51999918,68045637.9149994,-4158891.0,-4129097.0,74013.0,3592.0,35906443.47,146259000.0,3365550.0,6136672.185,230431.5,2540618.325,2487625.020000002,6528715.5149999885,6036634.079999997,34436342.7,35768565.13499998,35773879.54499998,166.0,597.0,6.0,425.0,20300.0,-33212.0,924.0,38.0,1465406.0,14705558.0,3228372.0,8543479.0,11592164.0,1413733.0,1056385288.3320012,800984688.2774949,72014959914.90709,21651528699.74262,581630461.1594988,5792395.7475,689.5,94245.0,-276580973.0,21848850.5,-123639914.0,-218437919.5,-2012336.0,5914476138.307462,18694077750.0,198601820.325,447320563.6274977,1948107.735,256441897.7775008,308707978.0499988,635514858.1349982,458384921.3474992,5699950586.910028,5877835819.177498,5878079001.9225,13363.0,80719.5,44.0,70247.5,970376.0,-1696237.0,177364.0,6755.0,4267289.5,2475992.5,-8992145.0,921269.0,37582.5,3728564823.329964,3653129494.124961,-260303227.5,-256996677.5,2523357.5,268857.5,3921155312.377454,33215515815.12841,36640794372.457634,1727524015.7400494,48024989394.72822,3982985.5,-247281608.0,102954912239.0,1052334685.0,17255842327.0,3499861214.0,18869123287.5,3667508.0,71822.5,20848.8127889465,89667122.5,-89.27664516129032,2.0124444444444443,7.776049766718508,412.7697650141673,15.648868152756178,830.6762204373997,202500.0,-0.2225209339563146,-0.9749279121818236,0.0,0.0,0.0,0.0,0.0,0.0,1.0,0.0,0.0,0.0,0.0,0.0,0.0,1.0,0.0,0.0,0.0,0.0,1.0,0.0,0.0,0.0,1.0,0.0,0.0,1.0,0.0,0.0,0.0,0.0,0.0,0.0,0.0,0.0,0.0,0.0,0.0,0.0,1.0,0.0,0.0,0.0,0.0,0.0,0.0,0.0,0.0,0.0,0.0,0.0,0.0,0.0,0.0,0.0,0.0,0.0,0.0,0.0,0.0,0.0,0.0,0.0,0.0,0.0,0.0,0.0,0.0,0.0,0.0,0.0,0.0,0.0,0.0,0.0,0.0,0.0,0.0,0.0,0.0,0.0,0.0,0.0,0.0,0.0,0.0,0.0,0.0,0.0,0.0,0.0,0.0,1.0,0.0,0.0,0.0,0.0,0.0,0.0,0.0,0.0,0.0,0.0,0.0,0.0,0.0,0.0,0.0,0.0,0.0,0.0,0.0,0.0,0.0,0.0,0.0,0.0,0.0,0.0,0.0,0.0
100117,0,0.0,1.0,1.0,1.0,0.0,90000.0,499221.0,22117.5,373500.0,0.0031219999999999,62.2054794520548,,-5107.0,-5990.0,15.0,2.0,3.0,3.0,10.0,0.5871754960133346,0.6467635239646198,0.6528965519806539,,,,,,,,,,,,,,,,,,,,,,,,,,,,,,,,,,,,,,,,,,,,,0.0,0.0,0.0,0.0,-1132.0,0.0,0.0,0.0,0.0,1.0,0.0,1.0,0.0,0.0,1.0,0.0,0.0,0.0,0.0,0.0,0.0,0.0,0.0,0.0,1.0,0.0,0.0,0.0,0.0,0.0,0.0,0.0,0.0,0.0,0.0,0.0,0.0,0.0,0.0,0.0,0.0,0.0,0.0,8.0,0.0,0.0,38400.75,0.0,0.0,0.0,0.0,0.0,-1153.0,-618.0,-859.5,-1087.5,318.0,-19.0,2.0,4635.54,39937.5,43695.0,1125.0,39937.5,12.0,-946.0,365243.0,-910.5,-895.5,-580.5,-890.5,12.0,0.0,0.0672278338945005,1714.5,6.0,4.0,2.5,-30.5,0.0,0.0,3.0,14523.705,14523.705,-751.0,-721.0,1.0,2.0,0.0,,,,,,,,,,,,,,,,,,,,,8335987681.5,184209135754.5,165415421997.0,51908332960.935,1862.0,1703.0,71123.0,70619.0,9140.0,505400.0,,,,,,,128244.0,661975.0,,,,13511479.421917403,,-920775557.0,-296100946.0,-1533342385.0416667,43952.0,30658.0,,,,,,,67354.96611654194,157845.70628886358,125954.07803172656,,,,,,,3709699.0,,,,,,,,,,,,,,,,435888.0,430692.0,1261426.0,6417.238792002897,631168.0,624728.0,,,,,,,,,38.5,1092997.53,575969.7599999999,188199252.9,59801274.85499998,3022023.1499999994,0.0,2.0,0.0,-589292.0,132277.0,-305054.0,-328928.5,-18.75,0.0,0.0,43942.5,0.0,0.0,0.0,0.0,0.0,-1267.0,-788.0,-880.0,-1093.0,7896259.192499997,112009150.755,122791416.345,2469856.41,112009150.755,7604.0,-504801.0,111192480.5,6234757.0,21301199.0,11124810.0,22410324.5,7456.5,96.0,21.127987070838444,231671.5,56257.5,32773.0,-112765.5,127292.0,147.0,73732929.16499937,72148172.89499952,-4417995.0,-4386300.0,79134.0,3774.0,,,,,,,,,,,,,,,,,,,,,1465414.0,14705876.0,3228372.0,8543485.0,11592167.0,1413735.0,1056385288.3320012,800984688.2774949,72014998315.65709,21651528699.74262,581630461.1594988,5792395.7475,689.5,94245.0,-276582126.0,21848232.5,-123640773.5,-218439007.0,-2012355.0,,,,,,,,,,,,,,,,,,,,,4267293.5,2475995.0,-8992175.5,921269.0,37582.5,3728579347.034964,3653144017.829961,-260303978.5,-256997398.5,2523358.5,268859.5,3921159947.917454,33215555752.62841,36640838067.457634,1727525140.7400494,48025029332.22822,3982997.5,-247282554.0,102955277482.0,1052333774.5,17255841431.5,3499860633.5,18869122397.0,3667520.0,71822.5,20848.8800167804,89668837.0,,5.5469,4.069175991861648,253.12504354854445,22.57131230925737,1404.0593040594215,45000.0,-0.9009688679024191,-0.433883739117558,0.0,0.0,0.0,0.0,0.0,0.0,1.0,0.0,0.0,1.0,0.0,0.0,0.0,0.0,0.0,0.0,0.0,0.0,1.0,0.0,1.0,0.0,0.0,0.0,0.0,1.0,0.0,0.0,0.0,0.0,0.0,0.0,0.0,0.0,0.0,0.0,0.0,0.0,0.0,0.0,0.0,0.0,0.0,0.0,0.0,0.0,0.0,0.0,0.0,0.0,0.0,0.0,0.0,0.0,0.0,0.0,0.0,0.0,0.0,0.0,0.0,0.0,0.0,0.0,0.0,0.0,0.0,0.0,0.0,0.0,0.0,0.0,0.0,0.0,0.0,0.0,0.0,0.0,0.0,0.0,0.0,0.0,0.0,0.0,0.0,0.0,0.0,0.0,0.0,0.0,0.0,0.0,0.0,0.0,0.0,0.0,0.0,0.0,0.0,0.0,0.0,0.0,0.0,0.0,0.0,1.0,0.0,0.0,0.0,0.0,0.0,0.0,0.0,0.0,0.0,0.0,0.0,0.0,0.0,0.0
100128,0,0.0,0.0,1.0,1.0,1.0,225000.0,431280.0,23526.0,360000.0,0.025164,30.03287671232877,-1883.0,-99.0,-1721.0,8.0,3.0,2.0,2.0,10.0,0.339002380827429,0.3750732637427585,0.3474182272002641,0.1093,0.0464,0.9881,0.8368,0.0,0.12,0.1034,0.375,0.4167,0.0,0.0891,0.0986,0.0,0.0282,0.1113,0.0482,0.9881,0.8432,0.0,0.1208,0.1034,0.375,0.4167,0.0,0.0973,0.1027,0.0,0.0299,0.1103,0.0464,0.9881,0.8390000000000001,0.0,0.12,0.1034,0.375,0.4167,0.0,0.0906,0.1004,0.0,0.0288,0.0837,1.0,5.0,0.0,5.0,0.0,-1616.0,0.0,0.0,0.0,0.0,3.0,4.0,1.0,1.0,0.0,1.0,0.0,1.0,0.0,0.0,0.0,0.0,0.0,0.0,0.0,1.0,0.0,0.0,0.0,0.0,0.0,0.0,0.0,0.0,0.0,0.0,0.0,0.0,0.0,0.0,0.0,0.0,0.0,0.0,28.0,0.0,0.0,106600.5,0.0,0.0,0.0,0.0,0.0,-1224.0,1257.0,-1033.0,-1113.0,1162.0,-22.0,13.0,15250.5,225000.0,270000.0,0.0,270000.0,21.0,-613.0,365243.0,-720.0,-720.0,-390.0,-711.0,10.0,1.0,0.0,-1.0,27.0,12.0,5.0,-52.0,0.0,0.0,28.0,10429.965,8805.015,-1653.0,-1628.0,5.0,1.0,11.0,0.0,270000.0,,0.0,,,0.0,,0.0,0.0,0.0,0.0,,0.0,,,0.0,-7.0,0.0,0.0,8336011207.5,184209567034.5,165415781997.0,51908557960.935,1862.0,1703.0,71123.0,70622.0,9140.0,505404.0,17786.795600002304,17848.806599999116,17300.725999998096,11282.544800000089,11220.372700000093,11167.866100000056,128245.0,661978.0,4134.092300000122,4131.720300000017,3942.541100000096,13511509.454794114,-601158810.0,-920777278.0,-296102562.0,-1533342484.0416667,43952.0,30658.0,11337.77999999917,11213.739999998965,10698.417199997302,22860.9633000096,22782.80650000956,22169.00220000811,67355.30511892277,157846.08136212733,125954.42544995376,34958.72640002786,34899.1984000283,34345.8823000287,22927.49519999593,22900.942699995507,22548.331799995743,3709709.0,8286.672400000172,8391.056500000079,8114.84960000023,9806.978200000722,9921.78370000216,10280.930899999645,16449.72809999975,16634.709999999694,16231.647499999706,828.0428000001756,813.2236000000457,759.2107000000133,3908.691200000125,3891.90220000016,3724.639300000155,435893.0,430697.0,1261434.0,6417.2639560028965,631170.0,624730.0,,16313.5812999998,153998.0962999906,154000.83779999008,153892.64989998715,77521.46999999628,77858.8590000066,78259.73700000644,41.0,1114222.5000000002,587421.8099999997,197986543.785,62113028.71499997,3315267.765,166.5,2.0,55.0,-633738.5,225436.0,-333928.0,-356417.0,-20.0,0.0,0.0,123201.0,0.0,0.0,0.0,0.0,0.0,-1498.0,438.0,-1121.0,-1117.0,8552001.284999998,123008118.57,135195427.845,2583868.725,122558118.57,8359.0,-543756.0,120871420.0,6208403.0,22011435.0,11108821.0,23120061.0,8107.0,106.0,22.48923021088105,249090.0,60746.0,34943.0,-125443.0,127380.0,213.0,78024526.0424992,76444527.53249942,-4658646.0,-4624310.0,80965.0,4113.5,47193763.68000002,169299000.0,,7170180.435,,,3415367.025000002,,7229333.024999998,45282000.105,47036841.38999999,47042155.79999998,,647.0,,,22627.0,-36943.0,953.0,39.0,1465442.0,14707038.0,3228383.0,8543512.0,11592195.0,1413748.0,1056385288.3320012,800984688.2774949,72015104916.15709,21651528699.74262,581630461.1594988,5792395.7475,689.5,94245.0,-276583350.0,21849489.5,-123641806.5,-218440120.0,-2012377.0,5914476138.307462,18694347750.0,,447320563.6274977,,,308707978.0499988,,458384921.3474992,5699950586.910028,5877835819.177498,5878079001.9225,,80719.5,,,970376.0,-1696244.0,177364.0,6755.0,4267305.5,2476000.0,-8992227.5,921269.0,37582.5,3728589776.999964,3653152822.844961,-260305631.5,-256999026.5,2523363.5,268860.5,3921175198.417454,33215780752.62841,36641108067.457634,1727525140.7400494,48025299332.22822,3983018.5,-247283167.0,102955642725.0,1052333054.5,17255840711.5,3499860243.5,18869121686.0,3667530.0,71823.5,20848.8800167804,89668836.0,-62.69795657726692,1.9168,9.56388676358072,287.2310320612927,18.33205814843152,550.5644422550859,75000.0,-0.9009688679024191,0.4338837391175582,0.0,0.0,0.0,0.0,0.0,0.0,1.0,0.0,1.0,0.0,0.0,0.0,0.0,0.0,0.0,1.0,0.0,0.0,0.0,1.0,0.0,0.0,0.0,0.0,0.0,0.0,0.0,0.0,0.0,1.0,0.0,0.0,0.0,0.0,0.0,0.0,0.0,0.0,0.0,0.0,1.0,0.0,0.0,0.0,0.0,0.0,0.0,0.0,0.0,0.0,1.0,0.0,0.0,0.0,0.0,0.0,0.0,0.0,0.0,0.0,0.0,0.0,0.0,0.0,0.0,0.0,0.0,0.0,0.0,0.0,0.0,0.0,0.0,0.0,0.0,0.0,0.0,0.0,0.0,0.0,0.0,0.0,0.0,0.0,0.0,0.0,0.0,0.0,0.0,0.0,0.0,0.0,0.0,0.0,0.0,0.0,0.0,0.0,0.0,0.0,0.0,0.0,0.0,0.0,0.0,0.0,0.0,0.0,1.0,0.0,1.0,0.0,0.0,0.0,0.0,0.0,0.0,1.0,0.0,0.0
100141,0,0.0,0.0,1.0,1.0,0.0,175500.0,478498.5,46741.5,454500.0,0.010147,49.19178082191781,-305.0,-10087.0,-1516.0,10.0,2.0,2.0,2.0,11.0,0.6965655054935606,0.7427647756395467,,,,,,,,,,,,,,,,,,,,,,,,,,,,,,,,,,,,,,,,,,,,,,0.0,0.0,0.0,0.0,-814.0,,,,,,,1.0,1.0,1.0,1.0,0.0,0.0,1.0,1.0,0.0,1.0,1.0,0.0,0.0,1.0,0.0,0.0,0.0,0.0,0.0,0.0,0.0,0.0,0.0,0.0,0.0,0.0,0.0,0.0,0.0,0.0,0.0,0.0,0.0,,,,,,,,,,,,,0.0,,1.0,4033.26,20160.0,21352.5,2016.0,20160.0,6.0,-814.0,365243.0,-783.0,-633.0,-633.0,-625.0,20.0,0.0,0.093955849657756,13.0,7.0,6.0,3.0,-24.0,0.0,0.0,6.0,4033.26,4033.26,-707.5,-708.0,3.5,1.0,0.0,,,,,,,,,,,,,,,,,,,,,8336057949.0,184210045533.0,165416236497.0,51908733460.935,,,,,,,,,,,,,128245.0,661980.0,,,,13511558.64657494,-601159115.0,-920778794.0,-296103376.0,-1533352571.0416667,43952.0,30658.0,,,,,,,67356.00168442827,157846.82412690294,,,,,,,,3709720.0,,,,,,,,,,,,,,,,435893.0,430697.0,1261444.0,6417.2741030028965,631172.0,624732.0,,,,,,,,,,,,,,,,,,,,,,,,,,,,,,,,,,,9344278.755000006,132274095.57,146446129.845,2645635.725,132274095.57,8953.0,-588786.0,130364452.0,7278545.0,25647200.0,13287928.0,26391158.0,8798.0,119.0,23.41705418897252,258855.0,64687.0,37468.0,-131810.0,127431.0,261.0,86753458.799999,86131147.00499922,-4976935.0,-4938513.5,89458.5,4452.5,,,,,,,,,,,,,,,,,,,,,1465442.0,14707038.0,3228383.0,8543519.0,11592201.0,1413749.0,,,,,,,,,,,,,,,,,,,,,,,,,,,,,,,,,,4267311.5,2476003.0,-8992251.5,921269.0,37582.5,3728593810.259964,3653156856.104961,-260306339.0,-256999734.5,2523367.0,268861.5,3921179231.677454,33215800912.62841,36641129419.957634,1727527156.7400494,48025319492.22822,3983024.5,-247283981.0,102956007968.0,1052332271.5,17255840078.5,3499859610.5,18869121061.0,3667550.0,71823.5,20848.97397263005,89668849.0,-6.200222779170147,2.7264871794871794,3.7546933667083855,184.7000531486276,10.237123327235969,503.5823269603338,87750.0,0.6234898018587336,0.7818314824680298,0.0,1.0,0.0,0.0,0.0,0.0,0.0,0.0,0.0,0.0,0.0,0.0,0.0,1.0,0.0,0.0,0.0,0.0,1.0,0.0,1.0,0.0,0.0,0.0,0.0,1.0,0.0,0.0,0.0,0.0,0.0,0.0,0.0,0.0,0.0,0.0,0.0,0.0,1.0,0.0,0.0,0.0,0.0,0.0,0.0,0.0,0.0,0.0,0.0,0.0,0.0,0.0,0.0,0.0,0.0,0.0,0.0,0.0,0.0,0.0,0.0,0.0,0.0,0.0,0.0,0.0,0.0,0.0,1.0,0.0,0.0,0.0,0.0,0.0,0.0,0.0,0.0,0.0,0.0,0.0,0.0,0.0,0.0,0.0,0.0,0.0,0.0,0.0,0.0,0.0,0.0,0.0,0.0,0.0,0.0,0.0,0.0,0.0,0.0,0.0,0.0,0.0,0.0,0.0,0.0,0.0,0.0,0.0,0.0,0.0,0.0,0.0,0.0,0.0,0.0,0.0,0.0,0.0,0.0,0.0
100150,0,0.0,0.0,0.0,1.0,0.0,99000.0,225000.0,19242.0,225000.0,0.0072739999999999,28.786301369863008,-2780.0,-5072.0,-2729.0,,2.0,2.0,2.0,10.0,0.5905311435762867,0.6009994171816399,0.7610263695502636,0.0825,0.0654,0.9762,0.6736,0.0,0.0,0.1379,0.1667,0.2083,0.0477,0.0672,0.0474,0.0,0.0,0.084,0.0678,0.9762,0.6864,0.0,0.0,0.1379,0.1667,0.2083,0.0488,0.0735,0.0494,0.0,0.0,0.0833,0.0654,0.9762,0.6779999999999999,0.0,0.0,0.1379,0.1667,0.2083,0.0486,0.0684,0.0482,0.0,0.0,0.0547,1.0,0.0,0.0,0.0,0.0,-2297.0,0.0,0.0,0.0,0.0,1.0,2.0,1.0,1.0,0.0,1.0,1.0,0.0,0.0,0.0,0.0,0.0,0.0,0.0,0.0,1.0,0.0,0.0,0.0,0.0,0.0,0.0,0.0,0.0,0.0,0.0,0.0,0.0,0.0,0.0,0.0,0.0,0.0,0.0,4.0,,0.0,90000.0,0.0,0.0,0.0,0.0,0.0,-2142.0,-1777.0,-931.0,-1931.5,293.0,-36.0,4.0,15704.955,115177.5,149899.5,5400.0,180000.0,30.0,-778.5,365243.0,-1649.5,-1454.5,-1049.5,-1447.5,11.0,0.5,0.1073084071688226,-1.0,18.0,12.0,6.5,-67.5,0.0,0.0,17.0,5923.71,5923.71,-2037.0,-2047.0,6.0,1.0,0.0,,,,,,,,,,,,,,,,,,,,,8336077191.0,184210270533.0,165416461497.0,51908832460.935,1862.0,1703.0,71123.0,70623.0,9140.0,505406.0,17786.878100002305,17848.889899999114,17300.809999998095,11282.610200000085,11220.438100000092,11167.933900000056,128245.0,661982.0,4134.092300000122,4131.720300000017,3942.541100000096,13511587.43287631,-601161895.0,-920781523.0,-296105673.0,-1533357643.0416667,43952.0,30658.0,11337.77999999917,11213.739999998965,10698.417199997302,22861.1012000096,22782.94440000956,22169.14010000811,67356.59221557183,157847.42512632016,125955.1864763233,34958.89310002786,34899.3651000283,34346.0490000287,22927.70349999593,22901.15099999551,22548.540099995746,3709730.0,8286.720100000171,8391.105100000079,8114.898400000229,9807.04540000072,9921.85210000216,10281.004399999643,16449.775499999752,16634.7581999997,16231.696899999706,828.0428000001756,813.2236000000457,759.2107000000133,3908.691200000125,3891.90220000016,3724.639300000155,435893.0,430697.0,,6417.281377002895,631174.0,624734.0,,16313.6359999998,153999.0724999906,154001.8139999901,153893.62609998722,77522.14359999629,77859.5370000066,78260.42340000645,71.0,,744050.4749999995,241094379.33,83498118.16499998,4061875.86,166.5,3.0,55.0,-748628.5,321109.0,-386547.5,-418861.0,-35.0,,0.0,90000.0,0.0,0.0,0.0,0.0,0.0,-2415.0,-2050.0,-931.0,-2038.0,9924365.250000011,142234553.97,157808242.845,2787638.625,142234553.97,9611.0,-624376.5,140406557.5,7615160.5,28183653.5,14007770.5,29659251.0,9251.0,135.0,25.167061665880016,267685.5,71236.0,41770.0,-139928.5,127440.0,262.0,97118200.93499924,96519219.8849995,-5692075.0,-5649467.0,110803.0,4811.0,,,,,,,,,,,,,,,,,,,,,1465446.0,14707331.0,3228383.0,8543537.0,11592218.0,1413753.0,,800984688.2774949,72015194916.15709,21651528699.74262,581630461.1594988,5792395.7475,689.5,94245.0,-276585492.0,21847712.5,-123642737.5,-218442051.5,-2012413.0,,,,,,,,,,,,,,,,,,,,,4267323.5,2476009.5,-8992319.0,921269.0,37582.5,3728599733.969964,3653162779.814961,-260308376.0,-257001781.5,2523373.0,268862.5,3921194936.632454,33215916090.12841,36641279319.457634,1727532556.7400494,48025499492.22822,3983054.5,-247284759.5,102956373211.0,1052330622.0,17255838624.0,3499858561.0,18869119613.5,3667561.0,71824.0,20849.08128103722,89668848.0,-96.57371276291995,2.272727272727273,5.144995322731526,148.10538590668529,11.693171188026191,336.60314978792115,49500.0,0.6234898018587336,0.7818314824680298,0.0,0.0,0.0,0.0,0.0,0.0,1.0,0.0,1.0,0.0,0.0,0.0,0.0,0.0,0.0,0.0,0.0,0.0,1.0,1.0,0.0,0.0,0.0,0.0,0.0,1.0,0.0,0.0,0.0,0.0,0.0,0.0,0.0,0.0,0.0,0.0,0.0,0.0,0.0,0.0,0.0,0.0,0.0,0.0,1.0,0.0,0.0,0.0,0.0,0.0,0.0,0.0,0.0,1.0,0.0,0.0,0.0,0.0,0.0,0.0,0.0,0.0,0.0,0.0,0.0,0.0,0.0,0.0,0.0,0.0,0.0,0.0,0.0,0.0,0.0,0.0,0.0,0.0,0.0,0.0,0.0,0.0,0.0,0.0,0.0,0.0,0.0,0.0,0.0,0.0,0.0,0.0,0.0,0.0,0.0,0.0,0.0,0.0,0.0,0.0,0.0,0.0,0.0,0.0,0.0,0.0,0.0,0.0,1.0,0.0,1.0,0.0,0.0,0.0,0.0,0.0,0.0,1.0,0.0,0.0
100168,0,0.0,0.0,0.0,1.0,0.0,157500.0,266652.0,16443.0,202500.0,0.0116569999999999,61.8,-13294.0,-13154.0,-4187.0,,1.0,1.0,1.0,15.0,,0.7089390399675721,0.746300213050371,0.0515,0.0455,0.9627,,,0.04,0.1379,0.2083,,0.0,,0.0,,0.0397,0.0525,0.0472,0.9628,,,0.0403,0.1379,0.2083,,0.0,,0.0,,0.0421,0.052,0.0455,0.9627,,,0.04,0.1379,0.2083,,0.0,,0.0,,0.0406,0.0508,1.0,0.0,0.0,0.0,0.0,-1144.0,0.0,0.0,0.0,0.0,0.0,4.0,1.0,1.0,0.0,1.0,0.0,0.0,0.0,0.0,0.0,0.0,0.0,0.0,0.0,1.0,0.0,0.0,0.0,0.0,0.0,0.0,0.0,0.0,0.0,0.0,0.0,0.0,0.0,0.0,0.0,0.0,0.0,0.0,1.0,0.0,,360000.0,0.0,,0.0,0.0,0.0,-1407.0,-676.0,-779.0,-781.0,47.0,-23.0,4.0,42967.8,749776.5,796232.25,0.0,1066500.0,36.0,-596.5,365243.0,-759.0,-369.0,676.0,-359.0,12.0,0.0,0.0,-1.0,54.0,36.0,30.0,-18.5,0.0,0.0,53.0,42967.8,42967.8,-579.0,-570.0,9.0,1.0,0.0,,,,,,,,,,,,,,,,,,,,,8336093634.0,184210537185.0,165416663997.0,51908989960.935,1862.0,1703.0,71123.0,70623.0,9140.0,505410.0,17786.929600002306,17848.941899999114,17300.862499998097,11282.655700000088,11220.483600000092,11167.981100000055,128245.0,661983.0,,,,13511649.23287631,-601175189.0,-920785710.0,-296106817.0,-1533370797.0416667,43952.0,30658.0,11337.81999999917,11213.779999998966,10698.457499997305,22861.2391000096,22783.08230000956,22169.27800000811,,157848.13406536012,125955.93277653634,34959.10140002786,34899.5734000283,34346.2573000287,,,,3709745.0,8286.720100000171,8391.105100000079,8114.898400000229,,,,16449.775499999752,16634.7581999997,16231.696899999706,,,,3908.730900000125,3891.94280000016,3724.681400000157,435893.0,430697.0,,6417.293034002895,631175.0,624735.0,,16313.6867999998,154000.0351999906,154002.7766999901,153894.5888999872,,,,47.0,1969552.1250000016,,263381444.82,89785064.02499998,,180.0,3.0,1327.0,-881011.0,290535.0,-464261.0,-497221.0,-23.0,0.0,,360000.0,0.0,,0.0,0.0,0.0,-1407.0,-676.0,-779.0,-781.0,10993931.190000013,159210138.10500005,177125389.02,2957706.585,159210138.10500005,10801.0,-712289.0,161040197.0,10472964.0,33250339.0,16894966.0,34361342.0,10214.0,155.0,28.23279188983884,296035.5,82794.0,48964.0,-162692.0,127485.0,280.0,110753080.19999924,109940426.59499943,-6521662.0,-6472157.0,124056.0,5431.0,,,,,,,,,,,,,,,,,,,,,1465447.0,14707378.0,3228383.0,8543591.0,11592271.0,1413757.0,1056385288.3320012,,72015554916.15709,21651528699.74262,,5792395.7475,689.5,94245.0,-276586899.0,21847036.5,-123643516.5,-218442832.5,-2012436.0,,,,,,,,,,,,,,,,,,,,,4267359.5,2476039.5,-8992337.5,921269.0,37582.5,3728642701.769964,3653205747.614961,-260308955.0,-257002351.5,2523382.0,268863.5,3921237904.432454,33216665866.62841,36642075551.707634,1727532556.7400494,48026565992.22822,3983090.5,-247285356.0,102956738454.0,1052329863.0,17255838255.0,3499859237.0,18869119254.5,3667573.0,71824.0,20849.08128103722,89668847.0,-215.11326860841427,1.693028571428571,9.578544061302685,591.9540229885058,16.216748768472907,1002.1950738916256,157500.0,0.6234898018587336,0.7818314824680298,0.0,0.0,0.0,0.0,0.0,0.0,1.0,0.0,0.0,0.0,0.0,0.0,0.0,1.0,0.0,1.0,0.0,0.0,0.0,0.0,0.0,0.0,0.0,1.0,0.0,1.0,0.0,0.0,0.0,0.0,0.0,0.0,0.0,0.0,0.0,0.0,0.0,0.0,0.0,0.0,0.0,0.0,0.0,0.0,0.0,0.0,0.0,0.0,0.0,0.0,0.0,0.0,0.0,0.0,0.0,0.0,0.0,0.0,0.0,0.0,0.0,0.0,0.0,0.0,0.0,0.0,0.0,0.0,0.0,0.0,0.0,0.0,0.0,0.0,0.0,0.0,0.0,0.0,0.0,0.0,0.0,1.0,0.0,0.0,0.0,0.0,0.0,0.0,0.0,0.0,0.0,0.0,0.0,0.0,0.0,0.0,0.0,0.0,0.0,0.0,0.0,0.0,0.0,0.0,0.0,0.0,0.0,0.0,0.0,0.0,1.0,0.0,0.0,0.0,0.0,0.0,0.0,0.0,1.0,0.0
100169,0,0.0,0.0,0.0,1.0,0.0,135000.0,540000.0,27702.0,540000.0,0.072508,62.42191780821918,,-5103.0,-5229.0,,1.0,1.0,1.0,12.0,0.8660097825914488,0.6386136180590145,0.1595195404777181,0.3423,0.142,0.9925,0.898,0.0,0.4,0.1724,0.6667,0.7083,0.0,0.2749,0.3755,0.0193,0.0164,0.3487,0.1474,0.9926,0.902,0.0,0.4028,0.1724,0.6667,0.7083,0.0,0.3003,0.3912,0.0195,0.0174,0.3456,0.142,0.9925,0.8994,0.0,0.4,0.1724,0.6667,0.7083,0.0,0.2796,0.3822,0.0194,0.0167,0.2989,1.0,0.0,0.0,0.0,0.0,-519.0,0.0,0.0,0.0,0.0,0.0,0.0,1.0,0.0,0.0,1.0,0.0,0.0,0.0,0.0,0.0,0.0,0.0,0.0,0.0,0.0,0.0,0.0,1.0,0.0,0.0,0.0,0.0,0.0,0.0,0.0,0.0,0.0,0.0,0.0,0.0,0.0,0.0,0.0,1.0,16033.5,7.695,176382.0,97011.0,0.0,0.0,0.0,0.0,-187.0,118.0,-36.0,,7.0,-3.0,17.0,20169.405,0.0,0.0,0.0,286744.5,9.5,-446.0,365243.0,-452.5,-251.5,417.5,-131.5,15.0,0.5,0.0,-1.0,33.0,12.0,8.0,-11.0,0.0,0.0,40.0,35327.835,34986.2175,-351.0,-341.5,5.0,2.0,12.0,0.0,405000.0,0.0,0.0,0.0,0.0,0.0,0.0,0.0,0.0,0.0,0.0,0.0,0.0,0.0,0.0,4.0,-8.5,0.0,0.0,8336121336.0,184211077185.0,165417203997.0,51909124960.935,1862.0,1703.0,71123.0,70623.0,9140.0,505410.0,17787.271900002306,17849.287499999115,17301.211199998095,11282.797700000085,11220.625600000092,11168.128500000055,128245.0,661984.0,4134.092300000122,4131.720300000017,3942.541100000096,13511711.654794116,,-920790939.0,-296107336.0,-1533375900.0416667,43952.0,30658.0,11338.21999999917,11214.179999998963,10698.860299997305,22861.4115000096,22783.25470000956,22169.45040000811,67357.45822535444,157848.77267897822,125956.09229607684,34959.76810002786,34900.2401000283,34346.9240000287,22928.41179999593,22901.859299995507,22549.248399995744,3709757.0,8286.720100000171,8391.105100000079,8114.898400000229,9807.320300000722,9922.13170000216,10281.304699999646,16450.15099999975,16635.1403999997,16232.088099999706,828.0621000001756,813.2430000000458,759.2302000000133,3908.747300000125,3891.95950000016,3724.698800000156,435893.0,430697.0,,6417.365542002895,631176.0,624736.0,,16313.9856999998,154001.0276999906,154003.76919999009,153895.5814999872,77523.04159999629,77860.4364000066,78261.32540000645,7.0,1985585.6250000016,928155.2849999996,263557826.82,89882075.02499998,4419393.48,180.0,3.0,1327.0,-881198.0,290653.0,-464297.0,,-3.0,16033.5,7.695,176382.0,97011.0,0.0,0.0,0.0,0.0,-187.0,118.0,-36.0,,11110601.655000014,161552932.60500005,179702035.02,2957706.585,161755432.60500005,10907.0,-716719.0,162135703.0,10471482.5,33614781.0,17078954.0,34908465.5,10361.0,158.0,28.23279188983884,297629.0,84314.0,50220.0,-163223.0,127485.0,280.0,114559970.69249916,113658325.7399994,-6538073.0,-6487847.0,124381.5,5501.0,90037762.11000001,280908000.0,8226852.75,11352813.705,230431.5,2895457.0950000007,5749655.8050000025,12322932.79499992,11264749.01999999,86069206.03499995,89720320.45499992,89726579.86499992,452.0,945.0,6.0,487.0,35677.0,-58168.0,1029.0,66.0,1465448.0,14707385.0,3228395.0,8543624.0,11592311.0,1413774.0,1056401321.8320012,800984695.9724951,72015731298.15709,21651625710.74262,581630461.1594988,5792395.7475,689.5,94245.0,-276587086.0,21847154.5,-123643552.5,,-2012439.0,5914476138.307462,18694752750.0,198601820.325,447320563.6274977,1948107.735,256441897.7775008,308707978.0499988,635514858.1349982,458384921.3474992,5699950586.910028,5877835819.177498,5878079001.9225,13363.0,80719.5,44.0,70247.5,970380.0,-1696252.5,177364.0,6755.0,4267371.5,2476047.5,-8992348.5,921269.0,37582.5,3728678029.604964,3653240733.832461,-260309306.0,-257002693.0,2523387.0,268865.5,3921258073.837455,33216665866.62841,36642075551.707634,1727532556.7400494,48026852736.72822,3983100.0,-247285802.0,102957103697.0,1052329410.5,17255838003.5,3499859654.5,18869119123.0,3667588.0,71824.5,20849.08128103722,89668846.0,,4.0,4.8732943469785575,304.2003791823546,19.49317738791423,1216.8015167294184,135000.0,0.6234898018587336,0.7818314824680298,0.0,1.0,0.0,0.0,0.0,0.0,0.0,0.0,0.0,1.0,0.0,0.0,0.0,0.0,0.0,1.0,0.0,0.0,0.0,0.0,0.0,1.0,0.0,0.0,0.0,1.0,0.0,0.0,0.0,0.0,0.0,0.0,0.0,0.0,0.0,0.0,0.0,0.0,0.0,0.0,0.0,0.0,0.0,0.0,0.0,0.0,0.0,0.0,0.0,0.0,0.0,0.0,0.0,0.0,0.0,0.0,0.0,0.0,0.0,0.0,0.0,0.0,0.0,0.0,0.0,0.0,0.0,0.0,0.0,0.0,0.0,0.0,0.0,0.0,0.0,0.0,0.0,0.0,0.0,0.0,0.0,0.0,0.0,0.0,0.0,0.0,0.0,0.0,0.0,0.0,0.0,0.0,0.0,0.0,0.0,0.0,0.0,0.0,0.0,0.0,0.0,0.0,0.0,0.0,0.0,1.0,0.0,0.0,1.0,0.0,1.0,0.0,0.0,0.0,0.0,0.0,0.0,1.0,0.0,0.0
100170,0,0.0,1.0,0.0,1.0,1.0,337500.0,1313212.5,42493.5,1012500.0,0.02461,32.73424657534247,-1415.0,-5611.0,-4052.0,,3.0,2.0,2.0,11.0,,0.6612258810815439,0.4400578303966329,0.1237,0.0595,0.9866,,,0.12,0.1034,0.375,,0.0629,,0.1239,,0.0243,0.1261,0.0617,0.9866,,,0.1208,0.1034,0.375,,0.0644,,0.1291,,0.0257,0.1249,0.0595,0.9866,,,0.12,0.1034,0.375,,0.064,,0.1261,,0.0248,0.1217,1.0,1.0,0.0,1.0,0.0,-1582.0,0.0,0.0,0.0,0.0,0.0,6.0,1.0,1.0,0.0,1.0,0.0,1.0,0.0,0.0,0.0,0.0,0.0,0.0,0.0,1.0,0.0,0.0,0.0,0.0,0.0,0.0,0.0,0.0,0.0,0.0,0.0,0.0,0.0,0.0,0.0,0.0,0.0,0.0,9.0,6385.5,0.0,50661.945,6750.0,0.0,0.0,0.0,0.0,-1205.0,4477.0,-105.0,-535.0,341.0,-23.0,16.0,7531.4475,45000.0,60286.5,0.0,56250.0,12.0,-637.5,365243.0,-1635.0,-1125.0,-1125.0,-1118.5,13.0,1.0,0.0,-1.0,89.0,24.0,8.0,-49.0,0.0,0.0,115.0,6536.34,6024.06,-1447.0,-1446.0,9.0,1.0,7.0,356021.055,337500.0,3600.0,3600.0,0.0,0.0,17466.12,18000.0,18000.0,337079.25,348434.73,348434.73,1.0,1.0,0.0,0.0,2.0,-5.0,0.0,0.0,8336163829.5,184212390397.5,165418216497.0,51909462460.935,1862.0,1703.0,71123.0,70623.0,9140.0,505416.0,17787.395600002306,17849.41239999911,17301.337299998097,11282.857200000086,11220.685100000092,11168.190200000055,128246.0,661987.0,,,,13511744.389040696,-601176604.0,-920794991.0,-296108918.0,-1533381511.0416667,43952.0,30658.0,11338.33999999917,11214.299999998964,10698.981099997303,22861.5149000096,22783.35810000956,22169.55380000811,,157849.43390485927,125956.53235390724,34960.14310002786,34900.6151000283,34347.2990000287,,,,3709768.0,8286.783000000172,8391.16910000008,8114.962800000229,,,,16450.27489999975,16635.2664999997,16232.217199999706,,,,3908.771600000125,3891.98430000016,3724.724500000156,435894.0,430698.0,,6417.390152002897,631178.0,624738.0,,16314.1073999998,154002.0142999906,154004.7557999901,153896.5680999872,,,,40.0,1999353.3750000016,928155.2849999996,264072208.32,90177360.52499998,4419393.48,180.0,3.0,1327.0,-888449.0,335056.5,-466054.0,-499003.0,-19.5,9175.5,0.0,111600.0,0.0,0.0,0.0,0.0,0.0,-1503.0,9512.0,-298.0,-770.0,11258666.235000014,163849278.10500005,182063342.52,2957706.585,163797528.10500005,11018.0,-729771.0,163778959.0,10464857.0,33611950.0,17259076.0,35088555.0,10574.0,161.5,28.23279188983884,298517.0,85546.0,50921.0,-166189.0,127618.0,413.0,115797231.449999,114822185.17499933,-6646499.0,-6595960.0,125089.0,5582.0,91703017.21500002,283540500.0,8750202.75,11876163.705,230431.5,2895457.0950000007,5800966.560000002,12375034.15499992,11316850.37999999,87640668.71999995,91348023.28499994,91354282.69499992,468.0,961.0,6.0,487.0,35702.0,-58232.0,1029.0,66.0,1465457.0,14707726.0,3228402.0,8543713.0,11592426.0,1413790.0,1056407707.3320012,800984695.9724951,72015781960.1021,21651632460.74262,581630461.1594988,5792395.7475,689.5,94245.0,-276588291.0,21851631.5,-123643657.5,-218443367.5,-2012462.0,5914832159.362462,18695090250.0,198605420.325,447324163.6274977,1948107.735,256441897.7775008,308725444.1699988,635532858.1349982,458402921.3474992,5700287666.160028,5878184253.907496,5878427436.652497,13364.0,80720.5,44.0,70247.5,970382.0,-1696257.5,177364.0,6755.0,4267395.5,2476055.5,-8992397.5,921269.0,37582.5,3728684565.944965,3653246757.892461,-260310753.0,-257004139.0,2523396.0,268866.5,3921265605.2849545,33216710866.62841,36642135838.207634,1727532556.7400494,48026908986.72822,3983112.0,-247286439.5,102957468940.0,1052327775.5,17255836878.5,3499858529.5,18869118004.5,3667601.0,71825.5,20849.08128103722,89668845.0,-43.22689989956478,3.891,7.942391189240707,259.98819158643283,30.90384411733559,1011.61405346281,112500.0,0.6234898018587336,0.7818314824680298,0.0,0.0,0.0,0.0,0.0,0.0,1.0,0.0,1.0,0.0,0.0,0.0,0.0,0.0,0.0,0.0,1.0,0.0,0.0,0.0,1.0,0.0,0.0,0.0,0.0,1.0,0.0,0.0,0.0,0.0,0.0,0.0,0.0,0.0,0.0,0.0,0.0,0.0,1.0,0.0,0.0,0.0,0.0,0.0,0.0,0.0,0.0,0.0,0.0,0.0,0.0,0.0,0.0,1.0,0.0,0.0,0.0,0.0,0.0,0.0,0.0,0.0,0.0,0.0,0.0,0.0,0.0,0.0,0.0,0.0,0.0,0.0,0.0,0.0,0.0,0.0,0.0,0.0,0.0,0.0,0.0,0.0,0.0,0.0,0.0,0.0,0.0,0.0,0.0,0.0,0.0,0.0,0.0,0.0,0.0,0.0,0.0,0.0,0.0,0.0,0.0,0.0,0.0,0.0,0.0,0.0,0.0,0.0,0.0,0.0,1.0,0.0,0.0,0.0,0.0,0.0,0.0,1.0,0.0,0.0
100171,0,0.0,1.0,1.0,1.0,0.0,157500.0,539100.0,29245.5,450000.0,0.031329,36.08767123287672,-3518.0,-6207.0,-4243.0,20.0,2.0,2.0,2.0,14.0,,0.6874076897321058,0.6626377922738201,,,,,,,,,,,,,,,,,,,,,,,,,,,,,,,,,,,,,,,,,,,,,7.0,0.0,7.0,0.0,-2470.0,0.0,0.0,0.0,0.0,1.0,4.0,1.0,1.0,1.0,1.0,0.0,0.0,0.0,0.0,0.0,0.0,0.0,0.0,0.0,1.0,0.0,0.0,0.0,0.0,0.0,0.0,0.0,0.0,0.0,0.0,0.0,0.0,0.0,0.0,0.0,0.0,0.0,0.0,8.0,11250.0,9845.955,297000.0,0.0,0.0,0.0,0.0,0.0,-1505.0,-472.0,-715.0,-1799.0,403.0,-27.0,1.0,5119.695,43870.5,43870.5,0.0,43870.5,12.0,-2776.0,365243.0,-2728.0,-2458.0,-2398.0,-2453.0,9.0,0.0,0.0,15.0,18.0,10.0,2.5,-89.5,0.0,0.0,117.0,4500.0,4500.0,-1685.0,-1662.0,45.0,0.0,96.0,33.75,90000.0,0.0,0.0,0.0,0.0,67.5,1659.735,0.0,0.0,0.0,0.0,0.0,0.0,0.0,0.0,44.0,-48.5,0.0,0.0,8336193075.0,184212929497.5,165418666497.0,51909619960.935,1862.0,1703.0,71123.0,70624.0,9140.0,505420.0,,,,,,,128246.0,661989.0,,,,13511780.476711929,-601180122.0,-920799234.0,-296111388.0,-1533387718.0416667,43952.0,30658.0,,,,,,,,157850.12131254902,125957.19499169948,,,,,,,3709782.0,,,,,,,,,,,,,,,,435901.0,430705.0,1261464.0,6417.421481002897,631180.0,624740.0,,,,,,,,,50.0,2053751.6250000016,940615.1999999996,266728325.265,90952458.52499998,4455348.48,180.0,3.0,1327.0,-899569.0,358775.0,-472449.0,-505020.0,-24.5,11250.0,9845.955,270000.0,0.0,0.0,0.0,0.0,0.0,-1975.0,-1610.0,-1794.0,-1799.0,11304934.290000016,164309398.60500005,182704772.52,2957706.585,164309398.60500005,11072.0,-738183.0,164691952.0,10459497.0,33971118.0,17618304.0,35447761.0,10684.0,163.0,28.23279188983884,298526.0,86429.0,51350.5,-168809.0,127622.0,417.0,116366639.17499894,115323171.70499928,-6807831.0,-6756970.0,128340.0,5631.0,94041130.59000002,288580500.0,8956302.75,12082263.705,230431.5,2895457.0950000007,5940519.660000003,12644708.062499903,11550845.87999999,89871829.51499996,93675139.87499994,93681399.28499994,477.0,970.0,6.0,487.0,37180.0,-60875.5,1032.0,69.0,1465465.0,14708129.0,3228498.0,8543731.0,11592543.0,1413791.0,1056418957.3320012,800994541.927495,72016078960.1021,21651632460.74262,581630461.1594988,5792395.7475,689.5,94245.0,-276589796.0,21851159.5,-123644372.5,-218445166.5,-2012489.0,5914832193.112462,18695180250.0,198605420.325,447324163.6274977,1948107.735,256441897.7775008,308725511.6699988,635534517.8699981,458402921.3474992,5700287666.160028,5878184253.907496,5878427436.652497,13364.0,80720.5,44.0,70247.5,970426.0,-1696306.0,177364.0,6755.0,4267405.5,2476058.0,-8992487.0,921269.0,37582.5,3728689065.944965,3653251257.892461,-260312438.0,-257005801.0,2523441.0,268866.5,3921270724.9799542,33216754737.12841,36642179708.707634,1727532556.7400494,48026952857.22822,3983124.0,-247289215.5,102957834183.0,1052325047.5,17255834420.5,3499856131.5,18869115551.5,3667610.0,71825.5,20849.08128103722,89668860.0,-97.48481627695112,3.4228571428571435,5.385443914448377,194.3481294277097,18.43360517002616,665.2258830125605,78750.0,-0.2225209339563143,0.9749279121818236,0.0,0.0,0.0,0.0,0.0,0.0,1.0,0.0,0.0,0.0,0.0,0.0,0.0,1.0,0.0,0.0,0.0,0.0,1.0,0.0,1.0,0.0,0.0,0.0,0.0,1.0,0.0,0.0,0.0,0.0,0.0,0.0,0.0,0.0,1.0,0.0,0.0,0.0,0.0,0.0,0.0,0.0,0.0,0.0,0.0,0.0,0.0,0.0,0.0,0.0,0.0,0.0,0.0,1.0,0.0,0.0,0.0,0.0,0.0,0.0,0.0,0.0,0.0,0.0,0.0,0.0,0.0,0.0,0.0,0.0,0.0,0.0,0.0,0.0,0.0,0.0,0.0,0.0,0.0,0.0,0.0,0.0,0.0,0.0,0.0,0.0,0.0,0.0,0.0,0.0,0.0,0.0,0.0,0.0,0.0,0.0,0.0,0.0,0.0,0.0,0.0,0.0,0.0,0.0,0.0,0.0,0.0,0.0,0.0,0.0,0.0,0.0,0.0,0.0,0.0,0.0,0.0,0.0,0.0,0.0
100172,0,0.0,0.0,0.0,1.0,0.0,76500.0,225000.0,12334.5,225000.0,0.010966,42.175342465753424,-967.0,-5389.0,-5433.0,,2.0,2.0,2.0,10.0,,0.3488858471220637,0.5352762504724826,,,,,,,,,,,,,,,,,,,,,,,,,,,,,,,,,,,,,,,,,,,,,4.0,2.0,4.0,0.0,0.0,0.0,0.0,0.0,0.0,1.0,2.0,1.0,1.0,0.0,1.0,0.0,0.0,0.0,0.0,0.0,0.0,1.0,1.0,0.0,1.0,0.0,0.0,0.0,0.0,0.0,0.0,0.0,0.0,0.0,0.0,0.0,0.0,0.0,0.0,0.0,0.0,0.0,0.0,3.0,2238.75,,33457.5,0.0,0.0,0.0,0.0,0.0,-659.0,437.0,-110.0,-179.0,59.0,-9.0,3.0,5361.75,30055.5,33228.0,0.0,66687.75,18.0,-311.0,365243.0,-420.5,182318.5,89.5,182323.0,11.0,0.0,0.0,200.0,12.0,12.0,10.5,-20.5,0.0,0.0,9.0,3406.545,3406.545,-708.0,-636.0,3.0,1.0,0.0,,,,,,,,,,,,,,,,,,,,,8336205409.5,184213154497.5,165418891497.0,51909696460.935,1862.0,1703.0,71123.0,70625.0,9140.0,505422.0,,,,,,,128246.0,661991.0,,,,13511822.652054396,-601181089.0,-920804667.0,-296111388.0,-1533393107.0416667,43954.0,30658.0,,,,,,,,157850.4701983961,125957.73026794998,,,,,,,3709792.0,,,,,,,,,,,,,,,,435905.0,430709.0,,6417.432447002897,631182.0,624742.0,,,,,,,,,22.0,2110620.375000002,,270443097.765,92846384.59499995,4455348.48,180.0,3.0,1327.0,-904645.0,360657.0,-474227.0,-506685.5,-10.5,4477.5,,33457.5,0.0,0.0,0.0,0.0,0.0,-659.0,437.0,-110.0,-245.0,11313954.517500011,164442774.10500005,182863141.02,2957706.585,164427746.35500005,11102.0,-739086.0,165239816.5,10459034.0,34336058.0,17618696.0,35812705.5,10705.0,163.0,28.23279188983884,298925.0,86634.0,51501.0,-169647.0,127622.0,417.0,116667046.25999886,115623578.7899992,-6903101.0,-6851853.0,131068.0,5649.0,,,,,,,,,,,,,,,,,,,,,1465468.0,14708188.0,3228498.0,8543743.0,11592552.0,1413794.0,1056421196.0820012,,72016112417.6021,21651632460.74262,581630461.1594988,5792395.7475,689.5,94245.0,-276590455.0,21851596.5,-123644482.5,-218445345.5,-2012498.0,,,,,,,,,,,,,,,,,,,,,4267417.5,2476068.5,-8992507.5,921269.0,37582.5,3728692472.489965,3653254664.437461,-260313146.0,-257006437.0,2523444.0,268867.5,3921276086.7299542,33216784792.62841,36642212936.707634,1727532556.7400494,48027019544.97822,3983142.0,-247289526.5,102958199426.0,1052324627.0,17256016739.0,3499856221.0,18869297874.5,3667621.0,71825.5,20849.08128103722,89669060.0,-22.92808886579187,2.9411764705882355,6.202116016052536,261.57636698935,18.24151769427216,769.3422558510292,38250.0,0.6234898018587336,0.7818314824680298,0.0,0.0,0.0,0.0,0.0,0.0,1.0,0.0,0.0,0.0,0.0,0.0,0.0,1.0,0.0,0.0,0.0,0.0,1.0,1.0,0.0,0.0,0.0,0.0,0.0,1.0,0.0,0.0,0.0,0.0,0.0,0.0,0.0,0.0,0.0,0.0,0.0,0.0,1.0,0.0,0.0,0.0,0.0,0.0,0.0,0.0,0.0,0.0,0.0,0.0,0.0,0.0,0.0,1.0,0.0,0.0,0.0,0.0,0.0,0.0,0.0,0.0,0.0,0.0,0.0,0.0,0.0,0.0,0.0,0.0,0.0,0.0,0.0,0.0,0.0,0.0,0.0,0.0,0.0,0.0,0.0,0.0,0.0,0.0,0.0,0.0,0.0,0.0,0.0,0.0,0.0,0.0,0.0,0.0,0.0,0.0,0.0,0.0,0.0,0.0,0.0,0.0,0.0,0.0,0.0,0.0,0.0,0.0,0.0,0.0,0.0,0.0,0.0,0.0,0.0,0.0,0.0,0.0,0.0,0.0
100184,0,0.0,0.0,0.0,1.0,0.0,112500.0,256032.0,10759.5,180000.0,0.0196889999999999,57.94520547945206,,-4157.0,-4658.0,,1.0,2.0,2.0,11.0,,0.2631011921849177,0.4740512892789932,0.1361,,0.9826,0.762,0.0573,0.0,0.069,0.1667,0.2083,0.0645,,0.0488,,0.0284,0.1387,,0.9826,0.7713,0.0579,0.0,0.069,0.1667,0.2083,0.066,,0.0509,,0.0301,0.1374,,0.9826,0.7652,0.0577,0.0,0.069,0.1667,0.2083,0.0656,,0.0497,,0.029,0.0759,1.0,1.0,0.0,1.0,0.0,-672.0,0.0,0.0,0.0,0.0,0.0,4.0,1.0,0.0,0.0,1.0,0.0,0.0,0.0,0.0,0.0,0.0,0.0,0.0,0.0,1.0,0.0,0.0,0.0,0.0,0.0,0.0,0.0,0.0,0.0,0.0,0.0,0.0,0.0,0.0,0.0,0.0,0.0,0.0,11.0,0.0,,90000.0,17010.0,0.0,0.0,0.0,0.0,-612.0,1.0,-242.0,-473.0,198.0,-11.0,11.0,14232.69,48105.0,46854.0,1803.6,163971.0,24.0,-573.0,365243.0,-2882.0,-2642.0,-2612.0,-2636.0,13.0,1.0,0.1016636585288622,-1.0,37.0,24.0,8.0,-19.0,0.0,0.0,37.0,8654.535,8654.535,-594.0,-564.0,7.0,1.0,0.0,,,,,,,,,,,,,,,,,,,,,8336216169.0,184213410529.5,165419071497.0,51909808960.935,1862.0,1703.0,71123.0,70625.0,9140.0,505426.0,17787.531700002306,17849.549799999113,17301.475999998096,,,,128246.0,661992.0,4134.1496000001225,4131.7780000000175,3942.599000000096,13511880.597259875,,-920809325.0,-296112060.0,-1533397264.0416667,43954.0,30658.0,11338.33999999917,11214.299999998964,10698.981099997303,22861.5839000096,22783.42710000956,22169.62280000811,,157850.7332995883,125958.20431923926,34960.30980002786,34900.7818000283,34347.465700028704,22928.620099995933,22902.067599995506,22549.456699995742,3709803.0,8286.847500000173,8391.23470000008,8115.028800000229,,,,16450.32369999975,16635.3161999997,16232.268099999706,,,,3908.800000000125,3892.01330000016,3724.754600000156,435906.0,430710.0,,6417.452136002897,631184.0,624744.0,,16314.1832999998,154002.9968999906,154005.73839999008,153897.55069998722,77523.80359999627,77861.20160000659,78262.09670000644,21.0,2735294.625000002,,288049592.385,98622980.59499995,4643526.96,180.0,3.0,1327.0,-999570.0,429581.0,-524028.0,-561400.0,-10.0,0.0,,112500.0,0.0,0.0,0.0,0.0,0.0,-797.0,-432.0,-458.0,-484.0,11846990.115000011,171891723.10500005,191755573.02,3066341.085,171779223.10500005,11660.0,-784914.0,174915954.0,11152677.0,36496724.0,18691978.0,37608698.0,11310.0,170.0,30.24249770283969,304137.0,91693.0,54660.0,-182954.0,127676.0,437.0,123721343.54999886,121556995.60499915,-7637389.0,-7581718.0,143377.0,5975.0,,,,,,,,,,,,,,,,,,,,,1465479.0,14708386.0,3228498.0,8543780.0,11592589.0,1413805.0,1056421196.0820012,,72016202417.6021,21651649470.74262,581630461.1594988,5792395.7475,689.5,94245.0,-276591067.0,21851597.5,-123644724.5,-218445818.5,-2012509.0,,,,,,,,,,,,,,,,,,,,,4267441.5,2476076.5,-8992526.5,921269.0,37582.5,3728701127.024964,3653263318.9724607,-260313740.0,-257007001.0,2523451.0,268868.5,3921290319.419955,33216832897.62841,36642259790.707634,1727534360.3400495,48027183515.97822,3983166.0,-247290099.5,102958564669.0,1052321745.0,17256014097.0,3499853609.0,18869295238.5,3667634.0,71826.5,20849.18294469575,89669059.0,,2.27584,10.455876202425763,605.8678950172737,23.795901296528648,1378.8583901961124,112500.0,-0.9009688679024191,0.4338837391175582,0.0,0.0,0.0,0.0,0.0,0.0,1.0,0.0,0.0,1.0,0.0,0.0,0.0,0.0,0.0,0.0,0.0,0.0,1.0,0.0,0.0,0.0,0.0,1.0,0.0,1.0,0.0,0.0,0.0,0.0,0.0,0.0,0.0,0.0,0.0,0.0,0.0,0.0,0.0,0.0,0.0,0.0,0.0,0.0,0.0,0.0,0.0,0.0,0.0,0.0,0.0,0.0,0.0,0.0,0.0,0.0,0.0,0.0,0.0,0.0,0.0,0.0,0.0,0.0,0.0,0.0,0.0,0.0,0.0,0.0,0.0,0.0,0.0,0.0,0.0,0.0,0.0,0.0,0.0,0.0,0.0,0.0,0.0,0.0,0.0,0.0,0.0,0.0,0.0,0.0,0.0,0.0,0.0,0.0,0.0,0.0,0.0,0.0,0.0,0.0,0.0,0.0,0.0,0.0,0.0,1.0,0.0,0.0,1.0,0.0,1.0,0.0,0.0,0.0,0.0,0.0,0.0,0.0,1.0,0.0
100187,0,0.0,0.0,0.0,1.0,0.0,225000.0,501363.0,25726.5,418500.0,0.031329,57.64383561643836,-2467.0,-918.0,-3663.0,,2.0,2.0,2.0,12.0,,0.266212100961842,0.5954562029091491,0.0722,,0.9965,,,0.04,0.0345,0.5,,,,0.0986,,0.0843,0.0735,,0.9965,,,0.0403,0.0345,0.5,,,,0.1027,,0.0893,0.0729,,0.9965,,,0.04,0.0345,0.5,,,,0.1004,,0.0861,0.1175,1.0,5.0,1.0,5.0,1.0,-1792.0,0.0,0.0,0.0,0.0,0.0,0.0,1.0,1.0,0.0,1.0,1.0,0.0,0.0,0.0,0.0,0.0,0.0,0.0,0.0,1.0,0.0,0.0,0.0,0.0,0.0,0.0,0.0,0.0,0.0,0.0,0.0,0.0,0.0,0.0,0.0,0.0,0.0,0.0,4.0,33750.0,0.0,1035000.0,0.0,0.0,0.0,0.0,0.0,-631.0,-437.0,-424.0,-437.0,80.0,-10.0,7.0,11250.0,200196.0,206982.0,0.0,206982.0,12.0,-394.0,365243.0,-892.5,-627.0,168.0,-623.5,10.0,0.0,0.0,-1.0,46.0,24.0,10.5,-42.5,0.0,0.0,43.0,10625.85,10625.85,-1283.0,-1280.0,8.0,1.0,11.0,0.0,90000.0,,0.0,,,0.0,,0.0,0.0,0.0,0.0,,0.0,,,0.0,-8.0,0.0,0.0,8336241895.5,184213911892.5,165419489997.0,51910033960.935,1862.0,1703.0,71123.0,70625.0,9140.0,505426.0,17787.603900002305,17849.622699999112,17301.549499998095,,,,128246.0,661994.0,,,,13511938.24109549,-601183556.0,-920812988.0,-296113852.0,-1533398182.0416667,43955.0,30659.0,11338.379999999172,11214.339999998963,10699.021399997304,22861.6184000096,22783.46160000956,22169.65730000811,,157850.99951168927,125958.79977544217,34960.80980002786,34901.2818000283,34347.965700028704,,,,3709815.0,,,,,,,16450.42229999975,16635.4165999997,16232.370799999708,,,,3908.884300000125,3892.09940000016,3724.843900000156,435911.0,430715.0,,6417.483465002897,631186.0,624746.0,,16314.3007999998,154003.9933999906,154006.7348999901,153898.5471999872,,,,21.0,2816308.125000002,1036967.9399999996,293103519.165,101527451.59499995,4643526.96,180.0,3.0,1327.0,-1005844.5,430265.0,-527816.5,-565561.0,-10.5,33750.0,0.0,450000.0,0.0,0.0,0.0,0.0,0.0,-765.0,-437.0,-431.0,-437.0,12123949.455000011,175785752.20500004,195791852.52,3101714.685,175785752.20500004,11896.0,-802593.0,179481491.5,11502892.0,37218070.0,19048214.0,37965960.5,11525.0,173.0,30.796902831964463,313663.0,93958.0,56047.5,-187567.0,128273.0,437.0,127600370.00999892,125975623.4999992,-7768208.0,-7711162.0,144226.0,6137.0,111235714.06499995,331308000.0,,12626763.705,,,7081938.900000002,,12901519.034999987,106388399.8799999,110867319.26999988,110874838.67999987,,1003.0,,,47081.0,-73234.0,1142.0,84.0,1465483.0,14708466.0,3228509.0,8543826.0,11592632.0,1413812.0,1056454946.0820012,800994541.927495,72017237417.6021,21651649470.74262,581630461.1594988,5792395.7475,689.5,94245.0,-276591698.0,21851160.5,-123645148.5,-218446255.5,-2012519.0,5914832193.112462,18695270250.0,,447324163.6274977,,,308725511.6699988,,458402921.3474992,5700287666.160028,5878184253.907496,5878427436.652497,,80720.5,,,970426.0,-1696314.0,177364.0,6755.0,4267465.5,2476087.0,-8992569.0,921269.0,37582.5,3728711752.874964,3653273944.822461,-260315023.0,-257008281.0,2523459.0,268869.5,3921301569.419955,33217033093.62841,36642466772.707634,1727534360.3400495,48027390497.97822,3983178.0,-247290493.5,102958929912.0,1052320852.5,17256013470.0,3499853777.0,18869294615.0,3667644.0,71826.5,20849.18294469575,89669058.0,-42.79729087452471,2.22828,8.745845723281441,504.1440931995658,19.48819310827357,1123.3741999947283,112500.0,-0.9009688679024191,0.4338837391175582,0.0,1.0,0.0,0.0,0.0,0.0,0.0,0.0,1.0,0.0,0.0,0.0,0.0,0.0,0.0,1.0,0.0,0.0,0.0,0.0,1.0,0.0,0.0,0.0,0.0,1.0,0.0,0.0,0.0,0.0,0.0,0.0,0.0,0.0,0.0,0.0,0.0,0.0,0.0,0.0,0.0,0.0,0.0,0.0,0.0,0.0,0.0,0.0,0.0,0.0,0.0,0.0,0.0,0.0,0.0,0.0,0.0,0.0,0.0,0.0,0.0,0.0,0.0,0.0,0.0,0.0,0.0,0.0,0.0,0.0,0.0,0.0,0.0,0.0,0.0,0.0,0.0,0.0,0.0,0.0,0.0,0.0,0.0,0.0,0.0,0.0,0.0,0.0,0.0,0.0,1.0,0.0,0.0,0.0,0.0,0.0,0.0,0.0,0.0,0.0,0.0,0.0,0.0,0.0,0.0,0.0,0.0,0.0,0.0,0.0,1.0,0.0,0.0,0.0,0.0,0.0,0.0,0.0,1.0,0.0
100212,0,0.0,0.0,1.0,0.0,0.0,90000.0,450000.0,23107.5,450000.0,0.005002,43.213698630137,-1310.0,-7173.0,-5049.0,22.0,2.0,3.0,3.0,15.0,,0.7629532085826144,0.3572932680336494,,,,,,,,,,,,,,,,,,,,,,,,,,,,,,,,,,,,,,,,,,,,,5.0,0.0,5.0,0.0,-2865.0,0.0,0.0,0.0,0.0,0.0,0.0,1.0,1.0,0.0,1.0,0.0,0.0,0.0,0.0,0.0,0.0,0.0,0.0,0.0,1.0,0.0,0.0,0.0,0.0,0.0,0.0,0.0,0.0,0.0,0.0,0.0,0.0,0.0,0.0,0.0,0.0,0.0,0.0,1.0,3357.54,0.0,23502.645,16299.0,0.0,0.0,0.0,0.0,-78.0,107.0,-16.0,,3.0,-1.0,5.0,11614.455,59355.0,63567.0,9841.5,96606.0,12.0,-965.0,365243.0,-1015.0,-865.0,-685.0,-860.0,14.0,0.0,0.0991016075191329,60.0,44.0,24.0,8.5,-72.5,0.0,0.0,42.0,2962.215,2962.215,-2222.5,-2218.0,6.0,1.0,0.0,,,,,,,,,,,,,,,,,,,,,8336265003.0,184214361892.5,165419939997.0,51910123960.935,1862.0,1703.0,71123.0,70625.0,9140.0,505426.0,,,,,,,128246.0,661996.0,,,,13511981.45479412,-601184866.0,-920818037.0,-296116717.0,-1533405355.0416667,43955.0,30659.0,,,,,,,,157851.76246489782,125959.1570687102,,,,,,,3709830.0,,,,,,,,,,,,,,,,435916.0,430720.0,1261486.0,6417.488467002897,631189.0,624749.0,,,,,,,,,3.0,3210334.020000002,1165561.0649999997,318606825.14999986,108659491.28999996,4781036.295,180.0,3.0,1327.0,-1146303.0,438295.0,-612605.0,,-1.0,3357.54,0.0,23502.645,16299.0,0.0,0.0,0.0,0.0,-78.0,107.0,-16.0,,13457341.867500018,194481886.45500004,216300350.52,3414923.685,194452208.95500004,13418.0,-934854.0,203946373.5,12146527.5,40803067.5,21547319.5,42284422.0,13075.0,193.5,36.17634099707652,354854.0,104805.0,62640.5,-213592.0,130408.0,507.0,140292970.53749928,138089712.98249906,-8857013.0,-8791897.5,159819.5,6987.5,,,,,,,,,,,,,,,,,,,,,1465484.0,14708469.0,3228509.0,8543870.0,11592674.0,1413817.0,1056458303.6220012,800994541.927495,72017260920.2471,21651665769.74262,581630461.1594988,5792395.7475,689.5,94245.0,-276591776.0,21851267.5,-123645164.5,,-2012520.0,,,,,,,,,,,,,,,,,,,,,4267489.5,2476095.5,-8992641.5,921269.0,37582.5,3728714715.089965,3653276907.037461,-260317245.5,-257010499.0,2523465.0,268870.5,3921313183.874954,33217092448.62841,36642530339.707634,1727544201.8400495,48027487103.97822,3983190.0,-247291458.5,102959295155.0,1052319837.5,17256012605.0,3499853092.0,18869293755.0,3667658.0,71826.5,20849.28204630327,89669118.0,-30.314461421416343,5.0,3.894839337877313,168.31041335983247,19.474196689386567,841.5520667991624,45000.0,1.0,0.0,0.0,0.0,0.0,0.0,0.0,0.0,1.0,0.0,0.0,0.0,0.0,0.0,0.0,1.0,0.0,0.0,0.0,1.0,0.0,0.0,1.0,0.0,0.0,0.0,0.0,1.0,0.0,0.0,0.0,0.0,0.0,0.0,0.0,1.0,0.0,0.0,0.0,0.0,0.0,0.0,0.0,0.0,0.0,0.0,0.0,0.0,0.0,0.0,0.0,0.0,0.0,0.0,0.0,0.0,0.0,0.0,0.0,0.0,0.0,0.0,0.0,0.0,0.0,0.0,0.0,0.0,0.0,0.0,0.0,0.0,0.0,0.0,0.0,0.0,0.0,0.0,0.0,0.0,0.0,0.0,0.0,0.0,0.0,0.0,0.0,0.0,0.0,0.0,0.0,0.0,1.0,0.0,0.0,0.0,0.0,0.0,0.0,0.0,0.0,0.0,0.0,0.0,0.0,0.0,0.0,0.0,0.0,0.0,0.0,0.0,0.0,0.0,0.0,0.0,0.0,0.0,0.0,0.0,0.0,0.0
100222,0,0.0,0.0,1.0,1.0,0.0,360000.0,945000.0,34074.0,945000.0,0.030755,48.75616438356165,-2785.0,-2296.0,-1224.0,1.0,2.0,2.0,2.0,12.0,,0.6786018822974562,0.2539628093363117,,,,,,,,,,,,,,,,,,,,,,,,,,,,,,,,,,,,,,,,,,,,,0.0,0.0,0.0,0.0,0.0,0.0,0.0,0.0,0.0,1.0,3.0,1.0,1.0,0.0,1.0,0.0,0.0,0.0,0.0,0.0,0.0,0.0,0.0,0.0,1.0,0.0,0.0,0.0,0.0,0.0,0.0,0.0,0.0,0.0,0.0,0.0,0.0,0.0,0.0,0.0,0.0,0.0,0.0,14.0,0.0,0.0,207522.0,0.0,0.0,0.0,0.0,0.0,-1415.0,-1007.0,-819.5,-1356.0,578.0,-22.0,4.0,23870.4975,360000.0,338256.0,36000.0,360000.0,18.0,-582.0,,,,,,14.0,,0.1009165038075342,80.0,19.0,18.0,9.0,-10.0,0.0,0.0,18.0,21672.315,21672.315,-301.5,-296.0,9.5,1.0,0.0,,,,,,,,,,,,,,,,,,,,,8336299077.0,184215306892.5,165420884997.0,51910483960.935,1862.0,1703.0,71123.0,70626.0,9140.0,505429.0,,,,,,,128246.0,661998.0,,,,13512030.210958503,-601187651.0,-920819261.0,-296116717.0,-1533407651.0416667,43955.0,30659.0,,,,,,,,157852.44106678013,125959.41103151956,,,,,,,3709842.0,,,,,,,,,,,,,,,,435916.0,430720.0,1261487.0,6417.519222002897,631191.0,624751.0,,,,,,,,,47.0,3309280.020000002,1170547.9649999994,327798219.91499984,112941218.65499996,4981027.545,180.0,3.0,1327.0,-1215334.0,465455.0,-652324.0,-698642.0,-23.0,0.0,0.0,186840.0,0.0,0.0,0.0,0.0,0.0,-1558.0,-1373.0,-1013.0,-1373.0,14056534.192500018,201626051.35500005,224456173.92,3657300.435,201806051.35500005,13801.0,-975007.0,,,,,,13621.0,,38.533313963274544,364752.0,110509.0,65155.0,-228904.0,218277.0,527.0,146765598.05249882,144451537.67249897,-9312272.0,-9243790.5,166580.5,7328.5,,,,,,,,,,,,,,,,,,,,,1465498.0,14709047.0,3228509.0,8543889.0,11592692.0,1413821.0,1056458303.6220012,800994541.927495,72017468442.2471,21651665769.74262,581630461.1594988,5792395.7475,689.5,94245.0,-276593191.0,21850260.5,-123645984.0,-218447611.5,-2012542.0,,,,,,,,,,,,,,,,,,,,,4267507.5,2476104.5,-8992651.5,921269.0,37582.5,3728736387.404965,3653298579.352461,-260317547.0,-257010795.0,2523474.5,268871.5,3921337054.372455,33217452448.62841,36642868595.707634,1727580201.8400495,48027847103.97822,3983208.0,-247292040.5,,,,,,3667672.0,,20849.38296280708,89669198.0,-57.12098224320072,2.625,10.565240359218173,515.1205957058811,27.733755942947703,1352.1915637279378,180000.0,-0.2225209339563143,0.9749279121818236,0.0,0.0,0.0,0.0,0.0,0.0,1.0,0.0,0.0,0.0,0.0,0.0,0.0,1.0,0.0,0.0,0.0,0.0,1.0,0.0,1.0,0.0,0.0,0.0,0.0,1.0,0.0,0.0,0.0,0.0,0.0,0.0,0.0,0.0,0.0,0.0,0.0,0.0,0.0,0.0,0.0,0.0,0.0,0.0,0.0,0.0,0.0,0.0,0.0,0.0,0.0,0.0,0.0,0.0,0.0,0.0,0.0,0.0,0.0,0.0,0.0,0.0,0.0,0.0,0.0,0.0,0.0,0.0,0.0,0.0,0.0,0.0,0.0,0.0,0.0,0.0,0.0,0.0,0.0,0.0,0.0,0.0,0.0,0.0,0.0,0.0,0.0,0.0,0.0,0.0,1.0,0.0,0.0,0.0,0.0,0.0,0.0,0.0,0.0,0.0,0.0,0.0,0.0,0.0,0.0,0.0,0.0,0.0,0.0,0.0,0.0,0.0,0.0,0.0,0.0,0.0,0.0,0.0,0.0,0.0
100223,0,0.0,0.0,0.0,0.0,0.0,180000.0,490374.0,35811.0,400500.0,0.00496,35.6,-2055.0,-164.0,-3461.0,,2.0,2.0,2.0,11.0,0.4477538250164531,0.7858814044490458,0.6127042441012546,0.1129,,0.9876,,,0.0,0.3103,0.1875,,0.0114,,,,,0.0998,,0.9866,,,0.0,0.2759,0.1667,,0.0116,,,,,0.114,,0.9876,,,0.0,0.3103,0.1875,,0.0116,,,,,0.0856,1.0,2.0,0.0,1.0,0.0,-1967.0,0.0,0.0,0.0,0.0,1.0,3.0,1.0,1.0,0.0,1.0,0.0,0.0,0.0,0.0,0.0,0.0,0.0,0.0,0.0,1.0,0.0,0.0,0.0,0.0,0.0,0.0,0.0,0.0,0.0,0.0,0.0,0.0,0.0,0.0,0.0,0.0,0.0,0.0,7.0,31.5,0.0,210150.0,27900.0,0.0,0.0,0.0,0.0,-464.0,-98.0,-343.0,-343.0,185.0,-16.0,6.0,18055.4175,175500.0,201062.25,1550.25,175500.0,15.0,-1094.0,365243.0,-1179.0,-969.0,-669.0,-960.0,13.0,0.0,0.0499989096724171,-1.0,75.0,18.0,13.0,-25.0,0.0,0.0,71.0,19340.46,19340.46,-710.0,-709.0,8.0,1.0,0.0,,,,,,,,,,,,,,,,,,,,,8336334888.0,184215797266.5,165421285497.0,51910663960.935,1862.0,1703.0,71123.0,70627.0,9140.0,505432.0,17787.716800002305,17849.736699999114,17301.649299998095,,,,128246.0,662000.0,,,,13512065.810958505,-601189706.0,-920822722.0,-296118684.0,-1533407815.0416667,43955.0,30659.0,11338.379999999172,11214.339999998963,10699.021399997304,22861.9287000096,22783.77190000956,22169.93320000811,67357.90597917946,157853.22694818454,125960.02373576364,34960.99730002786,34901.4693000283,34348.132400028706,,,,3709853.0,8286.858900000172,8391.246300000079,8115.040400000229,,,,,,,,,,,,,435918.0,430721.0,,6417.524182002897,631193.0,624753.0,,16314.3863999998,154004.9809999906,154007.72249999008,153899.5337999872,,,,16.0,3430064.520000002,1170547.9649999994,336232445.71499985,119852351.81999998,5052817.845,180.0,3.0,1327.0,-1227947.0,526472.0,-658494.0,-703744.0,-7.5,31.5,0.0,135324.0,27900.0,0.0,0.0,0.0,0.0,-1364.0,-566.0,-535.0,-633.0,14134694.64750002,203266256.35500005,226187265.42,3694850.685,203266256.35500005,13906.0,-979265.5,213256708.0,12110163.0,42966916.0,22985266.0,44815398.0,13689.0,201.0,38.684229376754494,364908.5,111921.0,66040.0,-229904.0,218277.0,527.0,147859194.01499864,145520520.16499883,-9341641.0,-9272892.0,167065.0,7374.0,,,,,,,,,,,,,,,,,,,,,1465505.0,14709232.0,3228509.0,8543964.0,11592763.0,1413827.0,1056458335.1220012,800994541.927495,72017678592.2471,21651693669.74262,581630461.1594988,5792395.7475,689.5,94245.0,-276593655.0,21850162.5,-123646327.0,-218447954.5,-2012558.0,,,,,,,,,,,,,,,,,,,,,4267525.5,2476117.5,-8992676.5,921269.0,37582.5,3728755727.864965,3653317919.812461,-260318257.0,-257011504.0,2523482.5,268872.5,3921355109.789954,33217627948.62841,36643069657.957634,1727581752.0900495,48028022603.97822,3983223.0,-247293134.5,102959660398.0,1052318658.5,17256011636.0,3499852423.0,18869292795.0,3667685.0,71826.5,20849.43296171675,89669197.0,-57.72471910112359,2.7243,5.026388539834128,178.939432018095,13.69339029907012,487.4846946468962,90000.0,1.0,0.0,0.0,0.0,0.0,0.0,0.0,0.0,1.0,0.0,1.0,0.0,0.0,0.0,0.0,0.0,0.0,1.0,0.0,0.0,0.0,0.0,1.0,0.0,0.0,0.0,0.0,1.0,0.0,0.0,0.0,0.0,0.0,0.0,0.0,0.0,0.0,0.0,0.0,0.0,0.0,0.0,1.0,0.0,0.0,0.0,0.0,0.0,0.0,0.0,0.0,0.0,0.0,0.0,0.0,0.0,0.0,0.0,0.0,0.0,0.0,0.0,0.0,0.0,0.0,0.0,0.0,0.0,0.0,0.0,0.0,0.0,0.0,0.0,0.0,0.0,0.0,0.0,0.0,0.0,0.0,0.0,0.0,0.0,0.0,0.0,0.0,0.0,0.0,0.0,0.0,0.0,0.0,0.0,0.0,0.0,0.0,0.0,0.0,0.0,1.0,0.0,0.0,0.0,0.0,0.0,0.0,0.0,0.0,0.0,0.0,0.0,0.0,0.0,0.0,0.0,0.0,0.0,0.0,0.0,1.0,0.0
100232,0,0.0,0.0,0.0,0.0,1.0,102150.0,335592.0,21577.5,265500.0,0.00496,39.57534246575342,-1751.0,-2204.0,-5049.0,,3.0,2.0,2.0,15.0,,0.7845722127718678,0.5673792367572691,,,,,,,,,,,,,,,,,,,,,,,,,,,,,,,,,,,,,,,,,,,,,0.0,0.0,0.0,0.0,-551.0,0.0,0.0,0.0,0.0,0.0,2.0,1.0,1.0,0.0,1.0,0.0,0.0,0.0,0.0,0.0,0.0,0.0,0.0,0.0,1.0,0.0,0.0,0.0,0.0,0.0,0.0,0.0,0.0,0.0,0.0,0.0,0.0,0.0,0.0,0.0,0.0,0.0,0.0,2.0,5962.5,,252000.0,96297.75,0.0,0.0,0.0,0.0,-827.5,-257.0,-157.5,,55.0,-13.0,3.0,33652.619999999995,144135.0,127485.0,28827.0,522067.5,18.0,-317.0,365243.0,-401.0,182409.0,109.0,182413.0,12.0,0.5,0.200849734098237,-1.0,15.0,24.0,17.0,-8.0,0.0,0.0,14.0,54366.795,54366.795,-229.5,-212.0,4.0,1.0,0.0,,,,,,,,,,,,,,,,,,,,,8336356465.5,184216132858.5,165421550997.0,51910766110.935,1862.0,1703.0,71123.0,70627.0,9140.0,505434.0,,,,,,,128247.0,662003.0,,,,13512105.386300968,-601191457.0,-920827771.0,-296119235.0,-1533410019.0416667,43955.0,30659.0,,,,,,,,157854.01152039735,125960.5911150004,,,,,,,3709868.0,,,,,,,,,,,,,,,,435918.0,430721.0,,6417.529142002897,631195.0,624755.0,,,,,,,,,27.5,3460777.020000002,,347546037.5099999,123344662.5,5198319.09,180.0,3.0,1327.0,-1295935.0,587457.0,-698867.0,,-13.25,0.0,,279000.0,0.0,0.0,0.0,0.0,0.0,-987.0,-257.0,-311.0,,14461645.882500015,207626558.35500005,230661979.92,3841984.935,207554490.85500005,14234.0,-1015726.0,221839918.5,13185696.5,46240033.5,24067758.5,47723253.5,14242.0,211.0,40.470394520374334,392647.0,114879.0,67607.0,-238669.0,227223.0,564.0,150664740.0524996,148253953.5224995,-9840511.5,-9774913.5,175598.5,7587.5,,,,,,,,,,,,,,,,,,,,,1465507.0,14709287.0,3228509.0,8543979.0,11592777.0,1413830.0,1056464297.6220012,,72017930592.2471,21651789967.49262,581630461.1594988,5792395.7475,689.5,94245.0,-276594482.5,21849905.5,-123646484.5,,-2012571.0,,,,,,,,,,,,,,,,,,,,,4267549.5,2476134.5,-8992684.5,921269.0,37582.5,3728810094.659965,3653372286.607462,-260318486.5,-257011716.0,2523486.5,268873.5,3921388762.4099545,33217772083.62841,36643197142.957634,1727610579.0900495,48028544671.47822,3983241.0,-247293451.5,102960025641.0,1052318257.5,17256194045.0,3499852532.0,18869475208.0,3667697.0,71827.0,20849.633811450847,89669196.0,-44.24472135687089,3.2852863436123347,4.734098018769552,187.35355035924977,15.552867570385818,615.5100604225291,34050.0,-0.9009688679024191,0.4338837391175582,0.0,0.0,0.0,0.0,0.0,0.0,1.0,0.0,0.0,0.0,0.0,0.0,0.0,1.0,0.0,1.0,0.0,0.0,0.0,0.0,1.0,0.0,0.0,0.0,0.0,1.0,0.0,0.0,0.0,0.0,0.0,0.0,0.0,1.0,0.0,0.0,0.0,0.0,0.0,0.0,0.0,0.0,0.0,0.0,0.0,0.0,0.0,0.0,0.0,0.0,0.0,0.0,0.0,0.0,0.0,0.0,0.0,0.0,0.0,0.0,0.0,0.0,0.0,0.0,0.0,0.0,0.0,0.0,0.0,0.0,0.0,0.0,0.0,0.0,0.0,0.0,0.0,0.0,0.0,0.0,0.0,0.0,0.0,0.0,0.0,0.0,0.0,1.0,0.0,0.0,0.0,0.0,0.0,0.0,0.0,0.0,0.0,0.0,0.0,0.0,0.0,0.0,0.0,0.0,0.0,0.0,0.0,0.0,0.0,0.0,0.0,0.0,0.0,0.0,0.0,0.0,0.0,0.0,0.0,0.0
100241,0,0.0,0.0,0.0,0.0,0.0,67500.0,431280.0,17797.5,360000.0,0.015221,25.16986301369863,-270.0,-3663.0,-725.0,,2.0,2.0,2.0,14.0,,0.0909218916196025,0.633031641417419,,,,,,,,,,,,,,,,,,,,,,,,,,,,,,,,,,,,,,,,,,,,,0.0,0.0,0.0,0.0,-247.0,0.0,0.0,0.0,0.0,0.0,2.0,1.0,1.0,1.0,1.0,0.0,0.0,1.0,1.0,0.0,1.0,1.0,1.0,0.0,0.0,0.0,0.0,0.0,0.0,0.0,0.0,0.0,0.0,0.0,0.0,0.0,0.0,0.0,0.0,0.0,0.0,0.0,0.0,2.0,0.0,,22407.75,562.2525,0.0,0.0,0.0,0.0,-433.5,-111.0,-253.0,-438.0,30.0,-7.0,0.0,,,,,,,,,,,,,,,,,0.0,,,,,,0.0,,,,,,,0.0,,,,,,,,,,,,,,,,,,,,,8336374263.0,184216564138.5,165421910997.0,51910833610.935,1862.0,1703.0,71123.0,70627.0,9140.0,505436.0,,,,,,,128247.0,662005.0,,,,13512130.556163983,-601191727.0,-920828496.0,-296119482.0,-1533413682.0416667,43955.0,30659.0,,,,,,,,157854.10244228895,125961.22414664183,,,,,,,3709882.0,,,,,,,,,,,,,,,,435918.0,430721.0,,6417.544363002897,631197.0,624757.0,,,,,,,,,15.0,3514326.0300000017,,355974122.87999994,125564328.49499996,5239241.774999999,180.0,3.0,1327.0,-1356967.0,665900.0,-727914.0,-772942.0,-7.0,0.0,,44815.5,0.0,0.0,0.0,0.0,0.0,-620.0,-438.0,-434.0,-438.0,,,,,,,,,,,,,,,,,,,,,,,,,,,,,,,,,,,,,,,,,,,,,,,,1465509.0,14709317.0,3228509.0,8543979.0,11592777.0,1413830.0,1056464297.6220012,,72017952999.9971,21651790529.74512,581630461.1594988,5792395.7475,689.5,94245.0,-276594916.0,21849794.5,-123646737.5,-218448392.5,-2012578.0,,,,,,,,,,,,,,,,,,,,,,,,,,,,,,,,,,,,,,,,,,,,,,,,-10.727114400783716,6.389333333333332,3.7926675094816686,95.46092167015917,24.232616940581547,609.9316488578703,33750.0,-0.9009688679024191,-0.433883739117558,0.0,0.0,0.0,0.0,0.0,0.0,1.0,0.0,0.0,0.0,0.0,0.0,0.0,1.0,0.0,0.0,0.0,0.0,1.0,0.0,1.0,0.0,0.0,0.0,0.0,0.0,0.0,0.0,1.0,0.0,0.0,0.0,0.0,0.0,0.0,0.0,0.0,0.0,1.0,0.0,0.0,0.0,0.0,0.0,0.0,0.0,0.0,0.0,0.0,0.0,0.0,0.0,0.0,1.0,0.0,0.0,0.0,0.0,0.0,0.0,0.0,0.0,0.0,0.0,0.0,0.0,0.0,0.0,0.0,0.0,0.0,0.0,0.0,0.0,0.0,0.0,0.0,0.0,0.0,0.0,0.0,0.0,0.0,0.0,0.0,0.0,0.0,0.0,0.0,0.0,0.0,0.0,0.0,0.0,0.0,0.0,0.0,0.0,0.0,0.0,0.0,0.0,0.0,0.0,0.0,0.0,0.0,0.0,0.0,0.0,0.0,0.0,0.0,0.0,0.0,0.0,0.0,0.0,0.0,0.0
100245,0,0.0,0.0,0.0,0.0,0.0,112500.0,364896.0,20947.5,315000.0,0.016612,36.61643835616439,-1397.0,-5725.0,-5788.0,,2.0,2.0,2.0,17.0,0.637953185640725,0.6708899286421401,0.5460231970049609,0.1814,0.0292,0.9752,0.66,0.0194,0.0,0.0345,0.1667,0.2083,0.0759,0.1471,0.0898,0.0039,0.006,0.1849,0.0303,0.9752,0.6733,0.0196,0.0,0.0345,0.1667,0.2083,0.0777,0.1607,0.0935,0.0039,0.0064,0.1832,0.0292,0.9752,0.6645,0.0195,0.0,0.0345,0.1667,0.2083,0.0773,0.1496,0.0914,0.0039,0.0062,0.0825,1.0,1.0,0.0,1.0,0.0,-2264.0,0.0,0.0,0.0,0.0,0.0,3.0,1.0,1.0,0.0,1.0,0.0,0.0,0.0,0.0,0.0,0.0,0.0,0.0,0.0,1.0,0.0,0.0,0.0,0.0,0.0,0.0,0.0,0.0,0.0,0.0,0.0,0.0,0.0,0.0,0.0,0.0,0.0,0.0,10.0,6804.0,0.0,191540.25,0.0,0.0,0.0,0.0,0.0,-1785.5,-1068.0,-330.0,-1620.0,547.0,-28.0,0.0,,,,,,,,,,,,,,,,,3.0,2.0,1.0,-93.0,0.0,0.0,126.0,830.835,830.835,-1839.0,-1839.0,74.5,0.0,96.0,0.0,90000.0,0.0,0.0,0.0,0.0,0.0,830.835,0.0,0.0,0.0,0.0,0.0,0.0,0.0,0.0,29.0,-48.5,0.0,0.0,8336395210.5,184216929034.5,165422225997.0,51910946110.935,1862.0,1703.0,71123.0,70627.0,9140.0,505439.0,17787.898200002306,17849.919899999113,17301.834199998095,11282.886400000089,11220.714300000092,11168.22050000006,128247.0,662007.0,4134.169000000124,4131.797500000018,3942.618600000096,13512167.172602337,-601193124.0,-920834284.0,-296121746.0,-1533419407.0416667,43955.0,30659.0,11338.379999999172,11214.339999998963,10699.021399997304,22861.963200009606,22783.80640000956,22169.967700008117,67358.5439323651,157854.77333221762,125961.77016983884,34961.164000027864,34901.6360000283,34348.29910002871,22928.828399995928,22902.275899995504,22549.664999995737,3709899.0,8286.934800000172,8391.32360000008,8115.11810000023,9807.467400000722,9922.28130000216,10281.465399999646,16450.512099999753,16635.5079999997,16232.464299999709,828.0660000001758,813.2469000000458,759.2341000000133,3908.890300000125,3892.10560000016,3724.850300000156,435919.0,430722.0,,6417.560975002897,631199.0,624759.0,,16314.468899999802,154005.9561999906,154008.6976999901,153900.5089999872,77524.46359999628,77861.86610000659,78262.77000000644,59.0,3537753.480000002,1286424.1799999992,364141824.75,133464111.47999996,5239874.789999999,180.0,3.0,1327.0,-1372521.5,694923.0,-733231.0,-780562.0,-29.0,0.0,0.0,113080.5,0.0,0.0,0.0,0.0,0.0,-2044.0,-1630.0,-474.0,-1610.0,,,,,,,,,,,,,,,,,123582.0,72842.0,-252811.0,227223.0,564.0,158018138.64000067,155134391.80500022,-10377721.5,-10306600.0,184702.5,7984.0,147590139.82500032,424813500.0,12228477.75,16284038.084999995,342481.5,3709607.850000002,9012996.855000006,17510180.87249979,15912432.494999984,141185279.74499992,147031269.52500007,147039544.93500006,683.0,1417.0,8.0,726.0,57806.5,-96144.0,41679.0,133.0,1465519.0,14709864.0,3228605.0,8543982.0,11592903.0,1413830.0,1056471101.6220012,800994541.927495,72018144540.2471,21651790529.74512,581630461.1594988,5792395.7475,689.5,94245.0,-276596701.5,21848726.5,-123647067.5,-218450012.5,-2012606.0,5914832193.112462,18695360250.0,198605420.325,447324163.6274977,1948107.735,256441897.7775008,308725511.6699988,635535348.7049981,458402921.3474992,5700287666.160028,5878184253.907496,5878427436.652497,13364.0,80720.5,44.0,70247.5,970455.0,-1696362.5,177364.0,6755.0,4267551.5,2476135.5,-8992777.5,921269.0,37582.5,3728810925.494965,3653373117.4424615,-260320325.5,-257013555.0,2523561.0,268873.5,,,,,,,,,,,,,,,,,-38.1522633744856,3.24352,5.370569280343718,196.6511189912158,17.41954887218045,637.8418374703882,56250.0,-0.9009688679024191,-0.433883739117558,0.0,0.0,0.0,0.0,0.0,0.0,1.0,0.0,0.0,0.0,0.0,0.0,0.0,1.0,0.0,0.0,1.0,0.0,0.0,0.0,1.0,0.0,0.0,0.0,0.0,1.0,0.0,0.0,0.0,0.0,0.0,0.0,0.0,0.0,0.0,0.0,0.0,0.0,1.0,0.0,0.0,0.0,0.0,0.0,0.0,0.0,0.0,0.0,0.0,0.0,0.0,0.0,0.0,0.0,0.0,0.0,0.0,0.0,0.0,0.0,0.0,0.0,0.0,0.0,0.0,1.0,0.0,0.0,0.0,0.0,0.0,0.0,0.0,0.0,0.0,0.0,0.0,0.0,0.0,0.0,0.0,0.0,0.0,0.0,0.0,0.0,0.0,0.0,0.0,0.0,0.0,0.0,0.0,0.0,0.0,0.0,0.0,0.0,0.0,0.0,0.0,0.0,0.0,0.0,0.0,0.0,0.0,0.0,1.0,0.0,1.0,0.0,0.0,0.0,0.0,0.0,0.0,0.0,1.0,0.0
100253,0,0.0,0.0,1.0,1.0,0.0,171000.0,819792.0,39568.5,720000.0,0.010966,42.824657534246576,-3060.0,-1545.0,-3162.0,1.0,1.0,2.0,2.0,14.0,0.3987508957507237,0.6083332060612188,0.6769925032909132,0.3309,0.2276,0.9856,0.8028,0.151,0.36,0.3103,0.3333,0.375,,0.269,0.2138,0.0039,0.0103,0.3372,0.2362,0.9856,0.8105,0.1524,0.3625,0.3103,0.3333,0.375,,0.2938,0.2227,0.0039,0.0109,0.3341,0.2276,0.9856,0.8054,0.1519,0.36,0.3103,0.3333,0.375,,0.2736,0.2176,0.0039,0.0106,0.2529,1.0,0.0,0.0,0.0,0.0,-2302.0,0.0,0.0,0.0,0.0,1.0,2.0,1.0,1.0,0.0,1.0,0.0,0.0,0.0,0.0,0.0,0.0,0.0,0.0,0.0,0.0,0.0,0.0,0.0,0.0,1.0,0.0,0.0,0.0,0.0,0.0,0.0,0.0,0.0,0.0,0.0,0.0,0.0,0.0,9.0,0.0,0.0,224424.0,0.0,0.0,0.0,0.0,0.0,-2437.0,-1467.0,-604.0,-2303.0,567.0,-33.0,7.0,7676.145,43992.0,35190.0,3523.5,43992.0,6.0,-2571.0,365243.0,-2447.0,-2237.0,-2237.0,-2228.0,14.0,0.0,0.1281915538916283,12.0,49.0,8.0,4.0,-83.0,0.0,0.0,46.0,4753.845,4378.7925,-2446.0,-2402.0,4.0,1.0,0.0,,,,,,,,,,,,,,,,,,,,,8336434779.0,184217748826.5,165422945997.0,51911117110.935,1862.0,1703.0,71123.0,70628.0,9140.0,505441.0,17788.229100002307,17850.25399999911,17302.171399998097,11283.114000000089,11220.941900000093,11168.456700000055,128247.0,662008.0,4134.3200000001225,4131.949400000018,3942.771000000096,13512209.99725987,-601196184.0,-920837446.0,-296124048.0,-1533420952.0416667,43955.0,30659.0,11338.739999999172,11214.699999998966,10699.383899997303,22862.273500009604,22784.116700009567,22170.278000008115,67358.94268326084,157855.3816654237,125962.44716234213,34961.49730002786,34901.9693000283,34348.632400028706,22929.203399995928,22902.650899995504,22550.039999995737,3709913.0,,,,9807.736400000722,9922.55490000216,10281.759199999646,16450.725899999754,16635.7255999997,16232.686999999709,828.0699000001758,813.2508000000457,759.2380000000132,3908.900600000125,3892.11620000016,3724.861200000156,435919.0,430722.0,1261488.0,6417.571941002897,631201.0,624761.0,,16314.7217999998,154006.9417999906,154009.68329999008,153901.4945999872,77525.26639999628,77862.67150000659,78263.58050000643,81.0,3810057.480000002,1450986.1199999994,379445139.35999984,135324949.27499998,5710857.614999998,180.0,4.0,1327.0,-1441202.0,674352.0,-769201.0,-819998.0,-40.0,12735.0,0.0,224424.0,0.0,0.0,0.0,0.0,0.0,-2451.0,-1712.0,-1708.0,-2415.0,15453787.63500002,223004560.27500007,248315365.89,4055150.385,223004560.27500007,15682.0,-1111169.0,245580448.5,14213601.0,53128770.0,25496312.0,53882254.5,15626.0,233.0,44.2889306380709,409476.0,132416.0,79212.0,-263957.0,232002.0,573.0,166976936.01000094,164838672.09000045,-10793004.0,-10717861.0,191919.0,8380.5,,,,,,,,,,,,,,,,,,,,,1465528.0,14710431.0,3228605.0,8544031.0,11592949.0,1413837.0,1056471101.6220012,800994541.927495,72018368964.2471,21651790529.74512,581630461.1594988,5792395.7475,689.5,94245.0,-276599138.5,21847259.5,-123647671.5,-218452315.5,-2012639.0,,,,,,,,,,,,,,,,,,,,,4267559.5,2476139.5,-8992860.5,921269.0,37582.5,3728815679.339965,3653377496.2349615,-260322771.5,-257015957.0,2523565.0,268874.5,3921396438.5549545,33217816075.62841,36643232332.957634,1727614102.5900495,48028588663.47822,3983247.0,-247296022.5,102960390884.0,1052315810.5,17256191808.0,3499850295.0,18869472980.0,3667711.0,71827.0,20849.76200300474,89669208.0,-71.45416160194485,4.794105263157895,4.3216194700329815,185.0718737974946,20.718298646650744,887.2540442350626,171000.0,0.6234898018587336,0.7818314824680298,0.0,1.0,0.0,0.0,0.0,0.0,0.0,0.0,1.0,0.0,0.0,0.0,0.0,0.0,0.0,0.0,0.0,0.0,1.0,0.0,0.0,1.0,0.0,0.0,0.0,1.0,0.0,0.0,0.0,0.0,1.0,0.0,0.0,0.0,0.0,0.0,0.0,0.0,0.0,0.0,0.0,0.0,0.0,0.0,0.0,0.0,0.0,0.0,0.0,0.0,0.0,0.0,0.0,1.0,0.0,0.0,0.0,0.0,0.0,0.0,0.0,0.0,0.0,0.0,0.0,0.0,0.0,0.0,0.0,0.0,0.0,0.0,0.0,0.0,0.0,0.0,0.0,0.0,0.0,0.0,0.0,0.0,0.0,0.0,0.0,0.0,0.0,0.0,0.0,0.0,0.0,0.0,0.0,0.0,0.0,0.0,0.0,0.0,0.0,0.0,0.0,0.0,0.0,0.0,0.0,0.0,0.0,1.0,0.0,0.0,1.0,0.0,0.0,1.0,0.0,0.0,0.0,0.0,0.0,0.0
100256,0,0.0,1.0,1.0,1.0,0.0,121500.0,119925.0,13563.0,112500.0,0.019101,27.73972602739726,-1161.0,-239.0,-2335.0,19.0,1.0,2.0,2.0,15.0,,0.4966999265160138,0.3201633668633456,0.0804,0.0938,0.9886,0.8436,0.1385,0.0,0.2069,0.1667,0.0417,0.0315,0.0656,0.0822,0.0,0.0,0.0819,0.0974,0.9886,0.8497,0.1398,0.0,0.2069,0.1667,0.0417,0.0322,0.0716,0.0857,0.0,0.0,0.0812,0.0938,0.9886,0.8457,0.1394,0.0,0.2069,0.1667,0.0417,0.0321,0.0667,0.0837,0.0,0.0,0.0757,1.0,0.0,0.0,0.0,0.0,-1198.0,0.0,0.0,0.0,0.0,1.0,6.0,1.0,1.0,0.0,1.0,0.0,0.0,0.0,0.0,0.0,0.0,0.0,0.0,0.0,0.0,0.0,0.0,0.0,0.0,1.0,0.0,0.0,0.0,0.0,0.0,0.0,0.0,0.0,0.0,0.0,0.0,0.0,0.0,3.0,6923.43,0.0,44384.76,0.0,0.0,0.0,0.0,0.0,-1219.0,-945.0,-852.0,-1138.0,98.0,-19.0,17.0,10215.63,45000.0,45000.0,2025.0,90000.0,18.0,-881.0,365243.0,-1683.5,-1398.5,-1263.5,-1392.0,12.0,0.5,0.0794828104066188,-1.0,48.0,18.0,7.5,-32.5,0.0,0.0,58.0,7972.47,4354.02,-1028.0,-1022.0,6.0,1.0,0.0,,,,,,,,,,,,,,,,,,,,,8336448342.0,184217868751.5,165423058497.0,51911238610.935,1862.0,1703.0,71123.0,70629.0,9140.0,505447.0,17788.309500002306,17850.335199999114,17302.253299998098,11283.207800000087,11221.035700000091,11168.55410000006,128247.0,662009.0,4134.4585000001225,4132.088800000018,3942.910800000096,13512237.736985898,-601197345.0,-920839781.0,-296125246.0,-1533421191.0416667,43955.0,30659.0,11338.739999999172,11214.699999998966,10699.383899997303,22862.480400009605,22784.323600009564,22170.48490000812,,157855.8783653502,125962.767325709,34961.664000027864,34902.1360000283,34348.79910002871,22929.245099995933,22902.692599995506,22550.081699995742,3709928.0,8286.966300000171,8391.35570000008,8115.150300000227,9807.802000000722,9922.62160000216,10281.830799999643,16450.808099999755,16635.8092999997,16232.772699999708,828.0699000001758,813.2508000000457,759.2380000000132,3908.900600000125,3892.11620000016,3724.861200000156,435919.0,430722.0,1261507.0,6417.591042002897,631203.0,624763.0,,16314.7974999998,154007.9303999906,154010.6718999901,153902.4831999872,77526.10999999628,77863.51720000661,78264.43020000645,41.0,3816980.910000002,1531388.2049999994,389990883.7799999,137414374.73999998,5935870.034999998,180.0,5.0,1327.0,-1465975.0,687471.0,-785567.0,-836347.5,-20.0,6923.43,0.0,44384.76,0.0,0.0,0.0,0.0,0.0,-1219.0,-945.0,-852.0,-1305.0,15735472.290000023,226462283.77500007,252003696.39,4194713.385,226417283.77500007,15922.0,-1127892.0,248502392.5,14202665.5,53119124.5,25487843.5,53872656.5,15878.0,235.0,45.352063154610434,410573.0,133050.0,79563.5,-267394.0,232003.0,574.0,168284760.48000142,166088153.1600008,-10903530.0,-10827656.5,192258.5,8451.5,,,,,,,,,,,,,,,,,,,,,1465531.0,14710529.0,3228605.0,8544079.0,11593007.0,1413854.0,1056478025.0520012,800994541.927495,72018413349.0071,21651790529.74512,581630461.1594988,5792395.7475,689.5,94245.0,-276600357.5,21846314.5,-123648523.5,-218453453.5,-2012658.0,,,,,,,,,,,,,,,,,,,,,4267577.5,2476147.0,-8992893.0,921269.0,37582.5,3728823651.809964,3653381850.2549615,-260323799.5,-257016979.0,2523571.0,268875.5,3921406654.184954,33217861075.62841,36643277332.957634,1727616127.5900495,48028678663.47822,3983265.0,-247296903.5,102960756127.0,1052314127.0,17256190409.5,3499849031.5,18869471588.0,3667723.0,71827.5,20849.84148581515,89669207.0,-41.85333333333333,0.987037037037037,8.958195089581949,248.49787748497883,8.842070338420703,245.27660870276608,121500.0,-0.2225209339563143,0.9749279121818236,0.0,0.0,0.0,0.0,0.0,0.0,1.0,0.0,0.0,0.0,0.0,0.0,0.0,1.0,0.0,0.0,0.0,0.0,1.0,0.0,0.0,0.0,1.0,0.0,0.0,1.0,0.0,0.0,0.0,0.0,0.0,0.0,0.0,1.0,0.0,0.0,0.0,0.0,0.0,0.0,0.0,0.0,0.0,0.0,0.0,0.0,0.0,0.0,0.0,0.0,0.0,0.0,0.0,0.0,0.0,0.0,0.0,0.0,0.0,0.0,0.0,0.0,0.0,0.0,0.0,0.0,0.0,0.0,0.0,0.0,0.0,0.0,0.0,0.0,0.0,0.0,0.0,0.0,0.0,0.0,0.0,0.0,0.0,0.0,0.0,0.0,0.0,0.0,0.0,0.0,0.0,0.0,0.0,0.0,0.0,0.0,0.0,0.0,0.0,1.0,0.0,0.0,0.0,0.0,0.0,0.0,0.0,0.0,1.0,0.0,1.0,0.0,0.0,0.0,0.0,0.0,0.0,0.0,1.0,0.0
100271,0,0.0,0.0,1.0,1.0,0.0,270000.0,1800000.0,98770.5,1800000.0,0.026392,63.39452054794521,,-262.0,-4637.0,0.0,2.0,2.0,2.0,11.0,,0.7494215648098264,0.7209441499436497,,,,,,,,,,,,,,,,,,,,,,,,,,,,,,,,,,,,,,,,,,,,,2.0,0.0,2.0,0.0,-2023.0,0.0,0.0,0.0,0.0,2.0,6.0,1.0,0.0,0.0,1.0,0.0,0.0,0.0,0.0,0.0,0.0,0.0,0.0,0.0,1.0,0.0,0.0,0.0,0.0,0.0,0.0,0.0,0.0,0.0,0.0,0.0,0.0,0.0,0.0,0.0,0.0,0.0,0.0,8.0,0.0,,297555.75,0.0,0.0,0.0,0.0,0.0,-1005.0,-662.0,-649.5,-390.0,368.0,-24.0,13.0,39347.595,450000.0,491580.0,0.0,675000.0,30.0,-950.0,365243.0,-1276.0,-1126.0,-586.0,-1121.0,13.0,1.0,0.0,-1.0,100.0,18.0,12.5,-40.5,0.0,0.0,97.0,32890.095,32890.095,-1127.0,-1126.0,9.0,2.0,0.0,,,,,,,,,,,,,,,,,,,,,8336547112.5,184219668751.5,165424858497.0,51911508610.935,1862.0,1703.0,71123.0,70631.0,9140.0,505453.0,,,,,,,128247.0,662011.0,,,,13512301.131506445,,-920844418.0,-296127269.0,-1533421453.0416667,43955.0,30659.0,,,,,,,,157856.627786915,125963.48826985896,,,,,,,3709939.0,,,,,,,,,,,,,,,,435921.0,430724.0,1261507.0,6417.6174340028965,631205.0,624765.0,,,,,,,,,33.5,3934237.410000002,,404201021.4449999,141363287.95499998,6306810.704999997,180.0,7.0,1327.0,-1526961.5,688301.5,-820229.5,-866370.0,-16.25,0.0,,235111.5,0.0,0.0,0.0,0.0,0.0,-2133.0,-1567.0,-1229.0,-1232.0,16748022.825000027,240412243.68000007,269383893.795,4275047.385,239917243.68000007,16747.0,-1199069.0,262194898.0,15615871.0,56736139.0,27652267.0,57491801.0,16911.0,253.0,46.84947317449875,447099.0,140734.0,83914.5,-283027.0,232087.0,618.0,181758600.81000105,180466034.89500067,-11655541.0,-11579779.0,203742.0,9066.0,,,,,,,,,,,,,,,,,,,,,1465539.0,14710897.0,3228605.0,8544179.0,11593104.0,1413867.0,1056478025.0520012,,72018710904.7571,21651790529.74512,581630461.1594988,5792395.7475,689.5,94245.0,-276601362.5,21845652.5,-123649173.0,-218453843.5,-2012682.0,,,,,,,,,,,,,,,,,,,,,4267595.5,2476159.5,-8992933.5,921269.0,37582.5,3728856541.904964,3653414740.349961,-260324926.5,-257018105.0,2523580.0,268877.5,3921446001.779953,33218311075.62841,36643768912.957634,1727616127.5900495,48029353663.47822,3983295.0,-247297853.5,102961121370.0,1052312851.0,17256189283.5,3499848445.5,18869470467.0,3667736.0,71828.5,20849.84148581515,89669206.0,,6.666666666666668,2.7336097316506445,173.29587830318974,18.22406487767097,1155.3058553545986,135000.0,1.0,0.0,0.0,0.0,0.0,0.0,0.0,0.0,1.0,0.0,0.0,1.0,0.0,0.0,0.0,0.0,0.0,0.0,0.0,0.0,1.0,0.0,1.0,0.0,0.0,0.0,0.0,1.0,0.0,0.0,0.0,0.0,0.0,0.0,0.0,0.0,0.0,0.0,0.0,0.0,0.0,0.0,0.0,0.0,0.0,0.0,0.0,0.0,0.0,0.0,0.0,0.0,0.0,0.0,0.0,0.0,0.0,0.0,0.0,0.0,0.0,0.0,0.0,0.0,0.0,0.0,0.0,0.0,0.0,0.0,0.0,0.0,0.0,0.0,0.0,0.0,0.0,0.0,0.0,0.0,0.0,0.0,0.0,0.0,0.0,0.0,0.0,0.0,0.0,0.0,0.0,0.0,0.0,0.0,0.0,0.0,0.0,0.0,0.0,0.0,0.0,0.0,0.0,0.0,0.0,0.0,0.0,1.0,0.0,0.0,0.0,0.0,0.0,0.0,0.0,0.0,0.0,0.0,0.0,0.0,0.0,0.0
100278,1,0.0,0.0,0.0,1.0,1.0,121500.0,450000.0,35685.0,450000.0,0.005002,29.682191780821924,-1787.0,-4039.0,-365.0,,3.0,3.0,3.0,15.0,0.4306276617744951,0.472078723935541,0.3001077565791181,0.0062,,0.9657,0.5308,,,,0.0,,,0.005,0.0022,,0.0,0.0063,,0.9657,0.5492,,,,0.0,,,0.0055,0.0023,,0.0,0.0062,,0.9657,0.5371,,,,0.0,,,0.0051,0.0023,,0.0,0.0028,1.0,5.0,1.0,5.0,1.0,-358.0,0.0,0.0,0.0,0.0,1.0,0.0,1.0,1.0,1.0,1.0,0.0,0.0,0.0,0.0,0.0,0.0,0.0,0.0,0.0,1.0,0.0,0.0,0.0,0.0,0.0,0.0,0.0,0.0,0.0,0.0,0.0,0.0,0.0,0.0,0.0,0.0,0.0,0.0,3.0,20724.75,,193315.5,178006.5,0.0,0.0,0.0,0.0,-631.0,647.0,-20.0,,50.0,-11.0,3.0,8177.985,130455.0,133038.0,0.0,130455.0,12.0,-314.0,365243.0,365243.0,365243.0,268.0,365243.0,16.0,1.0,0.0,22.0,27.0,10.0,5.0,-14.0,0.0,0.0,0.0,,,,,,,0.0,,,,,,,,,,,,,,,,,,,,,8336582797.5,184220118751.5,165425308497.0,51911630110.935,1862.0,1703.0,71123.0,70632.0,9140.0,505453.0,17788.315700002306,17850.34139999911,17302.259599998102,,,,128248.0,662014.0,,,,13512330.813698228,-601199132.0,-920844783.0,-296127627.0,-1533425492.0416667,43956.0,30660.0,,,,,,,67359.37331092263,157857.09986563894,125963.78837761552,34961.664000027864,34902.1360000283,34348.79910002871,,,,3709954.0,,,,9807.80700000072,9922.62670000216,10281.836299999644,16450.810299999754,16635.8115999997,16232.774999999709,,,,3908.900600000125,3892.11620000016,3724.861200000156,435926.0,430729.0,,6417.622436002896,631208.0,624768.0,,16314.8002999998,154008.8960999906,154011.6375999901,153903.4488999872,77526.64079999628,77864.0543000066,78264.97940000643,21.0,4007040.660000002,,418980751.0199999,150326698.45499998,6307251.704999997,180.0,7.0,1327.0,-1552413.0,684170.0,-830239.0,,-10.0,22410.0,,180000.0,168723.0,0.0,0.0,0.0,0.0,-802.0,647.0,-190.0,,17337854.385000035,250293896.95500007,280304471.295,4579386.66,250293896.95500007,17421.0,-1227088.0,268766488.0,16324720.0,59281649.0,28376917.0,60037378.0,17355.0,260.0,47.3999054175038,495732.0,151648.0,90517.0,-295038.0,232144.0,675.0,,,,,,,,,,,,,,,,,,,,,,,,,,,1465542.0,14710947.0,3228605.0,8544206.0,11593104.0,1413870.0,1056498749.8020012,,72018904220.2571,21651968536.24512,581630461.1594988,5792395.7475,689.5,94245.0,-276601993.5,21846299.5,-123649193.0,,-2012693.0,,,,,,,,,,,,,,,,,,,,,4267605.5,2476164.5,-8992947.5,921269.0,37582.5,,,,,,,3921454179.7649546,33218441530.62841,36643901950.957634,1727616127.5900495,48029484118.47822,3983307.0,-247298167.5,102961486613.0,1052678094.0,17256554526.5,3499848713.5,18869835710.0,3667752.0,71829.5,20849.84148581515,89669228.0,-60.20444895698726,3.703703703703704,3.4047919293820934,101.06168702171396,12.61034047919294,374.30254452486656,40500.0,0.6234898018587336,0.7818314824680298,0.0,0.0,0.0,0.0,0.0,0.0,1.0,0.0,0.0,0.0,0.0,0.0,0.0,1.0,0.0,0.0,0.0,0.0,1.0,0.0,1.0,0.0,0.0,0.0,0.0,1.0,0.0,0.0,0.0,0.0,0.0,0.0,0.0,0.0,0.0,0.0,0.0,0.0,0.0,0.0,0.0,0.0,0.0,0.0,1.0,0.0,0.0,0.0,0.0,0.0,0.0,0.0,0.0,1.0,0.0,0.0,0.0,0.0,0.0,0.0,0.0,0.0,0.0,0.0,0.0,0.0,0.0,0.0,0.0,0.0,0.0,0.0,0.0,0.0,0.0,0.0,0.0,0.0,0.0,0.0,0.0,0.0,0.0,0.0,0.0,0.0,0.0,0.0,0.0,0.0,0.0,0.0,0.0,0.0,0.0,0.0,0.0,0.0,0.0,0.0,0.0,0.0,0.0,0.0,0.0,0.0,0.0,0.0,0.0,1.0,1.0,0.0,0.0,0.0,0.0,0.0,0.0,0.0,0.0,1.0
100280,0,0.0,1.0,1.0,1.0,2.0,405000.0,513040.5,61015.5,472500.0,0.04622,39.293150684931504,-976.0,-2238.0,-1168.0,3.0,4.0,1.0,1.0,10.0,0.857563772195475,0.7458858805173066,0.6817058776720116,,,,,,,,,,,,,,,,,,,,,,,,,,,,,,,,,,,,,,,,,,,,,0.0,0.0,0.0,0.0,-329.0,0.0,0.0,0.0,0.0,0.0,2.0,1.0,1.0,0.0,1.0,0.0,1.0,0.0,1.0,1.0,0.0,0.0,0.0,0.0,0.0,0.0,0.0,0.0,0.0,1.0,0.0,0.0,0.0,0.0,0.0,0.0,0.0,0.0,0.0,0.0,0.0,0.0,0.0,15.0,0.0,0.0,302985.0,0.0,0.0,0.0,0.0,0.0,-1470.0,-761.5,-755.0,-1456.0,780.0,-27.0,4.0,41066.64,260205.75,293753.25,14085.0,450000.0,18.0,-483.5,365243.0,-773.5,-593.5,-173.5,-586.5,12.0,0.5,0.1910043450134221,-1.0,16.0,22.0,17.5,-20.5,0.0,0.0,17.0,56858.535,61323.03,-579.0,-578.0,5.0,1.0,0.0,,,,,,,,,,,,,,,,,,,,,8336643813.0,184220631792.0,165425780997.0,51912035110.935,1862.0,1703.0,71123.0,70632.0,9140.0,505455.0,,,,,,,128250.0,662018.0,,,,13512370.106848912,-601200108.0,-920845951.0,-296127956.0,-1533427730.0416667,43956.0,30660.0,,,,,,,67360.23087469481,157857.84575151946,125964.4700834932,,,,,,,3709964.0,,,,,,,,,,,,,,,,435926.0,430729.0,1261510.0,6417.668656002897,631209.0,624769.0,,,,,,,,,49.0,4016560.410000002,1631865.0599999996,431134005.91499984,151136608.545,6513473.609999999,180.0,7.0,1327.0,-1571226.0,717398.0,-838150.0,-887950.0,-24.0,0.0,0.0,302985.0,0.0,0.0,0.0,0.0,0.0,-2293.0,-1034.0,-883.0,-1481.0,17501346.855000034,252226311.70500007,282477343.545,4596212.16,252261517.45500007,17627.0,-1234423.0,271505810.5,16319760.0,59643110.0,28374672.0,60398881.0,17581.5,261.5,47.69334317775064,496511.0,152399.0,90963.0,-296142.5,232144.0,675.0,191196919.9800017,189808181.37000105,-12280473.0,-12198840.0,221692.0,9504.0,,,,,,,,,,,,,,,,,,,,,1465557.0,14711727.0,3228605.0,8544222.0,11593121.0,1413874.0,1056498749.8020012,800994541.927495,72019207205.2571,21651968536.24512,581630461.1594988,5792395.7475,689.5,94245.0,-276603463.5,21845538.0,-123649948.0,-218455299.5,-2012720.0,,,,,,,,,,,,,,,,,,,,,4267627.5,2476182.0,-8992968.0,921269.0,37582.5,3728913400.439964,3653476063.3799615,-260325505.5,-257018683.0,2523585.0,268878.5,3921495246.404953,33218701736.37841,36644195704.207634,1727630212.5900495,48029934118.47822,3983325.0,-247298651.0,102961851856.0,1052677320.5,17256553933.0,3499848540.0,18869835123.5,3667764.0,71830.0,20850.03249016016,89669227.0,-24.83893459768512,1.2667666666666666,6.637657644369054,260.8144820151807,8.408363448631905,330.39109200076376,101250.0,0.6234898018587336,0.7818314824680298,0.0,0.0,0.0,0.0,0.0,0.0,1.0,0.0,1.0,0.0,0.0,0.0,0.0,0.0,0.0,0.0,1.0,0.0,0.0,0.0,1.0,0.0,0.0,0.0,0.0,1.0,0.0,0.0,0.0,0.0,0.0,0.0,0.0,0.0,0.0,0.0,0.0,0.0,0.0,0.0,1.0,0.0,0.0,0.0,0.0,0.0,0.0,0.0,0.0,0.0,0.0,0.0,0.0,1.0,0.0,0.0,0.0,0.0,0.0,0.0,0.0,0.0,0.0,0.0,0.0,0.0,0.0,0.0,0.0,0.0,0.0,0.0,0.0,0.0,0.0,0.0,0.0,0.0,0.0,0.0,0.0,0.0,0.0,0.0,0.0,0.0,0.0,0.0,0.0,0.0,0.0,0.0,0.0,0.0,0.0,0.0,0.0,0.0,0.0,0.0,0.0,0.0,0.0,0.0,0.0,0.0,0.0,0.0,0.0,0.0,0.0,0.0,0.0,0.0,0.0,0.0,0.0,0.0,0.0,0.0
100306,0,0.0,1.0,0.0,0.0,0.0,112500.0,360000.0,28570.5,360000.0,0.010032,23.953424657534253,-253.0,-8712.0,-1416.0,,1.0,2.0,2.0,5.0,,0.3834644932070785,0.4920600938649263,0.0134,,,,,0.0,0.069,0.0417,,,,0.0062,,,0.0137,,,,,0.0,0.069,0.0417,,,,0.0065,,,0.0135,,,,,0.0,0.069,0.0417,,,,0.0063,,,0.0068,1.0,0.0,0.0,0.0,0.0,0.0,0.0,0.0,0.0,0.0,0.0,2.0,1.0,1.0,0.0,1.0,0.0,0.0,0.0,0.0,0.0,0.0,0.0,0.0,0.0,1.0,0.0,0.0,0.0,0.0,0.0,0.0,0.0,0.0,0.0,0.0,0.0,0.0,0.0,0.0,0.0,0.0,0.0,0.0,2.0,0.0,,66690.0,7479.0,0.0,0.0,0.0,0.0,-1123.5,-785.0,-753.5,-755.0,75.0,-18.0,3.0,10182.8475,31455.0,35770.5,1572.75,83241.0,11.0,-1158.0,365243.0,-1466.5,-1166.5,-1166.5,-1161.5,5.0,0.0,0.0440144857455218,136.0,24.0,12.0,5.5,-49.5,0.0,0.0,24.0,10150.8525,4288.905,-1308.0,-1301.5,6.0,1.0,0.0,,,,,,,,,,,,,,,,,,,,,8336672383.5,184220991792.0,165426140997.0,51912147610.935,1862.0,1703.0,71123.0,70632.0,9140.0,505457.0,17788.329100002305,17850.354899999114,17302.273299998098,,,,128250.0,662019.0,,,,13512394.06027357,-601200361.0,-920847367.0,-296127956.0,-1533436442.0416667,43956.0,30660.0,11338.739999999172,11214.699999998966,10699.383899997303,22862.549400009604,22784.392600009567,22170.553900008115,,157858.22921601267,125964.96214358704,34961.705700027866,34902.177700028304,34348.84080002871,,,,3709969.0,,,,,,,16450.81649999975,16635.8178999997,16232.781499999706,,,,,,,435926.0,430729.0,,6417.678688002897,631211.0,624771.0,,16314.8070999998,,,,,,,37.5,4328768.970000002,,471929272.4699999,160318587.55499998,8230399.425,180.0,8.0,1327.0,-1705091.5,696917.5,-915487.5,-971701.5,-18.25,0.0,,43380.0,14958.0,0.0,0.0,0.0,0.0,-1315.0,-1135.0,-1135.0,-1135.0,19291833.112500027,275129377.02,309823458.165,5141437.605,275145104.52,19581.0,-1347492.0,298164979.5,17331673.0,66154369.0,31246150.0,66911368.5,19277.0,289.0,52.55796694010694,534489.0,165240.0,98409.0,-326703.5,244168.0,704.0,207925403.9625025,206736690.98250148,-13134899.5,-13045767.0,231868.5,10436.5,,,,,,,,,,,,,,,,,,,,,1465559.0,14711802.0,3228605.0,8544246.0,11593145.0,1413877.0,1056498749.8020012,,72019273895.2571,21651976015.24512,581630461.1594988,5792395.7475,689.5,94245.0,-276604587.0,21844753.0,-123650701.5,-218456054.5,-2012738.0,,,,,,,,,,,,,,,,,,,,,4267639.5,2476187.5,-8993017.5,921269.0,37582.5,3728923551.292464,3653480352.2849617,-260326813.5,-257019984.5,2523591.0,268879.5,3921505429.252455,33218733191.37841,36644231474.707634,1727631785.3400495,48030017359.47822,3983336.0,-247299809.0,102962217099.0,1052675854.0,17256552766.5,3499847373.5,18869833962.0,3667769.0,71830.0,20850.076504645906,89669363.0,-10.562164016927827,3.2,3.93762797290912,94.31967497847788,12.600409513309186,301.8229599311293,112500.0,-0.9009688679024191,0.4338837391175582,0.0,0.0,0.0,0.0,0.0,0.0,1.0,0.0,0.0,0.0,0.0,0.0,0.0,1.0,0.0,0.0,0.0,0.0,1.0,0.0,0.0,0.0,1.0,0.0,0.0,0.0,0.0,0.0,0.0,1.0,0.0,0.0,0.0,0.0,0.0,0.0,0.0,0.0,0.0,0.0,0.0,0.0,0.0,0.0,1.0,0.0,0.0,0.0,0.0,0.0,0.0,0.0,0.0,1.0,0.0,0.0,0.0,0.0,0.0,0.0,0.0,0.0,0.0,0.0,0.0,0.0,0.0,0.0,0.0,0.0,0.0,0.0,0.0,0.0,0.0,0.0,0.0,0.0,0.0,0.0,0.0,0.0,0.0,0.0,0.0,0.0,0.0,0.0,0.0,0.0,0.0,0.0,0.0,0.0,0.0,0.0,0.0,0.0,0.0,0.0,0.0,0.0,0.0,0.0,0.0,0.0,0.0,0.0,0.0,0.0,1.0,0.0,0.0,0.0,0.0,0.0,0.0,0.0,0.0,1.0
100311,0,0.0,0.0,0.0,1.0,0.0,175500.0,247500.0,12766.5,247500.0,0.018209,48.51780821917808,-3910.0,-9194.0,-1265.0,,2.0,3.0,3.0,11.0,0.6696215496138287,0.3121728034737758,0.164414178829907,,,,,,,,,,,,,,,,,,,,,,,,,,,,,,,,,,,,,,,,,,,,,0.0,0.0,0.0,0.0,-1098.0,0.0,0.0,0.0,0.0,2.0,5.0,1.0,1.0,0.0,1.0,0.0,1.0,0.0,0.0,0.0,0.0,0.0,0.0,0.0,1.0,0.0,0.0,0.0,0.0,0.0,0.0,0.0,0.0,0.0,0.0,0.0,0.0,0.0,0.0,0.0,0.0,0.0,0.0,14.0,0.0,0.0,73506.1725,12667.5,0.0,0.0,0.0,0.0,-833.5,61.0,-386.5,-1158.5,409.0,-21.0,16.0,14552.4375,22500.0,27130.5,,202500.0,15.0,-469.0,365243.0,-484.0,-330.0,-64.0,-325.5,7.0,1.0,,-1.0,51.0,18.0,11.0,-18.0,0.0,0.0,47.0,16592.175,16592.175,-559.0,-551.0,5.0,1.0,0.0,,,,,,,,,,,,,,,,,,,,,8336685150.0,184221239292.0,165426388497.0,51912323110.935,1862.0,1703.0,71123.0,70634.0,9140.0,505462.0,,,,,,,128250.0,662021.0,,,,13512442.578081788,-601204271.0,-920848632.0,-296129054.0,-1533445636.0416667,43956.0,30660.0,,,,,,,67360.90049624443,157858.54138881614,125965.12655776588,,,,,,,3709980.0,,,,,,,,,,,,,,,,435926.0,430729.0,,6417.696897002897,631214.0,624774.0,,,,,,,,,28.0,4477965.750000002,1669446.4499999995,480507912.13499993,162406344.55499998,8770423.049999999,180.0,8.0,1327.0,-1740938.0,733285.5,-934720.5,-993587.0,-13.5,0.0,0.0,90000.0,0.0,0.0,0.0,0.0,0.0,-1412.0,-1270.0,-1033.0,-1270.0,19658609.100000024,280926335.52,315885952.665,,281016335.52,20005.0,-1380841.0,306197533.5,17669219.0,67593166.5,31961135.5,68716679.0,19729.5,298.5,,550129.5,168780.0,100609.0,-336959.0,244218.0,754.0,214387574.62500224,213133755.9150009,-13650023.0,-13558685.0,241391.0,10797.0,,,,,,,,,,,,,,,,,,,,,1465573.0,14712211.0,3228605.0,8544297.0,11593192.0,1413893.0,1056498749.8020012,800994541.927495,72019347401.4296,21651988682.74512,581630461.1594988,5792395.7475,689.5,94245.0,-276605420.5,21844814.0,-123651088.0,-218457213.0,-2012759.0,,,,,,,,,,,,,,,,,,,,,4267657.5,2476198.5,-8993035.5,921269.0,37582.5,3728940143.467464,3653496944.459962,-260327372.5,-257020535.5,2523596.0,268880.5,3921519981.689953,33218755691.37841,36644258605.207634,,48030219859.47822,3983351.0,-247300278.0,102962582342.0,1052675370.0,17256552436.5,3499847309.5,18869833636.5,3667776.0,71831.0,,89669362.0,-80.58896606245413,1.4102564102564104,13.746915756080366,666.9702222587046,19.38667606626718,940.599031390481,87750.0,0.6234898018587334,-0.7818314824680299,0.0,0.0,0.0,0.0,0.0,0.0,1.0,0.0,0.0,0.0,0.0,0.0,0.0,1.0,0.0,0.0,0.0,0.0,1.0,0.0,1.0,0.0,0.0,0.0,0.0,1.0,0.0,0.0,0.0,0.0,0.0,0.0,0.0,0.0,0.0,0.0,0.0,0.0,0.0,0.0,0.0,1.0,0.0,0.0,0.0,0.0,0.0,0.0,0.0,0.0,0.0,0.0,0.0,0.0,0.0,0.0,0.0,0.0,0.0,1.0,0.0,0.0,0.0,0.0,0.0,0.0,0.0,0.0,0.0,0.0,0.0,0.0,0.0,0.0,0.0,0.0,0.0,0.0,0.0,0.0,0.0,0.0,0.0,0.0,0.0,0.0,0.0,0.0,0.0,0.0,0.0,0.0,0.0,0.0,0.0,0.0,0.0,0.0,0.0,0.0,0.0,0.0,0.0,0.0,0.0,0.0,0.0,0.0,0.0,0.0,0.0,0.0,0.0,0.0,0.0,0.0,0.0,0.0,0.0,0.0
100312,0,0.0,1.0,0.0,0.0,0.0,67500.0,463500.0,33921.0,463500.0,0.009175,63.871232876712334,,-1806.0,-5207.0,,2.0,2.0,2.0,18.0,0.7180567240139539,0.4818925139065904,0.8214433128935934,0.1098,0.104,0.9925,,,0.1,0.0862,0.375,,0.0181,,0.1467,,0.0051,0.0567,0.1079,0.9881,,,0.0403,0.0345,0.375,,0.0185,,0.099,,0.0054,0.1109,0.104,0.9925,,,0.1,0.0862,0.375,,0.0184,,0.1494,,0.0052,0.1572,1.0,4.0,0.0,4.0,0.0,0.0,0.0,0.0,0.0,0.0,0.0,3.0,1.0,0.0,0.0,1.0,1.0,0.0,0.0,0.0,0.0,0.0,0.0,0.0,0.0,0.0,0.0,0.0,1.0,0.0,0.0,0.0,0.0,0.0,0.0,0.0,0.0,0.0,0.0,0.0,0.0,0.0,0.0,0.0,3.0,15075.0,,1215000.0,56927.25,0.0,0.0,0.0,0.0,-2472.0,-1377.0,-1587.0,-1602.0,189.0,-36.0,2.0,26281.17,490700.25,482330.25,16740.0,490700.25,24.0,-1764.5,365243.0,-1734.0,181542.0,-1044.0,181544.5,12.5,0.0,0.1154612038478777,2903.0,44.0,24.0,13.0,-73.5,0.0,0.0,99.0,6750.0,6578.1,-2495.0,-2495.0,18.0,1.0,95.0,0.0,0.0,0.0,0.0,0.0,0.0,0.0,0.0,0.0,0.0,0.0,0.0,0.0,0.0,0.0,0.0,29.0,-49.0,0.0,0.0,8336719071.0,184221702792.0,165426851997.0,51912390610.935,1862.0,1703.0,71123.0,70634.0,9140.0,505465.0,17788.438900002304,17850.465799999114,17302.3299999981,11283.311800000089,11221.139700000092,11168.662000000058,128250.0,662023.0,,,,13512506.449314663,,-920853839.0,-296129054.0,-1533447442.0416667,43956.0,30660.0,11338.839999999173,11214.799999998964,10699.424199997304,22862.63560000961,22784.478800009565,22170.58840000812,67361.61855296844,157859.02328133007,125965.94800107877,34962.080700027866,34902.552700028304,34349.21580002871,,,,3709998.0,8286.98440000017,8391.374100000081,8115.16880000023,,,,16450.963199999755,16635.9672999997,16232.880499999706,,,,3908.905700000125,3892.12140000016,3724.866600000156,435930.0,430733.0,,6417.706072002897,631216.0,624776.0,,16314.9642999998,154009.8885999906,154012.63009999009,153904.4369999872,,,,82.0,4505333.8050000025,,483585891.4799999,162693469.39499998,8770423.049999999,180.0,8.0,1327.0,-1747639.0,731237.0,-938474.0,-998245.0,-40.5,30150.0,,1215000.0,0.0,0.0,0.0,0.0,0.0,-2472.0,-1377.0,-1587.0,-1602.0,19750318.11000002,282548785.77,317541644.415,5331974.355,282548785.77,20077.0,-1386812.0,307658505.5,17665673.5,67957095.5,31959822.5,69080614.0,19808.5,301.0,53.97492746038753,554525.0,169653.0,101129.5,-337904.0,244250.0,754.0,215956898.91000253,214649385.3000016,-13744677.0,-13652864.0,242172.0,10873.0,189574308.22500035,547978500.0,16365327.75,22233639.599999987,462451.5,5402137.050000002,11221351.650000012,23223969.85499989,21350759.939999998,181654443.80999985,188961061.0950001,188969336.50500005,869.0,2022.0,13.0,1140.0,70828.0,-125493.0,88867.0,184.0,1465576.0,14712400.0,3228700.0,8544341.0,11593291.0,1413895.0,1056513824.8020012,,72020562401.4296,21652045609.99512,581630461.1594988,5792395.7475,689.5,94245.0,-276607892.5,21843437.0,-123652675.0,-218458815.0,-2012795.0,5914832193.112462,18695360250.0,198605420.325,447324163.6274977,1948107.735,256441897.7775008,308725511.6699988,635535348.7049981,458402921.3474992,5700287666.160028,5878184253.907496,5878427436.652497,13364.0,80720.5,44.0,70247.5,970484.0,-1696411.5,177364.0,6755.0,4267681.5,2476211.5,-8993109.0,921269.0,37582.5,3728946893.467464,3653503522.559962,-260329867.5,-257023030.5,2523614.0,268881.5,3921546262.859953,33219246391.62841,36644740935.457634,1727648525.3400495,48030710559.72822,3983375.0,-247302042.5,102962947585.0,1052673636.0,17256733978.5,3499846265.5,18870015181.0,3667788.5,71831.0,20850.19196584976,89672265.0,,6.866666666666666,1.9899177500663303,127.09850001999004,13.664101883788804,872.7430334705983,33750.0,-0.9009688679024191,-0.433883739117558,0.0,0.0,0.0,0.0,0.0,1.0,0.0,0.0,0.0,1.0,0.0,0.0,0.0,0.0,0.0,0.0,0.0,0.0,1.0,0.0,1.0,0.0,0.0,0.0,0.0,1.0,0.0,0.0,0.0,0.0,0.0,0.0,0.0,0.0,0.0,0.0,0.0,0.0,0.0,0.0,0.0,0.0,0.0,0.0,0.0,0.0,0.0,0.0,0.0,0.0,0.0,0.0,0.0,0.0,0.0,0.0,0.0,0.0,0.0,0.0,0.0,0.0,0.0,0.0,0.0,0.0,0.0,0.0,0.0,0.0,0.0,0.0,0.0,0.0,0.0,0.0,0.0,0.0,0.0,0.0,0.0,0.0,0.0,0.0,0.0,0.0,0.0,0.0,0.0,0.0,0.0,0.0,0.0,0.0,0.0,0.0,0.0,0.0,0.0,0.0,0.0,0.0,0.0,0.0,0.0,1.0,0.0,0.0,0.0,0.0,1.0,0.0,0.0,0.0,0.0,0.0,0.0,0.0,1.0,0.0
100330,0,0.0,0.0,1.0,1.0,0.0,211500.0,539100.0,27652.5,450000.0,0.020713,38.08219178082192,-2292.0,-308.0,-5677.0,21.0,2.0,3.0,3.0,9.0,0.3228945706861466,0.5061354324171047,0.4920600938649263,0.0082,0.0327,0.9811,,,0.0,0.0345,0.0417,,0.0227,,0.0062,,0.0,0.0084,0.034,0.9811,,,0.0,0.0345,0.0417,,0.0232,,0.0065,,0.0,0.0083,0.0327,0.9811,,,0.0,0.0345,0.0417,,0.0231,,0.0064,,0.0,0.0054,1.0,10.0,0.0,9.0,0.0,-998.0,0.0,0.0,0.0,0.0,1.0,3.0,1.0,1.0,0.0,1.0,0.0,1.0,0.0,0.0,0.0,0.0,0.0,0.0,0.0,1.0,0.0,0.0,0.0,0.0,0.0,0.0,0.0,0.0,0.0,0.0,0.0,0.0,0.0,0.0,0.0,0.0,0.0,0.0,12.0,0.0,3879.0,174510.0,0.0,0.0,0.0,0.0,0.0,-1344.5,-562.0,-899.5,-1147.0,562.0,-24.5,4.0,10923.795,38553.75,41751.0,0.0,57105.0,6.0,-778.0,365243.0,-746.0,-656.0,-596.0,-647.0,8.0,0.0,0.0,601.0,13.0,6.0,3.0,-27.0,0.0,0.0,47.0,2250.0,2250.0,-252.0,-252.0,14.0,0.0,26.0,71201.655,225000.0,0.0,1209.375,0.0,6196.5,1125.0,5892.84,18.495,70884.72,71201.655,71201.655,0.0,1.5,0.0,4.0,0.5,-13.5,0.0,0.0,8336746723.5,184222241892.0,165427301997.0,51912602110.935,1862.0,1703.0,71123.0,70635.0,9140.0,505468.0,17788.447100002304,17850.474099999115,17302.338399998098,11283.344500000088,11221.172400000092,11168.696000000058,128250.0,662025.0,,,,13512544.531506443,-601206563.0,-920859516.0,-296130052.0,-1533447750.0416667,43956.0,30660.0,11338.839999999173,11214.799999998964,10699.424199997304,22862.67010000961,22784.51330000957,22170.62290000812,67361.94144753912,157859.52941676247,125966.44006117266,34962.122400027874,34902.594400028305,34349.25750002871,,,,3710007.0,8287.007100000172,8391.397200000081,8115.192000000228,,,,16450.969399999754,16635.973699999693,16232.886999999708,,,,3908.905700000125,3892.12140000016,3724.866600000156,435940.0,430742.0,1261531.0,6417.726785002897,631219.0,624779.0,,16314.9696999998,154010.8696999906,154013.6111999901,153905.4180999872,,,,44.5,5188613.8050000025,1761637.0499999996,530830291.1399999,182585182.005,9198737.64,180.0,9.0,1327.0,-1856968.5,786828.0,-994165.5,-1062902.0,-21.75,0.0,3879.0,157500.0,0.0,0.0,0.0,0.0,0.0,-1868.0,-1137.0,-1147.0,-1147.0,21064904.820000038,298764780.39,335753997.615,5517582.524999999,298774781.64,21229.0,-1476679.0,327191693.0,17596515.0,71927753.0,33381999.0,73419775.0,20888.0,331.0,56.58962630115022,571758.5,184253.0,108655.0,-368309.0,285470.0,760.0,237116785.68000224,234586456.96500185,-15227947.0,-15131280.0,280575.0,11563.0,226621138.32000035,603126000.0,18651552.75,24813021.23999999,462451.5,5690274.3900000015,13363734.510000017,26749203.614999995,24724962.9,217366749.15749985,225987201.90000013,225995477.31000012,1017.0,2272.0,13.0,1241.0,81499.5,-141230.5,88871.0,188.0,1465588.0,14712962.0,3228726.0,8544354.0,11593338.0,1413899.0,1056513824.8020012,800998420.927495,72020736911.4296,21652045609.99512,581630461.1594988,5792395.7475,689.5,94245.0,-276609237.0,21842875.0,-123653574.5,-218459962.0,-2012819.5,5914903394.767462,18695585250.0,198605420.325,447325373.0024977,1948107.735,256448094.2775008,308726636.6699988,635541241.5449983,458402939.8424992,5700358550.880029,5878255455.562497,5878498638.307498,13364.0,80722.0,44.0,70251.5,970484.5,-1696425.0,177364.0,6755.0,4267687.5,2476214.5,-8993136.0,921269.0,37582.5,3728949143.467464,3653505772.559962,-260330119.5,-257023282.5,2523628.0,268881.5,3921557186.654953,33219284945.37841,36644782686.457634,1727648525.3400495,48030767664.72822,3983381.0,-247302820.5,102963312828.0,1052672890.0,17256733322.5,3499845669.5,18870014534.0,3667796.5,71831.0,20850.19196584976,89672866.0,-60.18561151079137,2.5489361702127664,7.648494711147274,291.27144242451266,19.49552481692433,742.4323149458853,105750.0,-0.2225209339563143,0.9749279121818236,0.0,0.0,0.0,0.0,0.0,0.0,1.0,0.0,0.0,0.0,0.0,0.0,0.0,1.0,0.0,0.0,0.0,0.0,1.0,0.0,1.0,0.0,0.0,0.0,0.0,1.0,0.0,0.0,0.0,0.0,0.0,0.0,0.0,1.0,0.0,0.0,0.0,0.0,0.0,0.0,0.0,0.0,0.0,0.0,0.0,0.0,0.0,0.0,0.0,0.0,0.0,0.0,0.0,0.0,0.0,0.0,0.0,0.0,0.0,0.0,0.0,0.0,0.0,0.0,0.0,0.0,0.0,0.0,0.0,0.0,0.0,0.0,0.0,0.0,0.0,0.0,0.0,0.0,0.0,0.0,0.0,0.0,0.0,1.0,0.0,0.0,0.0,0.0,0.0,0.0,0.0,0.0,0.0,0.0,0.0,0.0,0.0,0.0,0.0,0.0,0.0,0.0,0.0,0.0,0.0,0.0,0.0,0.0,0.0,0.0,1.0,0.0,0.0,0.0,0.0,0.0,0.0,0.0,1.0,0.0
100331,0,0.0,1.0,1.0,1.0,0.0,225000.0,792162.0,40576.5,630000.0,0.0084739999999999,48.9972602739726,-2634.0,-7177.0,-1057.0,13.0,2.0,2.0,2.0,14.0,,0.7564625800013871,,0.268,0.0564,0.9856,,,0.08,0.069,0.3333,,0.0098,,0.0823,,,0.2731,0.0586,0.9856,,,0.0806,0.069,0.3333,,0.01,,0.0858,,,0.2706,0.0564,0.9856,,,0.08,0.069,0.3333,,0.01,,0.0838,,,0.1355,1.0,0.0,0.0,0.0,0.0,-866.0,,,,,,,1.0,1.0,0.0,1.0,0.0,0.0,1.0,1.0,1.0,1.0,1.0,1.0,0.0,1.0,0.0,0.0,0.0,0.0,0.0,0.0,0.0,0.0,0.0,0.0,0.0,0.0,0.0,0.0,0.0,0.0,0.0,0.0,0.0,,,,,,,,,,,,,0.0,,3.0,19799.1225,95125.5,76459.5,11250.0,109167.75,6.0,-529.0,365243.0,-666.5,-531.5,-516.5,-522.0,14.0,0.0,0.1238109805250908,15.0,13.0,6.0,3.0,-17.0,0.0,0.0,12.0,24215.1075,24215.1075,-616.5,-606.5,3.0,1.0,0.0,,,,,,,,,,,,,,,,,,,,,8336787300.0,184223034054.0,165427931997.0,51912827110.935,,,,,,,17788.715100002304,17850.744699999115,17302.611499998096,11283.400900000086,11221.228800000094,11168.754600000058,128250.0,662027.0,,,,13512593.52876672,-601209197.0,-920860573.0,-296130918.0,-1533454927.0416667,43956.0,30660.0,11338.919999999172,11214.879999998964,10699.504799997305,22862.73910000961,22784.58230000957,22170.69190000812,,157860.28587934247,,34962.455700027866,34902.927700028304,34349.59080002871,,,,3710021.0,8287.016900000172,8391.407200000082,8115.202000000227,,,,16451.051699999753,16636.057499999693,16232.972799999709,,,,,,,435940.0,430742.0,1261544.0,6417.735259002897,631221.0,624781.0,,16315.1051999998,154011.85529999062,154014.5967999901,153906.40369998722,,,,,,,,,,,,,,,,,,,,,,,,,,,,,,21103644.622500032,299094907.14,336067148.115,5540082.524999999,299156512.14,21238.0,-1479222.0,327739557.5,17595029.0,72291451.0,33745787.0,73783497.0,20929.0,331.0,56.8372482622004,572445.0,184326.0,108697.0,-368618.0,285470.0,760.0,237305993.91750228,234798165.20250183,-15237906.0,-15141151.0,281005.5,11577.5,,,,,,,,,,,,,,,,,,,,,1465588.0,14712962.0,3228726.0,8544367.0,11593350.0,1413902.0,,,,,,,,,,,,,,,,,,,,,,,,,,,,,,,,,,4267693.5,2476217.5,-8993153.0,921269.0,37582.5,3728973358.574964,3653529987.667462,-260330736.0,-257023889.0,2523631.0,268882.5,3921576985.777455,33219380070.87841,36644859145.957634,1727659775.3400495,48030876832.47822,3983387.0,-247303349.5,102963678071.0,1052672223.5,17256732791.0,3499845153.0,18870014012.0,3667810.5,71831.0,20850.31577683028,89672881.0,-53.75810780585999,3.52072,5.5450815126982365,271.6938021180692,19.522679383386933,956.5578029931288,112500.0,-0.9009688679024191,0.4338837391175582,0.0,0.0,0.0,0.0,0.0,0.0,1.0,0.0,0.0,0.0,0.0,0.0,0.0,1.0,0.0,1.0,0.0,0.0,0.0,0.0,1.0,0.0,0.0,0.0,0.0,0.0,0.0,0.0,1.0,0.0,0.0,0.0,0.0,0.0,1.0,0.0,0.0,0.0,0.0,0.0,0.0,0.0,0.0,0.0,0.0,0.0,0.0,0.0,0.0,0.0,0.0,0.0,0.0,1.0,0.0,0.0,0.0,0.0,0.0,0.0,0.0,0.0,0.0,0.0,0.0,0.0,0.0,0.0,0.0,0.0,0.0,0.0,0.0,0.0,0.0,0.0,0.0,0.0,0.0,0.0,0.0,0.0,0.0,0.0,0.0,0.0,0.0,0.0,0.0,0.0,0.0,0.0,0.0,0.0,0.0,0.0,0.0,0.0,0.0,0.0,0.0,0.0,0.0,0.0,0.0,0.0,0.0,0.0,0.0,0.0,0.0,1.0,0.0,0.0,0.0,0.0,0.0,0.0,1.0,0.0
100352,0,0.0,1.0,1.0,1.0,1.0,180000.0,729792.0,37390.5,630000.0,0.031329,51.85753424657535,-1555.0,-6615.0,-2457.0,3.0,3.0,2.0,2.0,9.0,0.5363793062797462,0.672240432121728,0.1852020815902493,,,,,,,,,,,,,,,,,,,,,,,,,,,,,,,,,,,,,,,,,,,,,6.0,0.0,6.0,0.0,-1895.0,0.0,0.0,0.0,0.0,0.0,0.0,1.0,1.0,0.0,1.0,0.0,1.0,0.0,0.0,0.0,0.0,0.0,0.0,0.0,0.0,0.0,0.0,0.0,0.0,1.0,0.0,0.0,0.0,0.0,0.0,0.0,0.0,0.0,0.0,0.0,0.0,0.0,0.0,11.0,11475.0,0.0,225000.0,0.0,0.0,0.0,0.0,0.0,-1115.0,628.5,-334.0,-533.0,441.0,-23.0,5.0,7670.79,66141.0,68238.0,3667.5,66141.0,12.0,-1895.0,365243.0,-1863.0,-1653.0,-1533.0,-1648.0,14.0,0.0,0.0812189651037617,2800.0,77.0,38.0,14.0,-49.0,0.0,0.0,82.0,17509.5,11993.265,-1401.5,-1398.0,8.5,1.0,0.0,,,,,,,,,,,,,,,,,,,,,8336824690.5,184223763846.0,165428561997.0,51913007110.935,1862.0,1703.0,71123.0,70635.0,9140.0,505468.0,,,,,,,128251.0,662030.0,,,,13512645.386300964,-601210752.0,-920863030.0,-296132813.0,-1533461542.0416667,43956.0,30660.0,,,,,,,67362.47782684541,157860.95811977462,125966.62526325422,,,,,,,3710030.0,,,,,,,,,,,,,,,,435946.0,430748.0,1261547.0,6417.766588002897,631223.0,624783.0,,,,,,,,,37.0,5555990.790000003,2001726.81,564214523.8499999,193572740.835,9422101.62,19998.0,9.0,1513.0,-1986750.0,877670.0,-1064110.0,-1121252.0,-18.0,0.0,4608.0,247500.0,0.0,0.0,0.0,0.0,0.0,-1778.0,24.0,-533.0,-533.0,22345253.73000004,318137055.84,357779130.615,5799330.225,318137055.84,22549.0,-1563959.0,346174564.0,18624367.0,76630674.0,36997279.0,78125412.0,22065.0,356.0,59.88100210489471,590552.0,195164.0,115217.0,-388561.0,285471.0,761.0,253074294.8550015,250220092.0050009,-16512154.5,-16404576.5,320547.0,12155.5,,,,,,,,,,,,,,,,,,,,,1465599.0,14713403.0,3228726.0,8544444.0,11593432.0,1413907.0,1056525299.8020012,800998420.927495,72020961911.4296,21652045609.99512,581630461.1594988,5792395.7475,689.5,94245.0,-276610352.0,21843503.5,-123653908.5,-218460495.0,-2012842.5,,,,,,,,,,,,,,,,,,,,,4267731.5,2476231.5,-8993202.0,921269.0,37582.5,3728990868.074964,3653541980.9324617,-260332137.5,-257025287.0,2523639.5,268883.5,3921584656.567455,33219446211.87841,36644927383.957634,1727663442.8400495,48030942973.47822,3983399.0,-247305244.5,102964043314.0,1052670360.5,17256731138.0,3499843620.0,18870012364.0,3667824.5,71831.0,20850.39699579538,89675681.0,-29.98599957734573,4.0544,4.814057046576003,249.64512815778235,19.518112889637734,1012.1612076029128,60000.0,-0.2225209339563143,0.9749279121818236,0.0,0.0,0.0,0.0,0.0,0.0,1.0,0.0,0.0,0.0,1.0,0.0,0.0,0.0,0.0,0.0,0.0,0.0,1.0,0.0,1.0,0.0,0.0,0.0,0.0,1.0,0.0,0.0,0.0,0.0,0.0,0.0,0.0,0.0,1.0,0.0,0.0,0.0,0.0,0.0,0.0,0.0,0.0,0.0,0.0,0.0,0.0,0.0,0.0,0.0,0.0,0.0,0.0,0.0,0.0,0.0,0.0,0.0,0.0,0.0,0.0,0.0,0.0,0.0,0.0,0.0,0.0,0.0,0.0,0.0,0.0,0.0,0.0,0.0,0.0,0.0,0.0,0.0,1.0,0.0,0.0,0.0,0.0,0.0,0.0,0.0,0.0,0.0,0.0,0.0,0.0,0.0,0.0,0.0,0.0,0.0,0.0,0.0,0.0,0.0,0.0,0.0,0.0,0.0,0.0,0.0,0.0,0.0,0.0,0.0,0.0,0.0,0.0,0.0,0.0,0.0,0.0,0.0,0.0,0.0
100358,0,0.0,0.0,0.0,1.0,0.0,202500.0,798777.0,51178.5,697500.0,0.018029,50.82739726027398,-2425.0,-3294.0,-2096.0,,2.0,3.0,3.0,10.0,0.6707215946089536,0.2906310801784493,0.445396241560834,0.0082,,0.9717,,,0.0,0.0345,0.0417,,0.0163,,0.0084,,,0.0084,,0.9717,,,0.0,0.0345,0.0417,,0.0167,,0.0088,,,0.0083,,0.9717,,,0.0,0.0345,0.0417,,0.0166,,0.0086,,,0.0073,1.0,0.0,0.0,0.0,0.0,-1766.0,0.0,0.0,0.0,0.0,1.0,6.0,1.0,1.0,0.0,1.0,0.0,0.0,0.0,0.0,0.0,0.0,0.0,0.0,0.0,1.0,0.0,0.0,0.0,0.0,0.0,0.0,0.0,0.0,0.0,0.0,0.0,0.0,0.0,0.0,0.0,0.0,0.0,0.0,14.0,0.0,13650.615,90228.15,0.0,0.0,0.0,0.0,0.0,-1219.0,130.0,-101.0,-577.0,595.0,-22.0,18.0,25822.89,193495.5,227585.25,1575.0,283500.0,18.0,-455.5,365243.0,-1084.5,-703.0,-403.0,-695.5,7.0,0.5,0.0544634398649752,-1.0,93.0,18.0,10.0,-23.0,0.0,0.0,85.0,22312.98,22312.98,-674.0,-665.0,6.0,1.0,0.0,,,,,,,,,,,,,,,,,,,,,8336875869.0,184224562623.0,165429259497.0,51913209610.935,1862.0,1703.0,71123.0,70636.0,9140.0,505474.0,17788.723300002304,17850.752999999117,17302.619899998095,,,,128251.0,662032.0,,,,13512696.213698229,-601213177.0,-920865126.0,-296134579.0,-1533464836.0416667,43956.0,30660.0,11338.919999999172,11214.879999998964,10699.504799997305,22862.77360000961,22784.61680000957,22170.72640000812,67363.14854844003,157861.24875085478,125967.07065949574,34962.497400027874,34902.969400028305,34349.63250002871,,,,3710040.0,8287.033200000169,8391.423800000082,8115.21870000023,,,,16451.06009999975,16636.066099999698,16232.981599999706,,,,,,,435946.0,430748.0,,6417.784617002897,631226.0,624786.0,,16315.1124999998,154012.82699999062,154015.5684999901,153907.3753999872,,,,41.0,5620831.290000003,2106871.425,574693611.2549998,197729359.87500003,9455589.225,19998.0,9.0,1513.0,-2004240.5,881711.0,-1069438.5,-1125814.0,-20.0,0.0,13650.615,97975.8,0.0,0.0,0.0,0.0,0.0,-1432.0,130.0,-88.0,-1065.0,22868293.32000005,324804764.34,365050523.115,5890414.725,325412264.34,22934.0,-1586021.5,352201073.5,18607384.5,77711490.5,36986131.5,79206335.5,22294.5,362.0,61.20877712655032,609164.5,198087.0,117008.0,-394950.0,285493.0,780.0,257914126.12500107,255847966.9650007,-16707217.0,-16597895.0,322401.0,12520.0,,,,,,,,,,,,,,,,,,,,,1465613.0,14713998.0,3228726.0,8544537.0,11593517.0,1413925.0,1056525299.8020012,801012071.542495,72021052139.57959,21652045609.99512,581630461.1594988,5792395.7475,689.5,94245.0,-276611571.0,21843633.5,-123654009.5,-218461072.0,-2012864.5,,,,,,,,,,,,,,,,,,,,,4267749.5,2476241.5,-8993225.0,921269.0,37582.5,3729013181.054964,3653564293.9124618,-260332811.5,-257025952.0,2523645.5,268884.5,3921610479.4574537,33219639707.37841,36645154969.207634,1727665017.8400495,48031226473.47822,3983417.0,-247305700.0,102964408557.0,1052669276.0,17256730435.0,3499843217.0,18870011668.5,3667831.5,71831.5,20850.45145923525,89675680.0,-47.71048943510133,3.9445777777777775,3.956739646531258,201.1107778697203,15.6076672821595,793.2971052565016,101250.0,-0.2225209339563146,-0.9749279121818236,0.0,0.0,0.0,0.0,0.0,0.0,1.0,0.0,0.0,0.0,0.0,0.0,0.0,1.0,0.0,0.0,0.0,0.0,1.0,0.0,1.0,0.0,0.0,0.0,0.0,1.0,0.0,0.0,0.0,0.0,0.0,0.0,0.0,0.0,0.0,0.0,0.0,0.0,1.0,0.0,0.0,0.0,0.0,0.0,0.0,0.0,0.0,0.0,0.0,0.0,0.0,0.0,0.0,1.0,0.0,0.0,0.0,0.0,0.0,0.0,0.0,0.0,0.0,0.0,0.0,0.0,0.0,0.0,0.0,0.0,0.0,0.0,0.0,0.0,0.0,0.0,0.0,0.0,0.0,0.0,0.0,0.0,0.0,0.0,0.0,0.0,0.0,0.0,0.0,0.0,0.0,0.0,0.0,0.0,0.0,0.0,0.0,0.0,0.0,0.0,0.0,0.0,0.0,0.0,0.0,0.0,0.0,0.0,0.0,0.0,1.0,0.0,0.0,0.0,0.0,0.0,0.0,0.0,0.0,1.0
100367,0,0.0,1.0,1.0,0.0,0.0,157500.0,261000.0,26874.0,261000.0,0.0145199999999999,54.35616438356164,-3761.0,-1325.0,-3323.0,14.0,2.0,2.0,2.0,10.0,,0.5092289549980366,0.656158373001177,0.0928,0.0534,0.9841,0.762,,0.0532,0.1838,0.2221,,0.0585,,0.1123,,0.0007,0.0945,0.0,0.9786,0.7190000000000001,,0.0,0.2069,0.1667,,0.0198,,0.0957,,0.0,0.0937,0.0534,0.9866,0.7652,,0.0,0.2069,0.1667,,0.0595,,0.0949,,0.0,0.0724,1.0,2.0,0.0,2.0,0.0,-1780.0,0.0,0.0,0.0,0.0,1.0,4.0,1.0,1.0,0.0,1.0,0.0,0.0,0.0,0.0,0.0,0.0,0.0,0.0,0.0,1.0,0.0,0.0,0.0,0.0,0.0,0.0,0.0,0.0,0.0,0.0,0.0,0.0,0.0,0.0,0.0,0.0,0.0,0.0,2.0,0.0,21843.0,675000.0,0.0,0.0,0.0,0.0,0.0,-1985.0,-904.5,-517.5,-517.5,131.0,-32.0,5.0,9297.675,86562.0,86562.0,0.0,91179.0,12.0,-642.0,365243.0,-815.5,-500.5,-485.5,-494.0,9.0,0.0,0.0,30200.0,60.0,12.0,8.0,-29.5,0.0,0.0,58.0,7462.935,7462.935,-888.0,-885.0,8.0,1.0,0.0,,,,,,,,,,,,,,,,,,,,,8336902743.0,184224823623.0,165429520497.0,51913367110.935,1862.0,1703.0,71123.0,70637.0,9140.0,505478.0,17788.816100002306,17850.846699999118,17302.714399998094,11283.454300000089,11221.282200000092,11168.754600000058,128251.0,662034.0,,,,13512750.56986261,-601216938.0,-920868449.0,-296136359.0,-1533466161.0416667,43956.0,30660.0,11338.973199999173,11214.879999998964,10699.504799997305,22862.95740000961,22784.82370000957,22170.93330000812,,157861.75797980974,125967.72681786877,34962.719500027866,34903.136100028314,34349.79920002871,,,,3710050.0,8287.091700000168,8391.483300000082,8115.23850000023,,,,16451.172399999752,16636.160999999698,16233.077299999706,,,,3908.906400000125,3892.12140000016,3724.866600000156,435948.0,430750.0,1261561.0,6417.799137002897,631228.0,624788.0,,16315.184899999796,154013.81109999062,154016.5550999901,153908.35399998722,77527.40279999629,77864.81950000659,78265.69840000644,65.5,5866904.520000002,2140552.395,584758432.3499997,199691891.19000003,9455626.395,19998.0,9.0,1513.0,-2055480.0,919000.0,-1093618.0,-1154671.0,-32.25,0.0,21843.0,675000.0,0.0,0.0,0.0,0.0,0.0,-2514.0,-1449.0,-675.0,-675.0,23456991.33000005,333402360.84,374574561.615,5961393.225,333445641.84,23323.0,-1622438.0,360966257.5,18945624.5,79883568.0,37699558.5,81378554.5,22676.0,374.0,62.12498863742496,642277.0,203275.0,119839.0,-404169.5,285493.0,780.0,264042315.0000004,261919281.24,-16976175.0,-16864039.5,326012.0,12827.5,,,,,,,,,,,,,,,,,,,,,1465615.0,14714129.0,3228726.0,8544597.0,11593575.0,1413930.0,1056525299.8020012,801033914.542495,72021727139.57959,21652045609.99512,581630461.1594988,5792395.7475,689.5,94245.0,-276613556.0,21842729.0,-123654527.0,-218461589.5,-2012896.5,,,,,,,,,,,,,,,,,,,,,4267761.5,2476249.5,-8993254.5,921269.0,37582.5,3729020643.989964,3653571756.8474617,-260333699.5,-257026837.0,2523653.5,268885.5,3921619777.132455,33219726269.37841,36645241531.207634,1727665017.8400495,48031317652.47822,3983429.0,-247306342.0,102964773800.0,1052668460.5,17256729934.5,3499842731.5,18870011174.5,3667840.5,71831.5,20850.45145923525,89705880.0,-69.19178427419354,1.6571428571428573,5.860683188211653,318.5642587784088,9.71198928332217,527.9064859756489,78750.0,-0.9009688679024191,0.4338837391175582,0.0,0.0,0.0,0.0,0.0,0.0,1.0,0.0,0.0,0.0,0.0,0.0,0.0,1.0,0.0,0.0,0.0,0.0,1.0,0.0,1.0,0.0,0.0,0.0,0.0,1.0,0.0,0.0,0.0,0.0,0.0,0.0,0.0,0.0,0.0,0.0,0.0,0.0,1.0,0.0,0.0,0.0,0.0,0.0,0.0,0.0,0.0,0.0,0.0,0.0,0.0,0.0,0.0,0.0,0.0,0.0,0.0,0.0,0.0,0.0,0.0,1.0,0.0,0.0,0.0,0.0,0.0,0.0,0.0,0.0,0.0,0.0,0.0,0.0,0.0,0.0,0.0,0.0,0.0,0.0,0.0,0.0,0.0,0.0,0.0,0.0,0.0,0.0,0.0,0.0,0.0,0.0,0.0,0.0,0.0,0.0,0.0,0.0,0.0,0.0,0.0,0.0,0.0,0.0,0.0,0.0,0.0,0.0,0.0,0.0,1.0,0.0,0.0,0.0,0.0,0.0,0.0,1.0,0.0,0.0
100382,0,0.0,1.0,1.0,0.0,1.0,180000.0,431280.0,22149.0,360000.0,0.0072739999999999,32.18082191780822,-1804.0,-1095.0,-2911.0,22.0,3.0,2.0,2.0,14.0,,0.3785445267666673,0.164414178829907,0.0577,0.086,0.9747,0.6532,0.0062,0.0,0.1379,0.125,0.1667,0.038,0.0471,0.0554,0.0,0.0,0.0588,0.0892,0.9747,0.6668,0.0062,0.0,0.1379,0.125,0.1667,0.0389,0.0514,0.0577,0.0,0.0,0.0583,0.086,0.9747,0.6578,0.0062,0.0,0.1379,0.125,0.1667,0.0387,0.0479,0.0564,0.0,0.0,0.047,1.0,1.0,0.0,1.0,0.0,0.0,0.0,0.0,0.0,0.0,1.0,4.0,1.0,1.0,0.0,1.0,1.0,1.0,0.0,0.0,0.0,0.0,0.0,0.0,0.0,0.0,0.0,0.0,0.0,0.0,1.0,0.0,0.0,0.0,0.0,0.0,0.0,0.0,0.0,0.0,0.0,0.0,0.0,0.0,9.0,0.0,0.0,72819.0,16020.0,0.0,0.0,0.0,0.0,-1050.0,-52.0,-50.0,-925.0,286.0,-24.0,7.0,9323.28,67486.5,96556.5,0.0,107289.0,8.0,-642.0,365243.0,-744.5,-519.5,-414.5,-513.0,16.0,0.5,0.0,100.0,34.0,12.0,6.0,-23.5,0.0,0.0,35.0,9799.515,9799.515,-776.0,-758.0,4.0,1.0,0.0,,,,,,,,,,,,,,,,,,,,,8336924892.0,184225254903.0,165429880497.0,51913547110.935,1862.0,1703.0,71123.0,70638.0,9140.0,505482.0,17788.873800002304,17850.90499999912,17302.77319999809,11283.540300000086,11221.368200000094,11168.84380000006,128252.0,662037.0,4134.464700000122,4132.0950000000175,3942.917000000096,13512782.750684528,-601218742.0,-920871360.0,-296136359.0,-1533467256.0416667,43956.0,30660.0,11338.973199999173,11214.879999998964,10699.504799997305,22863.09530000961,22784.96160000957,22171.07120000812,,157862.13652433653,125967.8912320476,34962.844500027866,34903.261100028314,34349.92420002871,22929.41179999593,22902.859299995507,22550.248399995744,3710064.0,8287.129700000169,8391.522000000079,8115.277400000228,9807.85410000072,9922.67460000216,10281.887699999645,16451.22779999975,16636.2173999997,16233.134999999707,828.0699000001758,813.2508000000457,759.2380000000132,3908.906400000125,3892.12140000016,3724.866600000156,435949.0,430751.0,1261583.0,6417.806411002895,631230.0,624790.0,,16315.2318999998,154014.7857999906,154017.5297999901,153909.3286999872,77528.05599999629,77865.47730000659,78266.36520000645,35.0,6063824.520000002,2200928.0850000004,613956646.0799997,216593430.07500005,9636191.19,19998.0,10.0,1513.0,-2120964.0,915783.0,-1129719.0,-1193408.0,-17.0,0.0,0.0,135000.0,0.0,0.0,0.0,0.0,0.0,-1771.0,-925.0,-591.0,-1320.0,24079767.43500005,340530255.9,382953935.115,6120957.285,340530255.9,23953.0,-1664153.0,373383593.5,19644655.5,83148559.5,39507685.5,84643718.0,23435.0,388.5,63.900489322906935,729202.0,208076.0,122839.0,-413965.0,285549.0,788.0,270107858.42999995,267849076.6800004,-17293421.0,-17176237.0,328565.0,13171.0,,,,,,,,,,,,,,,,,,,,,1465624.0,14714415.0,3228726.0,8544631.0,11593610.0,1413937.0,1056525299.8020012,801033914.542495,72021799958.57959,21652061629.99512,581630461.1594988,5792395.7475,689.5,94245.0,-276614606.0,21842677.0,-123654577.0,-218462514.5,-2012920.5,,,,,,,,,,,,,,,,,,,,,4267773.5,2476255.5,-8993278.0,921269.0,37582.5,3729030443.504964,3653581556.3624616,-260334475.5,-257027595.0,2523657.5,268886.5,3921629100.412455,33219793755.87841,36645338087.707634,1727665017.8400495,48031424941.47822,3983437.0,-247306984.0,102965139043.0,1052667716.0,17256729415.0,3499842317.0,18870010661.5,3667856.5,71832.0,20850.45145923525,89705980.0,-56.05823258981781,2.396,8.126777732629012,261.5263869793435,19.471759447379117,626.617223202507,60000.0,0.6234898018587336,0.7818314824680298,0.0,0.0,0.0,0.0,0.0,0.0,1.0,0.0,0.0,0.0,0.0,0.0,0.0,1.0,0.0,1.0,0.0,0.0,0.0,0.0,1.0,0.0,0.0,0.0,0.0,1.0,0.0,0.0,0.0,0.0,0.0,0.0,0.0,0.0,0.0,0.0,0.0,0.0,0.0,0.0,1.0,0.0,0.0,0.0,0.0,0.0,0.0,0.0,0.0,0.0,0.0,0.0,0.0,1.0,0.0,0.0,0.0,0.0,0.0,0.0,0.0,0.0,0.0,0.0,0.0,0.0,0.0,0.0,0.0,0.0,0.0,0.0,0.0,0.0,0.0,0.0,0.0,0.0,0.0,0.0,0.0,0.0,0.0,0.0,0.0,0.0,0.0,0.0,0.0,0.0,0.0,0.0,0.0,0.0,0.0,0.0,0.0,0.0,0.0,0.0,0.0,0.0,0.0,0.0,0.0,0.0,0.0,0.0,1.0,0.0,1.0,0.0,0.0,0.0,0.0,0.0,0.0,0.0,1.0,0.0
100384,0,0.0,0.0,0.0,1.0,0.0,112500.0,360000.0,28570.5,360000.0,0.018209,32.85205479452055,-1303.0,-5282.0,-936.0,,2.0,3.0,3.0,13.0,0.6403608878311089,0.3942681389792175,,0.1701,0.0,0.9771,0.6872,0.0365,0.0,0.1034,0.1667,0.2083,0.0631,0.1378,0.0613,0.0039,0.0,0.1733,0.0,0.9772,0.6994,0.0368,0.0,0.1034,0.1667,0.2083,0.0646,0.1506,0.0638,0.0039,0.0,0.1718,0.0,0.9771,0.6914,0.0367,0.0,0.1034,0.1667,0.2083,0.0642,0.1402,0.0624,0.0039,0.0,0.0681,1.0,0.0,0.0,0.0,0.0,-213.0,0.0,0.0,0.0,0.0,1.0,0.0,1.0,1.0,0.0,1.0,0.0,0.0,0.0,0.0,0.0,0.0,0.0,0.0,0.0,1.0,0.0,0.0,0.0,0.0,0.0,0.0,0.0,0.0,0.0,0.0,0.0,0.0,0.0,0.0,0.0,0.0,0.0,0.0,1.0,8842.5,,85266.0,85648.5,,0.0,0.0,0.0,-407.0,,-4.0,,14.0,-6.5,1.0,10793.565,56250.0,59593.5,0.0,56250.0,6.0,-213.0,365243.0,-181.0,-31.0,-31.0,-24.0,10.0,0.0,0.0,50.0,17.0,9.0,4.0,-81.0,0.0,0.0,7.0,10793.565,10793.565,-97.0,-91.0,4.0,1.0,0.0,,,,,,,,,,,,,,,,,,,,,8336953462.5,184225614903.0,165430240497.0,51913659610.935,1862.0,1703.0,71123.0,70639.0,9140.0,505482.0,17789.043900002303,17851.07679999912,17302.946499998092,11283.540300000086,11221.368200000094,11168.84380000006,128252.0,662039.0,4134.5012000001225,4132.131700000017,3942.9538000000953,13512815.602739325,-601220045.0,-920872296.0,-296136572.0,-1533472538.0416667,43956.0,30660.0,11338.973199999173,11214.879999998964,10699.504799997305,22863.19870000961,22785.06500000957,22171.17460000812,67363.78890932785,157862.5307924755,,34963.01120002787,34903.42780002831,34350.090900028714,22929.620099995933,22903.067599995506,22550.456699995742,3710077.0,8287.192800000168,8391.586200000082,8115.342000000228,9807.99190000072,9922.81480000216,10282.038299999644,16451.289099999754,16636.2797999997,16233.198799999704,828.0738000001758,813.2547000000459,759.2419000000133,3908.906400000125,3892.12140000016,3724.866600000156,435949.0,430751.0,,6417.824620002895,631233.0,624793.0,,16315.2999999998,154015.7628999906,154018.50689999008,153910.3058999872,77528.74319999629,77866.16870000659,78267.06460000643,14.0,6080165.505000004,,616700062.0799997,217724806.57500005,,19998.0,10.0,1513.0,-2127909.0,,-1134326.0,,-6.5,8842.5,,85266.0,85648.5,,0.0,0.0,0.0,-407.0,,-4.0,,24310570.05000005,343184115.285,385914415.5,6150963.285,343184115.285,24257.0,-1685767.0,377218645.0,19632054.0,83138269.0,39499509.0,84633493.0,23865.0,395.0,64.29862924819838,734301.0,209762.0,123899.0,-418795.0,285723.0,962.0,272520288.94499946,270414686.925,-17419496.0,-17301161.0,329208.0,13285.0,,,,,,,,,,,,,,,,,,,,,1465625.0,14714429.0,3228726.0,8544648.0,11593617.0,1413938.0,1056534142.3020012,,72021885224.57959,21652147278.49512,,5792395.7475,689.5,94245.0,-276615013.0,,-123654581.0,,-2012927.0,,,,,,,,,,,,,,,,,,,,,4267782.5,2476259.5,-8993359.0,921269.0,37582.5,3729041237.069964,3653592349.9274616,-260334572.5,-257027686.0,2523661.5,268887.5,3921639893.977455,33219850005.87841,36645397681.207634,1727665017.8400495,48031481191.47822,3983443.0,-247307197.0,102965504286.0,1052667535.0,17256729384.0,3499842286.0,18870010637.5,3667866.5,71832.0,20850.45145923525,89706030.0,-39.66266366441498,3.2,3.93762797290912,129.3591699264473,12.600409513309186,413.9493437646312,56250.0,-0.2225209339563143,0.9749279121818236,0.0,0.0,0.0,0.0,0.0,0.0,1.0,0.0,0.0,0.0,1.0,0.0,0.0,0.0,0.0,1.0,0.0,0.0,0.0,0.0,1.0,0.0,0.0,0.0,0.0,0.0,0.0,0.0,0.0,1.0,0.0,0.0,0.0,0.0,0.0,0.0,0.0,0.0,0.0,0.0,0.0,1.0,0.0,0.0,0.0,0.0,0.0,0.0,0.0,0.0,0.0,0.0,0.0,0.0,0.0,0.0,0.0,0.0,0.0,0.0,0.0,0.0,0.0,0.0,0.0,0.0,0.0,0.0,0.0,0.0,0.0,0.0,0.0,0.0,0.0,0.0,0.0,0.0,1.0,0.0,0.0,0.0,0.0,0.0,0.0,0.0,0.0,0.0,0.0,0.0,0.0,0.0,0.0,0.0,0.0,0.0,0.0,0.0,0.0,0.0,0.0,0.0,0.0,0.0,0.0,0.0,0.0,0.0,1.0,0.0,1.0,0.0,0.0,0.0,0.0,0.0,0.0,0.0,1.0,0.0
100385,0,0.0,1.0,1.0,0.0,1.0,229500.0,544500.0,42268.5,544500.0,0.028663,34.43013698630137,-5041.0,-4640.0,-4565.0,4.0,3.0,2.0,2.0,13.0,,0.5767684103937347,0.2837118826350007,,,,,,,,,,,,,,,,,,,,,,,,,,,,,,,,,,,,,,,,,,,,,0.0,0.0,0.0,0.0,-256.0,0.0,0.0,0.0,0.0,1.0,5.0,1.0,1.0,0.0,1.0,0.0,0.0,0.0,0.0,0.0,0.0,0.0,0.0,0.0,1.0,0.0,0.0,0.0,0.0,0.0,0.0,0.0,0.0,0.0,0.0,0.0,0.0,0.0,0.0,0.0,0.0,0.0,0.0,8.0,2072.25,0.0,112500.0,24430.5,0.0,0.0,0.0,0.0,-574.5,179.0,-161.5,-453.0,176.0,-11.5,12.0,10639.9125,20677.5,20990.25,0.0,35460.0,10.0,-374.5,365243.0,-1475.0,-1370.0,-1355.0,-1362.0,12.0,0.0,0.0,12.0,30.0,9.0,4.0,-47.5,0.0,0.0,26.0,6389.145,6389.145,-1436.5,-1430.0,4.0,1.0,0.0,,,,,,,,,,,,,,,,,,,,,8336995731.0,184226159403.0,165430784997.0,51913889110.935,1862.0,1703.0,71123.0,70640.0,9140.0,505487.0,,,,,,,128253.0,662042.0,,,,13512850.032876307,-601225086.0,-920876861.0,-296136828.0,-1533477178.0416667,43956.0,30660.0,,,,,,,,157863.1075608859,125968.17494393024,,,,,,,3710090.0,,,,,,,,,,,,,,,,435949.0,430751.0,1261587.0,6417.853283002895,631235.0,624795.0,,,,,,,,,19.5,6203866.005000004,2200928.0850000004,620184457.0799997,219008719.57500005,9636191.19,19998.0,10.0,1513.0,-2131630.5,916720.0,-1135402.0,-1199946.5,-9.25,0.0,0.0,225000.0,0.0,0.0,0.0,0.0,0.0,-756.0,208.0,-297.0,-609.0,24333525.81000005,343421364.285,386150485.5,6154509.285,343290261.285,24282.0,-1694876.0,378131752.5,19627475.0,83134095.0,39495421.0,84629339.0,23937.0,395.5,64.40753833910748,734606.0,209929.5,123991.5,-419783.5,285728.0,967.0,272624200.78499925,270518573.0249998,-17445404.0,-17326951.0,329274.5,13303.5,,,,,,,,,,,,,,,,,,,,,1465633.0,14714605.0,3228726.0,8544678.0,11593643.0,1413950.0,1056536214.5520012,801033914.542495,72021997724.57959,21652171708.99512,581630461.1594988,5792395.7475,689.5,94245.0,-276615587.5,21842856.0,-123654742.5,-218462967.5,-2012938.5,,,,,,,,,,,,,,,,,,,,,4267791.5,2476263.5,-8993406.5,921269.0,37582.5,3729047626.214964,3653598739.0724616,-260336009.0,-257029116.0,2523665.5,268888.5,3921650533.8899546,33219870683.37841,36645418671.457634,1727665017.8400495,48031516651.47822,3983453.0,-247307571.5,102965869529.0,1052666060.0,17256728014.0,3499840931.0,18870009275.5,3667878.5,71832.0,20850.45145923525,89706042.0,-146.4124293785311,2.372549019607843,5.429575215586076,186.9410184500554,12.881933354625785,443.52673004817046,76500.0,-0.9009688679024191,0.4338837391175582,0.0,1.0,0.0,0.0,0.0,0.0,0.0,0.0,0.0,0.0,0.0,0.0,0.0,1.0,0.0,0.0,0.0,1.0,0.0,0.0,1.0,0.0,0.0,0.0,0.0,1.0,0.0,0.0,0.0,0.0,0.0,0.0,0.0,0.0,0.0,0.0,0.0,0.0,0.0,0.0,0.0,0.0,0.0,0.0,0.0,0.0,0.0,0.0,0.0,0.0,0.0,0.0,1.0,0.0,0.0,0.0,0.0,0.0,0.0,0.0,0.0,0.0,0.0,0.0,0.0,0.0,0.0,0.0,0.0,0.0,0.0,0.0,0.0,0.0,0.0,0.0,0.0,0.0,0.0,0.0,0.0,0.0,0.0,0.0,0.0,0.0,0.0,0.0,0.0,0.0,0.0,0.0,0.0,0.0,0.0,0.0,0.0,0.0,0.0,0.0,0.0,0.0,0.0,0.0,0.0,0.0,0.0,0.0,0.0,0.0,0.0,0.0,0.0,0.0,0.0,0.0,0.0,0.0,0.0,0.0
100386,0,0.0,0.0,0.0,1.0,3.0,202500.0,207396.0,13383.0,157500.0,0.006629,37.32054794520548,-993.0,-5684.0,-2089.0,,5.0,2.0,2.0,9.0,,0.5922055060542036,0.5136937663039473,,,,,,,,,,,,,,,,,,,,,,,,,,,,,,,,,,,,,,,,,,,,,0.0,0.0,0.0,0.0,-155.0,0.0,0.0,0.0,0.0,0.0,3.0,1.0,1.0,0.0,1.0,0.0,1.0,0.0,0.0,0.0,0.0,0.0,0.0,0.0,1.0,0.0,0.0,0.0,0.0,0.0,0.0,0.0,0.0,0.0,0.0,0.0,0.0,0.0,0.0,0.0,0.0,0.0,0.0,6.0,0.0,0.0,177241.5,41008.5,0.0,0.0,0.0,0.0,-788.0,297.0,-182.0,-527.5,156.0,-12.5,7.0,25450.425,135000.0,163732.5,0.0,227241.0,12.0,-155.0,365243.0,-561.0,-380.0,-231.0,-376.0,7.0,0.0,0.0,-1.0,30.0,12.0,8.5,-18.5,0.0,0.0,40.0,18072.81,18072.81,-452.5,-440.0,5.0,1.0,4.0,394.11,540000.0,0.0,22500.0,0.0,0.0,2720.34,26669.25,26669.25,0.0,0.0,0.0,0.0,0.5,0.0,0.0,2.5,-2.5,0.0,0.0,8337009114.0,184226366799.0,165430942497.0,51914091610.935,1862.0,1703.0,71123.0,70640.0,9140.0,505490.0,,,,,,,128256.0,662047.0,,,,13512887.353424257,-601226079.0,-920878950.0,-296136983.0,-1533482862.0416667,43956.0,30660.0,,,,,,,,157863.69976639195,125968.68863769654,,,,,,,3710099.0,,,,,,,,,,,,,,,,435949.0,430751.0,,6417.859912002897,631237.0,624797.0,,,,,,,,,26.5,6212911.005000004,2200928.0850000004,621362557.0799997,219512942.32500005,9636191.19,19998.0,10.0,1513.0,-2135597.0,948162.0,-1136644.0,-1201133.5,-12.75,0.0,0.0,168300.0,0.0,0.0,0.0,0.0,0.0,-861.0,-307.0,-342.0,-527.0,24457925.52000005,344772858.285,387546763.5,6154509.285,344772858.285,24331.0,-1697270.0,379409964.0,19625221.0,83497233.0,39859477.0,84992478.0,24038.0,396.0,64.40753833910748,734723.0,210220.0,124162.0,-420537.0,285728.0,967.0,273415404.14999926,271309776.38999975,-17461052.5,-17342168.0,329425.0,13326.5,267157878.3900004,698751000.0,22048152.75,28637014.41,462451.5,6118458.525000002,15471027.360000014,30768513.21000012,28352613.64500001,256143444.56999984,266382655.69500023,266396286.10500023,1264.5,2621.5,13.0,1344.0,95872.5,-167951.0,88882.0,199.0,1465639.0,14714761.0,3228730.0,8544708.0,11593683.0,1413957.0,1056536214.5520012,801033914.542495,72022174966.07959,21652212717.49512,581630461.1594988,5792395.7475,689.5,94245.0,-276616375.5,21843153.0,-123654924.5,-218463495.0,-2012951.0,5914903788.8774605,18696125250.0,198605420.325,447347873.0024977,1948107.735,256448094.2775008,308729357.00999874,635567910.7949983,458429609.0924992,5700358550.880029,5878255455.562497,5878498638.307498,13364.0,80722.5,44.0,70251.5,970487.0,-1696427.5,177364.0,6755.0,4267803.5,2476272.0,-8993425.0,921269.0,37582.5,3729065699.024964,3653616811.8824615,-260336461.5,-257029556.0,2523670.5,268889.5,3921675984.3149543,33220005683.37841,36645582403.957634,1727665017.8400495,48031743892.47822,3983465.0,-247307726.5,102966234772.0,1052665499.0,17256727634.0,3499840700.0,18870008899.5,3667885.5,71832.0,20850.45145923525,89706041.0,-26.60732638379093,1.024177777777778,15.131136516476126,564.7023058285966,15.496973772696704,578.3555526895193,40500.0,-0.9009688679024191,-0.433883739117558,0.0,0.0,0.0,0.0,0.0,0.0,1.0,0.0,1.0,0.0,0.0,0.0,0.0,0.0,0.0,1.0,0.0,0.0,0.0,1.0,0.0,0.0,0.0,0.0,0.0,0.0,1.0,0.0,0.0,0.0,0.0,0.0,0.0,1.0,0.0,0.0,0.0,0.0,0.0,0.0,0.0,0.0,0.0,0.0,0.0,0.0,0.0,0.0,0.0,0.0,0.0,0.0,0.0,0.0,0.0,0.0,0.0,0.0,0.0,0.0,0.0,0.0,0.0,0.0,0.0,0.0,0.0,0.0,0.0,0.0,0.0,0.0,0.0,0.0,0.0,0.0,0.0,0.0,1.0,0.0,0.0,0.0,0.0,0.0,0.0,0.0,0.0,0.0,0.0,0.0,0.0,0.0,0.0,0.0,0.0,0.0,0.0,0.0,0.0,0.0,0.0,0.0,0.0,0.0,0.0,0.0,0.0,0.0,0.0,0.0,0.0,0.0,0.0,0.0,0.0,0.0,0.0,0.0,0.0,0.0
100399,0,0.0,1.0,0.0,0.0,0.0,360000.0,1024740.0,43546.5,900000.0,0.010276,56.21917808219178,-3794.0,-3157.0,-4057.0,,2.0,2.0,2.0,18.0,0.5843807808242455,0.7904523245236238,0.4066174366275036,0.0742,0.0533,0.9841,,,0.08,0.069,0.3333,,0.0794,,0.0788,,0.0,0.0756,0.0553,0.9841,,,0.0806,0.069,0.3333,,0.0812,,0.0821,,0.0,0.0749,0.0533,0.9841,,,0.08,0.069,0.3333,,0.0808,,0.0802,,0.0,0.062,1.0,0.0,0.0,0.0,0.0,-3049.0,0.0,0.0,0.0,0.0,0.0,0.0,1.0,1.0,1.0,1.0,0.0,0.0,0.0,0.0,0.0,0.0,0.0,0.0,0.0,1.0,0.0,0.0,0.0,0.0,0.0,0.0,0.0,0.0,0.0,0.0,0.0,0.0,0.0,0.0,0.0,0.0,0.0,0.0,3.0,45000.0,,225000.0,0.0,0.0,0.0,0.0,0.0,-196.0,99.0,-25.0,-1295.0,60.0,-18.5,0.0,,,,,,,,,,,,,,,,,6.0,8.0,1.5,-93.5,0.0,0.0,5.0,6344.775,6344.775,-2862.0,-2857.0,6.0,1.0,0.0,,,,,,,,,,,,,,,,,,,,,8337052660.5,184227391539.0,165431842497.0,51914451610.935,1862.0,1703.0,71123.0,70640.0,9140.0,505490.0,17789.118100002306,17851.151699999118,17303.022099998092,11283.593600000086,11221.421500000091,11168.89910000006,128256.0,662049.0,,,,13512943.572602335,-601229873.0,-920883007.0,-296140032.0,-1533486019.0416667,43956.0,30660.0,11339.053199999173,11214.959999998964,10699.585399997302,22863.26770000961,22785.13400000957,22171.24360000812,67364.37329010868,157864.49021871647,125969.09525513314,34963.344500027866,34903.761100028314,34350.42420002871,,,,3710117.0,8287.272200000169,8391.667000000081,8115.423200000228,,,,16451.367899999754,16636.3599999997,16233.280899999703,,,,3908.906400000125,3892.12140000016,3724.866600000156,435949.0,430751.0,,6417.870188002897,631239.0,624799.0,,16315.3619999998,154016.7469999906,154019.49099999008,153911.2899999872,,,,7.0,6606789.660000007,,650634968.9249997,223566360.57000005,10162124.37,19998.0,11.0,1513.0,-2210049.0,961830.0,-1176233.0,-1244764.0,-3.0,45000.0,,66713.85,0.0,0.0,0.0,0.0,0.0,-1480.0,-1266.0,-12.0,-1295.0,,,,,,,,,,,,,,,,,213881.0,126564.0,-429994.0,285728.0,967.0,281579093.09999526,279440505.8099957,-18114573.0,-17992097.0,348460.0,13566.0,,,,,,,,,,,,,,,,,,,,,1465642.0,14714821.0,3228730.0,8544714.0,11593688.0,1413957.0,1056581214.5520012,,72022399966.07959,21652212717.49512,581630461.1594988,5792395.7475,689.5,94245.0,-276616571.5,21843252.0,-123654949.5,-218464790.0,-2012969.5,,,,,,,,,,,,,,,,,,,,,4267811.5,2476273.5,-8993518.5,921269.0,37582.5,3729072043.799964,3653623156.6574616,-260339323.5,-257032413.0,2523676.5,268890.5,,,,,,,,,,,,,,,,,-67.48586744639374,2.8465,8.267024904412526,464.76534531108217,23.532086390410253,1322.9545554279955,180000.0,1.0,0.0,0.0,0.0,0.0,0.0,0.0,0.0,1.0,0.0,1.0,0.0,0.0,0.0,0.0,0.0,0.0,1.0,0.0,0.0,0.0,0.0,1.0,0.0,0.0,0.0,0.0,1.0,0.0,0.0,0.0,0.0,0.0,0.0,0.0,0.0,0.0,0.0,0.0,0.0,0.0,0.0,0.0,0.0,0.0,0.0,0.0,0.0,0.0,0.0,0.0,0.0,0.0,0.0,0.0,0.0,0.0,0.0,0.0,0.0,0.0,0.0,0.0,0.0,0.0,0.0,0.0,0.0,0.0,0.0,0.0,0.0,0.0,0.0,0.0,0.0,0.0,0.0,0.0,0.0,0.0,0.0,0.0,1.0,0.0,0.0,0.0,0.0,0.0,0.0,0.0,0.0,0.0,0.0,0.0,0.0,0.0,0.0,0.0,0.0,0.0,0.0,0.0,0.0,0.0,0.0,0.0,0.0,0.0,0.0,0.0,0.0,1.0,0.0,0.0,0.0,0.0,0.0,0.0,0.0,1.0,0.0
100404,0,0.0,0.0,0.0,1.0,0.0,270000.0,2013840.0,83110.5,1800000.0,0.0105,39.2958904109589,-2682.0,-6069.0,-797.0,,2.0,3.0,3.0,14.0,,0.6625765416174567,0.2091546988410069,0.1268,0.0869,0.9767,0.6804,0.0179,0.0,0.2759,0.1667,0.2083,0.0191,0.0983,0.0781,0.0232,0.0207,0.1292,0.0902,0.9767,0.6929,0.0181,0.0,0.2759,0.1667,0.2083,0.0195,0.1074,0.0814,0.0233,0.0219,0.128,0.0869,0.9767,0.6847,0.018,0.0,0.2759,0.1667,0.2083,0.0194,0.1,0.0795,0.0233,0.0212,0.0941,1.0,6.0,0.0,6.0,0.0,-533.0,0.0,0.0,0.0,0.0,1.0,2.0,1.0,1.0,0.0,1.0,0.0,0.0,0.0,0.0,0.0,0.0,0.0,0.0,0.0,1.0,0.0,0.0,0.0,0.0,0.0,0.0,0.0,0.0,0.0,0.0,0.0,0.0,0.0,0.0,0.0,0.0,0.0,0.0,8.0,3363.75,0.0,388417.95,0.0,0.0,0.0,0.0,0.0,-607.5,-55.5,-235.5,-301.5,207.0,-14.0,3.0,44556.525,0.0,0.0,48474.0,484704.0,12.0,-393.0,365243.0,-502.0,-292.0,-172.0,-290.0,14.0,0.0,0.1089171798195862,-1.0,9.0,11.0,7.0,-14.0,0.0,0.0,8.0,44556.525,44556.525,-407.0,-397.0,4.5,2.0,0.0,,,,,,,,,,,,,,,,,,,,,8337135771.0,184229405379.0,165433642497.0,51914721610.935,1862.0,1703.0,71123.0,70641.0,9140.0,505492.0,17789.2449000023,17851.27969999912,17303.15129999809,11283.680500000086,11221.508400000092,11168.98930000006,128256.0,662051.0,4134.519100000122,4132.149700000017,3942.971900000095,13512982.868492749,-601232555.0,-920883804.0,-296140565.0,-1533492088.0416667,43956.0,30660.0,11339.053199999173,11214.959999998964,10699.585399997302,22863.54360000961,22785.40990000957,22171.51950000812,,157865.1527952581,125969.304409832,34963.51120002787,34903.92780002831,34350.590900028714,22929.828399995928,22903.275899995504,22550.664999995737,3710131.0,8287.291300000168,8391.686400000079,8115.442700000228,9808.09020000072,9922.91480000216,10282.145699999646,16451.445999999753,16636.4394999997,16233.362299999704,828.0970000001757,813.2780000000457,759.2652000000132,3908.927100000125,3892.14260000016,3724.888500000157,435955.0,430757.0,,6417.880688002897,631242.0,624802.0,,16315.4560999998,154017.7236999906,154020.46769999008,153912.2666999872,77529.42359999628,77866.85340000657,78267.75750000644,20.5,6881395.410000007,2221350.615,657614161.6424997,226774962.3150001,10379494.124999998,19998.0,11.0,1513.0,-2242804.5,957832.5,-1198193.0,-1263670.5,-9.75,0.0,0.0,222750.0,0.0,0.0,0.0,0.0,0.0,-936.0,-265.0,-310.0,-315.0,25188072.70500005,355197238.785,399613842.0,6293383.785,355197238.785,24885.0,-1742925.0,393288670.0,21049552.0,87121020.0,41298046.0,87886071.0,24869.0,407.0,66.32290464482622,750867.0,214566.0,126967.0,-432650.0,285734.0,973.0,283509820.2374948,281355588.24749523,-18171005.5,-18048077.0,348848.5,13623.0,,,,,,,,,,,,,,,,,,,,,1465650.0,14715028.0,3228730.0,8544723.0,11593696.0,1413960.0,1056584578.3020012,801033914.542495,72022788384.02959,21652212717.49512,581630461.1594988,5792395.7475,689.5,94245.0,-276617179.0,21843196.5,-123655185.0,-218465091.5,-2012983.5,,,,,,,,,,,,,,,,,,,,,4267822.5,2476280.5,-8993532.5,921269.0,37582.5,3729116600.324964,3653667713.1824617,-260339730.5,-257032810.0,2523681.0,268892.5,3921720540.839955,33220005683.37841,36645582403.957634,1727713491.8400495,48032228596.47822,3983477.0,-247308119.5,102966600015.0,1052664997.0,17256727342.0,3499840528.0,18870008609.5,3667899.5,71832.0,20850.560376415066,89706040.0,-68.2514118385275,7.458666666666668,3.248686989008609,127.66004789959035,24.23087335535221,952.1737439337446,135000.0,-0.2225209339563143,0.9749279121818236,0.0,0.0,0.0,0.0,0.0,1.0,0.0,0.0,1.0,0.0,0.0,0.0,0.0,0.0,0.0,1.0,0.0,0.0,0.0,0.0,1.0,0.0,0.0,0.0,0.0,1.0,0.0,0.0,0.0,0.0,0.0,0.0,0.0,0.0,0.0,0.0,0.0,0.0,0.0,0.0,1.0,0.0,0.0,0.0,0.0,0.0,0.0,0.0,0.0,0.0,0.0,0.0,0.0,1.0,0.0,0.0,0.0,0.0,0.0,0.0,0.0,0.0,0.0,0.0,0.0,0.0,0.0,0.0,0.0,0.0,0.0,0.0,0.0,0.0,0.0,0.0,0.0,0.0,0.0,0.0,0.0,0.0,0.0,0.0,0.0,0.0,0.0,0.0,0.0,0.0,0.0,0.0,0.0,0.0,0.0,0.0,0.0,0.0,0.0,0.0,0.0,0.0,0.0,0.0,0.0,0.0,0.0,0.0,1.0,0.0,1.0,0.0,0.0,0.0,0.0,0.0,0.0,0.0,1.0,0.0
100416,0,0.0,0.0,1.0,0.0,0.0,157500.0,869049.0,31342.5,733500.0,0.010147,45.10136986301371,-2757.0,-4150.0,-9.0,6.0,2.0,2.0,2.0,10.0,0.41094781385101,0.6448227181476635,0.6986675550534175,,,,,,,,,,,,,,,,,,,,,,,,,,,,,,,,,,,,,,,,,,,,,0.0,0.0,0.0,0.0,-2358.0,0.0,0.0,0.0,0.0,1.0,3.0,1.0,1.0,0.0,1.0,0.0,0.0,0.0,0.0,0.0,0.0,0.0,0.0,0.0,1.0,0.0,0.0,0.0,0.0,0.0,0.0,0.0,0.0,0.0,0.0,0.0,0.0,0.0,0.0,0.0,0.0,0.0,0.0,1.0,0.0,,150858.0,0.0,0.0,0.0,0.0,0.0,-1302.0,-574.0,-569.0,-570.0,43.0,-21.0,13.0,14667.345,0.0,0.0,4266.0,270000.0,18.0,-349.0,365243.0,-993.0,-528.0,-165.5,-190.5,12.0,0.0,0.0497282622973789,-1.0,56.0,18.0,9.0,-20.5,0.0,0.0,168.0,7159.365,7159.365,-1311.0,-1311.0,32.5,0.0,91.0,0.0,90000.0,0.0,0.0,0.0,0.0,0.0,7159.365,0.0,0.0,0.0,0.0,0.0,0.0,0.0,0.0,31.0,-48.0,0.0,0.0,8337167113.5,184230274428.0,165434375997.0,51914879110.935,1862.0,1703.0,71123.0,70642.0,9140.0,505495.0,,,,,,,128256.0,662053.0,,,,13513027.969862612,-601235312.0,-920883813.0,-296142923.0,-1533496238.0416667,43956.0,30660.0,,,,,,,67364.78423792253,157865.79761797626,125970.00307738708,,,,,,,3710141.0,,,,,,,,,,,,,,,,435955.0,430757.0,1261593.0,6417.890835002897,631244.0,624804.0,,,,,,,,,43.0,6944303.160000007,,671885861.4899997,229813944.16500005,10470010.77,19998.0,11.0,1513.0,-2281341.0,976732.0,-1219051.0,-1285317.0,-21.0,0.0,,150858.0,0.0,0.0,0.0,0.0,0.0,-1302.0,-574.0,-569.0,-570.0,25690633.875000045,363648854.925,408819856.14,6432865.785,363648854.925,25414.0,-1804280.0,401865549.5,21020019.0,88562231.0,42743429.0,90060307.0,25694.0,412.0,68.07390752137833,767589.0,218506.0,129230.0,-441665.0,285896.5,979.0,290153825.12249583,287764495.80749625,-18836268.5,-18708068.5,363805.0,13868.0,289492923.4650005,768235500.0,23635752.75,31487510.42999999,497551.5,7336084.410000003,16855986.64500001,34743841.29000013,31900437.85500001,277692149.83499986,288629391.7800006,288643022.19000065,1360.0,2899.0,14.0,1525.0,110513.5,-188226.0,88918.0,207.0,1465651.0,14715071.0,3228821.0,8544779.0,11593864.0,1413973.0,1056584578.3020012,,72022939242.02959,21652212717.49512,581630461.1594988,5792395.7475,689.5,94245.0,-276618481.0,21842622.5,-123655754.0,-218465661.5,-2013004.5,5914903788.8774605,18696215250.0,198605420.325,447347873.0024977,1948107.735,256448094.2775008,308729357.00999874,635575070.1599983,458429609.0924992,5700358550.880029,5878255455.562497,5878498638.307498,13364.0,80722.5,44.0,70251.5,970518.0,-1696475.5,177364.0,6755.0,4267840.5,2476289.5,-8993553.0,921269.0,37582.5,3729123759.689964,3653674872.5474615,-260341041.5,-257034121.0,2523713.5,268892.5,3921735208.184954,33220005683.37841,36645582403.957634,1727717757.8400495,48032498596.47822,3983495.0,-247308468.5,102966965258.0,1052664004.0,17256726814.0,3499840362.5,18870008419.0,3667911.5,71832.0,20850.61010467736,89706039.0,-61.128963673915685,5.51777142857143,5.025125628140704,226.6400495628829,27.727494615936827,1250.547990048088,78750.0,-0.9009688679024191,-0.433883739117558,0.0,1.0,0.0,0.0,0.0,0.0,0.0,0.0,1.0,0.0,0.0,0.0,0.0,0.0,0.0,1.0,0.0,0.0,0.0,0.0,1.0,0.0,0.0,0.0,0.0,1.0,0.0,0.0,0.0,0.0,0.0,0.0,0.0,0.0,0.0,0.0,0.0,0.0,0.0,0.0,0.0,0.0,0.0,0.0,1.0,0.0,0.0,0.0,0.0,0.0,0.0,0.0,0.0,0.0,0.0,0.0,0.0,0.0,0.0,0.0,0.0,0.0,0.0,0.0,0.0,0.0,0.0,0.0,0.0,0.0,0.0,0.0,0.0,0.0,0.0,0.0,0.0,0.0,0.0,0.0,0.0,0.0,0.0,0.0,0.0,0.0,0.0,0.0,0.0,0.0,1.0,0.0,0.0,0.0,0.0,0.0,0.0,0.0,0.0,0.0,0.0,0.0,0.0,0.0,0.0,0.0,0.0,0.0,0.0,0.0,0.0,0.0,0.0,0.0,0.0,0.0,0.0,0.0,0.0,0.0
100422,0,0.0,1.0,0.0,0.0,3.0,180000.0,315000.0,16213.5,315000.0,0.025164,50.11506849315069,-1203.0,-4513.0,-1807.0,,5.0,2.0,2.0,18.0,,0.5166751955415115,0.5797274227921155,,,,,,,,,,,,,,,,,,,,,,,,,,,,,,,,,,,,,,,,,,,,,0.0,0.0,0.0,0.0,-337.0,0.0,0.0,0.0,0.0,1.0,3.0,1.0,1.0,1.0,1.0,0.0,0.0,0.0,0.0,0.0,0.0,1.0,1.0,0.0,1.0,0.0,0.0,0.0,0.0,0.0,0.0,0.0,0.0,0.0,0.0,0.0,0.0,0.0,0.0,0.0,0.0,0.0,0.0,8.0,0.0,0.0,93915.0,0.0,0.0,0.0,0.0,0.0,-1069.0,-693.5,-684.5,-799.0,269.0,-18.0,7.0,12243.465,36252.0,39442.5,0.0,132151.5,10.0,-337.0,365243.0,-817.0,-551.0,-551.0,-549.0,12.0,0.0,0.0,10.0,42.0,12.0,6.0,-27.5,0.0,0.0,66.0,5606.82,5606.82,-596.0,-596.0,8.0,1.0,11.0,0.0,270000.0,0.0,0.0,0.0,0.0,225.0,45076.5,45076.5,0.0,0.0,0.0,0.0,0.0,0.0,0.0,2.0,-6.0,0.0,0.0,8337183327.0,184230589428.0,165434690997.0,51915059110.935,1862.0,1703.0,71123.0,70643.0,9140.0,505498.0,,,,,,,128259.0,662058.0,,,,13513078.084931104,-601236515.0,-920885620.0,-296143260.0,-1533500751.0416667,43956.0,30660.0,,,,,,,,157866.31429317174,125970.58280480983,,,,,,,3710159.0,,,,,,,,,,,,,,,,435955.0,430757.0,,6417.915999002897,631246.0,624806.0,,,,,,,,,36.0,6985757.160000007,2266386.660000001,677806720.2899997,230682328.7850001,10470413.565,19998.0,11.0,1513.0,-2313514.5,959302.0,-1235360.5,-1305669.0,-17.5,0.0,0.0,90000.0,0.0,0.0,0.0,0.0,0.0,-1233.0,-800.0,-1051.0,-1051.0,25845403.185000043,365220205.8299999,410642581.14,6452504.19,365243052.3299999,25595.0,-1826765.0,406793156.0,20999843.0,89280728.0,43462001.0,90778880.0,25986.0,414.0,68.66078268336135,769756.0,220795.0,130362.5,-447194.5,286673.0,1096.0,293116872.7574964,290565620.93249667,-19212051.5,-19081982.5,374240.0,14117.5,297570524.85000026,785506500.0,24104652.75,32223437.00999999,497551.5,7603110.990000002,17329797.495000012,35971878.73500021,32879828.565000016,285397231.2749998,296642537.32500046,296656167.73500043,1409.0,2959.0,14.0,1536.0,114755.0,-194590.0,88948.0,230.0,1465659.0,14715340.0,3228832.0,8544821.0,11593930.0,1413980.0,1056584578.3020012,801033914.542495,72023033157.02959,21652212717.49512,581630461.1594988,5792395.7475,689.5,94245.0,-276619550.0,21841929.0,-123656438.5,-218466460.5,-2013022.5,5914903788.8774605,18696485250.0,198605420.325,447347873.0024977,1948107.735,256448094.2775008,308729582.00999874,635620146.6599983,458474685.5924992,5700358550.880029,5878255455.562497,5878498638.307498,13364.0,80722.5,44.0,70251.5,970520.0,-1696481.5,177364.0,6755.0,4267852.5,2476295.5,-8993580.5,921269.0,37582.5,3729129366.509964,3653680479.3674617,-260341637.5,-257034717.0,2523721.5,268893.5,3921747451.649955,33220041935.37841,36645621846.457634,1727717757.8400495,48032630747.97822,3983505.0,-247308805.5,102967330501.0,1052663187.0,17256726263.0,3499839811.5,18870007870.0,3667923.5,71832.0,20850.61010467736,89706049.0,-24.00475617756396,1.75,11.101859561476548,556.370452324737,19.42825423258396,973.6482915682898,36000.0,-0.2225209339563146,-0.9749279121818236,0.0,0.0,0.0,0.0,0.0,0.0,1.0,0.0,0.0,0.0,0.0,0.0,0.0,1.0,0.0,0.0,0.0,0.0,1.0,0.0,1.0,0.0,0.0,0.0,0.0,1.0,0.0,0.0,0.0,0.0,0.0,0.0,0.0,0.0,0.0,0.0,0.0,0.0,1.0,0.0,0.0,0.0,0.0,0.0,0.0,0.0,0.0,0.0,0.0,0.0,0.0,0.0,0.0,0.0,0.0,1.0,0.0,0.0,0.0,0.0,0.0,0.0,0.0,0.0,0.0,0.0,0.0,0.0,0.0,0.0,0.0,0.0,0.0,0.0,0.0,0.0,0.0,0.0,0.0,0.0,0.0,0.0,0.0,0.0,0.0,0.0,0.0,0.0,0.0,0.0,0.0,0.0,0.0,0.0,0.0,0.0,0.0,0.0,0.0,0.0,0.0,0.0,0.0,0.0,0.0,0.0,0.0,0.0,0.0,0.0,0.0,0.0,0.0,0.0,0.0,0.0,0.0,0.0,0.0,0.0
100426,0,0.0,0.0,1.0,1.0,0.0,157500.0,1125000.0,65313.0,1125000.0,0.028663,40.824657534246576,-6438.0,-3513.0,-4258.0,8.0,2.0,2.0,2.0,13.0,0.5193296128757853,0.5684200435668831,0.4066174366275036,,,,,,,,,,,,,,,,,,,,,,,,,,,,,,,,,,,,,,,,,,,,,0.0,0.0,0.0,0.0,-1364.0,0.0,0.0,0.0,0.0,1.0,2.0,1.0,1.0,0.0,1.0,0.0,1.0,0.0,0.0,0.0,0.0,0.0,0.0,0.0,1.0,0.0,0.0,0.0,0.0,0.0,0.0,0.0,0.0,0.0,0.0,0.0,0.0,0.0,0.0,0.0,0.0,0.0,0.0,16.0,0.0,0.0,171000.0,0.0,0.0,0.0,0.0,0.0,-775.5,8.0,-38.5,-788.0,439.0,-16.0,7.0,14584.05,135000.0,182956.5,0.0,135000.0,12.0,-2093.0,365243.0,-2440.0,-2150.0,-2150.0,-2143.0,11.0,1.0,0.0,-1.0,68.0,12.0,6.0,-41.5,0.0,0.0,187.0,6750.0,6750.0,-1720.0,-1720.0,42.0,0.0,96.0,0.0,135000.0,0.0,0.0,0.0,0.0,0.0,2618.73,0.0,0.0,0.0,0.0,0.0,0.0,0.0,0.0,29.0,-48.5,0.0,0.0,8337248640.0,184231714428.0,165435815997.0,51915216610.935,1862.0,1703.0,71123.0,70644.0,9140.0,505500.0,,,,,,,128259.0,662060.0,,,,13513118.90958864,-601242953.0,-920889878.0,-296144624.0,-1533504264.0416667,43956.0,30660.0,,,,,,,67365.3035675354,157866.88271321534,125970.98942224652,,,,,,,3710172.0,,,,,,,,,,,,,,,,435955.0,430757.0,1261601.0,6417.944662002897,631248.0,624808.0,,,,,,,,,26.0,7181626.050000005,2290921.515000001,684527271.8849999,233926001.01000005,10560413.565,19998.0,11.0,1513.0,-2338801.5,1089668.0,-1245603.0,-1320718.0,-12.5,0.0,0.0,238500.0,0.0,0.0,0.0,0.0,0.0,-1041.0,-42.0,-412.0,-788.0,26130809.025000043,369211103.72999984,415089328.14,6464875.590000002,369211103.72999984,25901.0,-1846674.0,411175735.0,20985387.0,89999727.0,43819096.0,91497983.0,26259.0,422.0,68.85721076189239,782413.0,223145.0,131798.5,-451541.5,286680.0,1098.0,296665457.4449976,294728025.194998,-19433598.0,-19302404.0,382562.0,14229.0,298148422.54500026,792976500.0,24293652.75,32633378.00999999,497551.5,7824051.990000002,17398813.05000001,36608032.53000009,33413386.905000016,285948004.4549998,297210714.97500044,297224345.3850004,1416.0,2970.0,14.0,1540.0,116029.5,-196827.0,88948.0,230.0,1465675.0,14715779.0,3228928.0,8544889.0,11594117.0,1413987.0,1056584578.3020012,801033914.542495,72023204157.02959,21652212717.49512,581630461.1594988,5792395.7475,689.5,94245.0,-276620325.5,21841937.0,-123656477.0,-218467248.5,-2013038.5,5914903788.8774605,18696620250.0,198605420.325,447347873.0024977,1948107.735,256448094.2775008,308729582.00999874,635622765.3899982,458474685.5924992,5700358550.880029,5878255455.562497,5878498638.307498,13364.0,80722.5,44.0,70251.5,970549.0,-1696530.0,177364.0,6755.0,4267864.5,2476301.5,-8993622.0,921269.0,37582.5,3729136116.509964,3653687229.3674617,-260343357.5,-257036437.0,2523763.5,268893.5,3921762035.6999545,33220176935.37841,36645804802.957634,1727717757.8400495,48032765747.97822,3983517.0,-247310898.5,102967695744.0,1052660747.0,17256724113.0,3499837661.5,18870005727.0,3667934.5,71833.0,20850.61010467736,89706048.0,-157.6988121602577,7.142857142857142,2.411464792614028,98.44722431436062,17.224748518671632,703.1944593882903,78750.0,1.0,0.0,0.0,0.0,0.0,0.0,0.0,0.0,1.0,0.0,0.0,0.0,0.0,0.0,0.0,1.0,0.0,0.0,0.0,0.0,1.0,0.0,1.0,0.0,0.0,0.0,0.0,1.0,0.0,0.0,0.0,0.0,0.0,0.0,0.0,1.0,0.0,0.0,0.0,0.0,0.0,0.0,0.0,0.0,0.0,0.0,0.0,0.0,0.0,0.0,0.0,0.0,0.0,0.0,0.0,0.0,0.0,0.0,0.0,0.0,0.0,0.0,0.0,0.0,0.0,0.0,0.0,0.0,0.0,0.0,0.0,0.0,0.0,0.0,0.0,0.0,0.0,0.0,1.0,0.0,0.0,0.0,0.0,0.0,0.0,0.0,0.0,0.0,0.0,0.0,0.0,0.0,0.0,0.0,0.0,0.0,0.0,0.0,0.0,0.0,0.0,0.0,0.0,0.0,0.0,0.0,0.0,0.0,0.0,0.0,0.0,0.0,0.0,0.0,0.0,0.0,0.0,0.0,0.0,0.0,0.0,0.0
100438,0,0.0,0.0,0.0,1.0,1.0,144000.0,450000.0,23107.5,450000.0,0.030755,29.34520547945205,-1327.0,-14.0,-1272.0,,3.0,2.0,2.0,9.0,0.5254474461150329,0.6640709169996869,0.5602843280409464,0.0825,0.0855,0.9771,0.6872,0.0079,0.0,0.1379,0.1667,0.2083,0.0301,0.0672,0.0636,0.0,0.0,0.084,0.0887,0.9772,0.6994,0.008,0.0,0.1379,0.1667,0.2083,0.0308,0.0735,0.0663,0.0,0.0,0.0833,0.0855,0.9771,0.6914,0.008,0.0,0.1379,0.1667,0.2083,0.0306,0.0684,0.0647,0.0,0.0,0.05,1.0,2.0,1.0,2.0,0.0,-992.0,0.0,0.0,0.0,0.0,2.0,0.0,1.0,1.0,0.0,1.0,1.0,0.0,0.0,0.0,0.0,0.0,0.0,0.0,0.0,1.0,0.0,0.0,0.0,0.0,0.0,0.0,0.0,0.0,0.0,0.0,0.0,0.0,0.0,0.0,0.0,0.0,0.0,0.0,4.0,,0.0,33234.975,0.0,0.0,0.0,0.0,0.0,-579.5,-321.0,-343.0,-350.5,72.0,-9.0,3.0,6617.34,47272.5,47272.5,3309.75,47272.5,6.0,-70.0,365243.0,-500.5,182276.0,-290.5,182280.5,9.0,0.0,0.054465653337619,12.0,13.0,10.0,5.0,-26.0,0.0,0.0,12.0,6617.34,6617.34,-806.0,-796.0,4.5,1.0,0.0,,,,,,,,,,,,,,,,,,,,,8337271747.5,184232164428.0,165436265997.0,51915360610.935,1862.0,1703.0,71123.0,70646.0,9140.0,505500.0,17789.3274000023,17851.362999999117,17303.23529999809,11283.766000000083,11221.59390000009,11169.078000000058,128260.0,662063.0,4134.527000000122,4132.157700000017,3942.9799000000953,13513148.25479412,-601244280.0,-920891150.0,-296145616.0,-1533504278.0416667,43957.0,30660.0,11339.053199999173,11214.959999998964,10699.585399997302,22863.68150000961,22785.54780000957,22171.657400008124,67365.82901498151,157867.54678413234,125971.54970657451,34963.67790002787,34904.09450002831,34350.757600028715,22930.03669999593,22903.484199995502,22550.873299995736,3710181.0,8287.321400000168,8391.717000000079,8115.473500000228,9808.15740000072,9922.98320000216,10282.219199999648,16451.509599999754,16636.504199999694,16233.428599999705,828.0970000001757,813.2780000000457,759.2652000000132,3908.927100000125,3892.14260000016,3724.888500000157,435957.0,430759.0,,6417.975417002896,631250.0,624810.0,,16315.5060999998,154018.70079999062,154021.44479999007,153913.2438999872,77530.11079999628,77867.54480000657,78268.45690000644,20.0,,2332302.5250000004,703295687.8349997,240109036.5600001,10560413.565,19998.0,11.0,1513.0,-2445131.5,1193137.5,-1299100.0,-1378303.5,-9.5,,0.0,33295.5,0.0,0.0,0.0,0.0,0.0,-700.0,-517.0,-505.0,-517.0,26781440.62500005,380513911.4099999,428167680.57,6542649.090000002,380513911.4099999,26547.0,-1899003.0,422680406.5,21313360.5,92162151.5,44522451.5,93660577.0,27163.0,434.0,70.34953460293784,789155.0,227666.0,134374.0,-464119.0,286818.0,1125.0,302779435.81499785,300667068.4049989,-20043469.0,-19908885.5,390682.0,14632.5,,,,,,,,,,,,,,,,,,,,,1465679.0,14715851.0,3228928.0,8544902.0,11594129.0,1413990.0,,801033914.542495,72023237392.0046,21652212717.49512,581630461.1594988,5792395.7475,689.5,94245.0,-276620905.0,21841616.0,-123656820.0,-218467599.0,-2013047.5,,,,,,,,,,,,,,,,,,,,,4267874.5,2476306.5,-8993648.0,921269.0,37582.5,3729142733.849964,3653693846.707462,-260344163.5,-257037233.0,2523768.0,268894.5,3921768653.039954,33220224207.87841,36645852075.457634,1727721067.5900495,48032813020.47822,3983523.0,-247310968.5,102968060987.0,1052660246.5,17256906389.0,3499837371.0,18870188007.5,3667943.5,71833.0,20850.6645703307,89706060.0,-45.22033423583232,3.125,6.2317429406037,182.8717770871404,19.474196689386567,571.4743033973136,48000.0,-0.2225209339563143,0.9749279121818236,0.0,1.0,0.0,0.0,0.0,0.0,0.0,0.0,0.0,0.0,0.0,0.0,0.0,1.0,0.0,1.0,0.0,0.0,0.0,0.0,1.0,0.0,0.0,0.0,0.0,1.0,0.0,0.0,0.0,0.0,0.0,0.0,0.0,0.0,0.0,0.0,0.0,0.0,0.0,0.0,0.0,0.0,0.0,0.0,1.0,0.0,0.0,0.0,0.0,0.0,0.0,0.0,0.0,0.0,0.0,0.0,0.0,0.0,0.0,0.0,0.0,0.0,0.0,0.0,0.0,0.0,0.0,0.0,0.0,0.0,0.0,0.0,0.0,0.0,0.0,0.0,0.0,0.0,0.0,0.0,0.0,0.0,0.0,0.0,0.0,0.0,0.0,0.0,0.0,0.0,1.0,0.0,0.0,0.0,0.0,0.0,0.0,0.0,0.0,0.0,0.0,0.0,0.0,0.0,0.0,0.0,0.0,0.0,0.0,0.0,1.0,0.0,0.0,0.0,0.0,0.0,0.0,0.0,1.0,0.0
100444,0,0.0,1.0,0.0,0.0,1.0,202500.0,300735.0,16443.0,243000.0,0.016612,26.66027397260273,,-5251.0,-2314.0,,3.0,2.0,2.0,11.0,,0.2655718399366447,0.5388627065779676,,,,,,,,,,,,,,,,,,,,,,,,,,,,,,,,,,,,,,,,,,,,,1.0,1.0,1.0,1.0,-975.0,0.0,0.0,0.0,1.0,0.0,3.0,1.0,0.0,0.0,1.0,0.0,1.0,0.0,0.0,0.0,1.0,0.0,0.0,0.0,1.0,0.0,0.0,0.0,0.0,0.0,0.0,0.0,0.0,0.0,0.0,0.0,0.0,0.0,0.0,0.0,0.0,0.0,0.0,1.0,25002.0,,900000.0,563260.5,0.0,0.0,0.0,0.0,-680.0,765.0,-55.0,,22.0,-11.5,2.0,19970.7975,344020.5,346893.75,0.0,344020.5,30.0,-1486.5,365243.0,-1456.0,-1156.0,-586.0,-1150.0,14.0,0.0,0.0,1249.5,24.0,12.0,10.5,-54.5,0.0,0.0,22.0,7117.0875,7117.0875,-1653.0,-1652.0,6.0,1.0,0.0,,,,,,,,,,,,,,,,,,,,,8337288190.5,184232465163.0,165436508997.0,51915563110.935,1862.0,1703.0,71124.0,70646.0,9140.0,505503.0,,,,,,,128261.0,662066.0,,,,13513174.915068092,,-920893464.0,-296146591.0,-1533509529.0416667,43958.0,30661.0,,,,,,,,157867.81235597227,125972.08856928111,,,,,,,3710192.0,,,,,,,,,,,,,,,,435958.0,430760.0,,6417.992029002897,631252.0,624812.0,,,,,,,,,22.0,7805189.385000005,,706626189.4949998,241118152.5600001,10617867.54,19998.0,11.0,1513.0,-2465552.0,1184370.0,-1309125.0,,-11.5,25002.0,,900000.0,563260.5,0.0,0.0,0.0,0.0,-680.0,765.0,-55.0,,27122967.09000005,384871576.4099999,432885876.57,6616122.840000002,384871576.4099999,26987.0,-1916266.5,429254634.5,21664706.5,94345637.5,45248453.5,95844114.5,27535.0,442.0,70.92643290034411,792990.5,232564.0,137433.0,-468634.0,286867.0,1127.0,306854287.85249674,304528622.2424983,-20174113.0,-20036467.5,392947.0,14865.5,,,,,,,,,,,,,,,,,,,,,1465680.0,14715873.0,3228928.0,8544926.0,11594151.0,1413992.0,1056609580.3020012,,72024137392.0046,21652775977.99512,581630461.1594988,5792395.7475,689.5,94245.0,-276621585.0,21842381.0,-123656875.0,,-2013059.0,,,,,,,,,,,,,,,,,,,,,4267886.5,2476317.0,-8993702.5,921269.0,37582.5,3729149850.937464,3653700963.794962,-260345816.5,-257038885.0,2523774.0,268895.5,3921788623.837455,33220568228.37841,36646198969.207634,1727721067.5900495,48033157040.97822,3983553.0,-247312455.0,102968426230.0,1052658790.5,17256905233.0,3499836785.0,18870186857.5,3667957.5,71833.0,20850.6645703307,89707309.5,,1.4851111111111108,12.31527093596059,328.3284971995411,18.28954570333881,487.6042992854518,67500.0,-0.2225209339563146,-0.9749279121818236,0.0,0.0,0.0,0.0,0.0,0.0,1.0,0.0,0.0,1.0,0.0,0.0,0.0,0.0,0.0,0.0,0.0,0.0,1.0,0.0,1.0,0.0,0.0,0.0,0.0,1.0,0.0,0.0,0.0,0.0,0.0,0.0,0.0,0.0,0.0,0.0,0.0,0.0,0.0,0.0,0.0,0.0,0.0,0.0,0.0,0.0,0.0,0.0,0.0,0.0,0.0,0.0,0.0,0.0,0.0,0.0,0.0,0.0,0.0,0.0,0.0,0.0,0.0,0.0,0.0,0.0,0.0,0.0,0.0,0.0,0.0,0.0,0.0,0.0,0.0,0.0,0.0,0.0,0.0,0.0,0.0,0.0,0.0,0.0,0.0,0.0,0.0,0.0,0.0,0.0,0.0,0.0,0.0,0.0,0.0,0.0,0.0,0.0,0.0,0.0,0.0,0.0,0.0,0.0,0.0,1.0,0.0,0.0,0.0,0.0,0.0,0.0,0.0,0.0,0.0,0.0,0.0,0.0,0.0,0.0
100445,0,0.0,1.0,0.0,0.0,0.0,135000.0,278505.0,15237.0,211500.0,0.018801,36.13150684931506,-126.0,-7143.0,-1257.0,,1.0,2.0,2.0,15.0,0.1834083288062964,0.504134762347502,,0.1237,0.0915,0.9856,0.8028,0.0571,0.16,0.1379,0.375,0.4167,0.0316,0.1009,0.154,0.0,0.0,0.1261,0.0949,0.9856,0.8105,0.0577,0.1611,0.1379,0.375,0.4167,0.0323,0.1102,0.1605,0.0,0.0,0.1249,0.0915,0.9856,0.8054,0.0575,0.16,0.1379,0.375,0.4167,0.0322,0.1026,0.1568,0.0,0.0,0.1524,1.0,0.0,0.0,0.0,0.0,-1789.0,,,,,,,1.0,1.0,0.0,1.0,0.0,0.0,0.0,0.0,0.0,0.0,0.0,0.0,0.0,1.0,0.0,0.0,0.0,0.0,0.0,0.0,0.0,0.0,0.0,0.0,0.0,0.0,0.0,0.0,0.0,0.0,0.0,0.0,0.0,,,,,,,,,,,,,0.0,,8.0,20471.0175,18405.0,19377.0,5400.0,141660.0,6.0,-455.0,365243.0,-1266.0,-1026.0,-1026.0,-1019.0,9.0,0.0,0.1057718360420782,-1.0,28.0,6.0,4.0,-53.5,0.0,0.0,56.0,9382.2525,8703.0,-378.0,-375.5,7.5,0.0,15.0,128547.585,585000.0,0.0,0.0,0.0,0.0,6529.905,20159.1,9000.0,126355.5,128547.585,128547.585,0.0,0.0,0.0,0.0,6.0,-8.0,0.0,0.0,8337303427.5,184232743668.0,165436720497.0,51915698110.935,,,,,,,17789.4511000023,17851.487899999116,17303.36139999809,11283.857500000086,11221.685400000091,11169.172900000058,128261.0,662067.0,4134.584100000122,4132.215200000017,3943.037600000095,13513211.04657494,-601244406.0,-920894721.0,-296148380.0,-1533516672.0416667,43958.0,30661.0,11339.213199999173,11215.119999998964,10699.746499997302,22863.81940000961,22785.68570000957,22171.795300008125,67366.01242331033,157868.3164907346,,34964.05290002787,34904.46950002831,34351.132600028715,22930.453399995928,22903.900899995504,22551.289999995737,3710207.0,8287.353000000168,8391.74920000008,8115.505800000228,9808.25830000072,9923.08580000216,10282.329399999646,16451.663599999752,16636.660999999698,16233.589099999705,828.0970000001757,813.2780000000457,759.2652000000132,3908.927100000125,3892.14260000016,3724.888500000157,435958.0,430760.0,,6418.010830002897,631254.0,624814.0,,16315.6584999998,154019.6863999906,154022.4303999901,153914.2294999872,77530.91359999627,77868.35020000658,78269.26740000643,,,,,,,,,,,,,,,,,,,,,,,,,,,27174347.91000005,385281706.4099999,433300637.07,6624897.840000002,385574206.4099999,27023.0,-1921503.5,430167536.0,21660339.0,94525192.5,45428578.5,96023692.5,27585.0,442.0,71.08645313791493,793035.5,233147.0,137916.0,-469826.5,286882.0,1142.0,308010500.9774965,305664483.5774982,-20211262.0,-20073375.0,393277.5,14891.0,300754153.9800003,807255000.0,24726102.75,33603296.17499999,785038.5,8073806.490000002,17566108.740000013,37648227.68999998,34345854.585000016,288446163.1199997,299780050.81500006,299793681.225,1430.0,2993.0,17.0,1546.0,118733.0,-204240.0,88948.0,230.0,1465680.0,14715873.0,3228943.0,8544954.0,11594207.0,1414000.0,,,,,,,,,,,,,,5915032336.4624605,18697205250.0,198605420.325,447347873.0024977,1948107.735,256448094.2775008,308736111.9149987,635642924.4899982,458483685.5924992,5700484906.380029,5878384003.147497,5878627185.892498,13364.0,80722.5,44.0,70251.5,970555.0,-1696538.0,177364.0,6755.0,4267892.5,2476321.0,-8993756.0,921269.0,37582.5,3729159233.189964,3653709666.794962,-260346194.5,-257039260.5,2523781.5,268895.5,3921809094.8549542,33220586633.37841,36646218346.207634,1727726467.5900495,48033298700.97822,3983559.0,-247312910.0,102968791473.0,1052657524.5,17256904207.0,3499835759.0,18870185838.5,3667966.5,71833.0,20850.770342166743,89707308.5,-3.487261146496816,2.063,8.860011813349084,320.1255775190348,18.27820437093916,660.4190664217689,135000.0,-0.9009688679024191,0.4338837391175582,0.0,0.0,0.0,0.0,0.0,0.0,1.0,0.0,0.0,0.0,0.0,0.0,0.0,1.0,0.0,0.0,0.0,0.0,1.0,0.0,0.0,0.0,1.0,0.0,0.0,0.0,0.0,0.0,0.0,1.0,0.0,0.0,0.0,0.0,0.0,0.0,0.0,0.0,1.0,0.0,0.0,0.0,0.0,0.0,0.0,0.0,0.0,0.0,0.0,0.0,0.0,0.0,0.0,0.0,0.0,0.0,0.0,0.0,0.0,0.0,0.0,0.0,0.0,0.0,0.0,0.0,0.0,0.0,0.0,0.0,0.0,0.0,0.0,0.0,0.0,0.0,0.0,0.0,0.0,0.0,0.0,1.0,0.0,0.0,0.0,0.0,0.0,0.0,0.0,0.0,0.0,0.0,0.0,0.0,0.0,0.0,0.0,0.0,0.0,0.0,0.0,0.0,0.0,0.0,0.0,0.0,0.0,0.0,0.0,1.0,1.0,0.0,0.0,0.0,0.0,0.0,0.0,1.0,0.0,0.0
100446,0,0.0,1.0,1.0,0.0,0.0,157500.0,594121.5,30465.0,472500.0,0.019101,27.43835616438357,-1283.0,-4322.0,-2694.0,3.0,1.0,2.0,2.0,9.0,0.3426723877288315,0.0857030029138577,0.5638350489514956,,,,,,,,,,,,,,,,,,,,,,,,,,,,,,,,,,,,,,,,,,,,,7.0,0.0,7.0,0.0,-456.0,0.0,0.0,0.0,0.0,1.0,0.0,1.0,1.0,0.0,1.0,0.0,0.0,0.0,0.0,0.0,0.0,1.0,1.0,0.0,1.0,0.0,0.0,0.0,0.0,0.0,0.0,0.0,0.0,0.0,0.0,0.0,0.0,0.0,0.0,0.0,0.0,0.0,0.0,4.0,1980.0,0.0,74542.76999999999,0.0,0.0,0.0,0.0,0.0,-1317.5,-907.0,-721.0,-1223.0,138.0,-21.0,1.0,7252.155,77764.5,77764.5,0.0,77764.5,12.0,-456.0,365243.0,-426.0,-156.0,-96.0,-151.0,19.0,0.0,0.0,900.0,11.0,12.0,7.0,-10.0,0.0,0.0,11.0,7252.155,7252.155,-287.0,-276.0,6.0,1.0,0.0,,,,,,,,,,,,,,,,,,,,,8337333892.5,184233337789.5,165437192997.0,51915855610.935,1862.0,1703.0,71124.0,70647.0,9140.0,505503.0,,,,,,,128261.0,662068.0,,,,13513238.484931106,-601245689.0,-920897415.0,-296148836.0,-1533520994.0416667,43958.0,30661.0,,,,,,,67366.35509569806,157868.4021937375,125972.65240433006,,,,,,,3710216.0,,,,,,,,,,,,,,,,435965.0,430767.0,1261604.0,6418.029931002897,631256.0,624816.0,,,,,,,,,43.5,7807169.385000005,2332302.5250000004,706798066.9949998,241135945.5600001,10617867.54,19998.0,11.0,1513.0,-2467728.0,1182897.0,-1310360.5,-1389032.0,-21.75,0.0,0.0,74543.04,0.0,0.0,0.0,0.0,0.0,-1339.0,-1248.0,-967.0,-1223.0,27224727.88500005,386169470.9099999,434234702.07,6626922.840000002,386169470.9099999,27047.0,-1923910.0,430897816.0,21658941.0,94706528.0,45609974.0,96205046.0,27644.0,443.0,71.13797657242826,793935.0,233376.0,138034.0,-470189.0,286882.0,1142.0,308751805.88999647,306423527.48999816,-20223926.0,-20085748.0,393629.0,14914.0,,,,,,,,,,,,,,,,,,,,,1465684.0,14716011.0,3228943.0,8544965.0,11594218.0,1414001.0,1056611560.3020012,801033914.542495,72024211934.7746,21652775977.99512,581630461.1594988,5792395.7475,689.5,94245.0,-276622902.5,21841474.0,-123657596.0,-218468822.0,-2013080.0,,,,,,,,,,,,,,,,,,,,,4267904.5,2476328.0,-8993766.0,921269.0,37582.5,3729166485.344965,3653716918.9499617,-260346481.5,-257039536.5,2523787.5,268896.5,3921816347.0099545,33220664397.87841,36646296110.707634,1727726467.5900495,48033376465.47822,3983571.0,-247313366.0,102969156716.0,1052657098.5,17256904051.0,3499835663.0,18870185687.5,3667985.5,71833.0,20850.770342166743,89708208.5,-46.75936095856216,3.7722,5.1698670605613,141.8526537301957,19.501772525849336,535.0965804010442,157500.0,-0.9009688679024191,0.4338837391175582,0.0,0.0,0.0,0.0,0.0,0.0,1.0,0.0,0.0,0.0,1.0,0.0,0.0,0.0,0.0,1.0,0.0,0.0,0.0,0.0,0.0,0.0,1.0,0.0,0.0,1.0,0.0,0.0,0.0,0.0,0.0,0.0,0.0,1.0,0.0,0.0,0.0,0.0,0.0,0.0,0.0,0.0,0.0,0.0,0.0,0.0,0.0,0.0,0.0,0.0,0.0,0.0,0.0,0.0,0.0,0.0,0.0,0.0,0.0,0.0,0.0,0.0,0.0,0.0,0.0,0.0,0.0,0.0,0.0,0.0,0.0,0.0,0.0,0.0,0.0,0.0,0.0,0.0,0.0,1.0,0.0,0.0,0.0,0.0,0.0,0.0,0.0,0.0,0.0,0.0,0.0,0.0,0.0,0.0,0.0,0.0,0.0,0.0,0.0,0.0,0.0,0.0,0.0,0.0,0.0,0.0,0.0,0.0,0.0,0.0,0.0,0.0,0.0,0.0,0.0,0.0,0.0,0.0,0.0,0.0
100447,0,0.0,0.0,0.0,1.0,0.0,99000.0,130320.0,9873.0,112500.0,0.003069,59.057534246575344,,-4896.0,-5008.0,,2.0,3.0,3.0,10.0,,0.4877420933728962,0.6801388218428291,,,,,,,,,,,,,,,,,,,,,,,,,,,,,,,,,,,,,,,,,,,,,3.0,0.0,3.0,0.0,0.0,0.0,0.0,0.0,0.0,0.0,3.0,1.0,0.0,0.0,1.0,0.0,0.0,0.0,0.0,0.0,0.0,0.0,0.0,0.0,1.0,0.0,0.0,0.0,0.0,0.0,0.0,0.0,0.0,0.0,0.0,0.0,0.0,0.0,0.0,0.0,0.0,0.0,0.0,2.0,3037.5,0.0,135675.0,27434.25,0.0,0.0,0.0,0.0,-779.0,408.5,-146.0,-683.0,52.0,-14.5,3.0,32347.935,315000.0,332046.0,0.0,315000.0,18.0,-879.0,365243.0,-849.0,-699.0,-519.0,-691.0,12.0,1.0,0.0,-1.0,48.0,18.0,16.5,-24.5,0.0,0.0,47.0,42552.855,42552.855,-704.0,-699.0,9.0,1.0,0.0,,,,,,,,,,,,,,,,,,,,,8337343765.5,184233468109.5,165437305497.0,51915954610.935,1862.0,1703.0,71124.0,70647.0,9140.0,505506.0,,,,,,,128261.0,662070.0,,,,13513297.542465352,,-920902423.0,-296148836.0,-1533525890.0416667,43958.0,30661.0,,,,,,,,157868.88993583087,125973.33254315188,,,,,,,3710226.0,,,,,,,,,,,,,,,,435968.0,430770.0,,6418.033000002897,631259.0,624819.0,,,,,,,,,26.0,7812186.885000005,2332302.5250000004,707156785.0349997,241163379.8100001,10617867.54,19998.0,11.0,1513.0,-2471110.0,1182130.0,-1312127.0,-1390963.0,-12.5,0.0,0.0,162000.0,0.0,0.0,0.0,0.0,0.0,-1232.0,595.0,-270.0,-683.0,27277881.39000005,387664190.9099999,435890337.57,6626922.840000002,387664190.9099999,27125.0,-1925959.0,431628302.0,21656957.0,95070971.0,45610270.0,96569493.0,27667.0,444.0,71.13797657242826,868558.0,234801.0,139169.5,-470609.5,286882.0,1142.0,309784031.99999684,307455753.59999853,-20234294.0,-20095900.0,393951.0,14948.0,,,,,,,,,,,,,,,,,,,,,1465686.0,14716063.0,3228943.0,8545013.0,11594265.0,1414004.0,1056614597.8020012,801033914.542495,72024347609.7746,21652803412.24512,581630461.1594988,5792395.7475,689.5,94245.0,-276623681.5,21841882.5,-123657742.0,-218469505.0,-2013094.5,,,,,,,,,,,,,,,,,,,,,4267922.5,2476344.5,-8993790.5,921269.0,37582.5,3729209038.199965,3653759471.8049617,-260347185.5,-257040235.5,2523796.5,268897.5,3921848694.944955,33220979397.87841,36646628156.707634,1727726467.5900495,48033691465.47822,3983589.0,-247314245.0,102969521959.0,1052656249.5,17256903352.0,3499835144.0,18870184996.5,3667997.5,71834.0,20850.770342166743,89708207.5,,1.3163636363636364,10.027347310847766,592.1904072126971,13.199635369188696,779.5379178581686,49500.0,-0.9009688679024191,-0.433883739117558,0.0,0.0,0.0,0.0,0.0,0.0,1.0,0.0,0.0,1.0,0.0,0.0,0.0,0.0,0.0,1.0,0.0,0.0,0.0,0.0,1.0,0.0,0.0,0.0,0.0,1.0,0.0,0.0,0.0,0.0,0.0,0.0,0.0,0.0,0.0,0.0,0.0,0.0,0.0,0.0,0.0,0.0,0.0,0.0,0.0,0.0,0.0,0.0,0.0,0.0,0.0,0.0,0.0,0.0,0.0,0.0,0.0,0.0,0.0,0.0,0.0,0.0,0.0,0.0,0.0,0.0,0.0,0.0,0.0,0.0,0.0,0.0,0.0,0.0,0.0,0.0,0.0,0.0,0.0,0.0,0.0,0.0,0.0,0.0,0.0,0.0,0.0,0.0,0.0,0.0,0.0,0.0,0.0,0.0,0.0,0.0,0.0,0.0,0.0,0.0,0.0,0.0,0.0,0.0,0.0,1.0,0.0,0.0,0.0,0.0,0.0,0.0,0.0,0.0,0.0,0.0,0.0,0.0,0.0,0.0
100450,0,0.0,0.0,0.0,1.0,0.0,40500.0,90000.0,7110.0,90000.0,0.035792,63.0,,-10775.0,-3516.0,,2.0,2.0,2.0,10.0,,0.6964225111331641,0.3280631605201915,,,,,,,,,,,,,,,,,,,,,,,,,,,,,,,,,,,,,,,,,,,,,0.0,0.0,0.0,0.0,-575.0,0.0,0.0,0.0,0.0,0.0,2.0,1.0,0.0,0.0,1.0,0.0,0.0,0.0,0.0,0.0,0.0,0.0,0.0,0.0,1.0,0.0,0.0,0.0,0.0,0.0,0.0,0.0,0.0,0.0,0.0,0.0,0.0,0.0,0.0,0.0,0.0,0.0,0.0,9.0,4311.0,0.0,135000.0,39604.5,0.0,0.0,0.0,0.0,-974.0,706.0,-25.0,-1241.0,349.0,-21.0,2.0,7294.005,45000.0,53910.0,,90000.0,36.0,-362.5,365243.0,-545.0,-425.0,505.0,-417.0,10.0,1.0,,0.0,6.0,36.0,33.5,-16.5,0.0,0.0,6.0,7294.005,7294.005,-488.0,-470.0,3.5,1.0,0.0,,,,,,,,,,,,,,,,,,,,,8337350875.5,184233558109.5,165437395497.0,51915995110.935,1862.0,1703.0,71124.0,70647.0,9140.0,505508.0,,,,,,,128261.0,662072.0,,,,13513360.542465352,,-920905939.0,-296149411.0,-1533536665.0416667,43958.0,30661.0,,,,,,,,157869.586358342,125973.66060631242,,,,,,,3710236.0,,,,,,,,,,,,,,,,435968.0,430770.0,,6418.068792002897,631261.0,624821.0,,,,,,,,,33.0,7864823.385000005,2340186.120000001,710478614.2949997,243239029.5600001,10617867.54,19998.0,11.0,1513.0,-2482981.0,1187881.0,-1316390.0,-1396830.0,-16.0,0.0,0.0,135000.0,0.0,0.0,0.0,0.0,0.0,-1521.0,-927.0,-858.0,-1241.0,27349235.46000005,388425541.4099999,436705121.07,,388425541.4099999,27217.0,-1931626.0,433454517.0,21651517.0,95066791.0,45607440.0,96565342.0,27728.5,448.0,,868610.5,235906.5,139835.0,-472775.0,286882.0,1142.0,311008653.2024968,308572594.35749817,-20299454.0,-20160489.5,394414.5,15024.5,,,,,,,,,,,,,,,,,,,,,1465695.0,14716412.0,3228943.0,8545019.0,11594271.0,1414006.0,1056618908.8020012,801033914.542495,72024482609.7746,21652843016.74512,581630461.1594988,5792395.7475,689.5,94245.0,-276624655.5,21842588.5,-123657767.0,-218470746.0,-2013115.5,,,,,,,,,,,,,,,,,,,,,4267958.5,2476378.0,-8993807.0,921269.0,37582.5,3729216332.2049646,3653766765.809962,-260347673.5,-257040705.5,2523800.0,268898.5,3921855988.949957,33221024397.87841,36646682066.707634,,48033781465.47822,3983625.0,-247314607.5,102969887202.0,1052655704.5,17256902927.0,3499835649.0,18870184579.5,3668007.5,71835.0,,89708207.5,,2.2222222222222223,5.69620253164557,358.86075949367086,12.658227848101266,797.4683544303798,20250.0,-0.9009688679024191,0.4338837391175582,0.0,0.0,0.0,0.0,0.0,0.0,1.0,0.0,0.0,1.0,0.0,0.0,0.0,0.0,0.0,0.0,0.0,0.0,1.0,0.0,1.0,0.0,0.0,0.0,0.0,1.0,0.0,0.0,0.0,0.0,0.0,0.0,0.0,0.0,0.0,0.0,0.0,0.0,0.0,0.0,0.0,0.0,0.0,0.0,0.0,0.0,0.0,0.0,0.0,0.0,0.0,0.0,0.0,0.0,0.0,0.0,0.0,0.0,0.0,0.0,0.0,0.0,0.0,0.0,0.0,0.0,0.0,0.0,0.0,0.0,0.0,0.0,0.0,0.0,0.0,0.0,0.0,0.0,0.0,0.0,0.0,0.0,0.0,0.0,0.0,0.0,0.0,0.0,0.0,0.0,0.0,0.0,0.0,0.0,0.0,0.0,0.0,0.0,0.0,0.0,0.0,0.0,0.0,0.0,0.0,1.0,0.0,0.0,0.0,0.0,0.0,0.0,0.0,0.0,0.0,0.0,0.0,0.0,0.0,0.0
100466,0,0.0,0.0,0.0,1.0,0.0,175500.0,261801.0,18747.0,234000.0,0.035792,62.97534246575343,-2062.0,-8014.0,-4415.0,,2.0,2.0,2.0,17.0,0.8129680164245,0.6768346788470393,0.363945238612397,,,,,,,,,,,,,,,,,,,,,,,,,,,,,,,,,,,,,,,,,,,,,1.0,0.0,1.0,0.0,-2888.0,0.0,0.0,0.0,0.0,1.0,1.0,1.0,1.0,0.0,1.0,0.0,1.0,0.0,0.0,0.0,0.0,1.0,1.0,0.0,1.0,0.0,0.0,0.0,0.0,0.0,0.0,0.0,0.0,0.0,0.0,0.0,0.0,0.0,0.0,0.0,0.0,0.0,0.0,11.0,0.0,0.0,85846.5,0.0,0.0,0.0,0.0,0.0,-1432.0,-784.0,-784.0,-1059.0,483.0,-22.0,9.0,13861.44,192150.0,192150.0,4072.725,192150.0,24.0,-1076.0,365243.0,-1060.0,-370.0,-370.0,-365.0,14.0,1.0,0.1662226662226662,40.0,103.0,24.0,16.0,-23.0,0.0,0.0,99.0,19066.5,19066.5,-693.0,-686.0,8.0,1.0,0.0,,,,,,,,,,,,,,,,,,,,,8337369622.5,184233819910.5,165437629497.0,51916170610.935,1862.0,1703.0,71124.0,70648.0,9140.0,505509.0,,,,,,,128261.0,662074.0,,,,13513423.517807815,-601247751.0,-920910354.0,-296152299.0,-1533544679.0416667,43958.0,30661.0,,,,,,,67367.16806371449,157870.26319302086,125974.02455155106,,,,,,,3710253.0,,,,,,,,,,,,,,,,435969.0,430771.0,,6418.104584002896,631263.0,624823.0,,,,,,,,,48.0,8052301.395000005,2486957.5800000005,738547533.8549997,251385407.41500008,11132751.465,19998.0,15.0,1513.0,-2574703.0,1220382.0,-1349635.0,-1431897.0,-23.5,0.0,0.0,85846.5,0.0,0.0,0.0,0.0,0.0,-1564.0,-1064.0,-1058.0,-1063.0,28173747.64500004,401463581.985,452256478.92,6824626.065,401463581.985,28285.0,-1997370.0,447692433.0,22332779.0,99785762.0,47777764.0,101650568.0,28725.0,463.0,74.06582054743403,893983.0,248425.0,147554.0,-488242.0,286911.0,1161.0,321966902.20499706,319218809.53499854,-21073549.0,-20928218.0,413501.0,15570.0,,,,,,,,,,,,,,,,,,,,,1465706.0,14716895.0,3228943.0,8545122.0,11594370.0,1414015.0,1056618908.8020012,801033914.542495,72024568456.2746,21652843016.74512,581630461.1594988,5792395.7475,689.5,94245.0,-276626087.5,21841804.5,-123658551.0,-218471805.0,-2013137.5,,,,,,,,,,,,,,,,,,,,,4267982.5,2476394.0,-8993830.0,921269.0,37582.5,3729235398.7049646,3653785832.309962,-260348366.5,-257041391.5,2523808.0,268899.5,3921869850.389957,33221216547.87841,36646874216.707634,1727730540.3150494,48033973615.47822,3983649.0,-247315683.5,102970252445.0,1052654644.5,17256902557.0,3499835279.0,18870184214.5,3668021.5,71836.0,20850.93656483297,89708247.5,-32.74297398416427,1.4917435897435898,9.361497839654344,589.5435324446432,13.964954392702833,879.4477853990886,87750.0,1.0,0.0,0.0,0.0,1.0,0.0,0.0,0.0,0.0,0.0,0.0,0.0,0.0,0.0,0.0,1.0,0.0,0.0,0.0,0.0,1.0,0.0,1.0,0.0,0.0,0.0,0.0,1.0,0.0,0.0,0.0,0.0,0.0,0.0,0.0,0.0,0.0,0.0,0.0,0.0,0.0,0.0,1.0,0.0,0.0,0.0,0.0,0.0,0.0,0.0,0.0,0.0,0.0,0.0,0.0,0.0,0.0,0.0,0.0,0.0,0.0,0.0,0.0,0.0,0.0,0.0,0.0,0.0,0.0,0.0,0.0,0.0,0.0,0.0,0.0,0.0,0.0,0.0,0.0,0.0,0.0,0.0,0.0,0.0,0.0,0.0,0.0,0.0,0.0,1.0,0.0,0.0,0.0,0.0,0.0,0.0,0.0,0.0,0.0,0.0,0.0,0.0,0.0,0.0,0.0,0.0,0.0,0.0,0.0,0.0,0.0,0.0,0.0,0.0,0.0,0.0,0.0,0.0,0.0,0.0,0.0,0.0
100483,0,0.0,0.0,0.0,1.0,1.0,202500.0,675000.0,25578.0,675000.0,0.0060079999999999,42.07671232876712,-3235.0,-7912.0,-4830.0,,3.0,2.0,2.0,13.0,,0.7048113313247231,0.445396241560834,,,,,,,,,,,,,,,,,,,,,,,,,,,,,,,,,,,,,,,,,,,,,2.0,0.0,2.0,0.0,-480.0,0.0,0.0,0.0,0.0,0.0,2.0,1.0,1.0,0.0,1.0,0.0,0.0,0.0,0.0,0.0,0.0,1.0,1.0,0.0,1.0,0.0,0.0,0.0,0.0,0.0,0.0,0.0,0.0,0.0,0.0,0.0,0.0,0.0,0.0,0.0,0.0,0.0,0.0,9.0,8154.0,0.0,135000.0,0.0,0.0,0.0,0.0,0.0,-891.0,-229.5,-225.0,-467.0,346.0,-25.0,5.0,10278.945,90499.5,90499.5,0.0,110079.0,24.0,-228.0,365243.0,-389.5,-209.5,90.5,-206.0,14.0,0.5,0.0,-1.0,16.0,10.0,7.5,-10.5,0.0,0.0,14.0,10278.945,10278.945,-319.0,-299.5,4.0,1.0,0.0,,,,,,,,,,,,,,,,,,,,,8337395200.5,184234494910.5,165438304497.0,51916373110.935,1862.0,1703.0,71124.0,70648.0,9140.0,505511.0,,,,,,,128262.0,662077.0,,,,13513465.594520144,-601250986.0,-920915184.0,-296152779.0,-1533552591.0416667,43958.0,30661.0,,,,,,,,157870.96800435218,125974.4699477926,,,,,,,3710266.0,,,,,,,,,,,,,,,,435971.0,430773.0,,6418.110592002897,631265.0,624825.0,,,,,,,,,30.0,8545697.685000006,2539122.8400000003,762703820.8199997,261048516.88500008,11145717.36,38918.25,16.0,1577.0,-2642140.0,1346396.5,-1377481.0,-1466381.0,-14.5,7308.0,0.0,88672.5,0.0,0.0,0.0,0.0,0.0,-1833.0,-1694.0,-465.0,-1694.0,29199386.83500003,419893820.73,476009049.915,6963903.315,419893820.73,29345.0,-2056440.0,461752726.5,23019784.5,102674606.5,49212674.5,104539676.5,29755.0,476.0,76.2320236346925,916462.0,254858.0,151849.5,-501982.5,286913.0,1163.0,331368337.41749626,328444094.85749793,-21480785.0,-21330705.5,417873.5,15954.5,,,,,,,,,,,,,,,,,,,,,1465715.0,14717241.0,3228943.0,8545138.0,11594384.0,1414020.0,1056627062.8020012,801033914.542495,72024703456.2746,21652843016.74512,581630461.1594988,5792395.7475,689.5,94245.0,-276626978.5,21841575.0,-123658776.0,-218472272.0,-2013162.5,,,,,,,,,,,,,,,,,,,,,4267992.5,2476401.5,-8993840.5,921269.0,37582.5,3729245677.649965,3653796111.2549615,-260348685.5,-257041691.0,2523812.0,268900.5,3921880129.334956,33221307047.37841,36646964716.207634,1727730540.3150494,48034083694.47822,3983673.0,-247315911.5,102970617688.0,1052654255.0,17256902347.5,3499835369.5,18870184008.5,3668035.5,71836.5,20850.93656483297,89708246.5,-76.88338325302773,3.333333333333333,7.916959887403237,333.11964370065465,26.389866291344124,1110.3988123355152,67500.0,-0.2225209339563143,0.9749279121818236,0.0,0.0,0.0,0.0,0.0,0.0,1.0,0.0,1.0,0.0,0.0,0.0,0.0,0.0,0.0,1.0,0.0,0.0,0.0,0.0,1.0,0.0,0.0,0.0,0.0,1.0,0.0,0.0,0.0,0.0,0.0,0.0,0.0,1.0,0.0,0.0,0.0,0.0,0.0,0.0,0.0,0.0,0.0,0.0,0.0,0.0,0.0,0.0,0.0,0.0,0.0,0.0,0.0,0.0,0.0,0.0,0.0,0.0,0.0,1.0,0.0,0.0,0.0,0.0,0.0,0.0,0.0,0.0,0.0,0.0,0.0,0.0,0.0,0.0,0.0,0.0,0.0,0.0,0.0,0.0,0.0,0.0,0.0,0.0,0.0,0.0,0.0,0.0,0.0,0.0,0.0,0.0,0.0,0.0,0.0,0.0,0.0,0.0,0.0,0.0,0.0,0.0,0.0,0.0,0.0,0.0,0.0,0.0,0.0,0.0,0.0,0.0,0.0,0.0,0.0,0.0,0.0,0.0,0.0,0.0
100484,0,0.0,0.0,0.0,1.0,0.0,202500.0,1907010.0,66415.5,1741500.0,0.0196889999999999,60.2054794520548,-1083.0,-12431.0,-4962.0,,2.0,2.0,2.0,8.0,0.8903948895231032,0.5942687302880564,0.6397075677637197,0.1216,0.1172,0.9771,,,0.0,0.2759,0.1667,,0.141,,0.1123,,0.0074,0.1239,0.1216,0.9772,,,0.0,0.2759,0.1667,,0.1442,,0.117,,0.0078,0.1228,0.1172,0.9771,,,0.0,0.2759,0.1667,,0.1434,,0.1143,,0.0076,0.0883,1.0,5.0,1.0,5.0,1.0,-1363.0,0.0,0.0,0.0,0.0,0.0,4.0,1.0,1.0,1.0,1.0,1.0,1.0,0.0,0.0,0.0,0.0,0.0,0.0,0.0,0.0,0.0,0.0,1.0,0.0,0.0,0.0,0.0,0.0,0.0,0.0,0.0,0.0,0.0,0.0,0.0,0.0,0.0,0.0,2.0,0.0,,27000.0,0.0,0.0,0.0,0.0,0.0,-2760.0,14438.5,-1660.0,-1323.0,182.0,-45.0,10.0,12329.055,130275.0,136957.5,0.0,130275.0,15.0,-1534.0,365243.0,-1674.0,-1423.0,-1393.0,-1417.0,9.5,1.0,0.0,10.0,116.0,18.0,8.0,-45.5,0.0,0.0,114.0,25755.075,25539.03,-1491.0,-1468.0,7.0,1.0,0.0,,,,,,,,,,,,,,,,,,,,,8337461616.0,184236401920.5,165440045997.0,51916575610.935,1862.0,1703.0,71124.0,70648.0,9140.0,505515.0,17789.5727000023,17851.610699999117,17303.48529999809,11283.974700000086,11221.802600000094,11169.294500000058,128262.0,662079.0,,,,13513525.799999598,-601252069.0,-920920146.0,-296154142.0,-1533565022.0416667,43959.0,30662.0,11339.213199999173,11215.119999998964,10699.746499997302,22864.09530000961,22785.96160000957,22172.07120000813,67368.058458604,157871.56227308247,125975.10965536036,34964.21960002787,34904.63620002831,34351.299300028724,,,,3710274.0,8287.494000000168,8391.892600000081,8115.650000000228,,,,16451.77589999975,16636.7752999997,16233.706099999705,,,,3908.934500000125,3892.15020000016,3724.896300000156,435976.0,430778.0,,6418.1302810028965,631267.0,624827.0,,16315.7467999998,154020.6634999906,154023.40749999008,153915.2066999872,,,,91.0,8554697.685000006,,763207153.5599997,261048516.88500008,11145717.36,38918.25,16.0,1577.0,-2650968.0,1357002.0,-1382533.5,-1469865.0,-45.0,0.0,,27000.0,0.0,0.0,0.0,0.0,0.0,-2760.0,14438.5,-1660.0,-1323.0,29365105.590000022,422241178.23,478448279.415,6986403.315,422241178.23,29472.0,-2063723.5,463761563.0,23013340.0,103030383.0,49208195.0,104895492.0,29852.0,477.0,76.64311616021685,916781.0,255810.0,152397.0,-503870.5,286913.0,1163.0,334162402.19999605,331238159.6399976,-21533978.0,-21383017.0,418337.0,16029.5,,,,,,,,,,,,,,,,,,,,,1465717.0,14717423.0,3228943.0,8545254.0,11594498.0,1414030.0,1056627062.8020012,,72024730456.2746,21652843016.74512,581630461.1594988,5792395.7475,689.5,94245.0,-276629738.5,21856013.5,-123660436.0,-218473595.0,-2013207.5,,,,,,,,,,,,,,,,,,,,,4268010.5,2476409.5,-8993886.0,921269.0,37582.5,3729271432.7249646,3653821650.284962,-260350176.5,-257043159.0,2523819.0,268901.5,3921892458.389957,33221437322.37841,36647101673.707634,1727730540.3150494,48034213969.47822,3983688.0,-247317445.5,102970982931.0,1052652581.0,17256900924.5,3499833976.5,18870182591.5,3668045.0,71837.5,20850.93656483297,89708256.5,-17.98839590443686,9.417333333333334,3.0489870587438173,183.56572771478187,28.713327461210103,1728.6996464660058,101250.0,-0.2225209339563143,0.9749279121818236,0.0,1.0,0.0,0.0,0.0,0.0,0.0,0.0,0.0,0.0,0.0,0.0,0.0,1.0,0.0,1.0,0.0,0.0,0.0,0.0,1.0,0.0,0.0,0.0,0.0,1.0,0.0,0.0,0.0,0.0,0.0,0.0,0.0,1.0,0.0,0.0,0.0,0.0,0.0,0.0,0.0,0.0,0.0,0.0,0.0,0.0,0.0,0.0,0.0,0.0,0.0,0.0,0.0,0.0,0.0,0.0,0.0,0.0,0.0,0.0,0.0,0.0,0.0,0.0,0.0,0.0,0.0,0.0,0.0,0.0,0.0,0.0,0.0,0.0,0.0,0.0,0.0,0.0,0.0,0.0,0.0,0.0,0.0,0.0,0.0,0.0,0.0,0.0,0.0,0.0,1.0,0.0,0.0,0.0,0.0,0.0,0.0,0.0,0.0,0.0,0.0,0.0,0.0,0.0,0.0,0.0,0.0,0.0,0.0,0.0,1.0,0.0,0.0,0.0,0.0,0.0,0.0,1.0,0.0,0.0
100494,0,0.0,0.0,0.0,1.0,0.0,135000.0,675000.0,36747.0,675000.0,0.030755,28.701369863013703,-2786.0,-725.0,-3136.0,,2.0,2.0,2.0,13.0,,0.3079020349658547,0.6577838002083306,0.0464,0.0818,0.9985,0.9796,,0.0,0.069,0.0833,0.0417,0.0114,0.0378,0.0356,0.0,0.0,0.0473,0.0849,0.9985,0.9804,,0.0,0.069,0.0833,0.0417,0.0116,0.0413,0.037,0.0,0.0,0.0468,0.0818,0.9985,0.9799,,0.0,0.069,0.0833,0.0417,0.0116,0.0385,0.0362,0.0,0.0,0.0325,1.0,0.0,0.0,0.0,0.0,-1798.0,0.0,0.0,0.0,0.0,0.0,0.0,1.0,1.0,1.0,1.0,0.0,0.0,0.0,0.0,0.0,1.0,1.0,0.0,0.0,0.0,0.0,0.0,0.0,0.0,1.0,0.0,0.0,0.0,0.0,0.0,0.0,0.0,0.0,0.0,0.0,0.0,0.0,0.0,8.0,6669.0,0.0,58225.2075,0.0,0.0,0.0,0.0,0.0,-1173.0,-809.5,-891.0,-1080.5,325.0,-22.0,1.0,19683.0,247500.0,247500.0,,247500.0,24.0,-1035.0,365243.0,-1005.0,-555.0,-315.0,-547.0,12.0,0.0,,5.0,17.0,24.0,16.0,-26.0,0.0,0.0,16.0,19683.0,19683.0,-791.0,-780.0,8.5,1.0,0.0,,,,,,,,,,,,,,,,,,,,,8337498363.0,184237076920.5,165440720997.0,51916710610.935,1862.0,1703.0,71124.0,70648.0,9140.0,505515.0,17789.6191000023,17851.657499999117,17303.532599998092,11284.056500000086,11221.884400000094,11169.379400000058,128262.0,662081.0,,,,13513554.50136946,-601254855.0,-920923282.0,-296155940.0,-1533565747.0416667,43959.0,30662.0,11339.213199999173,11215.119999998964,10699.746499997302,22864.16430000961,22786.03060000957,22172.140200008125,,157871.87017511742,125975.76743916054,34964.30290002787,34904.71950002831,34351.382600028715,22930.495099995933,22903.942599995506,22551.331699995742,3710287.0,8287.505400000167,8391.904200000079,8115.661600000229,9808.29610000072,9923.12430000216,10282.370699999648,16451.811499999752,16636.811499999698,16233.743099999703,828.0970000001757,813.2780000000457,759.2652000000132,3908.934500000125,3892.15020000016,3724.896300000156,435976.0,430778.0,,6418.161036002895,631269.0,624829.0,,16315.779299999798,154021.66199999055,154024.40599999006,153916.20519998722,77531.89319999628,77869.33010000657,78270.24780000643,39.0,8612732.655000005,2867809.0500000007,774374791.1849997,263904103.5300001,11157880.005,38918.25,17.0,1577.0,-2681117.0,1369750.5,-1396685.5,-1486687.5,-19.0,0.0,0.0,48378.42,0.0,0.0,0.0,0.0,0.0,-1739.0,-1077.0,-891.0,-1586.0,30245526.090000022,434921598.675,492376854.915,,434921598.675,30197.0,-2111390.0,472524845.0,23347920.0,105205415.0,49919714.0,107070681.0,30535.0,489.0,,925964.0,260576.0,155152.0,-513662.0,286942.0,1192.0,340848020.9699954,337917962.6999971,-22082321.0,-21926771.5,436878.0,16331.5,,,,,,,,,,,,,,,,,,,,,1465725.0,14717748.0,3228943.0,8545271.0,11594514.0,1414031.0,1056633731.8020012,801033914.542495,72024788681.4821,21652843016.74512,581630461.1594988,5792395.7475,689.5,94245.0,-276630911.5,21855204.0,-123661327.0,-218474675.5,-2013229.5,,,,,,,,,,,,,,,,,,,,,4268034.5,2476425.5,-8993912.0,921269.0,37582.5,3729291115.7249646,3653841333.284962,-260350967.5,-257043939.0,2523827.5,268902.5,3921912141.389957,33221684822.37841,36647349173.707634,,48034461469.47822,3983712.0,-247318480.5,102971348174.0,1052651576.0,17256900369.5,3499833661.5,18870182044.5,3668057.0,71837.5,,89708261.5,-97.06853760977472,5.0,3.673769287288758,105.44221110585488,18.3688464364438,527.2110555292744,67500.0,1.0,0.0,0.0,0.0,0.0,0.0,0.0,0.0,1.0,0.0,0.0,0.0,0.0,0.0,0.0,1.0,0.0,1.0,0.0,0.0,0.0,1.0,0.0,0.0,0.0,0.0,0.0,1.0,0.0,0.0,0.0,0.0,0.0,0.0,0.0,0.0,0.0,0.0,0.0,0.0,0.0,0.0,0.0,0.0,0.0,0.0,1.0,0.0,0.0,0.0,0.0,0.0,0.0,0.0,0.0,0.0,0.0,0.0,0.0,0.0,0.0,0.0,0.0,0.0,0.0,0.0,0.0,0.0,0.0,0.0,0.0,0.0,0.0,0.0,0.0,0.0,0.0,0.0,0.0,0.0,0.0,0.0,0.0,0.0,0.0,0.0,0.0,0.0,0.0,0.0,0.0,0.0,1.0,0.0,0.0,0.0,0.0,0.0,0.0,0.0,0.0,0.0,0.0,0.0,0.0,0.0,0.0,0.0,0.0,0.0,1.0,0.0,1.0,0.0,0.0,0.0,0.0,0.0,0.0,0.0,1.0,0.0
100510,0,0.0,1.0,1.0,0.0,0.0,315000.0,405000.0,21969.0,405000.0,0.007114,41.28767123287671,-1169.0,-6699.0,-4110.0,15.0,1.0,2.0,2.0,14.0,0.3205971313066587,0.3439003270929021,0.4031416766587513,0.0928,0.1026,0.9826,,,0.0,0.2069,0.1667,,,,0.0874,,0.0,0.0945,0.1065,0.9826,,,0.0,0.2069,0.1667,,,,0.0911,,0.0,0.0937,0.1026,0.9826,,,0.0,0.2069,0.1667,,,,0.089,,0.0,0.0688,1.0,0.0,0.0,0.0,0.0,-682.0,0.0,0.0,0.0,0.0,0.0,2.0,1.0,1.0,0.0,1.0,0.0,0.0,0.0,0.0,0.0,0.0,0.0,0.0,0.0,1.0,0.0,0.0,0.0,0.0,0.0,0.0,0.0,0.0,0.0,0.0,0.0,0.0,0.0,0.0,0.0,0.0,0.0,0.0,9.0,6066.0,0.0,252000.0,33948.0,0.0,0.0,0.0,0.0,-1239.0,46.5,-26.0,-1721.5,366.0,-22.0,3.0,13500.0,270000.0,270000.0,0.0,270000.0,12.0,-682.0,365243.0,-1648.0,365243.0,122.0,365243.0,17.0,0.0,0.0,-1.0,54.0,60.0,32.5,-28.5,0.0,0.0,57.0,13288.5,13288.5,-840.0,-838.0,28.0,3.0,0.0,,,,,,,,,,,,,,,,,,,,,8337520332.0,184237481920.5,165441125997.0,51917025610.935,1862.0,1703.0,71124.0,70648.0,9140.0,505517.0,17789.711900002298,17851.75119999912,17303.627099998088,11284.159100000086,11221.987000000092,11169.485900000058,128262.0,662082.0,,,,13513595.789040696,-601256024.0,-920927392.0,-296156622.0,-1533572446.0416667,43959.0,30662.0,11339.213199999173,11215.119999998964,10699.746499997302,22864.371200009613,22786.23750000957,22172.34710000813,67368.3790557353,157872.21407544453,125976.17058083722,34964.46960002787,34904.88620002831,34351.549300028724,,,,3710301.0,,,,,,,16451.898899999753,16636.900499999698,16233.834199999705,,,,3908.934500000125,3892.15020000016,3724.896300000156,435976.0,430778.0,1261619.0,6418.168150002895,631271.0,624831.0,,16315.848099999796,154022.64459999054,154025.38859999005,153917.18779998718,,,,41.0,8968651.650000004,2945329.47,805912159.0499997,275795373.24000007,12598970.849999998,38918.25,18.0,1577.0,-2756745.0,1379962.5,-1432439.0,-1519993.0,-20.0,0.0,0.0,450000.0,0.0,0.0,0.0,0.0,0.0,-1904.0,-710.0,-792.0,-1809.0,31635414.18000001,457587999.315,516678182.415,7426224.9,457587999.315,31625.0,-2184839.0,491149425.0,23659905.0,109188706.0,50627966.0,111420206.0,31560.0,503.0,81.54697761481044,956605.0,276050.0,164699.0,-535426.0,314226.0,1276.0,363387717.31499314,357555145.0949957,-23099358.0,-22934084.0,462646.0,17397.0,,,,,,,,,,,,,,,,,,,,,1465734.0,14718114.0,3228943.0,8545325.0,11594571.0,1414034.0,1056639797.8020012,801033914.542495,72025040681.4821,21652876964.74512,581630461.1594988,5792395.7475,689.5,94245.0,-276632150.5,21855250.5,-123661353.0,-218476397.0,-2013251.5,,,,,,,,,,,,,,,,,,,,,4268094.5,2476458.0,-8993940.5,921269.0,37582.5,3729304404.2249646,3653854621.784962,-260351807.5,-257044777.0,2523855.5,268905.5,3921925641.389957,33221954822.37841,36647619173.707634,1727730540.3150494,48034731469.47822,3983724.0,-247319162.5,102971713417.0,1052649928.0,17257265612.5,3499833783.5,18870547287.5,3668074.0,71837.5,20850.93656483297,89708260.5,-28.313536828135373,1.2857142857142858,14.338385907414994,591.9985633554629,18.435067595247848,761.1410100284523,315000.0,0.6234898018587336,0.7818314824680298,0.0,0.0,0.0,0.0,0.0,0.0,1.0,0.0,0.0,0.0,0.0,0.0,0.0,1.0,0.0,0.0,0.0,0.0,1.0,0.0,0.0,0.0,1.0,0.0,0.0,0.0,1.0,0.0,0.0,0.0,0.0,0.0,0.0,0.0,1.0,0.0,0.0,0.0,0.0,0.0,0.0,0.0,0.0,0.0,0.0,0.0,0.0,0.0,0.0,0.0,0.0,0.0,0.0,0.0,0.0,0.0,0.0,0.0,0.0,1.0,0.0,0.0,0.0,0.0,0.0,0.0,0.0,0.0,0.0,0.0,0.0,0.0,0.0,0.0,0.0,0.0,0.0,0.0,0.0,0.0,0.0,0.0,0.0,0.0,0.0,0.0,0.0,0.0,0.0,0.0,0.0,0.0,0.0,0.0,0.0,0.0,0.0,0.0,0.0,0.0,0.0,0.0,0.0,0.0,0.0,0.0,0.0,0.0,0.0,0.0,1.0,0.0,0.0,0.0,0.0,0.0,0.0,1.0,0.0,0.0
100512,0,0.0,0.0,0.0,1.0,0.0,92250.0,130320.0,13815.0,112500.0,0.0038179999999999,64.87945205479453,,-3536.0,-4863.0,,1.0,2.0,2.0,4.0,,0.7323831066763843,,0.0124,0.031,0.9881,0.8368,0.0,0.0,0.069,0.0417,,0.0082,0.0101,0.0126,0.0,0.0,0.0126,0.0322,0.9881,0.8432,0.0,0.0,0.069,0.0417,,0.0084,0.011,0.0132,0.0,0.0,0.0125,0.031,0.9881,0.8390000000000001,0.0,0.0,0.069,0.0417,,0.0083,0.0103,0.0129,0.0,0.0,0.0099,1.0,4.0,0.0,4.0,0.0,-158.0,0.0,0.0,0.0,0.0,1.0,0.0,1.0,0.0,0.0,1.0,1.0,0.0,0.0,0.0,0.0,0.0,0.0,0.0,0.0,0.0,0.0,0.0,1.0,0.0,0.0,0.0,0.0,0.0,0.0,0.0,0.0,0.0,0.0,0.0,0.0,0.0,0.0,0.0,1.0,20929.5,,450000.0,431356.5,,0.0,0.0,0.0,-165.0,1296.0,-11.0,,6.0,-2.5,1.0,15754.32,97713.0,87318.0,10395.0,97713.0,6.0,-158.0,365243.0,-128.0,365243.0,22.0,365243.0,6.0,0.0,0.1158607350096711,80.0,5.0,6.0,4.0,-3.0,0.0,0.0,5.0,15754.32,15754.32,-85.0,-68.0,3.0,1.0,0.0,,,,,,,,,,,,,,,,,,,,,8337534147.0,184237612240.5,165441238497.0,51917117860.935,1862.0,1703.0,71124.0,70649.0,9140.0,505517.0,17789.724300002294,17851.76369999912,17303.639699998086,11284.190100000087,11222.018000000093,11169.51810000006,128262.0,662083.0,4134.584100000122,4132.215200000017,3943.037600000095,13513660.66849275,,-920932255.0,-296156780.0,-1533575982.0416667,43959.0,30662.0,11339.213199999173,11215.119999998964,10699.746499997302,22864.44020000961,22786.30650000957,22172.41610000813,,157872.94645855122,,34964.51130002787,34904.92790002831,34351.59100002872,,,,3710305.0,8287.513600000168,8391.912500000079,8115.670000000227,9808.30620000072,9923.13460000216,10282.381699999649,16451.91149999975,16636.9133999997,16233.847399999704,828.0970000001757,813.2780000000457,759.2652000000132,3908.934500000125,3892.15020000016,3724.896300000156,435980.0,430782.0,,6418.171968002896,631273.0,624833.0,,16315.857999999796,154023.63269999056,154026.37669999007,153918.17589998714,77532.72999999629,77870.16910000659,78271.09100000645,6.0,9128869.650000004,,810373450.0499997,278399302.74000007,,38918.25,18.0,1577.0,-2762537.0,1381337.0,-1434373.0,,-2.5,20929.5,,450000.0,431356.5,,0.0,0.0,0.0,-165.0,1296.0,-11.0,,31681852.02000001,458038152.315,517127543.415,7436619.9,458038152.315,31637.0,-2186466.0,491879911.0,23659021.0,109553283.0,50627382.0,111784787.0,31598.0,503.0,81.66283834982009,957412.0,277686.0,165696.0,-536404.0,314226.0,1276.0,363874153.45499307,358077581.2349956,-23124144.0,-22958436.0,463521.0,17488.0,,,,,,,,,,,,,,,,,,,,,1465735.0,14718120.0,3228943.0,8545330.0,11594576.0,1414035.0,1056660727.3020012,,72025490681.4821,21653308321.24512,,5792395.7475,689.5,94245.0,-276632315.5,21856546.5,-123661364.0,,-2013254.0,,,,,,,,,,,,,,,,,,,,,4268100.5,2476462.0,-8993943.5,921269.0,37582.5,3729320158.544965,3653870376.1049633,-260351892.5,-257044845.0,2523858.5,268906.5,3921941395.709956,33222052535.37841,36647706491.707634,1727740935.3150494,48034829182.47822,3983730.0,-247319320.5,102972078660.0,1052649800.0,17257630855.5,3499833805.5,18870912530.5,3668080.0,71837.5,20851.05242556797,89708340.5,,1.4126829268292682,6.677524429967427,433.2341260987909,9.433224755700326,612.0224532595603,92250.0,-0.2225209339563143,0.9749279121818236,0.0,0.0,0.0,0.0,0.0,0.0,1.0,0.0,0.0,1.0,0.0,0.0,0.0,0.0,0.0,0.0,0.0,0.0,1.0,0.0,0.0,0.0,1.0,0.0,0.0,1.0,0.0,0.0,0.0,0.0,0.0,0.0,0.0,0.0,0.0,0.0,0.0,0.0,0.0,0.0,0.0,0.0,0.0,0.0,0.0,0.0,0.0,0.0,0.0,0.0,0.0,0.0,0.0,0.0,0.0,0.0,0.0,0.0,0.0,0.0,0.0,0.0,0.0,0.0,0.0,0.0,0.0,0.0,0.0,0.0,0.0,0.0,0.0,0.0,0.0,0.0,0.0,0.0,0.0,0.0,0.0,0.0,0.0,0.0,0.0,0.0,0.0,0.0,0.0,0.0,0.0,0.0,0.0,0.0,0.0,0.0,0.0,0.0,0.0,0.0,0.0,0.0,0.0,0.0,0.0,1.0,0.0,0.0,1.0,0.0,1.0,0.0,0.0,1.0,0.0,0.0,0.0,0.0,0.0,0.0
100517,0,0.0,0.0,0.0,1.0,0.0,279000.0,630000.0,32296.5,630000.0,0.026392,41.82191780821917,-1685.0,-231.0,-2295.0,,2.0,2.0,2.0,12.0,0.5799234077822149,0.6990006602336026,0.622922000268356,0.1464,,0.9747,,,0.0,0.069,0.3333,,,,0.0612,,,0.1492,,0.9747,,,0.0,0.069,0.3333,,,,0.0637,,,0.1478,,0.9747,,,0.0,0.069,0.3333,,,,0.0623,,,0.0589,1.0,6.0,0.0,6.0,0.0,-2297.0,0.0,0.0,0.0,0.0,0.0,2.0,1.0,1.0,1.0,1.0,0.0,0.0,0.0,0.0,0.0,0.0,0.0,0.0,0.0,1.0,0.0,0.0,0.0,0.0,0.0,0.0,0.0,0.0,0.0,0.0,0.0,0.0,0.0,0.0,0.0,0.0,0.0,0.0,14.0,1653.75,0.0,77715.0,0.0,0.0,0.0,0.0,0.0,-1336.5,-1048.0,-870.5,-1175.5,594.0,-22.0,5.0,11835.585,126855.0,126855.0,0.0,126855.0,10.0,-790.0,365243.0,-709.5,-580.5,-49.5,-566.5,15.0,0.0,0.0,367.0,23.0,12.0,10.0,-24.0,0.0,0.0,46.0,6127.2,6127.2,-534.0,-529.5,7.0,0.0,22.0,0.0,0.0,0.0,0.0,0.0,0.0,0.0,0.99,0.99,0.0,0.0,0.0,0.0,0.0,0.0,0.0,5.0,-12.5,0.0,0.0,8337566443.5,184238242240.5,165441868497.0,51917396860.935,1862.0,1703.0,71124.0,70649.0,9140.0,505519.0,17789.8707000023,17851.911499999118,17303.788899998086,,,,128262.0,662085.0,,,,13513702.490410555,-601257709.0,-920934550.0,-296159077.0,-1533576213.0416667,43959.0,30662.0,11339.213199999173,11215.119999998964,10699.746499997302,22864.50920000961,22786.37550000957,22172.485100008125,67368.95897914309,157873.64545921143,125976.79350283748,34964.84460002787,34905.26120002831,34351.924300028724,,,,3710317.0,,,,,,,16451.97269999975,16636.9756999997,16233.911099999705,,,,,,,435986.0,430788.0,,6418.198360002895,631275.0,624835.0,,16315.916899999796,154024.60739999055,154027.35139999006,153919.15059998716,,,,44.5,9136638.900000004,2945432.97,827662950.9899997,285392873.83500016,12667365.134999998,38918.25,18.0,1577.0,-2809098.5,1378276.0,-1461446.0,-1552856.0,-21.75,0.0,0.0,45355.95,0.0,0.0,0.0,0.0,0.0,-1549.0,-1245.0,-897.0,-1245.0,32228229.240000013,468764127.315,529212131.415,7467638.4,468764127.315,32149.0,-2206429.0,496810034.0,24376771.0,110640173.0,51719605.5,113236886.0,31956.0,509.5,81.96512139974308,960551.0,280673.0,167711.0,-540835.0,314226.0,1276.0,371470893.6599936,366562303.109996,-23350106.5,-23183961.5,467466.0,17629.0,361453204.125,936751500.0,29738877.75,40307439.24000001,838498.5,9710784.855,21075547.634999994,45547207.83000019,41893711.06500004,346547591.05499923,360374212.6200002,360389790.9450002,1726.0,3565.0,23.0,1816.0,143879.5,-235781.0,89034.0,314.0,1465749.0,14718714.0,3228965.0,8545353.0,11594622.0,1414040.0,1056662381.0520012,801033914.542495,72025568396.4821,21653308321.24512,581630461.1594988,5792395.7475,689.5,94245.0,-276633652.0,21855498.5,-123662234.5,-218477572.5,-2013276.0,5915032336.4624605,18697205250.0,198605420.325,447347873.0024977,1948107.735,256448094.2775008,308736111.9149987,635642925.4799982,458483686.5824992,5700484906.380029,5878384003.147497,5878627185.892498,13364.0,80722.5,44.0,70251.5,970560.0,-1696550.5,177364.0,6755.0,4268112.5,2476472.0,-8993967.5,921269.0,37582.5,3729326285.744965,3653876503.3049626,-260352426.5,-257045374.5,2523865.5,268906.5,3921953231.294956,33222179390.37841,36647833346.707634,1727740935.3150494,48034956037.47822,3983740.0,-247320110.5,102972443903.0,1052649090.5,17257630275.0,3499833756.0,18870911964.0,3668095.0,71837.5,20851.05242556797,89708707.5,-40.289878807730105,2.2580645161290325,8.638706980632577,361.2872933133049,19.50675769820259,815.8100171590753,139500.0,-0.2225209339563143,0.9749279121818236,0.0,1.0,0.0,0.0,0.0,0.0,0.0,0.0,1.0,0.0,0.0,0.0,0.0,0.0,0.0,0.0,0.0,0.0,1.0,0.0,1.0,0.0,0.0,0.0,0.0,1.0,0.0,0.0,0.0,0.0,0.0,0.0,0.0,0.0,0.0,0.0,0.0,0.0,0.0,0.0,0.0,0.0,0.0,0.0,1.0,0.0,0.0,0.0,0.0,0.0,0.0,0.0,0.0,0.0,0.0,0.0,0.0,0.0,0.0,0.0,0.0,0.0,0.0,0.0,0.0,0.0,0.0,0.0,0.0,0.0,0.0,0.0,0.0,0.0,0.0,0.0,0.0,0.0,0.0,0.0,0.0,0.0,0.0,0.0,0.0,0.0,0.0,0.0,0.0,0.0,0.0,0.0,0.0,0.0,0.0,0.0,0.0,0.0,0.0,1.0,0.0,0.0,0.0,0.0,0.0,0.0,0.0,0.0,0.0,0.0,1.0,0.0,0.0,0.0,0.0,0.0,0.0,0.0,1.0,0.0
100548,0,0.0,0.0,0.0,1.0,0.0,87750.0,156384.0,11821.5,135000.0,0.031329,65.7041095890411,,-3369.0,-4340.0,,1.0,2.0,2.0,14.0,,0.3827771269872223,0.4956658291397297,0.0619,0.0541,0.9871,0.8232,,0.0,0.0345,0.1667,0.2083,0.0646,,0.0386,,0.0,0.063,0.0561,0.9871,0.8301,,0.0,0.0345,0.1667,0.2083,0.066,,0.0402,,0.0,0.0625,0.0541,0.9871,0.8256,,0.0,0.0345,0.1667,0.2083,0.0657,,0.0393,,0.0,0.0303,1.0,0.0,0.0,0.0,0.0,-1434.0,0.0,0.0,0.0,0.0,0.0,6.0,1.0,0.0,0.0,1.0,0.0,0.0,0.0,0.0,0.0,0.0,0.0,0.0,0.0,0.0,0.0,0.0,1.0,0.0,0.0,0.0,0.0,0.0,0.0,0.0,0.0,0.0,0.0,0.0,0.0,0.0,0.0,0.0,15.0,0.0,0.0,42507.0,0.0,0.0,0.0,0.0,0.0,-1033.0,-614.0,-404.0,-699.0,557.0,-21.0,19.0,10200.33,78250.5,78250.5,0.0,79123.5,12.0,-1434.0,365243.0,-1946.0,-1586.0,-1586.0,-1581.5,11.0,0.5,0.0,27.0,118.0,12.0,6.0,-58.0,0.0,0.0,111.0,10463.22,9937.44,-1763.0,-1725.0,5.0,1.0,0.0,,,,,,,,,,,,,,,,,,,,,8337578265.0,184238398624.5,165442003497.0,51917484610.935,1862.0,1703.0,71124.0,70649.0,9140.0,505525.0,17789.9326000023,17851.973999999118,17303.851899998084,11284.244200000085,11222.072100000092,11169.57420000006,128262.0,662086.0,,,,13513768.194520146,,-920938890.0,-296160511.0,-1533579582.0416667,43959.0,30662.0,11339.213199999173,11215.119999998964,10699.746499997302,22864.543700009614,22786.41000000957,22172.51960000813,,157874.02823633846,125977.28916866664,34965.01130002787,34905.42790002831,34352.09100002872,22930.703399995928,22904.150899995504,22551.539999995737,3710331.0,8287.578200000167,8391.97820000008,8115.736000000227,,,,16452.01129999975,16637.0149999997,16233.951299999704,,,,3908.934500000125,3892.15020000016,3724.896300000156,435986.0,430788.0,,6418.2296890028965,631277.0,624837.0,,16315.947199999797,154025.59449999055,154028.33849999006,153920.13769998716,77533.55319999628,77870.99470000659,78271.92110000644,34.0,9712311.660000004,3260510.9100000006,864594684.4499997,298442579.22,12745883.249999994,38918.25,21.0,1577.0,-2993312.0,1481265.0,-1551698.0,-1658633.5,-16.5,0.0,0.0,42507.0,0.0,0.0,0.0,0.0,0.0,-1624.0,-1443.0,-927.0,-1027.0,34272552.84750001,496708172.37,559847501.415,7934530.455,496717172.37,34402.0,-2365065.0,536617296.5,25710091.5,118942923.5,55658974.5,121907543.0,34299.0,541.0,89.10885539024298,994206.0,297924.0,178798.5,-579982.5,314279.0,1315.0,394998390.1349924,392525247.0149944,-24607423.0,-24427331.0,478874.0,18881.0,,,,,,,,,,,,,,,,,,,,,1465764.0,14719271.0,3228965.0,8545471.0,11594733.0,1414059.0,1056662381.0520012,801033914.542495,72025610903.4821,21653308321.24512,581630461.1594988,5792395.7475,689.5,94245.0,-276634685.0,21854884.5,-123662638.5,-218478271.5,-2013297.0,,,,,,,,,,,,,,,,,,,,,4268124.5,2476478.0,-8994025.5,921269.0,37582.5,3729336748.964965,3653886440.744962,-260354189.5,-257047099.5,2523870.5,268907.5,3921963431.624956,33222257640.87841,36647911597.207634,1727740935.3150494,48035035160.97822,3983752.0,-247321544.5,102972809146.0,1052647144.5,17257628689.0,3499832170.0,18870910382.5,3668106.0,71838.0,20851.05242556797,89708734.5,,1.7821538461538462,7.422915873620099,487.7160780305677,13.228778073848494,869.1850842932457,87750.0,-0.2225209339563143,0.9749279121818236,0.0,0.0,0.0,0.0,0.0,0.0,1.0,0.0,0.0,1.0,0.0,0.0,0.0,0.0,0.0,1.0,0.0,0.0,0.0,0.0,0.0,0.0,1.0,0.0,0.0,1.0,0.0,0.0,0.0,0.0,0.0,0.0,0.0,0.0,0.0,0.0,0.0,0.0,0.0,0.0,0.0,0.0,0.0,0.0,0.0,0.0,0.0,0.0,0.0,0.0,0.0,0.0,0.0,0.0,0.0,0.0,0.0,0.0,0.0,0.0,0.0,0.0,0.0,0.0,0.0,0.0,0.0,0.0,0.0,0.0,0.0,0.0,0.0,0.0,0.0,0.0,0.0,0.0,0.0,0.0,0.0,0.0,0.0,0.0,0.0,0.0,0.0,0.0,0.0,0.0,0.0,0.0,0.0,0.0,0.0,0.0,0.0,0.0,0.0,0.0,0.0,0.0,0.0,0.0,0.0,1.0,0.0,0.0,1.0,0.0,1.0,0.0,0.0,0.0,0.0,0.0,0.0,0.0,1.0,0.0
100551,0,0.0,0.0,0.0,1.0,0.0,144000.0,981360.0,31788.0,720000.0,0.00963,56.26575342465753,,-168.0,-1477.0,,2.0,2.0,2.0,12.0,0.8439277792628379,0.6101448727932867,0.4365064990977374,,,,,,,,,,,,,,,,,,,,,,,,,,,,,,,,,,,,,,,,,,,,,4.0,0.0,4.0,0.0,-2078.0,0.0,0.0,0.0,0.0,0.0,0.0,1.0,0.0,0.0,1.0,0.0,0.0,0.0,0.0,0.0,0.0,0.0,0.0,0.0,1.0,0.0,0.0,0.0,0.0,0.0,0.0,0.0,0.0,0.0,0.0,0.0,0.0,0.0,0.0,0.0,0.0,0.0,0.0,5.0,0.0,0.0,106875.0,0.0,0.0,0.0,0.0,0.0,-2001.0,-1725.0,-1270.0,-1725.0,282.0,-28.5,22.0,14746.455,0.0,0.0,3510.0,360000.0,12.0,-374.0,365243.0,-458.0,-218.0,-128.0,-214.0,16.0,1.0,0.0874591690611457,-1.0,42.0,12.0,10.0,-13.5,0.0,0.0,57.0,8970.39,13500.0,-363.0,-344.0,5.0,1.0,7.0,268960.005,351000.0,0.0,1018.755,0.0,0.0,2250.0,54.0,54.0,265491.0,265819.005,265819.005,0.0,0.0,0.0,0.0,2.0,-5.0,0.0,0.0,8337610053.0,184239379984.5,165442723497.0,51917628610.935,1862.0,1703.0,71124.0,70649.0,9140.0,505525.0,,,,,,,128262.0,662088.0,,,,13513824.46027357,,-920940367.0,-296162589.0,-1533579750.0416667,43959.0,30662.0,,,,,,,67369.80290692237,157874.63838121126,125977.72567516573,,,,,,,3710343.0,,,,,,,,,,,,,,,,435990.0,430792.0,,6418.239319002895,631279.0,624839.0,,,,,,,,,66.0,9719358.660000004,3276008.9100000006,868146587.4599997,299863098.31500006,12760505.954999994,38918.25,21.0,1577.0,-3016531.0,1471816.5,-1564163.0,-1671085.5,-32.5,0.0,0.0,52650.0,0.0,0.0,0.0,0.0,0.0,-2300.0,-2180.0,-1759.0,-2180.0,34478325.765,500317856.37,563961887.415,7965935.955,500250356.37,34699.0,-2388922.0,540086255.0,25694894.0,120022644.0,56378075.0,122989083.0,34705.5,548.0,89.50270134793745,997392.5,300083.0,179878.0,-586642.5,314279.0,1315.0,397499904.53999233,394989949.0349944,-24751651.0,-24572190.0,480453.0,18991.0,381489376.68,993136500.0,32415477.75,43547680.17000002,838498.5,10274425.785,22123863.899999995,48967389.7200003,45125678.29500016,365766868.3049992,380217578.53500015,380234950.47000015,1866.0,3912.0,23.0,2023.0,148205.0,-243303.0,89044.0,315.0,1465769.0,14719553.0,3228972.0,8545513.0,11594790.0,1414081.0,1056662381.0520012,801033914.542495,72025717778.4821,21653308321.24512,581630461.1594988,5792395.7475,689.5,94245.0,-276636686.0,21853159.5,-123663908.5,-218479996.5,-2013325.5,5915301296.467462,18697556250.0,198605420.325,447348891.75749767,1948107.735,256448094.2775008,308738361.9149987,635642979.4799982,458483740.5824992,5700750397.380029,5878649822.152497,5878893004.897498,13364.0,80722.5,44.0,70251.5,970562.0,-1696555.5,177364.0,6755.0,4268136.5,2476488.0,-8994039.0,921269.0,37582.5,3729345719.354964,3653899940.744962,-260354552.5,-257047443.5,2523875.5,268908.5,3921978178.079956,33222257640.87841,36647911597.207634,1727744445.3150494,48035395160.97822,3983764.0,-247321918.5,102973174389.0,1052646686.5,17257628471.0,3499832042.0,18870910168.5,3668122.0,71839.0,20851.13988473704,89708733.5,,6.815,4.530011325028314,254.8845002249492,30.87202718006795,1737.0378690330283,72000.0,-0.9009688679024191,0.4338837391175582,0.0,0.0,0.0,0.0,0.0,0.0,1.0,0.0,0.0,1.0,0.0,0.0,0.0,0.0,0.0,0.0,0.0,0.0,1.0,0.0,1.0,0.0,0.0,0.0,0.0,1.0,0.0,0.0,0.0,0.0,0.0,0.0,0.0,0.0,0.0,0.0,0.0,0.0,0.0,0.0,0.0,0.0,0.0,0.0,0.0,0.0,0.0,0.0,0.0,0.0,0.0,0.0,0.0,0.0,0.0,0.0,0.0,0.0,0.0,0.0,0.0,0.0,0.0,0.0,0.0,0.0,0.0,0.0,0.0,0.0,0.0,0.0,0.0,0.0,0.0,0.0,0.0,0.0,0.0,0.0,0.0,0.0,0.0,0.0,0.0,0.0,0.0,0.0,0.0,0.0,0.0,0.0,0.0,0.0,0.0,0.0,0.0,0.0,0.0,0.0,0.0,0.0,0.0,0.0,0.0,1.0,0.0,0.0,0.0,0.0,0.0,0.0,0.0,0.0,0.0,0.0,0.0,0.0,0.0,0.0
100552,0,0.0,1.0,1.0,1.0,2.0,180000.0,269982.0,32170.5,238500.0,0.010147,31.810958904109587,-2117.0,-4930.0,-4033.0,9.0,4.0,2.0,2.0,10.0,0.275537906348665,0.5475563590661789,0.3706496323299817,,,,,,,,,,,,,,,,,,,,,,,,,,,,,,,,,,,,,,,,,,,,,2.0,0.0,2.0,0.0,-2248.0,0.0,0.0,0.0,0.0,0.0,3.0,1.0,1.0,0.0,1.0,0.0,1.0,0.0,0.0,0.0,1.0,1.0,0.0,0.0,1.0,0.0,0.0,0.0,0.0,0.0,0.0,0.0,0.0,0.0,0.0,0.0,0.0,0.0,0.0,0.0,0.0,0.0,0.0,5.0,0.0,0.0,201990.33,0.0,0.0,0.0,0.0,0.0,-968.0,-200.0,-194.0,-885.0,150.0,-19.0,10.0,8106.21,40302.06750000001,37719.0,4747.5,73237.5,15.0,-205.0,365243.0,-1396.0,-1096.0,-976.0,-1090.0,10.0,1.0,0.0999992087981643,-1.0,41.0,12.0,8.0,-67.0,0.0,0.0,38.0,5651.1,5651.1,-2051.0,-2038.0,6.0,1.0,0.0,,,,,,,,,,,,,,,,,,,,,8337642223.5,184239649966.5,165442961997.0,51917808610.935,1862.0,1703.0,71124.0,70649.0,9140.0,505528.0,,,,,,,128264.0,662092.0,,,,13513856.271232473,-601259826.0,-920944400.0,-296164837.0,-1533584680.0416667,43959.0,30662.0,,,,,,,67370.0784448287,157875.18593757032,125978.09632479804,,,,,,,3710353.0,,,,,,,,,,,,,,,,435992.0,430794.0,1261628.0,6418.249466002895,631281.0,624841.0,,,,,,,,,32.0,9778988.160000004,3276008.9100000006,873381788.4599997,302852592.31500006,12760505.954999994,38918.25,21.0,1577.0,-3023794.0,1474206.0,-1567878.0,-1675924.0,-15.5,0.0,0.0,115843.5,0.0,0.0,0.0,0.0,0.0,-1436.0,-886.0,-253.0,-885.0,34574037.885000005,502158041.37,565843391.415,7977807.09,502158041.37,34855.0,-2397802.5,541729848.5,25689036.0,120201548.5,56374657.0,123168001.5,34921.0,551.0,89.8206046321522,999595.5,300619.0,180180.0,-588640.0,314279.0,1315.0,397920910.7699922,395498705.2649944,-24814081.0,-24634250.0,480740.0,19093.0,,,,,,,,,,,,,,,,,,,,,1465774.0,14719703.0,3228972.0,8545554.0,11594828.0,1414091.0,1056662381.0520012,801033914.542495,72025919768.8121,21653308321.24512,581630461.1594988,5792395.7475,689.5,94245.0,-276637654.0,21852959.5,-123664102.5,-218480881.5,-2013344.5,,,,,,,,,,,,,,,,,,,,,4268148.5,2476496.0,-8994106.0,921269.0,37582.5,3729351370.454964,3653905591.8449626,-260356603.5,-257049481.5,2523881.5,268909.5,3921986284.289956,33222297942.94591,36647949316.207634,1727749192.8150494,48035468398.47822,3983779.0,-247322123.5,102973539632.0,1052645290.5,17257627375.0,3499831066.0,18870909078.5,3668132.0,71840.0,20851.23988394584,89708732.5,-66.54939281715615,1.4999,5.595188138201146,177.98829992507814,8.3922226884879,266.9646510576247,45000.0,-0.9009688679024191,-0.433883739117558,0.0,0.0,0.0,0.0,0.0,0.0,1.0,0.0,0.0,0.0,0.0,0.0,0.0,1.0,0.0,0.0,0.0,0.0,1.0,0.0,1.0,0.0,0.0,0.0,0.0,1.0,0.0,0.0,0.0,0.0,0.0,0.0,0.0,0.0,0.0,0.0,0.0,0.0,1.0,0.0,0.0,0.0,0.0,0.0,0.0,0.0,0.0,0.0,0.0,0.0,0.0,0.0,0.0,0.0,0.0,0.0,0.0,0.0,0.0,0.0,0.0,0.0,0.0,0.0,0.0,0.0,0.0,0.0,0.0,1.0,0.0,0.0,0.0,0.0,0.0,0.0,0.0,0.0,0.0,0.0,0.0,0.0,0.0,0.0,0.0,0.0,0.0,0.0,0.0,0.0,0.0,0.0,0.0,0.0,0.0,0.0,0.0,0.0,0.0,0.0,0.0,0.0,0.0,0.0,0.0,0.0,0.0,0.0,0.0,0.0,0.0,0.0,0.0,0.0,0.0,0.0,0.0,0.0,0.0,0.0
100553,0,0.0,1.0,1.0,0.0,0.0,126000.0,165915.0,10278.0,126000.0,0.031329,31.79178082191781,-3552.0,-5576.0,-4239.0,13.0,1.0,2.0,2.0,8.0,0.3004303654453873,0.668926677741423,0.7910749129911773,0.2825,0.2629,0.9851,0.7756,0.0472,0.32,0.2759,0.3333,0.375,0.1402,0.2253,0.2751,0.0232,0.134,0.2878,0.2728,0.9851,0.7844,0.0476,0.3222,0.2759,0.3333,0.375,0.1434,0.2461,0.2866,0.0233,0.1419,0.2852,0.2629,0.9851,0.7786,0.0475,0.32,0.2759,0.3333,0.375,0.1427,0.2292,0.28,0.0233,0.1368,0.2713,1.0,0.0,0.0,0.0,0.0,-2746.0,0.0,0.0,0.0,0.0,0.0,0.0,1.0,1.0,0.0,1.0,0.0,0.0,0.0,0.0,0.0,0.0,0.0,0.0,0.0,1.0,0.0,0.0,0.0,0.0,0.0,0.0,0.0,0.0,0.0,0.0,0.0,0.0,0.0,0.0,0.0,0.0,0.0,0.0,1.0,0.0,,90000.0,,,0.0,0.0,0.0,-2921.0,-2624.0,-2618.0,-2618.0,96.0,-47.5,3.0,12140.2575,74610.0,72688.5,7461.0,149805.0,17.0,-1000.0,365243.0,-1842.0,-1407.0,-1362.0,-1402.0,15.0,0.5,0.1013818835142736,-1.0,33.0,24.0,8.0,-25.0,0.0,0.0,32.0,14469.39,14469.39,-715.5,-714.0,9.5,1.0,0.0,,,,,,,,,,,,,,,,,,,,,8337652501.5,184239815881.5,165443087997.0,51917934610.935,1862.0,1703.0,71124.0,70649.0,9140.0,505528.0,17790.2151000023,17852.259199999116,17304.139699998083,11284.507100000086,11222.335000000092,11169.847000000058,128264.0,662093.0,4134.631300000122,4132.2627000000175,3943.085200000095,13513888.063013297,-601263378.0,-920948639.0,-296167583.0,-1533590256.0416667,43959.0,30662.0,11339.533199999172,11215.439999998966,10700.068699997302,22864.81960000961,22786.685900009576,22172.79550000813,67370.37887519415,157875.85486424807,125978.88739971103,34965.34460002787,34905.76120002831,34352.424300028724,22931.078399995928,22904.525899995504,22551.914999995737,3710361.0,8287.718400000167,8392.12090000008,8115.879400000227,9808.53150000072,9923.36380000216,10282.62779999965,16452.28639999975,16637.2949999997,16234.237899999704,828.1202000001758,813.3013000000458,759.2885000000133,3909.068500000125,3892.28700000016,3725.038200000157,435992.0,430794.0,1261641.0,6418.280795002896,631283.0,624843.0,,16316.218499999795,154026.57959999054,154029.32359999002,153921.12279998715,77534.32879999628,77871.77330000661,78272.70550000647,96.0,9778988.160000004,,873988778.7899997,,,38918.25,21.0,1577.0,-3027303.0,1471382.0,-1570720.0,-1678742.0,-47.5,0.0,,90000.0,,,0.0,0.0,0.0,-2921.0,-2624.0,-2618.0,-2618.0,34623848.52,503113895.505,566863523.415,7985268.09,503151200.505,34938.0,-2401998.0,542825577.5,25684445.5,120381527.5,56371473.5,123347993.5,34998.0,552.5,89.92198651566645,999614.0,301273.0,180527.0,-589716.0,314279.0,1315.0,398361945.5999924,395934088.9949944,-24846343.5,-24666317.5,481038.0,19148.5,,,,,,,,,,,,,,,,,,,,,1465775.0,14719799.0,3228972.0,8545587.0,11594860.0,1414094.0,1056662381.0520012,,72026009768.8121,,,5792395.7475,689.5,94245.0,-276640575.0,21850335.5,-123666720.5,-218483499.5,-2013392.0,,,,,,,,,,,,,,,,,,,,,4268172.5,2476504.0,-8994131.0,921269.0,37582.5,3729365839.844964,3653920061.2349625,-260357319.0,-257050195.5,2523891.0,268910.5,3921998424.547456,33222372552.94591,36648022004.707634,1727756653.8150494,48035618203.47822,3983796.0,-247323123.5,102973904875.0,1052643448.5,17257625968.0,3499829704.0,18870907676.5,3668147.0,71840.5,20851.341265829346,89708731.5,-111.72699069286452,1.3167857142857142,12.259194395796849,389.74162128445647,16.142732049036773,513.2061991699254,126000.0,0.6234898018587336,0.7818314824680298,0.0,0.0,0.0,0.0,0.0,0.0,1.0,0.0,1.0,0.0,0.0,0.0,0.0,0.0,0.0,0.0,0.0,0.0,1.0,0.0,0.0,0.0,1.0,0.0,0.0,1.0,0.0,0.0,0.0,0.0,0.0,0.0,0.0,0.0,0.0,0.0,0.0,0.0,0.0,0.0,0.0,0.0,0.0,0.0,0.0,0.0,0.0,0.0,0.0,0.0,0.0,0.0,0.0,1.0,0.0,0.0,0.0,0.0,0.0,0.0,0.0,0.0,0.0,0.0,0.0,0.0,0.0,0.0,0.0,0.0,0.0,0.0,0.0,0.0,0.0,0.0,0.0,0.0,0.0,0.0,0.0,0.0,0.0,0.0,0.0,0.0,0.0,0.0,0.0,0.0,0.0,0.0,0.0,0.0,0.0,0.0,0.0,0.0,0.0,0.0,0.0,0.0,0.0,0.0,0.0,0.0,1.0,0.0,0.0,0.0,1.0,0.0,0.0,0.0,1.0,0.0,0.0,0.0,0.0,0.0
100561,0,0.0,1.0,1.0,1.0,0.0,180000.0,67500.0,8140.5,67500.0,0.015221,32.38082191780822,-2612.0,-9781.0,-4134.0,3.0,2.0,2.0,2.0,12.0,0.3790738822416448,0.2731936266061187,0.2188590822283744,0.1485,0.1048,0.9866,0.8164,0.0569,0.16,0.1379,0.3333,0.375,0.0974,0.121,0.1539,0.0,0.0,0.1513,0.1088,0.9866,0.8236,0.0574,0.1611,0.1379,0.3333,0.375,0.0996,0.1322,0.1604,0.0,0.0,0.1499,0.1048,0.9866,0.8189,0.0573,0.16,0.1379,0.3333,0.375,0.0991,0.1231,0.1567,0.0,0.0,0.1522,1.0,3.0,0.0,3.0,0.0,-1257.0,0.0,0.0,0.0,0.0,0.0,2.0,1.0,1.0,0.0,1.0,1.0,0.0,0.0,0.0,0.0,0.0,0.0,0.0,0.0,0.0,0.0,0.0,0.0,0.0,1.0,0.0,0.0,0.0,0.0,0.0,0.0,0.0,0.0,0.0,0.0,0.0,0.0,0.0,7.0,7650.0,0.0,115834.5,68918.625,0.0,0.0,0.0,0.0,-626.0,16023.0,-23.0,-961.0,162.0,-11.0,11.0,11698.7175,90000.0,90000.0,0.0,112500.0,12.0,-656.0,365243.0,-880.0,-296.0,-296.0,-285.0,13.0,0.0,0.0,39.0,89.0,12.0,10.5,-20.0,0.0,0.0,161.0,8524.935,8515.575,-573.0,-570.0,18.0,1.0,35.0,393582.24,450000.0,4500.0,15750.0,0.0,0.0,17319.6,18000.0,14507.82,350886.195,388477.035,388477.035,1.0,1.0,0.0,0.0,17.0,-18.0,0.0,0.0,8337660642.0,184239883381.5,165443155497.0,51918114610.935,1862.0,1703.0,71124.0,70649.0,9140.0,505530.0,17790.3636000023,17852.409099999117,17304.290999998084,11284.611900000084,11222.439800000093,11169.955800000058,128264.0,662095.0,4134.6882000001215,4132.320000000017,3943.142600000095,13513920.443835212,-601265990.0,-920952773.0,-296168840.0,-1533600037.0416667,43959.0,30662.0,11339.693199999172,11215.599999998964,10700.229799997302,22864.957500009616,22786.823800009573,22172.93340000813,67370.75794907639,157876.12805787468,125979.10625879328,34965.67790002787,34906.09450002831,34352.757600028715,22931.453399995928,22904.900899995504,22552.289999995737,3710373.0,8287.815800000168,8392.22000000008,8115.979000000227,9808.65250000072,9923.48690000216,10282.75999999965,16452.44029999975,16637.4516999997,16234.398299999704,828.1202000001758,813.3013000000458,759.2885000000133,3909.068500000125,3892.28700000016,3725.038200000157,435995.0,430797.0,1261644.0,6418.296016002895,631285.0,624845.0,,16316.370699999798,154027.56619999054,154030.31019999002,153922.10939998715,77535.14519999627,77872.59220000659,78273.52910000646,21.0,10029642.345000004,3285974.7900000005,883013420.0699998,304694826.95250005,12868083.674999995,39278.25,21.0,1659.0,-3059321.0,1558108.0,-1585963.0,-1697625.0,-10.0,7650.0,0.0,125626.5,73107.0,0.0,0.0,0.0,0.0,-630.0,1207.0,-23.0,-961.0,35105960.025,511456468.005,575678964.915,8053767.09,511411468.005,35416.0,-2431619.0,548849046.0,25662944.0,122924417.0,57821977.0,126257037.0,35404.0,558.0,91.31775361532344,1005621.0,305181.0,182895.5,-596145.0,314989.0,1323.0,405437741.6399918,402836841.6299937,-25189443.0,-25005865.0,491497.0,19348.0,391891393.53000015,1010304000.0,33512127.75,45221721.25500003,838498.5,10850798.115,22634299.53,50254137.76500032,46325474.28000014,375664311.5399993,390546953.8650004,390564325.8000004,1914.0,4210.0,23.0,2273.0,151329.0,-246951.0,89050.0,316.0,1465782.0,14719961.0,3229007.0,8545676.0,11595021.0,1414105.0,1056670031.0520012,801033914.542495,72026125603.3121,21653377239.87012,581630461.1594988,5792395.7475,689.5,94245.0,-276641201.0,21866358.5,-123666743.5,-218484460.5,-2013403.0,5915694878.707461,18698006250.0,198609920.325,447364641.75749767,1948107.735,256448094.2775008,308755681.51499873,635660979.4799982,458498248.4024992,5701101283.575028,5879038299.187497,5879281481.932498,13365.0,80723.5,44.0,70251.5,970579.0,-1696573.5,177364.0,6755.0,4268184.5,2476514.5,-8994151.0,921269.0,37582.5,3729374364.779964,3653928576.809962,-260357892.0,-257050765.5,2523909.0,268911.5,3922010123.264957,33222462552.94591,36648112004.707634,1727756653.8150494,48035730703.47822,3983808.0,-247323779.5,102974270118.0,1052642568.5,17257625672.0,3499829408.0,18870907391.5,3668160.0,71840.5,20851.341265829346,89708770.5,-80.66503088247738,0.375,22.11166390270868,715.993851140038,8.291873963515755,268.4976941775143,90000.0,-0.9009688679024191,-0.433883739117558,0.0,0.0,0.0,0.0,0.0,0.0,1.0,0.0,0.0,0.0,0.0,0.0,0.0,1.0,0.0,0.0,0.0,0.0,1.0,0.0,1.0,0.0,0.0,0.0,0.0,1.0,0.0,0.0,0.0,0.0,0.0,0.0,0.0,0.0,0.0,0.0,0.0,0.0,1.0,0.0,0.0,0.0,0.0,0.0,0.0,0.0,0.0,0.0,0.0,0.0,0.0,0.0,0.0,1.0,0.0,0.0,0.0,0.0,0.0,0.0,0.0,0.0,0.0,0.0,0.0,0.0,0.0,0.0,0.0,0.0,0.0,0.0,0.0,0.0,0.0,0.0,0.0,0.0,0.0,0.0,0.0,0.0,0.0,0.0,0.0,0.0,0.0,0.0,0.0,0.0,0.0,0.0,0.0,0.0,0.0,0.0,0.0,0.0,0.0,0.0,0.0,0.0,0.0,0.0,0.0,0.0,0.0,0.0,1.0,0.0,1.0,0.0,0.0,0.0,0.0,0.0,0.0,1.0,0.0,0.0
100568,1,0.0,1.0,0.0,0.0,0.0,112500.0,312768.0,24709.5,270000.0,0.02461,27.446575342465756,-464.0,-4394.0,-2671.0,,2.0,2.0,2.0,14.0,,0.3197248970630974,0.0441303158529594,0.0577,0.0819,0.9871,0.8232,0.0334,0.0,0.1379,0.125,0.1667,0.0,0.0471,0.0625,0.0,0.0,0.0588,0.085,0.9871,0.8301,0.0337,0.0,0.1379,0.125,0.1667,0.0,0.0514,0.0651,0.0,0.0,0.0583,0.0819,0.9871,0.8256,0.0336,0.0,0.1379,0.125,0.1667,0.0,0.0479,0.0636,0.0,0.0,0.0674,1.0,0.0,0.0,0.0,0.0,-207.0,0.0,0.0,0.0,0.0,2.0,2.0,1.0,1.0,1.0,1.0,1.0,0.0,0.0,0.0,0.0,0.0,1.0,1.0,0.0,1.0,0.0,0.0,0.0,0.0,0.0,0.0,0.0,0.0,0.0,0.0,0.0,0.0,0.0,0.0,0.0,0.0,0.0,0.0,7.0,5024.25,8178.885,75375.0,0.0,0.0,0.0,0.0,0.0,-319.0,-78.0,-189.0,-261.5,117.0,-8.0,5.0,9018.9,73615.5,74191.5,0.0,73615.5,11.0,-202.0,365243.0,-165.0,365243.0,165.0,365243.0,15.0,0.0,0.0,15.0,20.0,10.0,8.0,-16.5,0.0,0.0,18.0,8801.685,8801.685,-489.5,-476.0,4.0,1.0,0.0,,,,,,,,,,,,,,,,,,,,,8337685351.5,184240196149.5,165443425497.0,51918227110.935,1862.0,1703.0,71124.0,70651.0,9140.0,505532.0,17790.4213000023,17852.467399999117,17304.349799998083,11284.693800000085,11222.52170000009,11170.04080000006,128264.0,662097.0,4134.721600000122,4132.353600000017,3943.176300000095,13513947.890410556,-601266454.0,-920955444.0,-296169047.0,-1533604431.0416667,43959.0,30662.0,11339.693199999172,11215.599999998964,10700.229799997302,22865.095400009614,22786.96170000958,22173.07130000813,,157876.44778277175,125979.15038910914,34965.80290002787,34906.21950002831,34352.882600028715,22931.620099995933,22905.067599995506,22552.456699995742,3710387.0,8287.815800000168,8392.22000000008,8115.979000000227,9808.699600000718,9923.53480000216,10282.811399999648,16452.50279999975,16637.5152999997,16234.463399999704,828.1202000001758,813.3013000000458,759.2885000000133,3909.068500000125,3892.28700000016,3725.038200000157,435995.0,430797.0,,6418.3206260028965,631287.0,624847.0,,16316.438099999796,154028.55329999054,154031.29729999002,153923.09649998715,77535.96839999627,77873.41780000659,78274.35920000648,11.0,10052806.095000004,3382245.6750000007,894141060.5699998,305773908.84000003,12871473.749999994,39278.25,21.0,1659.0,-3100718.0,1585070.0,-1609793.0,-1720223.5,-5.0,0.0,8178.885,75375.0,0.0,0.0,0.0,0.0,0.0,-556.0,-301.0,-295.0,-301.0,35395589.92500001,514274759.505,578541203.415,8265559.59,514274759.505,35712.0,-2455014.0,556883328.0,26374795.0,125832510.0,58540712.0,128799807.0,35754.0,561.0,93.59769561613722,1016320.0,308675.0,184967.0,-601952.5,314992.0,1326.0,408588524.1224906,406019354.28749245,-25365528.5,-25180492.5,493987.5,19583.5,,,,,,,,,,,,,,,,,,,,,1465789.0,14720078.0,3229007.0,8545696.0,11595039.0,1414110.0,1056675055.3020012,801042093.427495,72026200978.3121,21653377239.87012,581630461.1594988,5792395.7475,689.5,94245.0,-276641520.0,21866280.5,-123666932.5,-218484722.0,-2013411.0,,,,,,,,,,,,,,,,,,,,,4268194.5,2476522.5,-8994167.5,921269.0,37582.5,3729383166.464964,3653937378.4949617,-260358381.5,-257051241.5,2523913.0,268912.5,3922019142.164956,33222536168.44591,36648186196.207634,1727756653.8150494,48035804318.97822,3983819.0,-247323981.5,102974635361.0,1052642403.5,17257990915.0,3499829573.0,18871272634.5,3668175.0,71840.5,20851.341265829346,89708785.5,-16.905569974046713,2.78016,4.5529047532325615,124.96164333666798,12.657803678747038,347.41336233887085,56250.0,-0.9009688679024191,-0.433883739117558,0.0,0.0,0.0,0.0,0.0,0.0,1.0,0.0,0.0,0.0,0.0,0.0,0.0,1.0,0.0,0.0,0.0,0.0,1.0,0.0,1.0,0.0,0.0,0.0,0.0,1.0,0.0,0.0,0.0,0.0,0.0,0.0,0.0,0.0,0.0,0.0,0.0,0.0,0.0,0.0,0.0,0.0,0.0,0.0,1.0,0.0,0.0,0.0,0.0,0.0,0.0,0.0,0.0,0.0,0.0,0.0,0.0,0.0,0.0,0.0,0.0,0.0,0.0,0.0,0.0,0.0,0.0,0.0,0.0,0.0,0.0,0.0,0.0,0.0,0.0,0.0,0.0,0.0,0.0,0.0,0.0,0.0,0.0,0.0,0.0,0.0,0.0,0.0,0.0,0.0,0.0,0.0,0.0,0.0,0.0,1.0,0.0,0.0,0.0,0.0,0.0,0.0,0.0,0.0,0.0,0.0,0.0,0.0,1.0,0.0,1.0,0.0,0.0,0.0,0.0,0.0,0.0,0.0,1.0,0.0
100569,0,0.0,0.0,0.0,1.0,1.0,225000.0,400392.0,42174.0,360000.0,0.009334,41.7890410958904,-6186.0,-5.0,-5219.0,,3.0,2.0,2.0,11.0,,0.6745249480913912,,,,,,,,,,,,,,,,,,,,,,,,,,,,,,,,,,,,,,,,,,,,,,0.0,0.0,0.0,0.0,-1459.0,,,,,,,1.0,1.0,0.0,1.0,0.0,0.0,0.0,0.0,0.0,0.0,0.0,0.0,0.0,1.0,0.0,0.0,0.0,0.0,0.0,0.0,0.0,0.0,0.0,0.0,0.0,0.0,0.0,0.0,0.0,0.0,0.0,0.0,0.0,,,,,,,,,,,,,0.0,,6.0,33503.0175,135877.5,110594.25,22500.0,168070.5,9.0,-761.5,365243.0,-992.0,-812.0,-782.0,-806.0,16.5,0.0,0.1225239525122524,24.5,37.0,12.0,4.0,-29.0,0.0,0.0,38.0,33269.355,33269.355,-875.0,-872.0,4.5,1.0,0.0,,,,,,,,,,,,,,,,,,,,,8337727525.5,184240596541.5,165443785497.0,51918452110.935,,,,,,,,,,,,,128265.0,662100.0,,,,13513989.67945165,-601272640.0,-920960663.0,-296170506.0,-1533604436.0416667,43959.0,30662.0,,,,,,,,157877.12230771984,,,,,,,,3710398.0,,,,,,,,,,,,,,,,435995.0,430797.0,,6418.329960002897,631289.0,624849.0,,,,,,,,,,,,,,,,,,,,,,,,,,,,,,,,,,,35476686.99000001,514881130.005,579103487.415,8324914.59,515038630.005,35756.0,-2458490.5,558161678.5,26371815.5,125830786.5,58538798.5,128798096.5,35845.0,561.5,94.06435227104818,1016964.5,308943.0,185107.0,-602689.0,314992.0,1326.0,409034334.2849904,406417705.1324924,-25387347.5,-25201940.5,494134.0,19612.5,,,,,,,,,,,,,,,,,,,,,1465789.0,14720078.0,3229007.0,8545733.0,11595077.0,1414116.0,,,,,,,,,,,,,,,,,,,,,,,,,,,,,,,,,,4268206.5,2476526.5,-8994196.5,921269.0,37582.5,3729416435.819964,3653970647.8499618,-260359256.5,-257052113.5,2523917.5,268913.5,3922052645.182456,33222672045.94591,36648296790.457634,1727779153.8150494,48035972389.47822,3983828.0,-247324743.0,102975000604.0,1052641411.5,17257990103.0,3499828791.0,18871271828.5,3668191.5,71840.5,20851.46378978185,89708810.0,-148.02924014947882,1.77952,5.335040546308152,222.94622863791295,9.493811352966285,396.7372727857389,75000.0,1.0,0.0,0.0,0.0,0.0,0.0,0.0,0.0,1.0,0.0,1.0,0.0,0.0,0.0,0.0,0.0,0.0,1.0,0.0,0.0,0.0,0.0,1.0,0.0,0.0,0.0,0.0,1.0,0.0,0.0,0.0,0.0,0.0,0.0,0.0,1.0,0.0,0.0,0.0,0.0,0.0,0.0,0.0,0.0,0.0,0.0,0.0,0.0,0.0,0.0,0.0,0.0,0.0,0.0,0.0,0.0,0.0,0.0,0.0,0.0,0.0,0.0,0.0,0.0,0.0,0.0,0.0,0.0,0.0,0.0,0.0,0.0,0.0,0.0,0.0,0.0,0.0,0.0,0.0,1.0,0.0,0.0,0.0,0.0,0.0,0.0,0.0,0.0,0.0,0.0,0.0,0.0,0.0,0.0,0.0,0.0,0.0,0.0,0.0,0.0,0.0,0.0,0.0,0.0,0.0,0.0,0.0,0.0,0.0,0.0,0.0,0.0,0.0,0.0,0.0,0.0,0.0,0.0,0.0,0.0,0.0,0.0
100591,0,0.0,1.0,1.0,1.0,0.0,180000.0,328405.5,26077.5,283500.0,0.01885,45.64109589041096,-243.0,-2132.0,-186.0,42.0,2.0,2.0,2.0,9.0,0.4672815702413091,0.7045564897720468,,,,,,,,,,,,,,,,,,,,,,,,,,,,,,,,,,,,,,,,,,,,,,2.0,0.0,2.0,0.0,-2687.0,,,,,,,1.0,1.0,0.0,1.0,0.0,0.0,0.0,1.0,1.0,0.0,1.0,1.0,0.0,1.0,0.0,0.0,0.0,0.0,0.0,0.0,0.0,0.0,0.0,0.0,0.0,0.0,0.0,0.0,0.0,0.0,0.0,0.0,0.0,,,,,,,,,,,,,0.0,,5.0,9725.4225,75807.0,75807.0,1190.25,161653.5,11.0,-399.0,365243.0,-459.5,182436.5,50.5,182439.0,9.0,0.0,0.0544545454545454,-1.0,37.0,12.0,9.0,-17.0,0.0,0.0,49.0,7075.845,7075.845,-284.0,-279.0,6.0,1.0,13.0,140717.655,247500.0,4050.0,0.0,0.0,0.0,0.0,11137.5,0.0,129870.0,130745.115,130745.115,1.0,0.0,0.0,0.0,0.0,-8.0,0.0,0.0,8337753603.0,184240924947.0,165444068997.0,51918632110.935,,,,,,,,,,,,,128265.0,662102.0,,,,13514035.32054754,-601272883.0,-920960849.0,-296173193.0,-1533606568.0416667,43959.0,30662.0,,,,,,,67371.22523064663,157877.8268642096,,,,,,,,3710407.0,,,,,,,,,,,,,,,,435997.0,430799.0,1261686.0,6418.348810002897,631291.0,624851.0,,,,,,,,,,,,,,,,,,,,,,,,,,,,,,,,,,,36735391.55250001,531691552.35,596981163.915,8611071.435,531871552.35,36836.0,-2535842.0,576787703.5,27047569.5,131087786.5,60332963.0,134055614.0,37151.0,576.5,98.0772221542586,1041239.0,318740.0,191216.0,-619234.0,315696.0,1362.0,422650961.59499234,420896173.7699942,-26084310.0,-25892244.0,509040.0,20388.0,401483751.8849999,1052037000.0,35055402.75,46959568.60500003,880618.5,11003250.465,23163789.465,52150185.13500042,48161118.91500017,384558521.62499934,400023619.51500016,400040991.45000017,2017.0,4337.0,24.0,2296.0,155911.0,-252658.0,89069.0,316.0,1465789.0,14720078.0,3229020.0,8545770.0,11595126.0,1414121.0,,,,,,,,,,,,,,5915835596.362461,18698253750.0,198613970.325,447364641.75749767,1948107.735,256448094.2775008,308755681.51499873,635672116.9799982,458498248.4024992,5701231153.575028,5879169044.302497,5879412227.047498,13366.0,80723.5,44.0,70251.5,970579.0,-1696581.5,177364.0,6755.0,4268218.5,2476535.5,-8994213.5,921269.0,37582.5,3729423511.664964,3653977723.6949615,-260359540.5,-257052392.5,2523923.5,268914.5,3922062370.604956,33222747852.94591,36648372597.457634,1727780344.0650494,48036134042.97822,3983839.0,-247325142.0,102975365847.0,1052640952.0,17258172539.5,3499828841.5,18871454267.5,3668200.5,71840.5,20851.518244327308,89708809.0,-5.324149108589952,1.824475,6.9025021570319245,315.0377628328625,12.59344262295082,574.7785223444869,90000.0,1.0,0.0,0.0,0.0,0.0,0.0,0.0,1.0,0.0,0.0,1.0,0.0,0.0,0.0,0.0,0.0,0.0,0.0,0.0,0.0,1.0,0.0,1.0,0.0,0.0,0.0,0.0,1.0,0.0,0.0,0.0,0.0,0.0,0.0,0.0,0.0,0.0,0.0,0.0,0.0,0.0,0.0,0.0,0.0,0.0,0.0,0.0,0.0,1.0,0.0,0.0,0.0,0.0,0.0,0.0,0.0,0.0,0.0,0.0,0.0,0.0,0.0,0.0,0.0,0.0,0.0,0.0,0.0,0.0,0.0,0.0,0.0,0.0,0.0,0.0,0.0,0.0,0.0,0.0,0.0,0.0,0.0,0.0,0.0,0.0,0.0,0.0,0.0,0.0,0.0,1.0,0.0,0.0,0.0,0.0,0.0,0.0,0.0,0.0,0.0,0.0,0.0,0.0,0.0,0.0,0.0,0.0,0.0,0.0,0.0,0.0,0.0,0.0,0.0,0.0,0.0,0.0,0.0,0.0,0.0,0.0,0.0
100592,0,0.0,0.0,0.0,1.0,0.0,180000.0,831730.5,30006.0,702000.0,0.025164,57.884931506849306,,-455.0,-4284.0,,1.0,2.0,2.0,14.0,,0.6206767695433769,0.7898803468924867,0.1227,0.0598,0.9945,0.9252,0.0208,0.12,0.1034,0.375,0.4167,0.0147,0.1,0.1198,0.0,0.0,0.125,0.0621,0.9945,0.9281,0.021,0.1208,0.1034,0.375,0.4167,0.015,0.1093,0.1248,0.0,0.0,0.1239,0.0598,0.9945,0.9262,0.0209,0.12,0.1034,0.375,0.4167,0.015,0.1018,0.1219,0.0,0.0,0.099,1.0,0.0,0.0,0.0,0.0,0.0,0.0,0.0,0.0,0.0,0.0,1.0,1.0,0.0,0.0,1.0,0.0,0.0,0.0,0.0,0.0,0.0,0.0,0.0,0.0,0.0,0.0,0.0,1.0,0.0,0.0,0.0,0.0,0.0,0.0,0.0,0.0,0.0,0.0,0.0,0.0,0.0,0.0,0.0,3.0,0.0,,69750.0,225753.75,0.0,0.0,0.0,0.0,-2252.0,-83.0,-104.0,-1029.5,166.0,-33.5,7.0,14287.59,130500.0,160726.5,0.0,130500.0,18.0,-2207.0,365243.0,-2569.5,-2157.5,-2157.5,-2146.5,9.0,1.0,0.0,0.0,61.0,12.0,5.0,-74.0,0.0,0.0,71.0,26275.23,18063.0,-2061.0,-2073.0,7.0,1.0,0.0,,,,,,,,,,,,,,,,,,,,,8337783609.0,184241756677.5,165444770997.0,51918812110.935,1862.0,1703.0,71124.0,70651.0,9140.0,505533.0,17790.5440000023,17852.591299999116,17304.474799998083,11284.753600000084,11222.581500000091,11170.102900000058,128265.0,662103.0,4134.742400000122,4132.374500000017,3943.1973000000953,13514093.205479044,,-920965133.0,-296173193.0,-1533607023.0416667,43959.0,30662.0,11339.813199999173,11215.719999998964,10700.350599997302,22865.198800009613,22787.06510000958,22173.17470000813,,157878.44754097913,125979.94026945606,34966.17790002787,34906.59450002831,34353.257600028715,22932.03679999593,22905.484299995507,22552.873399995744,3710421.0,8287.830500000167,8392.235000000079,8115.994000000227,9808.79960000072,9923.63660000216,10282.920699999648,16452.62259999975,16637.6371999997,16234.588199999704,828.1202000001758,813.3013000000458,759.2885000000133,3909.068500000125,3892.28700000016,3725.038200000157,435997.0,430799.0,,6418.373974002897,631293.0,624853.0,,16316.537099999798,154029.54779999054,154032.29179999002,153924.09099998715,77536.89359999629,77874.34400000659,78275.28730000647,75.0,10144054.845000004,,919656527.4899997,313952517.9000001,13627681.919999994,39278.25,23.0,1659.0,-3219315.0,1599721.0,-1674270.0,-1784389.5,-37.0,0.0,,69750.0,0.0,0.0,0.0,0.0,0.0,-2252.0,-83.0,-104.0,-111.0,36818939.92500001,532811359.35,598311750.915,8611071.435,532811359.35,36932.0,-2545824.0,578248675.5,27040938.5,131264230.5,60328051.5,134232096.5,37213.0,579.5,98.0772221542586,1041263.0,319582.0,191662.0,-621858.0,315711.0,1377.0,423656924.3549931,421789308.0749944,-26172449.0,-25980007.0,509550.0,20450.0,,,,,,,,,,,,,,,,,,,,,1465792.0,14720244.0,3229020.0,8545831.0,11595197.0,1414128.0,1056675055.3020012,,72026270728.3121,21653602993.62012,581630461.1594988,5792395.7475,689.5,94245.0,-276643772.0,21866197.5,-123667036.5,-218485751.5,-2013444.5,,,,,,,,,,,,,,,,,,,,,4268230.5,2476540.5,-8994287.5,921269.0,37582.5,3729449786.894964,3653995786.6949615,-260361601.5,-257054465.5,2523930.5,268915.5,3922076658.194956,33222878352.94591,36648533323.957634,1727780344.0650494,48036264542.97822,3983857.0,-247327349.0,102975731090.0,1052638382.5,17258170382.0,3499826684.0,18871452121.0,3668209.5,71841.5,20851.518244327308,89708809.0,,4.620725,5.9988002399520095,347.2401410128933,27.71880623875225,1604.5012005818014,180000.0,1.0,0.0,0.0,0.0,0.0,0.0,0.0,0.0,1.0,0.0,0.0,1.0,0.0,0.0,0.0,0.0,0.0,0.0,0.0,0.0,1.0,0.0,0.0,0.0,0.0,1.0,0.0,1.0,0.0,0.0,0.0,0.0,0.0,0.0,0.0,0.0,0.0,0.0,0.0,0.0,0.0,0.0,0.0,0.0,0.0,0.0,0.0,0.0,0.0,0.0,0.0,0.0,0.0,0.0,0.0,0.0,0.0,0.0,0.0,0.0,0.0,0.0,0.0,0.0,0.0,0.0,0.0,0.0,0.0,0.0,0.0,0.0,0.0,0.0,0.0,0.0,0.0,0.0,0.0,0.0,0.0,0.0,0.0,0.0,0.0,0.0,0.0,0.0,0.0,0.0,0.0,0.0,0.0,0.0,0.0,0.0,0.0,0.0,0.0,0.0,0.0,0.0,0.0,0.0,0.0,0.0,0.0,1.0,0.0,0.0,1.0,0.0,1.0,0.0,0.0,0.0,0.0,0.0,0.0,1.0,0.0,0.0
100602,0,0.0,0.0,0.0,0.0,0.0,99000.0,450000.0,23008.5,450000.0,0.04622,28.246575342465757,-968.0,-1625.0,-2079.0,,1.0,1.0,1.0,9.0,0.287061594916605,0.6785637263083949,,,,,,,,,,,,,,,,,,,,,,,,,,,,,,,,,,,,,,,,,,,,,,0.0,0.0,0.0,0.0,-1371.0,,,,,,,1.0,1.0,1.0,1.0,0.0,0.0,0.0,0.0,0.0,0.0,0.0,0.0,0.0,1.0,0.0,0.0,0.0,0.0,0.0,0.0,0.0,0.0,0.0,0.0,0.0,0.0,0.0,0.0,0.0,0.0,0.0,0.0,0.0,,,,,,,,,,,,,0.0,,2.0,16936.47,119137.5,115121.25,4016.25,119137.5,8.0,-831.5,365243.0,-800.5,181996.5,-590.5,182000.5,12.5,0.0,0.0544545454545454,619.5,15.0,12.0,5.0,-8.0,0.0,0.0,13.0,15127.875,15127.875,-219.0,-201.0,4.0,2.0,0.0,,,,,,,,,,,,,,,,,,,,,8337806617.5,184242206677.5,165445220997.0,51918911110.935,,,,,,,,,,,,,128265.0,662104.0,,,,13514121.452054389,-601273851.0,-920967212.0,-296174564.0,-1533608648.0416667,43959.0,30662.0,,,,,,,67371.51229224155,157879.12610470547,,,,,,,,3710430.0,,,,,,,,,,,,,,,,435997.0,430799.0,,6418.420194002897,631294.0,624854.0,,,,,,,,,,,,,,,,,,,,,,,,,,,,,,,,,,,37520185.07250001,543554870.76,610162338.915,8784159.345,543554870.76,37732.0,-2601190.0,590301272.5,27728745.5,135065062.5,61759013.5,137667821.5,37860.0,591.0,100.17829134991766,1066355.5,325372.0,195448.0,-636095.0,315750.0,1390.0,430677051.34499216,428499589.00499326,-26599241.0,-26403349.0,512212.0,20798.0,,,,,,,,,,,,,,,,,,,,,1465792.0,14720244.0,3229020.0,8545846.0,11595210.0,1414130.0,,,,,,,,,,,,,,,,,,,,,,,,,,,,,,,,,,4268242.5,2476545.5,-8994295.5,921269.0,37582.5,3729464914.769964,3654010914.5699615,-260361820.5,-257054666.5,2523934.5,268917.5,3922093594.664956,33222997490.44591,36648648445.207634,1727784360.3150494,48036383680.47822,3983865.0,-247328180.5,102976096333.0,1052637582.0,17258352378.5,3499826093.5,18871634121.5,3668222.0,71841.5,20851.57269887277,89709428.5,-34.26964112512124,4.545454545454546,4.302757676510855,121.53816888993676,19.557989438685706,552.4462222269851,99000.0,1.0,0.0,0.0,1.0,0.0,0.0,0.0,0.0,0.0,0.0,0.0,0.0,0.0,0.0,0.0,1.0,0.0,0.0,0.0,0.0,1.0,0.0,0.0,0.0,1.0,0.0,0.0,1.0,0.0,0.0,0.0,0.0,0.0,0.0,0.0,0.0,0.0,0.0,0.0,0.0,0.0,0.0,0.0,1.0,0.0,0.0,0.0,0.0,0.0,0.0,0.0,0.0,0.0,0.0,0.0,0.0,0.0,0.0,0.0,0.0,0.0,0.0,0.0,0.0,0.0,0.0,0.0,0.0,0.0,0.0,0.0,0.0,0.0,0.0,0.0,0.0,0.0,0.0,0.0,0.0,1.0,0.0,0.0,0.0,0.0,0.0,0.0,0.0,0.0,0.0,0.0,0.0,0.0,0.0,0.0,0.0,0.0,0.0,0.0,0.0,0.0,0.0,0.0,0.0,0.0,0.0,0.0,0.0,0.0,0.0,0.0,0.0,0.0,0.0,0.0,0.0,0.0,0.0,0.0,0.0,0.0,0.0
100607,0,0.0,1.0,1.0,1.0,0.0,135000.0,450000.0,23107.5,450000.0,0.028663,46.816438356164376,-1727.0,-10415.0,-637.0,8.0,2.0,2.0,2.0,9.0,,0.6467135635803658,0.5478104658520093,0.0887,0.0804,0.9806,,,0.04,0.1207,0.25,,,,0.0561,,0.0,0.0756,0.048,0.9757,,,0.0,0.069,0.1667,,,,0.0533,,0.0,0.0895,0.0804,0.9806,,,0.04,0.1207,0.25,,,,0.0571,,0.0,0.0785,1.0,6.0,0.0,6.0,0.0,-1472.0,0.0,0.0,0.0,0.0,0.0,3.0,1.0,1.0,0.0,1.0,0.0,0.0,0.0,0.0,0.0,0.0,0.0,0.0,0.0,1.0,0.0,0.0,0.0,0.0,0.0,0.0,0.0,0.0,0.0,0.0,0.0,0.0,0.0,0.0,0.0,0.0,0.0,0.0,4.0,4338.0,,553500.0,143679.015,0.0,0.0,0.0,0.0,-984.5,649.0,-113.0,-306.0,117.0,-14.0,3.0,12854.52,135000.0,152820.0,0.0,135000.0,24.0,-1833.0,365243.0,-2177.5,-1517.5,-1487.5,-1513.0,14.0,0.5,0.0,-1.0,48.0,24.0,12.5,-61.5,0.0,0.0,55.0,10750.905,10750.905,-1924.0,-1929.0,14.0,1.0,0.0,,,,,,,,,,,,,,,,,,,,,8337829725.0,184242656677.5,165445670997.0,51919046110.935,1862.0,1703.0,71124.0,70651.0,9140.0,505536.0,17790.6327000023,17852.680799999114,17304.550399998083,11284.834000000086,11222.661900000092,11170.15090000006,128265.0,662106.0,,,,13514168.268492743,-601275578.0,-920967849.0,-296176036.0,-1533619063.0416667,43959.0,30662.0,11339.853199999176,11215.759999998969,10700.350599997302,22865.319500009613,22787.18580000957,22173.24370000813,,157879.77281826903,125980.4880799219,34966.42790002787,34906.84450002831,34353.424300028724,,,,3710439.0,,,,,,,16452.67869999975,16637.6942999997,16234.641499999703,,,,3909.068500000125,3892.28700000016,3725.038200000157,436003.0,430805.0,1261694.0,6418.448857002897,631296.0,624856.0,,16316.615599999795,154030.52839999055,154033.27239999006,153925.06669998716,,,,33.0,10297648.845000004,,938606973.5249996,321729521.67,14004297.9,39278.25,23.0,1659.0,-3311045.5,1593701.0,-1734578.0,-1839734.0,-16.0,8676.0,,207000.0,132963.03,0.0,0.0,0.0,0.0,-1007.0,464.0,-220.0,-306.0,37780927.76250001,548353343.16,615158464.8149999,8840719.845,548353343.16,38180.0,-2632787.0,595777528.5,27708189.5,136328070.5,62111880.5,139663168.5,38272.0,593.5,101.02274579033012,1082903.0,328319.0,197231.0,-641610.5,315792.0,1395.0,432799290.0449925,430622199.58499366,-26880338.0,-26681693.0,517064.0,20985.0,,,,,,,,,,,,,,,,,,,,,1465796.0,14720361.0,3229020.0,8545894.0,11595265.0,1414133.0,1056679393.3020012,,72026824228.3121,21653746672.63512,581630461.1594988,5792395.7475,689.5,94245.0,-276644756.5,21866846.5,-123667149.5,-218486057.5,-2013458.5,,,,,,,,,,,,,,,,,,,,,4268266.5,2476558.0,-8994357.0,921269.0,37582.5,3729475665.674964,3654021665.4749618,-260363744.5,-257056595.5,2523948.5,268918.5,3922106449.184956,33223132490.44591,36648801265.207634,1727784360.3150494,48036518680.47822,3983889.0,-247330013.5,102976461576.0,1052635404.5,17258350861.0,3499824606.0,18871632608.5,3668236.0,71842.0,20851.57269887277,89709427.5,-36.88875234082397,3.333333333333333,5.8422590068159685,273.5137586533459,19.474196689386567,911.7125288444864,67500.0,1.0,0.0,0.0,0.0,0.0,0.0,0.0,0.0,1.0,0.0,1.0,0.0,0.0,0.0,0.0,0.0,0.0,0.0,0.0,0.0,1.0,0.0,1.0,0.0,0.0,0.0,0.0,1.0,0.0,0.0,0.0,0.0,0.0,0.0,0.0,0.0,0.0,0.0,0.0,0.0,1.0,0.0,0.0,0.0,0.0,0.0,0.0,0.0,0.0,0.0,0.0,0.0,0.0,0.0,0.0,0.0,0.0,1.0,0.0,0.0,0.0,0.0,0.0,0.0,0.0,0.0,0.0,0.0,0.0,0.0,0.0,0.0,0.0,0.0,0.0,0.0,0.0,0.0,0.0,0.0,0.0,0.0,0.0,0.0,0.0,0.0,0.0,0.0,0.0,0.0,0.0,0.0,0.0,0.0,0.0,0.0,0.0,0.0,0.0,0.0,0.0,0.0,0.0,0.0,0.0,0.0,0.0,0.0,0.0,0.0,0.0,0.0,1.0,0.0,0.0,0.0,0.0,0.0,0.0,0.0,1.0,0.0
100613,0,0.0,1.0,0.0,1.0,0.0,45000.0,526491.0,24525.0,454500.0,0.018209,61.86301369863013,,-1595.0,-3913.0,,2.0,3.0,3.0,7.0,,0.5898375066653111,,,,,,,,,,,,,,,,,,,,,,,,,,,,,,,,,,,,,,,,,,,,,,0.0,0.0,0.0,0.0,-1400.0,,,,,,,1.0,0.0,0.0,1.0,1.0,0.0,0.0,0.0,0.0,0.0,0.0,0.0,0.0,1.0,0.0,0.0,0.0,0.0,0.0,0.0,0.0,0.0,0.0,0.0,0.0,0.0,0.0,0.0,0.0,0.0,0.0,0.0,0.0,,,,,,,,,,,,,0.0,,4.0,10079.37,78689.25,79431.75,0.0,78689.25,9.0,-517.5,365243.0,-487.0,-337.0,-247.0,-332.0,8.5,0.5,0.0,125.0,36.0,12.0,4.0,-20.5,0.0,0.0,31.0,11521.035,11521.035,-651.0,-615.0,4.0,1.0,0.0,,,,,,,,,,,,,,,,,,,,,8337854250.0,184243183168.5,165446125497.0,51919091110.935,,,,,,,,,,,,,128265.0,662108.0,,,,13514230.131506445,,-920971762.0,-296177436.0,-1533620658.0416667,43959.0,30662.0,,,,,,,,157880.36265577574,,,,,,,,3710446.0,,,,,,,,,,,,,,,,436003.0,430805.0,,6418.467066002897,631299.0,624859.0,,,,,,,,,,,,,,,,,,,,,,,,,,,,,,,,,,,38042446.02750001,551897151.66,619034548.8149999,8900493.345,551897151.66,38425.0,-2653815.0,601253060.5,27689893.0,138142727.0,63199203.0,141477933.0,38605.5,600.5,101.84321503497031,1085163.0,331056.0,198887.0,-647737.0,315838.0,1395.0,437012540.9549919,434655797.30999327,-27167880.0,-26967636.0,522628.0,21175.0,,,,,,,,,,,,,,,,,,,,,1465796.0,14720361.0,3229020.0,8545930.0,11595296.0,1414137.0,,,,,,,,,,,,,,,,,,,,,,,,,,,,,,,,,,4268278.5,2476562.0,-8994377.5,921269.0,37582.5,3729487186.709964,3654033186.5099616,-260364395.5,-257057210.5,2523952.5,268919.5,3922116528.554957,33223211179.69591,36648880696.957634,1727784360.3150494,48036597369.72822,3983898.0,-247330531.0,102976826819.0,1052634917.5,17258350524.0,3499824359.0,18871632276.5,3668244.5,71842.5,20851.57269887277,89709552.5,,11.6998,1.834862385321101,113.51011687822044,21.46752293577981,1328.0456654518032,22500.0,-0.2225209339563143,0.9749279121818236,0.0,0.0,0.0,0.0,0.0,0.0,1.0,0.0,0.0,1.0,0.0,0.0,0.0,0.0,0.0,0.0,0.0,1.0,0.0,0.0,1.0,0.0,0.0,0.0,0.0,1.0,0.0,0.0,0.0,0.0,0.0,0.0,0.0,0.0,0.0,0.0,0.0,0.0,0.0,0.0,0.0,0.0,0.0,0.0,0.0,0.0,0.0,0.0,0.0,0.0,0.0,0.0,0.0,0.0,0.0,0.0,0.0,0.0,0.0,0.0,0.0,0.0,0.0,0.0,0.0,0.0,0.0,0.0,0.0,0.0,0.0,0.0,0.0,0.0,0.0,0.0,0.0,0.0,0.0,0.0,0.0,0.0,0.0,0.0,0.0,0.0,0.0,0.0,0.0,0.0,0.0,0.0,0.0,0.0,0.0,0.0,0.0,0.0,0.0,0.0,0.0,0.0,0.0,0.0,0.0,1.0,0.0,0.0,0.0,0.0,0.0,0.0,0.0,0.0,0.0,0.0,0.0,0.0,0.0,0.0
100617,0,0.0,0.0,0.0,1.0,2.0,202500.0,481176.0,24696.0,360000.0,0.032561,33.24109589041096,-291.0,-6212.0,-3643.0,,4.0,1.0,1.0,14.0,0.4586972985060652,0.6011305056142987,0.1229554179088549,,,,,,,,,,,,,,,,,,,,,,,,,,,,,,,,,,,,,,,,,,,,,1.0,0.0,1.0,0.0,0.0,0.0,0.0,0.0,0.0,1.0,2.0,1.0,1.0,0.0,1.0,0.0,1.0,0.0,0.0,0.0,0.0,0.0,0.0,0.0,1.0,0.0,0.0,0.0,0.0,0.0,0.0,0.0,0.0,0.0,0.0,0.0,0.0,0.0,0.0,0.0,0.0,0.0,0.0,13.0,0.0,3948.75,52848.0,0.0,0.0,0.0,0.0,0.0,-1594.0,-1473.0,-40.0,-1515.0,710.0,-31.0,8.0,4521.555,33813.0,32046.75,5303.25,33813.0,11.0,-1985.5,365243.0,-2068.5,-1918.5,-1888.5,-1912.5,14.0,0.0,0.1051555789157531,100.0,69.0,10.0,4.5,-66.0,0.0,0.0,64.0,4364.64,4364.64,-2007.0,-1956.0,6.0,1.0,0.0,,,,,,,,,,,,,,,,,,,,,8337878946.0,184243664344.5,165446485497.0,51919293610.935,1862.0,1703.0,71124.0,70652.0,9140.0,505538.0,,,,,,,128267.0,662112.0,,,,13514263.372602334,-601275869.0,-920975405.0,-296177436.0,-1533626870.0416667,43959.0,30662.0,,,,,,,67371.97098954006,157880.96378628135,125980.6110353398,,,,,,,3710460.0,,,,,,,,,,,,,,,,436004.0,430806.0,,6418.499627002897,631300.0,624860.0,,,,,,,,,53.0,10297648.845000004,3444701.715000001,954602411.8499995,333083751.66,14319297.9,39300.75,23.0,1719.0,-3357772.0,1622197.5,-1754026.0,-1861409.0,-26.0,0.0,7897.5,52848.0,0.0,0.0,0.0,0.0,0.0,-1924.0,-1528.0,-40.0,-1557.0,38122168.140000015,552713307.3,619856179.0649999,8938745.235000001,552713307.3,38563.0,-2675154.5,604905490.5,27674053.0,138129467.0,63186603.0,141464772.5,38811.5,602.0,102.83331396652916,1100194.0,332628.0,199691.5,-652952.0,315889.0,1407.0,437859905.4449904,435450272.7149919,-27310538.5,-27108597.0,523490.0,21283.5,,,,,,,,,,,,,,,,,,,,,1465809.0,14721071.0,3229020.0,8545999.0,11595360.0,1414145.0,1056679393.3020012,801046042.177495,72026877076.3121,21653746672.63512,581630461.1594988,5792395.7475,689.5,94245.0,-276646350.5,21865373.5,-123667189.5,-218487572.5,-2013489.5,,,,,,,,,,,,,,,,,,,,,4268288.5,2476566.5,-8994443.5,921269.0,37582.5,3729491551.349964,3654037551.149962,-260366402.5,-257059166.5,2523958.5,268920.5,3922121050.109956,33223244992.69591,36648912743.707634,1727789663.5650494,48036631182.72822,3983909.0,-247332516.5,102977192062.0,1052632849.0,17258348605.5,3499822470.5,18871630364.0,3668258.5,71842.5,20851.67785445168,89709652.5,-8.754224017143327,2.3761777777777784,8.199708454810496,272.5672950197692,19.48396501457725,647.6683493749749,50625.0,-0.9009688679024191,-0.433883739117558,0.0,0.0,0.0,0.0,0.0,0.0,1.0,0.0,1.0,0.0,0.0,0.0,0.0,0.0,0.0,1.0,0.0,0.0,0.0,0.0,1.0,0.0,0.0,0.0,0.0,1.0,0.0,0.0,0.0,0.0,0.0,0.0,0.0,1.0,0.0,0.0,0.0,0.0,0.0,0.0,0.0,0.0,0.0,0.0,0.0,0.0,0.0,0.0,0.0,0.0,0.0,0.0,0.0,0.0,0.0,0.0,0.0,0.0,0.0,0.0,0.0,0.0,0.0,0.0,0.0,0.0,0.0,0.0,0.0,0.0,0.0,0.0,0.0,0.0,0.0,0.0,1.0,0.0,0.0,0.0,0.0,0.0,0.0,0.0,0.0,0.0,0.0,0.0,0.0,0.0,0.0,0.0,0.0,0.0,0.0,0.0,0.0,0.0,0.0,0.0,0.0,0.0,0.0,0.0,0.0,0.0,0.0,0.0,0.0,0.0,0.0,0.0,0.0,0.0,0.0,0.0,0.0,0.0,0.0,0.0
100618,0,0.0,0.0,1.0,0.0,0.0,202500.0,781920.0,39924.0,675000.0,0.02461,41.97808219178082,-534.0,-209.0,-5600.0,10.0,2.0,2.0,2.0,10.0,0.7015047869803831,0.5741292648365941,0.3046721837533529,,,,,,,,,,,,,,,,,,,,,,,,,,,,,,,,,,,,,,,,,,,,,0.0,0.0,0.0,0.0,-1310.0,0.0,0.0,0.0,0.0,1.0,6.0,1.0,1.0,1.0,1.0,1.0,0.0,0.0,0.0,0.0,0.0,1.0,1.0,0.0,1.0,0.0,0.0,0.0,0.0,0.0,0.0,0.0,0.0,0.0,0.0,0.0,0.0,0.0,0.0,0.0,0.0,0.0,0.0,6.0,0.0,0.0,675000.0,0.0,0.0,0.0,0.0,0.0,-1302.0,65.0,-191.5,-723.0,270.0,-24.0,7.0,24290.2575,495000.0,495000.0,0.0,517500.0,39.0,-849.0,365243.0,-1131.0,-830.0,130.0,-824.0,10.0,1.0,0.0,-1.0,80.0,48.0,37.0,-26.5,0.0,0.0,73.0,35912.16,35912.16,-765.0,-759.0,8.0,1.0,0.0,,,,,,,,,,,,,,,,,,,,,8337918870.0,184244446264.5,165447160497.0,51919496110.935,1862.0,1703.0,71124.0,70653.0,9140.0,505544.0,,,,,,,128267.0,662114.0,,,,13514305.350684524,-601276403.0,-920981005.0,-296178746.0,-1533627079.0416667,43959.0,30662.0,,,,,,,67372.67249432704,157881.5379155462,125980.91570752356,,,,,,,3710470.0,,,,,,,,,,,,,,,,436004.0,430806.0,1261704.0,6418.524237002896,631302.0,624862.0,,,,,,,,,43.0,10312972.965000002,3448650.465000001,957772579.1399996,333560337.66,14360831.37,39300.75,23.0,1719.0,-3369460.0,1620036.0,-1758723.5,-1866873.0,-21.0,0.0,0.0,225000.0,0.0,0.0,0.0,0.0,0.0,-1761.0,-816.0,-881.0,-1222.0,38231886.01500002,554302185.3,621596434.8149999,8952382.485000001,554866935.3,38715.0,-2687205.0,606914327.0,27664223.0,138121362.0,63179938.0,141456706.0,38907.0,605.0,103.2093737675903,1104771.0,334191.0,200772.0,-656581.0,315889.0,1407.0,440171267.89498967,437761635.1649912,-27407259.0,-27204754.0,523977.0,21355.0,,,,,,,,,,,,,,,,,,,,,1465815.0,14721341.0,3229020.0,8546079.0,11595433.0,1414152.0,1056679393.3020012,801046042.177495,72027552076.3121,21653746672.63512,581630461.1594988,5792395.7475,689.5,94245.0,-276647652.5,21865438.5,-123667381.0,-218488295.5,-2013513.5,,,,,,,,,,,,,,,,,,,,,4268336.5,2476603.5,-8994470.0,921269.0,37582.5,3729527463.509964,3654073463.309962,-260367167.5,-257059925.5,2523966.5,268921.5,3922145340.367456,33223739992.69591,36649407743.707634,1727789663.5650494,48037148682.72822,3983948.0,-247333365.5,102977557305.0,1052631718.0,17258347775.5,3499822600.5,18871629540.0,3668268.5,71843.5,20851.67785445168,89709651.5,-12.720924161336642,3.8613333333333335,5.072137060414788,212.9185864100696,19.58521190261497,822.1496349914153,101250.0,-0.2225209339563143,0.9749279121818236,0.0,0.0,0.0,0.0,0.0,0.0,1.0,0.0,0.0,0.0,0.0,0.0,0.0,1.0,0.0,0.0,0.0,0.0,1.0,0.0,1.0,0.0,0.0,0.0,0.0,1.0,0.0,0.0,0.0,0.0,0.0,0.0,0.0,0.0,0.0,0.0,0.0,0.0,1.0,0.0,0.0,0.0,0.0,0.0,0.0,0.0,0.0,0.0,0.0,0.0,0.0,0.0,0.0,0.0,0.0,0.0,0.0,0.0,0.0,0.0,0.0,0.0,0.0,0.0,0.0,0.0,0.0,0.0,1.0,0.0,0.0,0.0,0.0,0.0,0.0,0.0,0.0,0.0,0.0,0.0,0.0,0.0,0.0,0.0,0.0,0.0,0.0,0.0,0.0,0.0,0.0,0.0,0.0,0.0,0.0,0.0,0.0,0.0,0.0,0.0,0.0,0.0,0.0,0.0,0.0,0.0,0.0,0.0,0.0,0.0,0.0,0.0,0.0,0.0,0.0,0.0,0.0,0.0,0.0,0.0
100622,0,0.0,1.0,0.0,0.0,0.0,67500.0,111384.0,9058.5,90000.0,0.010147,28.68493150684932,-3064.0,-4531.0,-3055.0,,1.0,2.0,2.0,19.0,0.8142789488854446,0.2947234081267146,0.4206109640437848,,,,,,,,,,,,,,,,,,,,,,,,,,,,,,,,,,,,,,,,,,,,,0.0,0.0,0.0,0.0,-1391.0,0.0,0.0,0.0,0.0,2.0,3.0,1.0,1.0,1.0,1.0,1.0,0.0,0.0,0.0,0.0,0.0,0.0,0.0,0.0,1.0,0.0,0.0,0.0,0.0,0.0,0.0,0.0,0.0,0.0,0.0,0.0,0.0,0.0,0.0,0.0,0.0,0.0,0.0,6.0,0.0,,9000.0,0.0,0.0,0.0,0.0,0.0,-60.5,-44.5,-52.5,-67.0,43.0,-9.0,8.0,7767.405,67500.0,68985.0,0.0,90000.0,12.0,-389.0,365243.0,-507.0,182429.0,-87.0,182433.0,15.0,0.5,0.0,-1.0,33.0,12.0,9.0,-15.0,0.0,0.0,30.0,7767.405,7767.405,-465.0,-460.0,5.5,1.0,13.0,0.0,90000.0,,0.0,,,0.0,,0.0,0.0,0.0,0.0,,0.0,,,0.0,-7.0,0.0,0.0,8337927928.5,184244557648.5,165447250497.0,51919563610.935,1862.0,1703.0,71124.0,70655.0,9140.0,505547.0,,,,,,,128267.0,662115.0,,,,13514334.035616033,-601279467.0,-920984060.0,-296180137.0,-1533631610.0416667,43959.0,30662.0,,,,,,,67373.48677327593,157881.8326389543,125981.33631848762,,,,,,,3710489.0,,,,,,,,,,,,,,,,436004.0,430806.0,,6418.534384002896,631304.0,624864.0,,,,,,,,,2.5,10471975.965000002,,961104649.1399996,335569191.66,15130580.265,39300.75,23.0,1719.0,-3373300.0,1621072.0,-1760444.5,-1868677.0,-0.75,0.0,,51255.0,0.0,0.0,0.0,0.0,0.0,-915.0,-550.0,-539.0,-550.0,38381571.85500002,557087577.3,624820738.8149999,8976511.485000001,557087577.3,38898.0,-2699402.5,610382732.5,27835176.5,139027032.5,63722796.5,142362409.5,39122.5,608.0,103.9080790162573,1107832.5,336989.0,202829.0,-659979.0,315889.0,1407.0,443915908.8074895,441495026.07749104,-27547721.0,-27343551.5,527136.5,21457.5,422920747.7099999,1097298000.0,,49558406.89500002,,,24576367.63500002,,50073796.62000015,404931311.45999926,421264171.3949997,421281543.3299997,,4567.0,,,160145.0,-259722.0,89069.0,316.0,1465821.0,14721384.0,3229033.0,8546112.0,11595463.0,1414160.0,1056679393.3020012,,72027561076.3121,21653746672.63512,581630461.1594988,5792395.7475,689.5,94245.0,-276647713.0,21865394.0,-123667433.5,-218488362.5,-2013522.5,5915835596.362461,18698343750.0,,447364641.75749767,,,308755681.51499873,,458498248.4024992,5701231153.575028,5879169044.302497,5879412227.047498,,80723.5,,,970579.0,-1696588.5,177364.0,6755.0,4268348.5,2476612.5,-8994485.0,921269.0,37582.5,3729535230.914964,3654081230.7149615,-260367632.5,-257060385.5,2523972.0,268922.5,3922153107.772456,33223807492.69591,36649476728.707634,1727789663.5650494,48037238682.72822,3983960.0,-247333754.5,102977922548.0,1052631211.0,17258530204.5,3499822513.5,18871811973.0,3668283.5,71844.0,20851.67785445168,89709650.5,-106.81566380133717,1.6501333333333332,7.451564828614009,213.74762672764012,12.296075509190269,352.71208378417,67500.0,-0.9009688679024191,-0.433883739117558,0.0,0.0,0.0,0.0,0.0,0.0,1.0,0.0,0.0,0.0,0.0,0.0,0.0,1.0,0.0,0.0,0.0,0.0,1.0,0.0,0.0,0.0,1.0,0.0,0.0,0.0,0.0,0.0,0.0,1.0,0.0,0.0,0.0,0.0,0.0,0.0,0.0,0.0,1.0,0.0,0.0,0.0,0.0,0.0,0.0,0.0,0.0,0.0,0.0,0.0,0.0,0.0,0.0,0.0,0.0,0.0,0.0,0.0,0.0,0.0,0.0,0.0,0.0,0.0,0.0,0.0,0.0,0.0,0.0,0.0,0.0,0.0,0.0,0.0,0.0,0.0,0.0,0.0,0.0,0.0,0.0,0.0,0.0,0.0,0.0,0.0,0.0,0.0,0.0,0.0,1.0,0.0,0.0,0.0,0.0,0.0,0.0,0.0,0.0,0.0,0.0,0.0,0.0,0.0,0.0,0.0,0.0,0.0,0.0,0.0,0.0,0.0,0.0,0.0,0.0,0.0,0.0,0.0,0.0,0.0
100625,0,0.0,0.0,0.0,0.0,1.0,112500.0,735579.0,32400.0,585000.0,0.010032,33.16164383561644,-4358.0,-5809.0,-1419.0,,3.0,2.0,2.0,5.0,0.117470147229535,0.5837453979138977,,,,,,,,,,,,,,,,,,,,,,,,,,,,,,,,,,,,,,,,,,,,,,0.0,0.0,0.0,0.0,-2424.0,,,,,,,1.0,1.0,0.0,1.0,0.0,1.0,0.0,0.0,0.0,0.0,0.0,0.0,0.0,1.0,0.0,0.0,0.0,0.0,0.0,0.0,0.0,0.0,0.0,0.0,0.0,0.0,0.0,0.0,0.0,0.0,0.0,0.0,0.0,,,,,,,,,,,,,0.0,,5.0,14386.2525,135000.0,143910.0,2058.75,157500.0,18.0,-653.0,365243.0,-986.5,-523.5,-433.5,-518.5,5.0,1.0,0.0545021976492114,1.0,69.0,24.0,10.0,-28.0,0.0,0.0,74.0,15737.985,13034.52,-954.5,-945.0,8.0,1.0,0.0,,,,,,,,,,,,,,,,,,,,,8337960328.5,184245293227.5,165447835497.0,51919676110.935,,,,,,,,,,,,,128268.0,662118.0,,,,13514367.197259868,-601283825.0,-920985479.0,-296182561.0,-1533637419.0416667,43959.0,30662.0,,,,,,,67373.60424342316,157882.41638435223,,,,,,,,3710494.0,,,,,,,,,,,,,,,,436004.0,430806.0,,6418.5444160028965,631306.0,624866.0,,,,,,,,,,,,,,,,,,,,,,,,,,,,,,,,,,,38613729.55500002,558971893.8,627658015.8149999,9000665.235000001,559196893.8,39092.0,-2719288.0,615130160.5,27999759.5,140110197.0,64258775.5,143445643.0,39322.0,614.5,104.17289916010296,1108851.0,339879.0,204344.0,-667652.0,316048.0,1407.0,447039716.984989,444354356.42998976,-27810422.0,-27604546.0,530037.0,21632.5,,,,,,,,,,,,,,,,,,,,,1465821.0,14721384.0,3229033.0,8546181.0,11595537.0,1414165.0,,,,,,,,,,,,,,,,,,,,,,,,,,,,,,,,,,4268372.5,2476622.5,-8994513.0,921269.0,37582.5,3729550968.899964,3654094265.2349615,-260368587.0,-257061330.5,2523980.0,268923.5,3922167494.024956,33223942492.69591,36649620638.707634,1727791722.3150494,48037396182.72822,3983978.0,-247334407.5,102978287791.0,1052630224.5,17258529681.0,3499822080.0,18871811454.5,3668288.5,71845.0,20851.73235664933,89709651.5,-131.4168869795109,6.53848,3.4722222222222223,115.14459665144597,22.703055555555554,752.8706423135463,37500.0,-0.9009688679024191,0.4338837391175582,0.0,1.0,0.0,0.0,0.0,0.0,0.0,0.0,0.0,0.0,0.0,0.0,0.0,1.0,0.0,0.0,0.0,0.0,1.0,0.0,1.0,0.0,0.0,0.0,0.0,0.0,1.0,0.0,0.0,0.0,0.0,0.0,0.0,0.0,0.0,0.0,0.0,0.0,0.0,0.0,0.0,0.0,1.0,0.0,0.0,0.0,0.0,0.0,0.0,0.0,0.0,0.0,0.0,0.0,0.0,0.0,0.0,0.0,0.0,0.0,0.0,0.0,0.0,0.0,0.0,0.0,0.0,0.0,0.0,0.0,0.0,0.0,0.0,0.0,0.0,0.0,0.0,0.0,0.0,0.0,0.0,0.0,0.0,0.0,0.0,0.0,0.0,0.0,0.0,0.0,1.0,0.0,0.0,0.0,0.0,0.0,0.0,0.0,0.0,0.0,0.0,0.0,0.0,0.0,0.0,0.0,0.0,0.0,0.0,0.0,0.0,0.0,0.0,0.0,0.0,0.0,0.0,0.0,0.0,0.0
100677,0,0.0,0.0,0.0,1.0,1.0,252000.0,402214.5,22459.5,328500.0,0.02461,40.56438356164384,-620.0,-489.0,-3039.0,,3.0,2.0,2.0,11.0,0.3704846019130429,0.6507498898246993,0.2091546988410069,0.0186,0.0561,0.9692,0.5784,0.0384,0.0,0.069,0.0833,0.125,0.033,0.0151,0.0262,0.0,0.0,0.0189,0.0582,0.9692,0.5949,0.0388,0.0,0.069,0.0833,0.125,0.0337,0.0165,0.0273,0.0,0.0,0.0187,0.0561,0.9692,0.584,0.0386,0.0,0.069,0.0833,0.125,0.0336,0.0154,0.0267,0.0,0.0,0.0418,1.0,2.0,0.0,2.0,0.0,-2352.0,0.0,0.0,0.0,0.0,1.0,2.0,1.0,1.0,0.0,1.0,0.0,1.0,0.0,0.0,0.0,0.0,1.0,1.0,0.0,1.0,0.0,0.0,0.0,0.0,0.0,0.0,0.0,0.0,0.0,0.0,0.0,0.0,0.0,0.0,0.0,0.0,0.0,0.0,7.0,48577.5,0.0,281626.74,94986.0,0.0,0.0,0.0,0.0,-350.0,962.0,-9.0,-1093.0,107.0,-10.0,2.0,3717.1575,30456.0,22936.5,8928.0,30456.0,8.0,-2008.5,365243.0,-1971.5,-1791.5,-1761.5,-1789.0,15.5,0.0,0.2971454743881626,17.5,16.0,10.0,4.0,-69.5,0.0,0.0,14.0,2921.58,2921.58,-2223.5,-2126.0,4.0,1.0,0.0,,,,,,,,,,,,,,,,,,,,,8337982788.0,184245695442.0,165448163997.0,51919928110.935,1862.0,1703.0,71124.0,70656.0,9140.0,505549.0,17790.6513000023,17852.699499999115,17304.569299998082,11284.890100000086,11222.718000000094,11170.209100000058,128269.0,662121.0,4134.780800000122,4132.413100000017,3943.236100000095,13514407.761643428,-601284445.0,-920988518.0,-296184913.0,-1533637908.0416667,43959.0,30662.0,11339.853199999176,11215.759999998969,10700.350599997302,22865.38850000961,22787.25480000957,22173.31270000813,67373.97472802507,157883.06713424204,125981.54547318644,34966.51120002787,34906.92780002831,34353.507600028715,22932.16179999593,22905.609299995507,22552.998399995744,3710505.0,8287.863500000167,8392.26860000008,8116.027700000227,9808.81470000072,9923.65200000216,10282.93719999965,16452.70489999975,16637.7209999997,16234.668799999705,828.1202000001758,813.3013000000458,759.2885000000133,3909.068500000125,3892.28700000016,3725.038200000157,436006.0,430808.0,,6418.569026002898,631308.0,624868.0,,16316.657399999798,154031.49759999054,154034.24159999003,153926.03589998715,77537.47199999628,77874.92800000659,78275.88220000647,12.0,11078644.365000002,3588192.45,1032012746.2349992,363380294.835,15850547.639999997,39300.75,26.0,1719.0,-3574191.0,1648912.0,-1854000.0,-1972240.0,-5.5,64800.0,0.0,281626.74,0.0,0.0,0.0,0.0,0.0,-870.0,2332.0,-131.0,-1093.0,41581645.82999995,605491868.5649999,679475368.2149999,9801723.6,605491868.5649999,42339.0,-2889259.0,661880507.5,30077441.5,149709100.5,67122389.5,152314630.0,42362.5,653.0,113.81810232251031,1174760.5,365570.0,220265.0,-710094.5,316207.0,1462.0,474099764.42248863,474645725.70748943,-28986377.5,-28762930.5,541410.0,23551.5,,,,,,,,,,,,,,,,,,,,,1465828.0,14721491.0,3229033.0,8546197.0,11595551.0,1414167.0,1056727970.8020012,801046042.177495,72027842703.05211,21653841658.63512,581630461.1594988,5792395.7475,689.5,94245.0,-276648063.0,21866356.0,-123667442.5,-218489455.5,-2013532.5,,,,,,,,,,,,,,,,,,,,,4268382.5,2476626.5,-8994582.5,921269.0,37582.5,3729553890.479964,3654097186.814962,-260370810.5,-257063456.5,2523984.0,268924.5,3922171211.182456,33223972948.69591,36649643575.207634,1727800650.3150494,48037426638.72822,3983986.0,-247336416.0,102978653034.0,1052628253.0,17258527889.5,3499820318.5,18871809665.5,3668304.0,71845.0,20852.02950212372,89709669.0,-15.284344184789948,1.5960892857142857,11.220196353436185,455.1403485177429,17.908435183329996,726.4446337654354,84000.0,-0.9009688679024191,0.4338837391175582,0.0,0.0,0.0,0.0,0.0,0.0,1.0,0.0,1.0,0.0,0.0,0.0,0.0,0.0,0.0,0.0,0.0,0.0,1.0,0.0,1.0,0.0,0.0,0.0,0.0,1.0,0.0,0.0,0.0,0.0,0.0,0.0,0.0,1.0,0.0,0.0,0.0,0.0,0.0,0.0,0.0,0.0,0.0,0.0,0.0,0.0,0.0,0.0,0.0,0.0,0.0,0.0,0.0,1.0,0.0,0.0,0.0,0.0,0.0,0.0,0.0,0.0,0.0,0.0,0.0,0.0,0.0,0.0,0.0,0.0,0.0,0.0,0.0,0.0,0.0,0.0,0.0,0.0,0.0,0.0,0.0,0.0,0.0,0.0,0.0,0.0,0.0,0.0,0.0,0.0,0.0,0.0,0.0,0.0,0.0,0.0,0.0,0.0,0.0,0.0,0.0,0.0,0.0,0.0,0.0,0.0,0.0,0.0,1.0,0.0,1.0,0.0,0.0,0.0,0.0,0.0,0.0,0.0,1.0,0.0
100699,0,0.0,1.0,1.0,1.0,1.0,225000.0,323460.0,23134.5,270000.0,0.020246,36.83287671232877,-1659.0,-2988.0,-4436.0,8.0,3.0,3.0,3.0,7.0,0.6581982829440185,0.3643069022857584,0.6413682574954046,0.0918,0.1513,0.9816,0.7484,0.0173,0.0,0.1379,0.1667,0.2083,0.0877,0.0748,0.097,0.0,0.0,0.0935,0.157,0.9816,0.7583,0.0175,0.0,0.1379,0.1667,0.2083,0.0897,0.0817,0.1011,0.0,0.0,0.0926,0.1513,0.9816,0.7518,0.0174,0.0,0.1379,0.1667,0.2083,0.0892,0.0761,0.0988,0.0,0.0,0.0858,1.0,3.0,0.0,3.0,0.0,-1901.0,0.0,0.0,0.0,0.0,0.0,3.0,1.0,1.0,0.0,1.0,0.0,0.0,0.0,0.0,0.0,0.0,0.0,0.0,0.0,1.0,0.0,0.0,0.0,0.0,0.0,0.0,0.0,0.0,0.0,0.0,0.0,0.0,0.0,0.0,0.0,0.0,0.0,0.0,8.0,9375.0075,0.0,55066.5,0.0,0.0,0.0,0.0,0.0,-1579.5,-1339.0,-1344.0,-1549.0,406.0,-26.0,4.0,11303.46,57510.0,54623.25,4108.5,57510.0,10.0,-1394.0,365243.0,-1294.0,-1084.0,-1084.0,-1081.0,10.0,0.0,0.1013805057096248,20.0,48.0,36.0,12.5,-24.5,0.0,0.0,46.0,23960.655,23960.655,-692.0,-674.0,8.0,1.0,0.0,,,,,,,,,,,,,,,,,,,,,8338005922.5,184246018902.0,165448433997.0,51920153110.935,1862.0,1703.0,71124.0,70656.0,9140.0,505552.0,17790.7431000023,17852.792099999115,17304.66279999808,11285.041400000086,11222.869300000091,11170.366100000056,128270.0,662124.0,4134.798100000124,4132.430500000017,3943.253600000095,13514444.59452014,-601286104.0,-920992954.0,-296186814.0,-1533640896.0416667,43959.0,30662.0,11339.853199999176,11215.759999998969,10700.350599997302,22865.52640000961,22787.39270000958,22173.45060000813,67374.63292630801,157883.43144114432,125982.18684144397,34966.67790002787,34907.09450002831,34353.674300028724,22932.370099995933,22905.817599995506,22553.206699995742,3710512.0,8287.951200000167,8392.35780000008,8116.1174000002275,9808.88950000072,9923.72810000216,10283.018899999648,16452.801899999755,16637.8197999997,16234.769899999705,828.1202000001758,813.3013000000458,759.2885000000133,3909.068500000125,3892.28700000016,3725.038200000157,436009.0,430811.0,1261712.0,6418.589272002898,631311.0,624871.0,,16316.7431999998,154032.47919999054,154035.22319999005,153927.01749998715,77538.22039999628,77875.67980000659,78276.64050000647,52.5,11435705.1,3607545.375,1079554149.1349993,376969592.475,16058587.14,39300.75,27.0,1719.0,-3700218.0,1692248.0,-1907798.5,-2039178.0,-25.75,0.0,0.0,29340.0,0.0,0.0,0.0,0.0,0.0,-2035.0,-1360.0,-1549.0,-1549.0,42947662.94999995,628806279.825,704228730.165,10442724.66,628806279.825,43672.0,-2982486.5,682875001.0,30739923.0,155141394.0,69649404.0,158480828.0,43655.0,668.0,117.74743834655258,1186022.0,384431.0,231308.0,-738809.0,316323.0,1496.0,496309591.687488,497220205.4324895,-30193513.5,-29961156.0,562269.5,24377.5,,,,,,,,,,,,,,,,,,,,,1465836.0,14721897.0,3229033.0,8546245.0,11595597.0,1414171.0,1056737345.8095012,801046042.177495,72027897769.55211,21653841658.63512,581630461.1594988,5792395.7475,689.5,94245.0,-276649642.5,21865017.0,-123668786.5,-218491004.5,-2013558.5,,,,,,,,,,,,,,,,,,,,,4268418.5,2476639.0,-8994607.0,921269.0,37582.5,3729577851.134964,3654121147.4699616,-260371502.5,-257064130.5,2523992.0,268925.5,3922182514.642456,33224030458.69591,36649698198.457634,1727804758.8150494,48037484148.72822,3983996.0,-247337810.0,102979018277.0,1052626959.0,17258526805.5,3499819234.5,18871808584.5,3668314.0,71845.0,20852.13088262943,89709689.0,-45.041282356441535,1.4376,9.725734292939118,358.2267721486945,13.981715619529275,514.9868076409632,75000.0,-0.2225209339563143,0.9749279121818236,0.0,0.0,0.0,0.0,0.0,0.0,1.0,0.0,0.0,0.0,0.0,0.0,0.0,1.0,0.0,1.0,0.0,0.0,0.0,0.0,1.0,0.0,0.0,0.0,0.0,1.0,0.0,0.0,0.0,0.0,0.0,0.0,0.0,0.0,0.0,0.0,0.0,0.0,1.0,0.0,0.0,0.0,0.0,0.0,0.0,0.0,0.0,0.0,0.0,0.0,0.0,0.0,0.0,0.0,0.0,0.0,0.0,0.0,0.0,0.0,0.0,0.0,0.0,0.0,0.0,0.0,0.0,0.0,0.0,0.0,0.0,0.0,0.0,0.0,0.0,0.0,0.0,0.0,0.0,0.0,0.0,1.0,0.0,0.0,0.0,0.0,0.0,0.0,0.0,0.0,0.0,0.0,0.0,0.0,0.0,0.0,0.0,0.0,0.0,0.0,0.0,0.0,0.0,0.0,0.0,0.0,0.0,0.0,1.0,0.0,1.0,0.0,0.0,0.0,0.0,0.0,0.0,1.0,0.0,0.0
100702,0,0.0,1.0,0.0,1.0,0.0,175500.0,315000.0,25015.5,315000.0,0.018209,24.21643835616439,-148.0,-8210.0,-1503.0,,2.0,3.0,3.0,17.0,,0.1400531333331133,0.133429254467317,0.0495,0.0579,0.9742,,,0.0,0.1034,0.125,,0.0,,0.0265,,0.0,0.0504,0.06,0.9742,,,0.0,0.1034,0.125,,0.0,,0.0276,,0.0,0.05,0.0579,0.9742,,,0.0,0.1034,0.125,,0.0,,0.027,,0.0,0.0319,1.0,2.0,0.0,2.0,0.0,-209.0,0.0,0.0,0.0,0.0,0.0,4.0,1.0,1.0,0.0,1.0,0.0,0.0,0.0,0.0,0.0,0.0,0.0,0.0,0.0,1.0,0.0,0.0,0.0,0.0,0.0,0.0,0.0,0.0,0.0,0.0,0.0,0.0,0.0,0.0,0.0,0.0,0.0,0.0,4.0,0.0,0.0,92884.5,37543.5,0.0,0.0,0.0,0.0,-571.0,15524.5,-29.0,-383.0,78.0,-9.0,6.0,6479.8425,65238.75,72587.25,0.0,84942.0,21.0,-378.5,365243.0,-656.5,-416.5,-236.5,-410.5,9.5,0.0,0.0,74.5,20.0,12.0,9.5,-16.5,0.0,0.0,19.0,5341.995,5341.995,-460.0,-457.0,5.0,1.0,0.0,,,,,,,,,,,,,,,,,,,,,8338030938.0,184246333902.0,165448748997.0,51920328610.935,1862.0,1703.0,71124.0,70656.0,9140.0,505556.0,17790.7926000023,17852.842099999114,17304.71319999808,11285.099300000084,11222.927200000093,11170.426100000055,128270.0,662126.0,,,,13514468.810958495,-601286252.0,-920994457.0,-296187023.0,-1533649106.0416667,43959.0,30662.0,11339.853199999176,11215.759999998969,10700.350599997302,22865.62980000961,22787.49610000958,22173.55400000813,,157883.57149427765,125982.32027069842,34966.80290002787,34907.21950002831,34353.799300028724,,,,3710529.0,8287.951200000167,8392.35780000008,8116.1174000002275,,,,16452.828399999755,16637.846799999694,16234.797499999702,,,,3909.068500000125,3892.28700000016,3725.038200000157,436011.0,430813.0,,6418.607481002898,631314.0,624874.0,,16316.7750999998,154033.45339999054,154036.19739999002,153927.99169998715,,,,19.5,11454455.115000002,3610830.375,1080653805.8549993,377517879.225,16062650.64,39300.75,27.0,1719.0,-3711319.5,1750005.0,-1913991.5,-2045114.0,-9.25,0.0,0.0,92884.5,37543.5,0.0,0.0,0.0,0.0,-595.0,15524.5,-29.0,-383.0,43041618.314999945,630452240.325,706021215.165,10477874.16,630712029.825,43842.0,-2993569.0,685249080.5,30732345.5,155135526.5,69645471.5,158474997.5,43780.0,669.0,118.54412782627617,1186963.5,385721.0,232163.5,-741711.5,316323.0,1496.0,498512369.1149881,499394778.0749897,-30274427.0,-30041264.0,562746.0,24457.0,,,,,,,,,,,,,,,,,,,,,1465840.0,14721975.0,3229033.0,8546265.0,11595616.0,1414177.0,1056737345.8095012,801046042.177495,72027990654.05211,21653879202.13512,581630461.1594988,5792395.7475,689.5,94245.0,-276650213.5,21880541.5,-123668815.5,-218491387.5,-2013567.5,,,,,,,,,,,,,,,,,,,,,4268430.5,2476648.5,-8994623.5,921269.0,37582.5,3729583193.129964,3654126489.4649615,-260371962.5,-257064587.5,2523997.0,268926.5,3922188994.484956,33224095697.44591,36649770785.707634,1727804758.8150494,48037569090.72822,3984017.0,-247338188.5,102979383520.0,1052626302.5,17258526389.0,3499818998.0,18871808174.0,3668323.5,71845.0,20852.13088262943,89709763.5,-6.1115510804389634,1.794871794871795,7.0156502968159735,169.8940629412504,12.592192840438928,304.9380616894238,87750.0,1.0,0.0,0.0,0.0,0.0,0.0,0.0,0.0,1.0,0.0,1.0,0.0,0.0,0.0,0.0,0.0,0.0,0.0,0.0,0.0,1.0,1.0,0.0,0.0,0.0,0.0,0.0,1.0,0.0,0.0,0.0,0.0,0.0,0.0,0.0,0.0,0.0,0.0,0.0,0.0,0.0,0.0,0.0,0.0,0.0,0.0,1.0,0.0,0.0,0.0,0.0,0.0,0.0,0.0,0.0,1.0,0.0,0.0,0.0,0.0,0.0,0.0,0.0,0.0,0.0,0.0,0.0,0.0,0.0,0.0,0.0,0.0,0.0,0.0,0.0,0.0,0.0,0.0,0.0,0.0,0.0,0.0,0.0,0.0,0.0,0.0,0.0,0.0,0.0,0.0,0.0,0.0,0.0,0.0,0.0,0.0,0.0,0.0,0.0,0.0,0.0,0.0,0.0,0.0,0.0,0.0,0.0,0.0,0.0,0.0,0.0,0.0,1.0,0.0,0.0,0.0,0.0,0.0,0.0,0.0,1.0,0.0
100711,0,0.0,0.0,0.0,1.0,0.0,180000.0,1525482.0,63085.5,1363500.0,0.010032,44.12876712328767,-9070.0,-8068.0,-2972.0,,2.0,2.0,2.0,11.0,,0.3065522993502637,0.3490552510751822,0.1222,0.0833,0.9786,0.7212,0.0831,0.0,0.1034,0.1667,0.0417,,0.1244,0.058,0.0,0.0,0.0935,0.0864,0.9782,0.7321,0.0839,0.0,0.1034,0.1667,0.0417,,0.1359,0.0602,0.0,0.0,0.1233,0.0833,0.9786,0.7249,0.0836,0.0,0.1034,0.1667,0.0417,,0.1266,0.059,0.0,0.0,0.0651,1.0,1.0,0.0,1.0,0.0,-852.0,0.0,0.0,0.0,0.0,0.0,0.0,1.0,1.0,0.0,1.0,0.0,0.0,0.0,0.0,0.0,0.0,0.0,0.0,0.0,0.0,0.0,1.0,0.0,0.0,0.0,0.0,0.0,0.0,0.0,0.0,0.0,0.0,0.0,0.0,0.0,0.0,0.0,0.0,5.0,4500.0,0.0,135000.0,33729.75,0.0,0.0,0.0,0.0,-738.0,-528.0,-525.0,-980.0,169.0,-20.0,1.0,15339.465,227016.0,227016.0,0.0,227016.0,16.0,-852.0,365243.0,-821.0,-371.0,-371.0,-365.0,10.0,0.0,0.0,300.0,18.0,16.0,7.5,-20.5,0.0,0.0,16.0,15339.465,15339.465,-602.0,-596.0,8.5,1.0,0.0,,,,,,,,,,,,,,,,,,,,,8338094023.5,184247859384.0,165450112497.0,51920508610.935,1862.0,1703.0,71124.0,70656.0,9140.0,505556.0,17790.9148000023,17852.96539999911,17304.80669999808,11285.182600000086,11223.010500000091,11170.512500000055,128270.0,662128.0,4134.881200000124,4132.514100000017,3943.337500000095,13514512.93972562,-601295322.0,-920997429.0,-296187875.0,-1533657174.0416667,43959.0,30662.0,11339.853199999176,11215.759999998969,10700.350599997302,22865.73320000961,22787.59950000958,22173.65740000813,,157883.87804657698,125982.6693259495,34966.96960002787,34907.38620002831,34353.96600002872,22932.41179999593,22905.859299995507,22553.248399995744,3710540.0,,,,9809.01390000072,9923.85470000216,10283.15479999965,16452.886399999756,16637.9057999997,16234.857699999702,828.1202000001758,813.3013000000458,759.2885000000133,3909.068500000125,3892.28700000016,3725.038200000157,436012.0,430814.0,,6418.617513002898,631316.0,624876.0,,16316.8401999998,154034.43199999054,154037.17599999002,153928.96989998716,77538.94159999628,77876.40470000659,78277.37260000646,25.0,11590103.115000002,3622941.135,1091506292.2349994,381172131.495,16417964.52,39300.75,27.0,1719.0,-3743760.0,1776042.0,-1929186.0,-2059990.0,-12.0,4500.0,0.0,135000.0,0.0,0.0,0.0,0.0,0.0,-1164.0,-980.0,-980.0,-2078.0,43487193.82499994,636799180.725,712306667.5649999,10819032.66,636799180.725,44378.0,-3051338.0,696023126.0,31427857.0,157298766.0,70717803.0,160638393.0,44493.0,679.0,122.05709345889768,1219078.0,389109.0,234270.5,-753021.0,316450.0,1516.0,503443985.0174887,504280398.26248986,-30639783.0,-30403836.5,564684.0,24745.5,,,,,,,,,,,,,,,,,,,,,1465845.0,14722144.0,3229033.0,8546283.0,11595632.0,1414178.0,1056741845.8095012,801046042.177495,72028125654.05211,21653912931.88512,581630461.1594988,5792395.7475,689.5,94245.0,-276650951.5,21880013.5,-123669340.5,-218492367.5,-2013587.5,,,,,,,,,,,,,,,,,,,,,4268446.5,2476656.0,-8994644.0,921269.0,37582.5,3729598532.594964,3654141828.9299617,-260372564.5,-257065183.5,2524005.5,268927.5,3922204333.949957,33224322713.44591,36649997801.707634,1727804758.8150494,48037796106.72822,3984033.0,-247339040.5,102979748763.0,1052625481.5,17258526018.0,3499818627.0,18871807809.0,3668333.5,71845.0,20852.13088262943,89710063.5,-205.5348606196064,8.4749,2.853270561380983,125.91131214291369,24.18118268064769,1067.0857792799789,90000.0,1.0,0.0,0.0,0.0,0.0,0.0,0.0,0.0,1.0,0.0,0.0,0.0,0.0,0.0,0.0,1.0,0.0,1.0,0.0,0.0,0.0,0.0,1.0,0.0,0.0,0.0,0.0,0.0,1.0,0.0,0.0,0.0,0.0,0.0,0.0,0.0,0.0,0.0,1.0,0.0,0.0,0.0,0.0,0.0,0.0,0.0,0.0,0.0,0.0,0.0,0.0,0.0,0.0,0.0,1.0,0.0,0.0,0.0,0.0,0.0,0.0,0.0,0.0,0.0,0.0,0.0,0.0,0.0,0.0,0.0,0.0,0.0,0.0,0.0,0.0,0.0,0.0,0.0,0.0,0.0,0.0,0.0,0.0,0.0,0.0,0.0,0.0,0.0,0.0,0.0,0.0,0.0,0.0,0.0,0.0,0.0,0.0,0.0,0.0,0.0,0.0,0.0,0.0,0.0,0.0,0.0,0.0,0.0,0.0,0.0,1.0,0.0,1.0,0.0,0.0,0.0,0.0,0.0,0.0,0.0,1.0,0.0
100729,0,0.0,1.0,0.0,0.0,1.0,112500.0,180000.0,14220.0,180000.0,0.010556,43.76438356164383,-472.0,-5283.0,-5319.0,,3.0,3.0,3.0,14.0,0.3787160820373647,0.377845152729456,0.3706496323299817,,,,,,,,,,,,,,,,,,,,,,,,,,,,,,,,,,,,,,,,,,,,,2.0,0.0,2.0,0.0,-2019.0,0.0,0.0,0.0,0.0,0.0,0.0,1.0,1.0,1.0,1.0,0.0,0.0,0.0,0.0,0.0,0.0,1.0,1.0,0.0,1.0,0.0,0.0,0.0,0.0,0.0,0.0,0.0,0.0,0.0,0.0,0.0,0.0,0.0,0.0,0.0,0.0,0.0,0.0,1.0,,0.0,20080.62,0.0,0.0,0.0,0.0,0.0,-866.0,-777.0,-772.0,-777.0,29.0,-14.0,7.0,4344.795,29880.0,20497.5,3825.0,53901.0,12.0,-1024.0,365243.0,-1459.0,-1354.0,-1339.0,-1345.5,13.0,0.0,0.1039544004762552,20.0,40.0,12.0,7.0,-46.5,0.0,0.0,39.0,4344.795,4302.09,-1573.0,-1577.0,6.0,1.0,0.0,,,,,,,,,,,,,,,,,,,,,8338108243.5,184248039384.0,165450292497.0,51920621110.935,1862.0,1703.0,71124.0,70656.0,9140.0,505556.0,,,,,,,128271.0,662131.0,,,,13514556.704109184,-601295794.0,-921002748.0,-296189894.0,-1533662457.0416667,43959.0,30662.0,,,,,,,67375.01164239005,157884.25589172973,125983.03997558182,,,,,,,3710554.0,,,,,,,,,,,,,,,,436014.0,430816.0,,6418.628069002898,631319.0,624879.0,,,,,,,,,29.0,,3752093.295,1112348148.7949994,387763994.52,16583900.94,39300.75,27.0,1719.0,-3801402.0,1804785.0,-1960461.0,-2083755.0,-14.0,,0.0,20080.62,0.0,0.0,0.0,0.0,0.0,-866.0,-777.0,-772.0,-777.0,44269942.09499995,643743139.725,721741192.0649999,10895465.16,644220139.725,44973.0,-3118813.0,709351442.5,31745443.5,159086615.5,71779808.5,162794049.5,45237.0,691.0,124.00655174860228,1261665.0,394092.0,237007.0,-767489.0,316574.0,1549.0,509941091.33998656,510897061.70998806,-31247689.0,-31008615.0,572005.0,25171.0,,,,,,,,,,,,,,,,,,,,,1465846.0,14722173.0,3229033.0,8546323.0,11595671.0,1414185.0,,801046042.177495,72028145734.6721,21653912931.88512,581630461.1594988,5792395.7475,689.5,94245.0,-276651817.5,21879236.5,-123670112.5,-218493144.5,-2013601.5,,,,,,,,,,,,,,,,,,,,,4268458.5,2476663.0,-8994690.5,921269.0,37582.5,3729602877.389964,3654146131.019962,-260374137.5,-257066760.5,2524011.5,268928.5,3922208678.744957,33224352593.44591,36650018299.207634,1727808583.8150494,48037850007.72822,3984045.0,-247340064.5,102980114006.0,1052624022.5,17258524664.0,3499817288.0,18871806463.5,3668346.5,71845.0,20852.234837029908,89710083.5,-10.7850256667084,1.6,7.9113924050632916,346.23721172186583,12.658227848101266,553.9795387549852,37500.0,1.0,0.0,0.0,0.0,0.0,0.0,0.0,0.0,1.0,0.0,0.0,0.0,0.0,0.0,0.0,1.0,0.0,0.0,0.0,0.0,1.0,0.0,1.0,0.0,0.0,0.0,0.0,1.0,0.0,0.0,0.0,0.0,0.0,0.0,0.0,0.0,0.0,0.0,1.0,0.0,0.0,0.0,0.0,0.0,0.0,0.0,0.0,0.0,0.0,0.0,0.0,0.0,0.0,0.0,0.0,0.0,0.0,0.0,0.0,0.0,0.0,0.0,0.0,0.0,0.0,0.0,0.0,0.0,0.0,0.0,1.0,0.0,0.0,0.0,0.0,0.0,0.0,0.0,0.0,0.0,0.0,0.0,0.0,0.0,0.0,0.0,0.0,0.0,0.0,0.0,0.0,0.0,0.0,0.0,0.0,0.0,0.0,0.0,0.0,0.0,0.0,0.0,0.0,0.0,0.0,0.0,0.0,0.0,0.0,0.0,0.0,0.0,0.0,0.0,0.0,0.0,0.0,0.0,0.0,0.0,0.0,0.0
100740,0,0.0,0.0,0.0,0.0,1.0,67500.0,296280.0,21559.5,225000.0,0.010643,28.224657534246568,-615.0,-1956.0,-2705.0,,3.0,2.0,2.0,15.0,,0.352725511085655,,,,,,,,,,,,,,,,,,,,,,,,,,,,,,,,,,,,,,,,,,,,,,0.0,0.0,0.0,0.0,-451.0,,,,,,,1.0,1.0,1.0,1.0,0.0,0.0,0.0,0.0,0.0,0.0,1.0,1.0,0.0,1.0,0.0,0.0,0.0,0.0,0.0,0.0,0.0,0.0,0.0,0.0,0.0,0.0,0.0,0.0,0.0,0.0,0.0,0.0,0.0,,,,,,,,,,,,,0.0,,2.0,8020.35,35307.0,35307.0,0.0,70614.0,10.0,-281.5,365243.0,-420.0,-180.0,-150.0,-176.0,16.5,0.0,0.0,28.0,10.0,10.0,5.5,-10.5,0.0,0.0,9.0,8020.35,8020.35,-306.0,-300.0,5.0,1.0,0.0,,,,,,,,,,,,,,,,,,,,,8338129803.0,184248335664.0,165450517497.0,51920688610.935,,,,,,,,,,,,,128272.0,662134.0,,,,13514584.928766714,-601296409.0,-921005453.0,-296190345.0,-1533664413.0416667,43959.0,30662.0,,,,,,,,157884.60861724082,,,,,,,,3710569.0,,,,,,,,,,,,,,,,436014.0,430816.0,,6418.638712002898,631321.0,624881.0,,,,,,,,,,,,,,,,,,,,,,,,,,,,,,,,,,,44759229.97499996,652093289.1,730331986.68,11129934.42,652093289.1,45559.0,-3170939.0,721949843.0,31699090.0,160875114.0,72114023.0,164949702.0,45893.0,704.0,126.78115719343288,1278384.5,398638.0,239992.5,-780372.0,316576.0,1551.0,516127466.15998834,517930173.58498985,-31742034.0,-31497008.0,579624.0,25638.0,,,,,,,,,,,,,,,,,,,,,1465846.0,14722173.0,3229033.0,8546333.0,11595680.0,1414187.0,,,,,,,,,,,,,,,,,,,,,,,,,,,,,,,,,,4268468.5,2476668.5,-8994701.0,921269.0,37582.5,3729610897.739964,3654154151.3699617,-260374443.5,-257067060.5,2524016.5,268929.5,3922216699.094957,33224387900.44591,36650053606.207634,1727808583.8150494,48037920621.72822,3984055.0,-247340346.0,102980479249.0,1052623602.5,17258524484.0,3499817138.0,18871806287.5,3668363.0,71845.0,20852.234837029908,89710111.5,-21.789458357600463,4.389333333333333,3.1308703819661865,88.36774431511137,13.742433729910248,387.87548571379546,22500.0,0.6234898018587334,-0.7818314824680299,0.0,1.0,0.0,0.0,0.0,0.0,0.0,0.0,0.0,0.0,0.0,0.0,0.0,1.0,0.0,0.0,0.0,0.0,1.0,0.0,1.0,0.0,0.0,0.0,0.0,1.0,0.0,0.0,0.0,0.0,0.0,0.0,0.0,0.0,0.0,0.0,0.0,0.0,1.0,0.0,0.0,0.0,0.0,0.0,0.0,0.0,0.0,0.0,0.0,0.0,0.0,0.0,0.0,0.0,0.0,0.0,0.0,0.0,0.0,0.0,0.0,0.0,0.0,0.0,1.0,0.0,0.0,0.0,0.0,0.0,0.0,0.0,0.0,0.0,0.0,0.0,0.0,0.0,0.0,0.0,0.0,0.0,0.0,0.0,0.0,0.0,0.0,0.0,0.0,0.0,0.0,0.0,0.0,0.0,0.0,0.0,0.0,0.0,0.0,0.0,0.0,0.0,0.0,0.0,0.0,0.0,0.0,0.0,0.0,0.0,0.0,0.0,0.0,0.0,0.0,0.0,0.0,0.0,0.0,0.0
100744,0,0.0,0.0,0.0,1.0,2.0,144000.0,225000.0,17905.5,225000.0,0.010006,28.56438356164384,-666.0,-1580.0,-20.0,,4.0,2.0,2.0,15.0,0.3184368784278764,0.4072754189233125,,,,,,,,,,,,,,,,,,,,,,,,,,,,,,,,,,,,,,,,,,,,,,0.0,0.0,0.0,0.0,0.0,,,,,,,1.0,1.0,1.0,1.0,1.0,0.0,0.0,0.0,0.0,0.0,0.0,0.0,0.0,1.0,0.0,0.0,0.0,0.0,0.0,0.0,0.0,0.0,0.0,0.0,0.0,0.0,0.0,0.0,0.0,0.0,0.0,0.0,0.0,,,,,,,,,,,,,0.0,,2.0,24404.94,156012.75,150545.25,13466.25,156012.75,12.0,-502.0,365243.0,-489.0,-189.0,-159.0,-183.0,12.5,1.0,0.0514013807342409,71.5,12.0,12.0,6.5,-11.5,0.0,0.0,11.0,24404.94,24404.94,-348.0,-339.0,6.0,1.0,0.0,,,,,,,,,,,,,,,,,,,,,8338147708.5,184248560664.0,165450742497.0,51920832610.935,,,,,,,,,,,,,128274.0,662138.0,,,,13514613.493150275,-601297075.0,-921005473.0,-296190345.0,-1533665993.0416667,43959.0,30662.0,,,,,,,67375.33007926847,157885.01589265975,,,,,,,,3710584.0,,,,,,,,,,,,,,,,436014.0,430816.0,,6418.648718002898,631323.0,624883.0,,,,,,,,,,,,,,,,,,,,,,,,,,,,,,,,,,,44830820.47499996,652701884.85,731304686.43,11159431.92,652701884.85,45649.0,-3179919.5,725237030.0,32422473.0,161966001.0,72839896.0,166040636.0,46069.5,708.0,126.98415069379448,1278969.5,399933.0,240633.5,-783685.0,316576.0,1551.0,516658179.68998873,518455759.4099903,-31831938.0,-31585732.0,580264.0,25727.0,,,,,,,,,,,,,,,,,,,,,1465846.0,14722173.0,3229033.0,8546345.0,11595691.0,1414189.0,,,,,,,,,,,,,,,,,,,,,,,,,,,,,,,,,,4268480.5,2476675.0,-8994712.5,921269.0,37582.5,3729635302.679964,3654178556.309962,-260374791.5,-257067399.5,2524022.5,268930.5,3922241104.034957,33224543913.19591,36650204151.457634,1727822050.0650494,48038076634.47822,3984067.0,-247340848.0,102980844492.0,1052623113.5,17258524295.0,3499816979.0,18871806104.5,3668375.5,71846.0,20852.28623841064,89710183.0,-23.315749088816425,1.5625,8.042221663734606,229.7211042906768,12.565971349585324,358.93922545418235,36000.0,1.0,0.0,0.0,0.0,0.0,0.0,0.0,1.0,0.0,0.0,0.0,0.0,0.0,0.0,0.0,1.0,0.0,0.0,0.0,0.0,1.0,0.0,1.0,0.0,0.0,0.0,0.0,1.0,0.0,0.0,0.0,0.0,0.0,0.0,0.0,0.0,0.0,0.0,0.0,0.0,0.0,0.0,0.0,0.0,0.0,0.0,1.0,0.0,0.0,0.0,0.0,0.0,0.0,0.0,0.0,0.0,0.0,0.0,0.0,0.0,0.0,0.0,0.0,0.0,0.0,0.0,0.0,0.0,0.0,0.0,0.0,0.0,0.0,0.0,0.0,0.0,0.0,0.0,0.0,0.0,0.0,0.0,0.0,0.0,0.0,0.0,0.0,0.0,0.0,0.0,0.0,0.0,1.0,0.0,0.0,0.0,0.0,0.0,0.0,0.0,0.0,0.0,0.0,0.0,0.0,0.0,0.0,0.0,0.0,0.0,0.0,0.0,0.0,0.0,0.0,0.0,0.0,0.0,0.0,0.0,0.0,0.0
100745,0,0.0,0.0,0.0,1.0,0.0,135000.0,900000.0,29034.0,900000.0,0.020713,30.136986301369863,-2266.0,-5278.0,-3680.0,,2.0,3.0,3.0,9.0,0.5285542771867807,0.4667684848289578,0.5867400085415683,,,,,,,,,,,,,,,,,,,,,,,,,,,,,,,,,,,,,,,,,,,,,17.0,0.0,16.0,0.0,-1783.0,0.0,0.0,0.0,0.0,0.0,1.0,1.0,1.0,1.0,1.0,0.0,0.0,0.0,0.0,0.0,0.0,0.0,0.0,0.0,1.0,0.0,0.0,0.0,0.0,0.0,0.0,0.0,0.0,0.0,0.0,0.0,0.0,0.0,0.0,0.0,0.0,0.0,0.0,2.0,1826.2125,0.0,36100.3275,1792.2375,0.0,0.0,0.0,0.0,-907.5,-565.5,-303.0,,60.0,-17.5,4.0,7451.3925,67344.75,67344.75,0.0,67344.75,12.0,-1258.5,365243.0,-1228.0,-901.5,-901.5,-897.0,10.5,0.0,0.0,1700.0,63.0,12.0,7.0,-38.0,0.0,0.0,66.0,4969.485,4112.077499999999,-1163.5,-1152.0,8.0,1.0,0.0,,,,,,,,,,,,,,,,,,,,,8338176742.5,184249460664.0,165451642497.0,51920967610.935,1862.0,1703.0,71124.0,70656.0,9140.0,505557.0,,,,,,,128274.0,662140.0,,,,13514643.63013658,-601299341.0,-921009153.0,-296192128.0,-1533671271.0416667,43959.0,30662.0,,,,,,,67375.85863354566,157885.48266114458,125983.62671559036,,,,,,,3710593.0,,,,,,,,,,,,,,,,436031.0,430832.0,,6418.669431002898,631326.0,624886.0,,,,,,,,,30.0,11884044.307500005,3809256.3,1148118425.0774994,397382623.7175,16755867.855,39300.75,27.0,1719.0,-3887269.5,1805778.0,-2001798.5,,-14.5,0.0,0.0,32175.0,0.0,0.0,0.0,0.0,0.0,-1458.0,-1153.0,-601.0,,44846567.12249996,652876635.6,731479437.18,11159431.92,652876635.6,45683.0,-3183570.5,726150137.5,32419141.0,161963614.0,72837509.0,166038264.0,46104.0,708.0,126.98415069379448,1281749.0,400443.0,240906.0,-784985.0,316576.0,1551.0,517003781.8724892,518784762.03749067,-31872260.5,-31625864.0,580573.0,25766.5,,,,,,,,,,,,,,,,,,,,,1465848.0,14722233.0,3229033.0,8546408.0,11595757.0,1414193.0,1056743672.0220011,801046042.177495,72028181834.9996,21653914724.122616,581630461.1594988,5792395.7475,689.5,94245.0,-276652725.0,21878671.0,-123670415.5,,-2013619.0,,,,,,,,,,,,,,,,,,,,,4268492.5,2476682.0,-8994750.5,921269.0,37582.5,3729640272.164964,3654182668.3874617,-260375955.0,-257068551.5,2524030.5,268931.5,3922248555.427456,33224611257.94591,36650271496.207634,1727822050.0650494,48038143979.22822,3984079.0,-247342106.5,102981209735.0,1052621885.5,17258523393.5,3499816077.5,18871805207.5,3668386.0,71846.0,20852.28623841064,89711883.0,-75.19,6.666666666666668,4.649721016738996,140.12857858665467,30.998140111593305,934.190523911031,67500.0,1.0,0.0,0.0,0.0,0.0,0.0,0.0,0.0,0.0,0.0,0.0,0.0,0.0,0.0,0.0,1.0,0.0,0.0,0.0,0.0,1.0,0.0,1.0,0.0,0.0,0.0,0.0,1.0,0.0,0.0,0.0,0.0,0.0,0.0,0.0,0.0,0.0,0.0,0.0,0.0,0.0,0.0,0.0,1.0,0.0,0.0,0.0,0.0,0.0,0.0,0.0,0.0,0.0,0.0,0.0,0.0,0.0,0.0,0.0,0.0,0.0,0.0,0.0,0.0,0.0,0.0,0.0,0.0,0.0,0.0,0.0,0.0,0.0,0.0,0.0,0.0,0.0,0.0,0.0,0.0,1.0,0.0,0.0,0.0,0.0,0.0,0.0,0.0,0.0,0.0,0.0,0.0,0.0,0.0,0.0,0.0,0.0,0.0,0.0,0.0,0.0,0.0,0.0,0.0,0.0,0.0,0.0,0.0,0.0,0.0,0.0,0.0,0.0,0.0,0.0,0.0,0.0,0.0,0.0,0.0,0.0,0.0
100747,0,0.0,1.0,1.0,1.0,0.0,495000.0,691551.0,54769.5,625500.0,0.007305,24.224657534246568,-839.0,-4283.0,-1485.0,3.0,2.0,3.0,3.0,9.0,,0.5627194869842227,0.3077366963789207,0.1485,0.0912,0.9866,0.8164,0.0219,0.16,0.1379,0.3333,0.0417,0.0,0.121,0.1583,0.0,0.0,0.1513,0.0946,0.9866,0.8236,0.0221,0.1611,0.1379,0.3333,0.0417,0.0,0.1322,0.1649,0.0,0.0,0.1499,0.0912,0.9866,0.8189,0.0221,0.16,0.1379,0.3333,0.0417,0.0,0.1231,0.1611,0.0,0.0,0.1245,1.0,0.0,0.0,0.0,0.0,-356.0,0.0,0.0,0.0,0.0,4.0,0.0,1.0,1.0,1.0,1.0,1.0,0.0,0.0,0.0,0.0,0.0,0.0,0.0,0.0,1.0,0.0,0.0,0.0,0.0,0.0,0.0,0.0,0.0,0.0,0.0,0.0,0.0,0.0,0.0,0.0,0.0,0.0,0.0,12.0,9846.0,0.0,418275.0,0.0,0.0,0.0,0.0,0.0,-590.0,922.5,-90.0,-583.5,247.0,-10.0,2.0,39715.38,221386.5,208451.25,44280.0,442773.0,12.0,-201.5,365243.0,-326.0,365243.0,4.0,365243.0,10.0,1.0,0.1045680299112508,3999.5,11.0,12.0,7.0,-7.0,0.0,0.0,12.0,39294.315,39715.38,-178.0,-176.0,6.0,1.5,0.0,,,,,,,,,,,,,,,,,,,,,8338231512.0,184250152215.0,165452267997.0,51921462610.935,1862.0,1703.0,71124.0,70660.0,9140.0,505557.0,17791.0633000023,17853.115299999114,17304.95799999808,11285.273800000086,11223.101700000092,11170.607100000056,128274.0,662142.0,4134.903100000122,4132.536200000017,3943.3596000000953,13514667.854794111,-601300180.0,-921010638.0,-296192484.0,-1533675554.0416667,43959.0,30662.0,11340.013199999175,11215.919999998969,10700.511699997302,22865.87110000962,22787.73740000958,22173.79530000813,,157886.04538063155,125983.93445228676,34967.30290002787,34907.71950002831,34354.299300028724,22932.45349999593,22905.90099999551,22553.290099995746,3710602.0,8287.951200000167,8392.35780000008,8116.1174000002275,9809.13490000072,9923.977800002162,10283.28699999965,16453.044699999755,16638.0668999997,16235.022599999702,828.1202000001758,813.3013000000458,759.2885000000133,3909.068500000125,3892.28700000016,3725.038200000157,436031.0,430832.0,1261715.0,6418.676736002898,631329.0,624889.0,,16316.9646999998,154035.41859999055,154038.16259999006,153929.95649998714,77539.75799999626,77877.22360000659,78278.19620000648,20.0,11918482.020000003,3809256.3,1153159915.9049995,399772473.705,16755867.855,39300.75,27.0,1719.0,-3892977.5,1815023.5,-2003290.0,-2130026.5,-9.5,9846.0,0.0,405000.0,0.0,0.0,0.0,0.0,0.0,-658.0,921.0,-132.0,-594.0,44962472.78999995,653944676.985,732537812.43,11225489.805,654166063.485,45833.0,-3200555.0,729619946.0,32404067.0,162317094.0,72825930.0,166391889.0,46279.0,710.0,127.78618398815998,1314554.0,402661.0,242015.0,-791076.0,316730.0,1569.0,518535665.77498966,520024632.02999055,-32090772.5,-31843369.0,582006.0,25922.5,,,,,,,,,,,,,,,,,,,,,1465860.0,14722480.0,3229033.0,8546419.0,11595769.0,1414195.0,1056753518.0220011,801046042.177495,72028600109.9996,21653914724.122616,581630461.1594988,5792395.7475,689.5,94245.0,-276653315.0,21879593.5,-123670505.5,-218493728.0,-2013629.0,,,,,,,,,,,,,,,,,,,,,4268504.5,2476689.0,-8994757.5,921269.0,37582.5,3729679566.479964,3654222383.767463,-260376133.0,-257068727.5,2524036.5,268933.0,3922288270.807457,33224832644.44591,36650479947.457634,1727866330.0650494,48038586752.22822,3984091.0,-247342308.0,102981574978.0,1052621559.5,17258888636.5,3499816081.5,18872170450.5,3668396.0,71847.0,20852.390806440548,89715882.5,-34.63413254919701,1.3970727272727272,9.037876920548843,218.9394732369668,12.626571358146414,305.87436698282346,247500.0,-0.9009688679024191,0.4338837391175582,0.0,0.0,0.0,0.0,0.0,1.0,0.0,0.0,1.0,0.0,0.0,0.0,0.0,0.0,0.0,0.0,1.0,0.0,0.0,1.0,0.0,0.0,0.0,0.0,0.0,1.0,0.0,0.0,0.0,0.0,0.0,0.0,0.0,0.0,1.0,0.0,0.0,0.0,0.0,0.0,0.0,0.0,0.0,0.0,0.0,0.0,0.0,0.0,0.0,0.0,0.0,0.0,0.0,1.0,0.0,0.0,0.0,0.0,0.0,0.0,0.0,0.0,0.0,0.0,0.0,0.0,0.0,0.0,0.0,0.0,0.0,0.0,0.0,0.0,0.0,0.0,0.0,0.0,0.0,0.0,0.0,0.0,0.0,0.0,0.0,0.0,0.0,0.0,0.0,0.0,0.0,0.0,0.0,0.0,0.0,0.0,0.0,0.0,0.0,0.0,0.0,0.0,0.0,0.0,0.0,0.0,0.0,0.0,1.0,0.0,1.0,0.0,0.0,0.0,0.0,0.0,0.0,0.0,1.0,0.0
100751,0,0.0,0.0,0.0,0.0,1.0,67500.0,450000.0,14517.0,450000.0,0.020246,39.64109589041096,-4949.0,-661.0,-5678.0,,3.0,3.0,3.0,13.0,0.1118792670322395,0.2770837796910885,0.1951984060044098,0.0165,0.0,0.9781,0.7008,0.0092,0.0,0.069,0.0417,0.0833,0.0525,0.0134,0.0143,0.0,0.0232,0.0168,0.0,0.9782,0.7125,0.0093,0.0,0.069,0.0417,0.0833,0.0537,0.0147,0.0149,0.0,0.0245,0.0167,0.0,0.9781,0.7048,0.0093,0.0,0.069,0.0417,0.0833,0.0534,0.0137,0.0145,0.0,0.0237,0.0163,1.0,5.0,1.0,5.0,1.0,-1882.0,0.0,0.0,0.0,0.0,1.0,1.0,1.0,1.0,1.0,1.0,0.0,0.0,0.0,0.0,0.0,0.0,0.0,0.0,0.0,1.0,0.0,0.0,0.0,0.0,0.0,0.0,0.0,0.0,0.0,0.0,0.0,0.0,0.0,0.0,0.0,0.0,0.0,0.0,8.0,6734.25,0.0,301500.0,0.0,0.0,0.0,0.0,0.0,-593.0,1076.0,-311.0,-1048.5,266.0,-19.5,3.0,4658.94,33255.0,36549.0,0.0,33255.0,12.0,-1260.0,365243.0,-1229.0,-1199.0,-899.0,-1194.0,8.0,0.0,0.0,40.0,19.0,12.0,12.0,-26.0,0.0,0.0,19.0,33012.675,33012.675,-776.0,-764.0,3.0,2.0,0.0,,,,,,,,,,,,,,,,,,,,,8338246029.0,184250602215.0,165452717997.0,51921530110.935,1862.0,1703.0,71124.0,70661.0,9140.0,505558.0,17791.079800002302,17853.131999999114,17304.974799998083,11285.273800000086,11223.101700000092,11170.607100000056,128275.0,662145.0,4134.912300000124,4132.5455000000175,3943.368900000096,13514707.495890005,-601305129.0,-921016316.0,-296194366.0,-1533676215.0416667,43960.0,30663.0,11340.013199999175,11215.919999998969,10700.511699997302,22865.94010000962,22787.80640000958,22173.86430000813,67375.9705128127,157886.32246441126,125984.12965069276,34967.34460002787,34907.76120002831,34354.34100002872,22932.53679999593,22905.984299995507,22553.373399995744,3710615.0,8288.003700000167,8392.411200000079,8116.171100000228,9809.14830000072,9923.99150000216,10283.301699999647,16453.058999999754,16638.0813999997,16235.037499999702,828.1202000001758,813.3013000000458,759.2885000000133,3909.091700000125,3892.310700000161,3725.062700000157,436036.0,430837.0,,6418.696982002898,631332.0,624892.0,,16316.980999999798,154036.39669999055,154039.14069999006,153930.93469998718,77540.45879999628,77877.9284000066,78278.90870000646,19.0,12019868.865000006,3809256.3,1162394227.3049994,403795270.71,16917867.854999997,39300.75,27.0,1719.0,-3909633.5,1852228.0,-2010565.0,-2138146.5,-10.0,0.0,0.0,270000.0,0.0,0.0,0.0,0.0,0.0,-2092.0,-996.0,-795.0,-1491.0,45188232.43499996,658015511.985,737278920.18,11251085.805,658015511.985,46260.0,-3220605.0,734001536.0,32757853.0,163038261.0,73185432.0,167479600.0,46572.0,711.0,128.51897742695314,1320226.0,403909.0,242824.0,-793647.0,316730.0,1569.0,520727720.939989,522228722.8049898,-32192846.0,-31944353.0,583560.0,26041.0,,,,,,,,,,,,,,,,,,,,,1465868.0,14722746.0,3229033.0,8546438.0,11595788.0,1414198.0,1056760252.2720011,801046042.177495,72028901609.9996,21653914724.122616,581630461.1594988,5792395.7475,689.5,94245.0,-276653908.0,21880669.5,-123670816.5,-218494776.5,-2013648.5,,,,,,,,,,,,,,,,,,,,,4268516.5,2476701.0,-8994783.5,921269.0,37582.5,3729712579.154965,3654255396.4424624,-260376909.0,-257069491.5,2524039.5,268935.0,3922292929.747457,33224865899.44591,36650516496.457634,1727866330.0650494,48038620007.22822,3984103.0,-247343568.0,102981940221.0,1052620330.5,17258887437.5,3499815182.5,18872169256.5,3668404.0,71847.0,20852.390806440548,89715922.5,-124.84518626028058,6.666666666666668,4.649721016738996,184.3200366882096,30.998140111593305,1228.8002445880643,22500.0,-0.2225209339563146,-0.9749279121818236,0.0,0.0,0.0,0.0,0.0,0.0,1.0,0.0,0.0,0.0,0.0,0.0,0.0,1.0,0.0,0.0,0.0,0.0,1.0,0.0,1.0,0.0,0.0,0.0,0.0,1.0,0.0,0.0,0.0,0.0,0.0,0.0,0.0,0.0,0.0,0.0,0.0,0.0,0.0,0.0,0.0,1.0,0.0,0.0,0.0,0.0,0.0,0.0,0.0,0.0,0.0,0.0,0.0,0.0,0.0,0.0,0.0,0.0,0.0,0.0,0.0,0.0,0.0,0.0,0.0,0.0,0.0,0.0,0.0,0.0,0.0,0.0,0.0,0.0,0.0,0.0,0.0,0.0,0.0,0.0,0.0,1.0,0.0,0.0,0.0,0.0,0.0,0.0,0.0,0.0,0.0,0.0,0.0,0.0,0.0,0.0,0.0,0.0,0.0,0.0,0.0,0.0,0.0,0.0,0.0,0.0,0.0,0.0,0.0,1.0,1.0,0.0,0.0,0.0,0.0,0.0,0.0,0.0,1.0,0.0
100752,0,0.0,1.0,1.0,1.0,0.0,135000.0,675000.0,27229.5,675000.0,0.018209,56.88219178082193,-3960.0,-12743.0,-4165.0,15.0,2.0,3.0,3.0,8.0,,0.4631291216401121,,0.068,0.0789,0.9757,0.6668,0.0092,0.0,0.1379,0.1667,0.0417,0.0146,0.0538,0.0756,0.0077,0.0711,0.0693,0.0819,0.9757,0.6798,0.0093,0.0,0.1379,0.1667,0.0417,0.0149,0.0588,0.0788,0.0078,0.0752,0.0687,0.0789,0.9757,0.6713,0.0093,0.0,0.1379,0.1667,0.0417,0.0148,0.0547,0.077,0.0078,0.0726,0.0645,1.0,0.0,0.0,0.0,0.0,0.0,0.0,0.0,0.0,0.0,1.0,3.0,1.0,1.0,0.0,1.0,0.0,0.0,0.0,0.0,0.0,0.0,0.0,0.0,0.0,1.0,0.0,0.0,0.0,0.0,0.0,0.0,0.0,0.0,0.0,0.0,0.0,0.0,0.0,0.0,0.0,0.0,0.0,0.0,5.0,652.5,31.5,73368.0,0.0,0.0,0.0,0.0,0.0,-2234.0,-1866.0,-1900.0,-1900.0,360.0,-35.5,4.0,8144.685,59659.8975,68499.0,1.1475,96264.0,12.0,-525.0,365243.0,-595.0,-445.0,-85.0,-439.0,7.0,0.0,4.902775029405575e-05,1633.5,20.0,12.0,8.5,-29.5,0.0,0.0,50.0,4218.7725,5012.6625,-361.0,-353.5,8.0,0.0,14.0,44448.165,213750.0,6750.0,11250.0,0.0,0.0,2439.5625,27000.0,24750.0,40124.295,40765.2075,40765.2075,1.0,1.0,0.0,0.0,6.5,-7.5,0.0,0.0,8338273258.5,184251277215.0,165453392997.0,51921665110.935,1862.0,1703.0,71124.0,70662.0,9140.0,505561.0,17791.147800002298,17853.200699999114,17305.044099998082,11285.352700000089,11223.180600000092,11170.689000000057,128275.0,662147.0,4134.921500000123,4132.554800000016,3943.378200000095,13514764.378081786,-601309089.0,-921020481.0,-296194366.0,-1533688958.0416667,43960.0,30663.0,11340.013199999175,11215.919999998969,10700.511699997302,22866.07800000962,22787.94430000958,22174.00220000813,,157886.78559353287,,34967.51130002787,34907.92790002831,34354.50770002872,22932.57849999593,22906.02599999551,22553.415099995746,3710623.0,8288.018300000167,8392.426000000081,8116.186000000228,9809.20210000072,9924.046200002162,10283.360499999648,16453.134599999754,16638.158399999702,16235.1162999997,828.1279000001758,813.3091000000458,759.2963000000133,3909.162800000125,3892.383300000161,3725.137900000157,436036.0,430837.0,1261730.0,6418.715191002898,631335.0,624895.0,,16317.045499999798,154037.37239999053,154040.11639999005,153931.91039998722,77541.12559999627,77878.5997000066,78279.58850000646,74.0,12075927.615000006,3809319.3,1163977875.1799994,404628126.21,16917867.854999997,39300.75,27.0,1719.0,-3920183.0,1850286.0,-2018847.0,-2143841.0,-36.5,0.0,0.0,73368.0,0.0,0.0,0.0,0.0,0.0,-2234.0,-1866.0,-1900.0,-1900.0,45211161.05999996,658246280.985,737528229.18,11251086.9525,658347530.985,46290.0,-3223748.5,734732022.0,32755030.0,163400500.0,73549247.0,167841854.0,46598.0,711.0,128.51902645470344,1323531.5,404275.0,243120.0,-794313.0,316742.0,1569.0,521270384.309989,522977141.60998976,-32215486.0,-31966777.0,583842.5,26105.0,463936628.0025005,1238087250.0,41112402.75,55413695.38500003,972418.5,13299604.515,26706783.42,59605188.48000049,54528948.27000007,444400478.8199992,462097387.1025002,462116649.03750014,2268.5,4928.5,25.0,2635.0,170147.0,-292389.0,89075.0,322.0,1465873.0,14723106.0,3229047.0,8546458.0,11595838.0,1414202.0,1056760904.7720011,801046073.677495,72028974977.9996,21653914724.122616,581630461.1594988,5792395.7475,689.5,94245.0,-276656142.0,21878803.5,-123672716.5,-218496676.5,-2013684.0,5915880044.527461,18698557500.0,198620720.325,447375891.75749767,1948107.735,256448094.2775008,308758121.07749873,635699116.9799982,458522998.4024992,5701271277.8700285,5879209809.509996,5879452992.254997,13367.0,80724.5,44.0,70251.5,970585.5,-1696596.0,177364.0,6755.0,4268528.5,2476709.5,-8994813.0,921269.0,37582.5,3729716797.927465,3654260409.104962,-260377270.0,-257069845.0,2524047.5,268935.0,3922301074.432457,33224925559.34341,36650584995.457634,1727866331.2125494,48038716271.22822,3984115.0,-247344093.0,102982305464.0,1052619735.5,17258886992.5,3499815097.5,18872168817.5,3668411.0,71847.0,20852.3908554683,89717556.0,-69.61757056160293,5.0,4.95785820525533,282.0138412534552,24.78929102627665,1410.069206267276,67500.0,-0.9009688679024191,-0.433883739117558,0.0,0.0,0.0,0.0,0.0,1.0,0.0,0.0,0.0,0.0,1.0,0.0,0.0,0.0,0.0,0.0,0.0,0.0,1.0,0.0,1.0,0.0,0.0,0.0,0.0,1.0,0.0,0.0,0.0,0.0,0.0,0.0,0.0,0.0,0.0,0.0,0.0,0.0,0.0,0.0,0.0,0.0,0.0,0.0,0.0,0.0,0.0,0.0,0.0,0.0,0.0,0.0,0.0,0.0,0.0,0.0,0.0,0.0,0.0,0.0,0.0,0.0,0.0,0.0,0.0,0.0,0.0,0.0,0.0,0.0,0.0,0.0,0.0,0.0,0.0,0.0,0.0,0.0,0.0,0.0,0.0,0.0,0.0,0.0,0.0,0.0,0.0,0.0,0.0,0.0,0.0,0.0,0.0,0.0,0.0,0.0,0.0,0.0,0.0,0.0,0.0,0.0,0.0,0.0,1.0,0.0,0.0,0.0,1.0,0.0,1.0,0.0,0.0,0.0,0.0,0.0,0.0,1.0,0.0,0.0
100753,0,0.0,0.0,1.0,1.0,0.0,180000.0,156384.0,18688.5,135000.0,0.022625,31.44383561643836,-2087.0,-610.0,-713.0,16.0,2.0,2.0,2.0,10.0,0.2826857378607877,0.4230110862786596,0.0938365970374978,,,,,,,,,,,,,,,,,,,,,,,,,,,,,,,,,,,,,,,,,,,,,0.0,0.0,0.0,0.0,-577.0,0.0,0.0,0.0,0.0,0.0,2.0,1.0,1.0,0.0,1.0,0.0,0.0,0.0,0.0,0.0,1.0,1.0,0.0,0.0,1.0,0.0,0.0,0.0,0.0,0.0,0.0,0.0,0.0,0.0,0.0,0.0,0.0,0.0,0.0,0.0,0.0,0.0,0.0,5.0,7036.29,0.0,143910.0,82731.285,0.0,0.0,0.0,0.0,-577.0,826.0,-22.0,-403.0,84.0,-8.0,3.0,11528.37,62910.0,63099.0,3145.5,62910.0,6.0,-577.0,365243.0,-532.0,-169.0,-139.0,-159.0,17.0,0.0,0.0493692960735762,30.0,15.0,7.0,4.0,-12.0,0.0,0.0,68.0,6946.3575,6946.3575,-307.0,-307.0,19.5,0.0,19.0,114157.845,180000.0,0.0,25382.7,0.0,13774.5,8650.035,18000.0,9130.545,113570.55,113712.345,113712.345,0.0,5.0,0.0,4.0,8.0,-10.0,0.0,0.0,8338291947.0,184251433599.0,165453527997.0,51921845110.935,1862.0,1703.0,71124.0,70662.0,9140.0,505563.0,,,,,,,128275.0,662149.0,,,,13514795.821917402,-601311176.0,-921021194.0,-296194943.0,-1533689568.0416667,43960.0,30663.0,,,,,,,67376.25319855056,157887.20860461914,125984.22348728975,,,,,,,3710633.0,,,,,,,,,,,,,,,,436036.0,430837.0,1261746.0,6418.737816002898,631337.0,624897.0,,,,,,,,,20.0,12100074.615000006,3809319.3,1165153756.6799994,405512983.215,16925136.569999997,39300.75,27.0,1719.0,-3925970.0,1885471.0,-2021379.0,-2146715.0,-9.5,7036.29,0.0,143910.0,82731.285,0.0,0.0,0.0,0.0,-577.0,826.0,-22.0,-403.0,45236553.83999995,658499453.28,737788666.68,11254233.6,658499453.28,46316.0,-3226105.0,735826765.0,32752977.0,163400331.0,73549108.0,167841695.0,46635.0,712.0,128.5684447785273,1326938.0,404452.0,243208.0,-794695.0,316742.0,1569.0,522115261.44748914,523820593.73248994,-32241387.0,-31992337.0,584692.0,26131.0,465034304.38500047,1240798500.0,41451252.75,56148121.93500003,972418.5,13695181.065,26774122.77,60159080.5200005,55039402.71000007,445457357.5949992,463170659.9400001,463189921.8750001,2291.0,5014.0,25.0,2698.0,170237.0,-292571.0,89075.0,322.0,1465878.0,14723190.0,3229066.0,8546473.0,11595906.0,1414205.0,1056767941.0620012,801046073.677495,72029118887.9996,21653997455.407616,581630461.1594988,5792395.7475,689.5,94245.0,-276656719.0,21879629.5,-123672738.5,-218497079.5,-2013692.0,5915994202.372461,18698737500.0,198620720.325,447401274.45749766,1948107.735,256461868.7775008,308766771.1124988,635717116.9799982,458532128.9474992,5701384848.420029,5879323521.854998,5879566704.5999975,13367.0,80729.5,44.0,70255.5,970593.5,-1696606.0,177364.0,6755.0,4268535.5,2476713.5,-8994825.0,921269.0,37582.5,3729723744.284965,3654267355.4624624,-260377577.0,-257070152.0,2524067.0,268935.0,3922312602.802456,33224988469.34341,36650648094.457634,1727869476.7125494,48038779181.22822,3984121.0,-247344670.0,102982670707.0,1052619203.5,17258886823.5,3499814958.5,18872168658.5,3668428.0,71847.0,20852.44022476437,89717586.0,-66.37230983706543,0.8688,9.631591620515293,302.85418364014794,8.367926799903682,263.11971474656053,90000.0,-0.9009688679024191,-0.433883739117558,0.0,0.0,0.0,0.0,0.0,0.0,1.0,0.0,0.0,0.0,0.0,0.0,0.0,1.0,0.0,0.0,0.0,0.0,1.0,1.0,0.0,0.0,0.0,0.0,0.0,0.0,0.0,0.0,0.0,1.0,0.0,0.0,0.0,0.0,0.0,0.0,0.0,0.0,0.0,0.0,0.0,0.0,0.0,0.0,1.0,0.0,0.0,0.0,0.0,0.0,0.0,0.0,0.0,0.0,0.0,0.0,0.0,0.0,0.0,0.0,0.0,0.0,0.0,0.0,0.0,0.0,0.0,0.0,0.0,0.0,0.0,0.0,0.0,0.0,0.0,0.0,0.0,0.0,0.0,0.0,0.0,0.0,0.0,0.0,0.0,0.0,0.0,0.0,0.0,0.0,1.0,0.0,0.0,0.0,0.0,0.0,0.0,0.0,0.0,0.0,0.0,0.0,0.0,0.0,0.0,0.0,0.0,0.0,0.0,0.0,0.0,0.0,0.0,0.0,0.0,0.0,0.0,0.0,0.0,0.0
100754,0,0.0,1.0,1.0,1.0,0.0,135000.0,364500.0,13221.0,364500.0,0.00733,53.24383561643835,-553.0,-9402.0,-2908.0,24.0,2.0,2.0,2.0,15.0,,0.2687013095065218,0.2301588968634147,0.1866,0.1316,0.9871,0.8232,,0.2,0.1724,0.3333,0.0417,0.1016,0.1513,0.1882,0.0039,,0.1901,0.1366,0.9871,0.8301,,0.2014,0.1724,0.3333,0.0417,0.104,0.1653,0.1961,0.0039,,0.1884,0.1316,0.9871,0.8256,,0.2,0.1724,0.3333,0.0417,0.1034,0.1539,0.1916,0.0039,,0.1486,1.0,0.0,0.0,0.0,0.0,-1714.0,0.0,0.0,0.0,0.0,1.0,2.0,1.0,1.0,0.0,1.0,0.0,0.0,0.0,0.0,0.0,0.0,0.0,0.0,0.0,1.0,0.0,0.0,0.0,0.0,0.0,0.0,0.0,0.0,0.0,0.0,0.0,0.0,0.0,0.0,0.0,0.0,0.0,0.0,6.0,14545.9575,0.0,551250.0,202654.035,0.0,0.0,0.0,0.0,-824.0,1589.5,-155.5,-529.0,169.0,-17.0,9.0,24928.065,73219.5,337500.0,3780.0,472500.0,12.0,-731.0,365243.0,-786.5,-480.0,647.5,-433.0,11.0,0.5,0.1667279685869078,-1.0,70.0,54.0,45.5,-27.0,0.0,0.0,115.0,21876.345,21876.345,-536.0,-536.0,11.0,1.0,23.0,0.0,900000.0,0.0,6970.005,0.0,0.0,2250.0,8550.0,7200.0,0.0,466.875,466.875,0.0,1.0,0.0,0.0,9.0,-13.0,0.0,0.0,8338305168.0,184251798099.0,165453892497.0,51921980110.935,1862.0,1703.0,71124.0,70663.0,9140.0,505565.0,17791.334400002306,17853.389099999113,17305.23419999808,11285.484300000087,11223.312200000091,11170.825600000057,128275.0,662151.0,,,,13514849.065753017,-601311729.0,-921024102.0,-296196657.0,-1533698970.0416667,43960.0,30663.0,11340.213199999174,11216.119999998968,10700.7130999973,22866.25040000962,22788.11670000958,22174.17460000813,,157887.47730592865,125984.45364618664,34967.84460002787,34908.26120002831,34354.84100002872,22932.62019999593,22906.067699995507,22553.456799995743,3710648.0,8288.119900000167,8392.529400000081,8116.290000000228,9809.353400000718,9924.20010000216,10283.525799999648,16453.322799999754,16638.3499999997,16235.3123999997,828.1318000001758,813.3130000000458,759.3002000000133,,,,436036.0,430837.0,1261770.0,6418.745146002898,631339.0,624899.0,,16317.1940999998,154038.35949999053,154041.10349999007,153932.89749998722,77541.94879999627,77879.4253000066,78280.41860000648,27.5,12142080.405000005,3809324.565,1167411434.3999994,406760003.64,16925136.569999997,39300.75,27.0,1719.0,-3930933.5,1923094.5,-2024003.0,-2149174.0,-13.25,0.0,0.0,111483.0,0.0,0.0,0.0,0.0,0.0,-840.0,-78.0,-529.0,-1930.0,45311470.15499995,660305978.28,739841472.18,11264939.1,660269368.53,46452.0,-3231500.0,737104779.0,32748667.0,163763847.0,73915047.0,168205230.0,46712.0,714.0,128.9512700117747,1327224.0,406434.0,244823.0,-795681.0,316742.0,1569.0,525366847.48498935,527070504.10499024,-32303489.0,-32053942.0,586132.0,26191.0,466250645.83500046,1246738500.0,41755002.75,56648008.62000004,972418.5,13891317.75,26844830.23499999,60705182.47500049,55539038.70000007,446633040.7349991,464373136.8450001,464392398.7800001,2305.0,5074.0,25.0,2744.0,170435.0,-292772.0,89075.0,322.0,1465884.0,14723359.0,3229089.0,8546543.0,11596021.0,1414214.0,1056782487.0195012,801046073.677495,72029670137.9996,21654200109.442616,581630461.1594988,5792395.7475,689.5,94245.0,-276657543.0,21881219.0,-123672894.0,-218497608.5,-2013709.0,5915994202.372461,18699637500.0,198620720.325,447408244.46249765,1948107.735,256461868.7775008,308769021.1124988,635725666.9799982,458539328.9474992,5701384848.420029,5879323988.729998,5879567171.4749975,13367.0,80730.5,44.0,70255.5,970602.5,-1696619.0,177364.0,6755.0,4268589.5,2476759.0,-8994852.0,921269.0,37582.5,3729745620.629965,3654289231.8074617,-260378113.0,-257070688.0,2524078.0,268936.0,3922337530.867456,33225061688.84341,36650985594.457634,1727873256.7125494,48039251681.22822,3984133.0,-247345401.0,102983035950.0,1052618417.0,17258886343.5,3499815606.0,18872168225.5,3668439.0,71847.5,20852.60695273296,89717585.0,-10.386178861788617,2.7,10.211027910142953,543.6742915225154,27.56977535738598,1467.920587110792,67500.0,-0.9009688679024191,-0.433883739117558,0.0,0.0,0.0,0.0,0.0,0.0,1.0,0.0,0.0,0.0,0.0,0.0,0.0,1.0,0.0,0.0,0.0,0.0,1.0,0.0,1.0,0.0,0.0,0.0,0.0,1.0,0.0,0.0,0.0,0.0,0.0,0.0,0.0,0.0,1.0,0.0,0.0,0.0,0.0,0.0,0.0,0.0,0.0,0.0,0.0,0.0,0.0,0.0,0.0,0.0,0.0,0.0,0.0,0.0,0.0,0.0,0.0,0.0,0.0,0.0,0.0,0.0,0.0,0.0,0.0,0.0,0.0,0.0,0.0,0.0,0.0,0.0,0.0,0.0,0.0,0.0,0.0,0.0,0.0,0.0,0.0,0.0,0.0,0.0,0.0,0.0,0.0,0.0,0.0,0.0,1.0,0.0,0.0,0.0,0.0,0.0,0.0,0.0,0.0,0.0,0.0,0.0,0.0,0.0,0.0,0.0,0.0,0.0,1.0,0.0,1.0,0.0,0.0,0.0,0.0,0.0,0.0,1.0,0.0,0.0
100760,0,0.0,1.0,0.0,1.0,0.0,90000.0,224149.5,22297.5,193500.0,0.030755,53.33424657534246,-3254.0,-445.0,-2701.0,,2.0,2.0,2.0,13.0,,0.5909797478001795,0.6446794549585961,,,,,,,,,,,,,,,,,,,,,,,,,,,,,,,,,,,,,,,,,,,,,0.0,0.0,0.0,0.0,-3468.0,0.0,0.0,0.0,0.0,0.0,4.0,1.0,1.0,0.0,1.0,0.0,0.0,0.0,0.0,0.0,0.0,1.0,1.0,0.0,0.0,0.0,0.0,1.0,0.0,0.0,0.0,0.0,0.0,0.0,0.0,0.0,0.0,0.0,0.0,0.0,0.0,0.0,0.0,7.0,0.0,0.0,37566.0,0.0,0.0,0.0,0.0,0.0,-1593.0,-1047.0,-365.0,-1503.5,355.0,-30.0,3.0,55381.32,558000.0,580095.0,,558000.0,18.0,-839.0,365243.0,-809.0,-629.0,-479.0,-624.0,11.0,1.0,,-1.0,30.0,18.0,10.0,-27.5,0.0,0.0,34.0,12942.135,12942.135,-923.0,-916.0,6.0,1.0,0.0,,,,,,,,,,,,,,,,,,,,,8338327465.5,184252022248.5,165454085997.0,51922070110.935,1862.0,1703.0,71124.0,70663.0,9140.0,505569.0,,,,,,,128275.0,662153.0,,,,13514902.399999592,-601314983.0,-921026803.0,-296200125.0,-1533699415.0416667,43960.0,30663.0,,,,,,,,157888.06828567645,125985.0983256416,,,,,,,3710661.0,,,,,,,,,,,,,,,,436036.0,430837.0,,6418.775901002898,631341.0,624901.0,,,,,,,,,53.0,12182485.320000006,3809335.68,1171894758.8399994,409046891.175,16989336.584999993,39300.75,27.0,1719.0,-3959415.0,1942601.0,-2036139.0,-2168201.0,-26.0,0.0,0.0,37566.0,0.0,0.0,0.0,0.0,0.0,-2227.0,-2013.0,-365.0,-2013.0,45708208.42499995,663958844.28,745739068.68,,663958844.28,46720.0,-3243827.0,742765283.0,33102476.0,165581941.0,75007072.0,170023483.0,46960.0,724.0,,1328337.0,409474.0,246983.5,-799346.0,316787.0,1592.0,530442251.3924888,532054386.4274898,-32411830.0,-32160375.0,589428.5,26361.5,,,,,,,,,,,,,,,,,,,,,1465891.0,14723714.0,3229089.0,8546573.0,11596055.0,1414217.0,1056782487.0195012,801046073.677495,72029707703.9996,21654200109.442616,581630461.1594988,5792395.7475,689.5,94245.0,-276659136.0,21880172.0,-123673259.0,-218499112.0,-2013739.0,,,,,,,,,,,,,,,,,,,,,4268607.5,2476769.0,-8994879.5,921269.0,37582.5,3729758562.764965,3654302173.9424624,-260379036.0,-257071604.0,2524084.0,268937.0,3922392912.187457,33225619688.84341,36651565689.457634,,48039809681.22822,3984151.0,-247346240.0,102983401193.0,1052617608.0,17258885714.5,3499815127.0,18872167601.5,3668450.0,71848.5,,89717584.0,-61.011455283299945,2.49055,4.036326942482342,215.2744564090513,10.052674066599394,536.1517974095627,45000.0,1.0,0.0,0.0,1.0,0.0,0.0,0.0,0.0,0.0,0.0,0.0,0.0,0.0,0.0,0.0,1.0,0.0,0.0,0.0,0.0,1.0,0.0,1.0,0.0,0.0,0.0,0.0,1.0,0.0,0.0,0.0,0.0,0.0,0.0,0.0,0.0,0.0,0.0,0.0,0.0,1.0,0.0,0.0,0.0,0.0,0.0,0.0,0.0,0.0,0.0,0.0,0.0,0.0,0.0,0.0,0.0,0.0,1.0,0.0,0.0,0.0,0.0,0.0,0.0,0.0,0.0,0.0,0.0,0.0,0.0,0.0,0.0,0.0,0.0,0.0,0.0,0.0,0.0,0.0,0.0,0.0,0.0,0.0,0.0,0.0,0.0,0.0,0.0,0.0,0.0,0.0,0.0,0.0,0.0,0.0,0.0,0.0,0.0,0.0,0.0,0.0,0.0,0.0,0.0,0.0,0.0,0.0,0.0,0.0,0.0,0.0,0.0,0.0,0.0,0.0,0.0,0.0,0.0,0.0,0.0,0.0,0.0
100762,0,0.0,0.0,0.0,0.0,0.0,180000.0,225000.0,20637.0,225000.0,0.015221,47.6054794520548,-2924.0,-1477.0,-909.0,,2.0,2.0,2.0,14.0,,0.5507073593136236,0.3092753558842053,,,,,,,,,,,,,,,,,,,,,,,,,,,,,,,,,,,,,,,,,,,,,0.0,0.0,0.0,0.0,-2604.0,0.0,0.0,0.0,0.0,0.0,1.0,1.0,1.0,0.0,1.0,1.0,0.0,0.0,0.0,0.0,0.0,0.0,0.0,0.0,1.0,0.0,0.0,0.0,0.0,0.0,0.0,0.0,0.0,0.0,0.0,0.0,0.0,0.0,0.0,0.0,0.0,0.0,0.0,11.0,0.0,0.0,85500.0,0.0,0.0,0.0,0.0,0.0,-1360.0,-963.0,-236.0,-1042.0,376.0,-25.0,2.0,3728.79,36236.25,35473.5,2749.5,36236.25,3.0,-1557.0,365243.0,-2564.0,-2414.0,-2414.0,-2411.0,12.5,1.0,0.1043491524940482,5.0,7.0,6.0,3.0,-83.0,0.0,0.0,6.0,5207.58,5207.58,-2518.5,-2489.0,3.5,1.0,0.0,,,,,,,,,,,,,,,,,,,,,8338348102.5,184252247248.5,165454310997.0,51922250110.935,1862.0,1703.0,71124.0,70663.0,9140.0,505570.0,,,,,,,128275.0,662155.0,,,,13514950.005479043,-601317907.0,-921027712.0,-296202729.0,-1533700892.0416667,43960.0,30663.0,,,,,,,,157888.61899303575,125985.4076009975,,,,,,,3710675.0,,,,,,,,,,,,,,,,436036.0,430837.0,,6418.791122002896,631343.0,624903.0,,,,,,,,,45.0,12182485.320000006,3809335.68,1173529452.0599997,409046891.175,17130591.584999993,39300.75,27.0,1719.0,-3971323.0,1964129.0,-2043159.0,-2174582.0,-22.0,0.0,0.0,76297.5,0.0,0.0,0.0,0.0,0.0,-1742.0,-1042.0,-1023.0,-1146.0,45824961.19499996,665196366.78,746993740.68,11312688.6,665196366.78,46768.0,-3249832.0,743495769.0,33099103.0,165578898.0,75004179.0,170020448.0,47017.5,726.0,129.32857427932913,1328362.5,410141.0,247421.0,-800791.0,316796.0,1601.0,531969899.1749887,533837699.0549898,-32456602.5,-32203425.0,589700.5,26431.5,,,,,,,,,,,,,,,,,,,,,1465902.0,14724090.0,3229089.0,8546580.0,11596061.0,1414219.0,1056782487.0195012,801046073.677495,72029793203.9996,21654200109.442616,581630461.1594988,5792395.7475,689.5,94245.0,-276660496.0,21879209.0,-123673495.0,-218500154.0,-2013764.0,,,,,,,,,,,,,,,,,,,,,4268613.5,2476772.0,-8994962.5,921269.0,37582.5,3729763770.344965,3654307381.5224624,-260381554.5,-257074093.0,2524087.5,268938.0,3922396640.977457,33225655925.09341,36651601162.957634,1727876006.2125494,48039845917.47822,3984154.0,-247347797.0,102983766436.0,1052615044.0,17258883300.5,3499812713.0,18872165190.5,3668462.5,71849.5,20852.71130188545,89717589.0,-61.42150092081031,1.25,8.722197993894461,415.22441737509627,10.902747492368077,519.0305217188704,90000.0,1.0,0.0,0.0,0.0,0.0,0.0,0.0,0.0,1.0,0.0,0.0,0.0,0.0,0.0,0.0,1.0,0.0,0.0,0.0,0.0,1.0,0.0,1.0,0.0,0.0,0.0,0.0,1.0,0.0,0.0,0.0,0.0,0.0,0.0,0.0,0.0,0.0,0.0,0.0,0.0,0.0,0.0,0.0,0.0,0.0,0.0,1.0,0.0,0.0,0.0,0.0,0.0,0.0,0.0,0.0,0.0,0.0,0.0,0.0,0.0,0.0,1.0,0.0,0.0,0.0,0.0,0.0,0.0,0.0,0.0,0.0,0.0,0.0,0.0,0.0,0.0,0.0,0.0,0.0,0.0,0.0,0.0,0.0,0.0,0.0,0.0,0.0,0.0,0.0,0.0,0.0,0.0,0.0,0.0,0.0,0.0,0.0,0.0,0.0,0.0,0.0,0.0,0.0,0.0,0.0,0.0,0.0,0.0,0.0,0.0,0.0,0.0,0.0,0.0,0.0,0.0,0.0,0.0,0.0,0.0,0.0,0.0
100763,0,0.0,0.0,1.0,1.0,0.0,157500.0,571486.5,24340.5,454500.0,0.010147,30.282191780821925,-1372.0,-891.0,-3299.0,2.0,2.0,2.0,2.0,16.0,,0.2144856498196455,0.7922644738669378,0.101,0.1313,0.9841,,,0.0,0.2759,0.1667,,0.0947,,0.1033,,0.1499,0.1029,0.1362,0.9841,,,0.0,0.2759,0.1667,,0.0968,,0.1076,,0.1587,0.102,0.1313,0.9841,,,0.0,0.2759,0.1667,,0.0963,,0.1051,,0.1531,0.0807,1.0,1.0,0.0,1.0,0.0,0.0,0.0,0.0,0.0,0.0,1.0,1.0,1.0,1.0,1.0,1.0,1.0,0.0,0.0,1.0,1.0,0.0,1.0,1.0,0.0,1.0,0.0,0.0,0.0,0.0,0.0,0.0,0.0,0.0,0.0,0.0,0.0,0.0,0.0,0.0,0.0,0.0,0.0,0.0,5.0,0.0,,97056.0,0.0,0.0,0.0,0.0,0.0,-1224.0,-1039.0,-969.0,-1039.0,238.0,-24.0,3.0,10125.0,202500.0,202500.0,0.0,202500.0,0.0,-533.0,365243.0,365243.0,365243.0,365243.0,-74.0,15.0,0.0,0.0,30.0,16.0,16.0,8.5,-10.5,0.0,0.0,15.0,23669.955,23669.955,-297.0,-292.0,8.0,1.0,21.0,0.0,0.0,,0.0,,,0.0,,0.0,0.0,0.0,0.0,,0.0,,,0.0,-8.0,0.0,0.0,8338372443.0,184252818735.0,165454765497.0,51922407610.935,1862.0,1703.0,71124.0,70664.0,9140.0,505571.0,17791.4354000023,17853.491099999108,17305.337099998083,11285.615600000085,11223.443500000092,11170.961800000056,128275.0,662157.0,,,,13514980.287670828,-601319279.0,-921031011.0,-296202729.0,-1533701783.0416667,43960.0,30663.0,11340.213199999174,11216.119999998968,10700.7130999973,22866.52630000962,22788.39260000958,22174.45050000813,,157888.83347868556,125986.19986547135,34968.01130002787,34908.42790002831,34355.00770002872,,,,3710691.0,8288.214600000167,8392.625700000079,8116.386800000227,,,,16453.42609999975,16638.4550999997,16235.4199999997,,,,3909.312700000125,3892.536400000161,3725.296600000157,436037.0,430838.0,1261772.0,6418.801269002896,631345.0,624905.0,,16317.2747999998,154039.34359999053,154042.08759999005,153933.88159998722,,,,41.0,12229948.305000003,,1174923978.6599994,410070245.175,17130591.584999993,39300.75,27.0,1719.0,-3978886.0,1960189.0,-2047960.0,-2181281.0,-20.0,0.0,,97056.0,0.0,0.0,0.0,0.0,0.0,-1724.0,-1422.0,-1033.0,-1207.0,45838461.19499996,665466366.78,747263740.68,11312688.6,665466366.78,46768.0,-3250706.0,744226255.0,33829087.0,166309302.0,75734613.0,170020040.0,47051.0,726.0,129.32857427932913,1328394.0,410295.0,247512.0,-801139.0,316796.0,1601.0,532172277.7649885,534040077.64498967,-32465628.0,-32212351.0,589761.0,26442.0,473943129.7500005,1270993500.0,,58555425.06000004,,,27170497.93499999,,56978845.29000007,454020879.28499913,471974005.8000001,471993267.7350001,,5237.0,,,170581.0,-293241.0,89075.0,322.0,1465907.0,14724328.0,3229110.0,8546596.0,11596076.0,1414222.0,1056782487.0195012,,72029890259.9996,21654200109.442616,581630461.1594988,5792395.7475,689.5,94245.0,-276661720.0,21878170.0,-123674464.0,-218501193.0,-2013788.0,5915994202.372461,18699637500.0,,447408244.46249765,,,308769021.1124988,,458539328.9474992,5701384848.420029,5879323988.729998,5879567171.4749975,,80730.5,,,970602.5,-1696627.0,177364.0,6755.0,4268629.5,2476780.5,-8994973.0,921269.0,37582.5,3729787440.299965,3654331051.4774623,-260381851.5,-257074385.0,2524095.5,268939.0,3922406765.977457,33225858425.09341,36651803662.957634,1727876006.2125494,48040048417.47822,3984154.0,-247348330.0,102984131679.0,1052980287.0,17259248543.5,3500177956.0,18872165116.5,3668477.5,71849.5,20852.71130188545,89717619.0,-45.30715642811906,3.628485714285714,6.470696986503974,195.94688710089983,23.47883157700129,710.9904806043708,78750.0,-0.9009688679024191,0.4338837391175582,0.0,1.0,0.0,0.0,0.0,0.0,0.0,0.0,1.0,0.0,0.0,0.0,0.0,0.0,0.0,0.0,1.0,0.0,0.0,1.0,0.0,0.0,0.0,0.0,0.0,1.0,0.0,0.0,0.0,0.0,0.0,0.0,0.0,0.0,0.0,0.0,0.0,0.0,0.0,0.0,0.0,0.0,0.0,0.0,0.0,0.0,0.0,0.0,0.0,0.0,0.0,0.0,0.0,1.0,0.0,0.0,0.0,0.0,0.0,0.0,0.0,0.0,0.0,0.0,0.0,0.0,0.0,0.0,0.0,0.0,0.0,0.0,0.0,0.0,0.0,0.0,0.0,0.0,0.0,0.0,0.0,0.0,0.0,0.0,0.0,0.0,0.0,0.0,0.0,0.0,0.0,0.0,0.0,0.0,0.0,0.0,0.0,0.0,0.0,0.0,0.0,0.0,0.0,0.0,0.0,0.0,0.0,0.0,0.0,0.0,1.0,0.0,0.0,0.0,0.0,0.0,0.0,0.0,1.0,0.0
100765,0,0.0,0.0,1.0,0.0,2.0,112500.0,136287.0,8847.0,103500.0,0.010966,39.97260273972604,-3714.0,-4701.0,-4743.0,4.0,4.0,2.0,2.0,10.0,,0.5136001642195136,0.6801388218428291,0.1031,0.0568,0.9816,0.7484,0.0125,0.0,0.2069,0.1667,0.2083,0.1027,0.0841,0.094,0.0,0.0,0.105,0.059,0.9816,0.7583,0.0126,0.0,0.2069,0.1667,0.2083,0.105,0.0918,0.0979,0.0,0.0,0.1041,0.0568,0.9816,0.7518,0.0126,0.0,0.2069,0.1667,0.2083,0.1045,0.0855,0.0957,0.0,0.0,0.0808,1.0,3.0,0.0,3.0,0.0,0.0,0.0,0.0,0.0,0.0,0.0,0.0,1.0,1.0,0.0,1.0,0.0,0.0,0.0,0.0,0.0,0.0,0.0,0.0,0.0,1.0,0.0,0.0,0.0,0.0,0.0,0.0,0.0,0.0,0.0,0.0,0.0,0.0,0.0,0.0,0.0,0.0,0.0,0.0,1.0,,0.0,17055.0,0.0,0.0,0.0,0.0,0.0,-2089.0,-1786.0,-1785.0,-1786.0,69.0,-34.0,4.0,8606.475,113339.25,115103.25,0.0,191043.0,12.0,-369.0,365243.0,-621.0,365243.0,69.0,365243.0,15.0,0.0,0.0,9.5,30.0,24.0,9.5,-16.5,0.0,0.0,30.0,8606.475,8606.475,-515.0,-456.0,8.0,1.0,2.0,0.0,270000.0,,0.0,,,0.0,,0.0,0.0,0.0,0.0,,0.0,,,0.0,-2.5,0.0,0.0,8338381290.0,184252955022.0,165454868997.0,51922520110.935,1862.0,1703.0,71124.0,70664.0,9140.0,505571.0,17791.5385000023,17853.595199999112,17305.442099998083,11285.672400000089,11223.500300000092,11171.020800000057,128277.0,662161.0,4134.934000000123,4132.567400000016,3943.390800000095,13515020.260273565,-601322993.0,-921035754.0,-296202729.0,-1533706484.0416667,43960.0,30663.0,11340.213199999174,11216.119999998968,10700.7130999973,22866.733200009618,22788.599500009583,22174.65740000813,,157889.34707884974,125986.8800042932,34968.178000027874,34908.594600028315,34355.17440002872,22932.82849999593,22906.27599999551,22553.665099995746,3710701.0,8288.317300000166,8392.73020000008,8116.491800000228,9809.43750000072,9924.28560000216,10283.617599999649,16453.520099999754,16638.550799999706,16235.5178999997,828.1318000001758,813.3130000000458,759.3002000000133,3909.312700000125,3892.536400000161,3725.296600000157,436040.0,430841.0,1261776.0,6418.812235002897,631347.0,624907.0,,16317.3555999998,154040.32519999053,154043.06919999004,153934.86319998722,77542.69719999628,77880.17710000661,78281.17690000648,69.0,,3809335.68,1176505049.1599994,410937998.175,17130591.584999993,39300.75,27.0,1719.0,-3985626.0,1957249.0,-2052074.0,-2185567.0,-34.0,,0.0,17055.0,0.0,0.0,0.0,0.0,0.0,-2089.0,-1786.0,-1785.0,-1786.0,45899152.24499995,666183927.78,747995170.68,11330679.6,666183927.78,46800.0,-3254474.5,745687227.0,34190665.0,166671831.0,76097232.0,170382500.0,47113.5,726.0,129.54639246114732,1332974.5,410671.0,247722.5,-802081.5,316796.0,1601.0,532546921.1474888,534414721.0274898,-32493124.0,-32239117.5,589953.0,26470.5,473943129.7500005,1271533500.0,,58555425.06000004,,,27170497.93499999,,56978845.29000007,454020879.28499913,471974005.8000001,471993267.7350001,,5237.0,,,170581.0,-293364.5,89075.0,322.0,1465908.0,14724397.0,3229112.0,8546626.0,11596106.0,1414226.0,,801046073.677495,72029907314.9996,21654200109.442616,581630461.1594988,5792395.7475,689.5,94245.0,-276663809.0,21876384.0,-123676249.0,-218502979.0,-2013822.0,5915994202.372461,18699907500.0,,447408244.46249765,,,308769021.1124988,,458539328.9474992,5701384848.420029,5879323988.729998,5879567171.4749975,,80730.5,,,970602.5,-1696629.5,177364.0,6755.0,4268653.5,2476790.0,-8994989.5,921269.0,37582.5,3729796046.774964,3654339657.9524617,-260382366.5,-257074841.0,2524103.5,268940.0,3922415372.452457,33225971764.34341,36651918766.207634,1727876006.2125494,48040239460.47822,3984166.0,-247348699.0,102984496922.0,1052979666.0,17259613786.5,3500178025.0,18872530359.5,3668492.5,71849.5,20852.71130188545,89717628.5,-92.91363947909528,1.21144,12.71617497456765,508.2986106272384,15.404883011190233,615.7732688582618,28125.0,0.6234898018587336,0.7818314824680298,0.0,0.0,0.0,0.0,0.0,0.0,1.0,0.0,0.0,0.0,0.0,0.0,0.0,1.0,0.0,0.0,0.0,0.0,1.0,0.0,1.0,0.0,0.0,0.0,0.0,1.0,0.0,0.0,0.0,0.0,0.0,0.0,0.0,0.0,0.0,0.0,0.0,0.0,1.0,0.0,0.0,0.0,0.0,0.0,0.0,0.0,0.0,0.0,0.0,0.0,0.0,0.0,1.0,0.0,0.0,0.0,0.0,0.0,0.0,0.0,0.0,0.0,0.0,0.0,0.0,0.0,0.0,0.0,0.0,0.0,0.0,0.0,0.0,0.0,0.0,0.0,0.0,0.0,0.0,0.0,0.0,0.0,0.0,0.0,0.0,0.0,0.0,0.0,0.0,0.0,0.0,0.0,0.0,0.0,0.0,0.0,0.0,0.0,0.0,0.0,0.0,0.0,0.0,0.0,0.0,0.0,0.0,1.0,0.0,0.0,1.0,0.0,0.0,1.0,0.0,0.0,0.0,0.0,0.0,0.0
100770,0,0.0,1.0,1.0,0.0,0.0,202500.0,697500.0,33687.0,697500.0,0.015221,24.16164383561644,-852.0,-2751.0,-1476.0,4.0,2.0,2.0,2.0,8.0,0.1763221241783251,0.5756416907714301,0.3001077565791181,0.1072,0.0785,0.9871,0.8844,0.0683,0.12,0.1034,0.3542,0.4167,0.0354,0.0815,0.1181,0.0116,0.0143,0.105,0.0809,0.9826,0.8889,0.069,0.1208,0.1034,0.3333,0.4167,0.0363,0.0891,0.1183,0.0117,0.0151,0.1083,0.0785,0.9871,0.8859,0.0688,0.12,0.1034,0.3542,0.4167,0.0361,0.0829,0.1202,0.0116,0.0145,0.0893,1.0,0.0,0.0,0.0,0.0,-1615.0,0.0,0.0,0.0,0.0,0.0,0.0,1.0,1.0,0.0,1.0,1.0,0.0,0.0,0.0,0.0,0.0,0.0,0.0,0.0,1.0,0.0,0.0,0.0,0.0,0.0,0.0,0.0,0.0,0.0,0.0,0.0,0.0,0.0,0.0,0.0,0.0,0.0,0.0,5.0,62478.0,0.0,900000.0,22500.0,0.0,0.0,0.0,0.0,-598.0,850.0,-53.0,-450.0,97.0,-10.0,4.0,10491.3675,61530.75,64521.0,1840.5,61530.75,7.0,-934.5,365243.0,-903.5,-873.5,-753.5,-864.0,11.5,0.0,0.0500042862391313,40.0,24.0,8.0,5.5,-37.5,0.0,0.0,19.0,12208.905,12208.905,-1133.0,-1123.0,3.0,1.0,0.0,,,,,,,,,,,,,,,,,,,,,8338414977.0,184253652522.0,165455566497.0,51922722610.935,1862.0,1703.0,71124.0,70664.0,9140.0,505571.0,17791.6457000023,17853.703499999112,17305.547099998083,11285.750900000085,11223.578800000092,11171.101700000056,128277.0,662163.0,4135.002300000123,4132.636200000016,3943.459800000095,13515044.4219174,-601323845.0,-921037230.0,-296204344.0,-1533709235.0416667,43960.0,30663.0,11340.333199999175,11216.239999998968,10700.833899997302,22866.836600009618,22788.702900009583,22174.76080000813,67376.42952067475,157889.92272054055,125987.1801120498,34968.53220002788,34908.94880002832,34355.50770002872,22933.24519999593,22906.692699995507,22554.081799995743,3710709.0,8288.352700000167,8392.76630000008,8116.528100000228,9809.51900000072,9924.36850000216,10283.706699999648,16453.638199999754,16638.670999999704,16235.6361999997,828.1434000001758,813.3246000000457,759.3119000000132,3909.327000000125,3892.550900000161,3725.3117000001566,436040.0,430841.0,1261780.0,6418.827456002897,631349.0,624909.0,,16317.4448999998,154041.31229999056,154044.05629999007,153935.84579998718,77543.58159999628,77881.06300000659,78282.06580000647,20.0,12295441.305000003,3869289.18,1178672175.0449994,412584162.795,17130591.584999993,39300.75,27.0,1719.0,-3992971.0,1956209.0,-2056122.0,-2189994.5,-9.5,62478.0,0.0,900000.0,0.0,0.0,0.0,0.0,0.0,-656.0,-233.0,-227.0,-667.0,46076502.98249997,667869032.2049999,749795288.5799999,11389381.875,667869032.2049999,46965.0,-3272578.5,750250574.5,34174856.5,168121349.0,76452409.5,171832105.0,47359.0,729.0,130.39734190029034,1338276.0,412671.0,248770.5,-806421.0,316910.0,1614.0,534485362.8599887,536165781.7049903,-32730990.0,-32474281.0,595162.0,26613.0,,,,,,,,,,,,,,,,,,,,,1465913.0,14724494.0,3229112.0,8546650.0,11596125.0,1414230.0,1056844965.0195012,801046073.677495,72030807314.9996,21654222609.442616,581630461.1594988,5792395.7475,689.5,94245.0,-276664407.0,21877234.0,-123676302.0,-218503429.0,-2013832.0,,,,,,,,,,,,,,,,,,,,,4268661.5,2476795.5,-8995027.0,921269.0,37582.5,3729808255.679965,3654351866.8574624,-260383499.5,-257075964.0,2524106.5,268941.0,3922425863.819956,33226033295.09341,36651983287.207634,1727877846.7125494,48040300991.22822,3984173.0,-247349633.5,102984862165.0,1052978762.5,17259612913.0,3500177271.5,18872529495.5,3668504.0,71849.5,20852.76130617169,89717668.5,-35.262501417394255,3.4444444444444446,6.011220945765428,145.2409795087817,20.705316590969808,500.2744849746925,101250.0,-0.2225209339563143,0.9749279121818236,0.0,0.0,0.0,0.0,0.0,0.0,1.0,0.0,0.0,0.0,0.0,0.0,0.0,1.0,0.0,0.0,1.0,0.0,0.0,0.0,1.0,0.0,0.0,0.0,0.0,0.0,0.0,0.0,0.0,1.0,0.0,0.0,0.0,0.0,0.0,0.0,0.0,0.0,0.0,0.0,0.0,0.0,0.0,0.0,1.0,0.0,0.0,0.0,0.0,0.0,0.0,0.0,0.0,0.0,0.0,1.0,0.0,0.0,0.0,0.0,0.0,0.0,0.0,0.0,0.0,0.0,0.0,0.0,0.0,0.0,0.0,0.0,0.0,0.0,0.0,0.0,0.0,0.0,0.0,0.0,0.0,0.0,0.0,0.0,0.0,0.0,0.0,0.0,0.0,0.0,0.0,0.0,0.0,0.0,0.0,0.0,0.0,0.0,0.0,0.0,0.0,0.0,0.0,0.0,0.0,0.0,0.0,1.0,0.0,0.0,1.0,0.0,0.0,0.0,0.0,0.0,0.0,1.0,0.0,0.0
100772,0,0.0,1.0,1.0,0.0,0.0,315000.0,1096020.0,56092.5,900000.0,0.072508,33.580821917808215,-1234.0,-6307.0,-4872.0,8.0,2.0,1.0,1.0,14.0,0.3408389706578599,0.7263836452325112,0.622922000268356,,,,,,,,,,,,,,,,,,,,,,,,,,,,,,,,,,,,,,,,,,,,,0.0,0.0,0.0,0.0,-2060.0,0.0,0.0,0.0,0.0,0.0,3.0,1.0,1.0,0.0,1.0,1.0,1.0,0.0,0.0,0.0,0.0,1.0,1.0,0.0,0.0,0.0,0.0,0.0,0.0,1.0,0.0,0.0,0.0,0.0,0.0,0.0,0.0,0.0,0.0,0.0,0.0,0.0,0.0,10.0,0.0,,185226.75,0.0,0.0,0.0,0.0,0.0,-1553.0,-795.0,-775.5,-1354.0,451.0,-24.0,7.0,10003.8375,70155.0,68350.5,8196.75,87720.75,11.0,-1686.0,365243.0,-1796.0,-1646.0,-1646.0,-1643.0,15.0,0.0,0.1460036840327238,25.0,43.0,10.0,5.0,-59.0,0.0,0.0,44.0,9323.01,9323.01,-1840.0,-1834.0,5.0,1.0,0.0,,,,,,,,,,,,,,,,,,,,,8338471069.5,184254748542.0,165456466497.0,51923037610.935,1862.0,1703.0,71124.0,70664.0,9140.0,505574.0,,,,,,,128277.0,662165.0,,,,13515078.00273932,-601325079.0,-921042102.0,-296206404.0,-1533715542.0416667,43960.0,30663.0,,,,,,,67376.77035964541,157890.64910418578,125987.80303405008,,,,,,,3710723.0,,,,,,,,,,,,,,,,436040.0,430841.0,1261788.0,6418.899964002897,631350.0,624910.0,,,,,,,,,51.5,12331895.805000003,,1186654315.7699995,413179306.74,17130591.584999993,39300.75,27.0,1719.0,-4015869.5,2007190.0,-2066905.0,-2203933.0,-25.25,0.0,,100453.5,0.0,0.0,0.0,0.0,0.0,-1586.0,-1345.0,-1083.0,-1388.0,46241282.87999997,670146794.9549999,752458424.5799999,11429931.375,670166403.7049999,47114.0,-3283931.0,752989897.0,34162373.0,168111950.0,76442461.0,171822741.0,47472.0,731.0,131.05331339062252,1338665.0,414064.0,249512.0,-811229.0,316982.0,1614.0,536157773.1449875,537717654.7199894,-32892468.0,-32635261.0,596058.5,26710.5,,,,,,,,,,,,,,,,,,,,,1465923.0,14724945.0,3229112.0,8546693.0,11596169.0,1414237.0,1056844965.0195012,,72030992541.7496,21654222609.442616,581630461.1594988,5792395.7475,689.5,94245.0,-276665960.0,21876439.0,-123677077.5,-218504783.0,-2013856.0,,,,,,,,,,,,,,,,,,,,,4268671.5,2476800.5,-8995086.0,921269.0,37582.5,3729817578.689965,3654361189.867463,-260385339.5,-257077798.0,2524111.5,268942.0,3922435867.657456,33226103450.09341,36652051637.707634,1727886043.4625494,48040388711.97822,3984184.0,-247351319.5,102985227408.0,1052976966.5,17259611267.0,3500175625.5,18872527852.5,3668519.0,71849.5,20852.907309855727,89717693.5,-36.74716488537162,3.4794285714285715,5.615724027276374,188.58062849952472,19.539510629763345,656.1528268192035,157500.0,-0.9009688679024191,-0.433883739117558,0.0,0.0,0.0,0.0,0.0,0.0,1.0,0.0,1.0,0.0,0.0,0.0,0.0,0.0,0.0,0.0,0.0,0.0,1.0,0.0,1.0,0.0,0.0,0.0,0.0,1.0,0.0,0.0,0.0,0.0,0.0,0.0,0.0,0.0,0.0,0.0,0.0,0.0,1.0,0.0,0.0,0.0,0.0,0.0,0.0,0.0,0.0,0.0,0.0,0.0,0.0,0.0,0.0,1.0,0.0,0.0,0.0,0.0,0.0,0.0,0.0,0.0,0.0,0.0,0.0,0.0,0.0,0.0,0.0,0.0,0.0,0.0,0.0,0.0,0.0,0.0,0.0,0.0,0.0,0.0,0.0,0.0,0.0,0.0,0.0,0.0,0.0,0.0,0.0,0.0,0.0,0.0,0.0,0.0,0.0,0.0,0.0,0.0,0.0,0.0,0.0,0.0,0.0,0.0,0.0,0.0,0.0,0.0,0.0,0.0,0.0,0.0,0.0,0.0,0.0,0.0,0.0,0.0,0.0,0.0
100777,0,0.0,1.0,1.0,1.0,1.0,360000.0,1024740.0,52452.0,900000.0,0.010276,33.47945205479452,-2825.0,-583.0,-2296.0,4.0,3.0,2.0,2.0,13.0,,0.6462787730632961,0.4507472818545589,,,,,,,,,,,,,,,,,,,,,,,,,,,,,,,,,,,,,,,,,,,,,3.0,0.0,3.0,0.0,-636.0,0.0,0.0,0.0,0.0,0.0,1.0,1.0,1.0,0.0,1.0,0.0,0.0,0.0,0.0,0.0,0.0,0.0,0.0,0.0,1.0,0.0,0.0,0.0,0.0,0.0,0.0,0.0,0.0,0.0,0.0,0.0,0.0,0.0,0.0,0.0,0.0,0.0,0.0,10.0,73039.5,81.0,1683000.0,0.0,0.0,0.0,0.0,0.0,-785.5,656.0,-255.5,-637.0,304.0,-16.0,1.0,77242.545,482760.0,434484.0,48276.0,482760.0,6.0,-636.0,365243.0,-605.0,-455.0,-455.0,-453.0,17.0,0.0,0.1089090909090909,100.0,7.0,6.0,3.0,-18.0,0.0,0.0,6.0,77242.545,77242.545,-538.5,-530.0,3.5,1.0,0.0,,,,,,,,,,,,,,,,,,,,,8338523521.5,184255773282.0,165457366497.0,51923397610.935,1862.0,1703.0,71124.0,70664.0,9140.0,505575.0,,,,,,,128278.0,662168.0,,,,13515111.482191376,-601327904.0,-921044398.0,-296207040.0,-1533716125.0416667,43960.0,30663.0,,,,,,,,157891.29538295884,125988.25378133194,,,,,,,3710736.0,,,,,,,,,,,,,,,,436043.0,430844.0,1261792.0,6418.910240002897,631352.0,624912.0,,,,,,,,,26.5,12612875.805000003,3957776.145,1221707377.9349997,427054713.165,17130591.584999993,39300.75,28.0,1719.0,-4039361.5,2010053.0,-2080551.0,-2216494.0,-12.75,73039.5,162.0,1741500.0,0.0,0.0,0.0,0.0,0.0,-1368.0,-1002.0,-1129.0,-1135.0,46468853.77499996,672058936.5749997,754732088.5499997,11576171.025,672058936.5749997,47295.0,-3305767.0,758102397.0,34510919.0,169195420.0,76796428.0,172906282.0,47725.0,732.0,132.17292290326358,1345859.0,416190.0,250741.0,-816509.0,316982.0,1614.0,538576123.7024896,540106129.0124903,-33074884.0,-32815018.5,598650.0,26892.5,,,,,,,,,,,,,,,,,,,,,1465933.0,14725249.0,3229112.0,8546700.0,11596175.0,1414238.0,1056918004.5195012,801046154.677495,72032675541.7496,21654222609.442616,581630461.1594988,5792395.7475,689.5,94245.0,-276666745.5,21877095.0,-123677333.0,-218505420.0,-2013872.0,,,,,,,,,,,,,,,,,,,,,4268677.5,2476803.5,-8995104.0,921269.0,37582.5,3729894821.234965,3654438432.412463,-260385878.0,-257078328.0,2524115.0,268943.0,3922513110.202457,33226586210.09341,36652486121.707634,1727934319.4625494,48040871471.97822,3984190.0,-247351955.5,102985592651.0,1052976361.5,17259610812.0,3500175170.5,18872527399.5,3668536.0,71849.5,20853.016218946635,89717793.5,-84.38011456628476,2.8465,6.863417982155112,229.7834732655767,19.53671928620453,654.078656650464,120000.0,-0.9009688679024191,-0.433883739117558,0.0,0.0,0.0,0.0,0.0,0.0,1.0,0.0,0.0,0.0,0.0,0.0,0.0,1.0,0.0,1.0,0.0,0.0,0.0,0.0,1.0,0.0,0.0,0.0,0.0,1.0,0.0,0.0,0.0,0.0,0.0,0.0,0.0,0.0,0.0,0.0,0.0,0.0,0.0,0.0,1.0,0.0,0.0,0.0,0.0,0.0,0.0,0.0,0.0,0.0,0.0,0.0,0.0,0.0,0.0,0.0,0.0,0.0,0.0,0.0,0.0,0.0,0.0,0.0,0.0,0.0,0.0,0.0,0.0,0.0,0.0,0.0,0.0,0.0,0.0,0.0,0.0,0.0,0.0,1.0,0.0,0.0,0.0,0.0,0.0,0.0,0.0,0.0,0.0,0.0,0.0,0.0,0.0,0.0,0.0,0.0,0.0,0.0,0.0,0.0,0.0,0.0,0.0,0.0,0.0,0.0,0.0,0.0,0.0,0.0,0.0,0.0,0.0,0.0,0.0,0.0,0.0,0.0,0.0,0.0
100791,0,0.0,0.0,1.0,0.0,1.0,135000.0,276277.5,17784.0,238500.0,0.006233,35.0,-2389.0,-11075.0,-715.0,9.0,3.0,2.0,2.0,11.0,0.4059160106981792,0.6244329537674215,0.6894791426446275,0.0742,,0.9846,,,0.08,0.069,0.3333,,,,0.0757,,0.0169,0.0756,,0.9846,,,0.0806,0.069,0.3333,,,,0.0789,,0.0178,0.0749,,0.9846,,,0.08,0.069,0.3333,,,,0.0771,,0.0172,0.064,1.0,0.0,0.0,0.0,0.0,-2340.0,0.0,0.0,0.0,0.0,1.0,2.0,1.0,1.0,0.0,1.0,0.0,1.0,0.0,0.0,0.0,0.0,0.0,0.0,0.0,1.0,0.0,0.0,0.0,0.0,0.0,0.0,0.0,0.0,0.0,0.0,0.0,0.0,0.0,0.0,0.0,0.0,0.0,0.0,1.0,20983.5,,715500.0,41598.0,0.0,0.0,0.0,0.0,-1433.0,28.0,-29.0,,48.0,-23.5,3.0,11142.9,0.0,67500.0,,180000.0,6.0,-709.0,181234.5,-1702.0,-988.5,182447.0,182434.5,15.0,0.0,,10.0,16.0,12.0,4.5,-19.5,0.0,0.0,139.0,673.425,673.425,-1666.0,-1660.0,55.0,0.0,91.0,0.0,67500.0,0.0,0.0,0.0,0.0,0.0,673.425,0.0,0.0,0.0,0.0,0.0,0.0,0.0,0.0,26.0,-46.0,0.0,0.0,8338541305.5,184256049559.5,165457604997.0,51923532610.935,1862.0,1703.0,71124.0,70665.0,9140.0,505577.0,17791.7199000023,17853.778399999108,17305.622699998083,,,,128279.0,662171.0,,,,13515146.482191376,-601330293.0,-921045113.0,-296209380.0,-1533727200.0416667,43960.0,30663.0,11340.413199999177,11216.319999998968,10700.9144999973,22866.90560000962,22788.771900009586,22174.82980000813,67377.17627565611,157891.9198159126,125988.94326047457,34968.865500027874,34909.282100028315,34355.84100002872,,,,3710747.0,,,,,,,16453.713899999755,16638.748099999702,16235.7150999997,,,,3909.343900000125,3892.568100000161,3725.3295000001567,436043.0,430844.0,1261801.0,6418.916473002897,631354.0,624914.0,,16317.5088999998,154042.29689999056,154045.04089999007,153936.83039998714,,,,48.0,12896593.110000003,,1245697993.0349994,431899609.54500014,17157300.209999993,39300.75,28.0,1719.0,-4131175.0,2019242.0,-2123622.0,,-23.5,20983.5,,715500.0,41598.0,0.0,0.0,0.0,0.0,-1433.0,28.0,-29.0,,47619557.90999994,685797050.9249997,770009450.3999999,,685797050.9249997,48311.0,-3375636.0,774170810.0,34455768.5,172809404.0,77313467.5,176703920.5,48608.0,756.0,,1384182.0,429516.0,259102.5,-837724.0,317076.0,1708.0,553133978.3699788,553019969.4749829,-33868881.0,-33605226.0,609714.0,27654.0,498912100.7850007,1302763500.0,44289177.75,60031570.90500004,972418.5,14740705.035000002,28407028.545,63785812.54500043,58547288.70000007,477839542.09499925,496863563.9850002,496882825.9200002,2415.0,5321.0,25.0,2881.0,174852.0,-299312.0,89155.0,330.0,1465934.0,14725297.0,3229203.0,8546716.0,11596314.0,1414241.0,1056938988.0195012,,72033391041.7496,21654264207.442616,581630461.1594988,5792395.7475,689.5,94245.0,-276668178.5,21877123.0,-123677362.0,,-2013895.5,5915994202.372461,18699975000.0,198620720.325,447408244.46249765,1948107.735,256461868.7775008,308769021.1124988,635726340.4049982,458539328.9474992,5701384848.420029,5879323988.729998,5879567171.4749975,13367.0,80730.5,44.0,70255.5,970628.5,-1696675.5,177364.0,6755.0,4268689.5,2476808.0,-8995123.5,921269.0,37582.5,3729895494.659965,3654439105.837464,-260387544.0,-257079988.0,2524170.0,268943.0,3922524253.102457,33226586210.09341,36652553621.707634,,48041051471.97822,3984196.0,-247352664.5,102985773885.5,1052974659.5,17259609823.5,3500357617.5,18872709834.0,3668551.0,71849.5,,89717803.5,-68.25714285714285,2.0465,7.591093117408906,265.68825910931173,15.53517206477733,543.7310222672065,45000.0,-0.2225209339563143,0.9749279121818236,0.0,0.0,0.0,0.0,0.0,0.0,1.0,0.0,1.0,0.0,0.0,0.0,0.0,0.0,0.0,0.0,0.0,0.0,1.0,0.0,1.0,0.0,0.0,0.0,0.0,1.0,0.0,0.0,0.0,0.0,0.0,0.0,0.0,0.0,0.0,0.0,0.0,0.0,1.0,0.0,0.0,0.0,0.0,0.0,0.0,0.0,0.0,0.0,0.0,0.0,0.0,0.0,0.0,1.0,0.0,0.0,0.0,0.0,0.0,0.0,0.0,0.0,0.0,0.0,0.0,0.0,0.0,0.0,0.0,0.0,0.0,0.0,0.0,0.0,0.0,0.0,0.0,0.0,0.0,0.0,0.0,0.0,0.0,0.0,0.0,0.0,0.0,0.0,0.0,0.0,0.0,0.0,0.0,0.0,0.0,0.0,0.0,0.0,0.0,0.0,0.0,0.0,0.0,0.0,0.0,0.0,0.0,0.0,0.0,0.0,1.0,0.0,0.0,0.0,0.0,0.0,0.0,1.0,0.0,0.0
100792,0,0.0,0.0,0.0,1.0,1.0,90000.0,276277.5,17784.0,238500.0,0.010147,42.31232876712329,-466.0,-13476.0,-2598.0,,3.0,2.0,2.0,14.0,0.6404830224822483,0.7565511982196262,0.813917469762627,0.2588,0.1502,0.9811,0.7416,0.0712,0.28,0.2414,0.3333,0.375,0.1371,0.211,0.2921,0.0,0.0,0.2637,0.1558,0.9811,0.7517,0.0718,0.282,0.2414,0.3333,0.375,0.1402,0.2305,0.3044,0.0,0.0,0.2613,0.1502,0.9811,0.7451,0.0716,0.28,0.2414,0.3333,0.375,0.1395,0.2146,0.2974,0.0,0.0,0.2687,1.0,2.0,0.0,2.0,0.0,-1864.0,0.0,0.0,0.0,0.0,1.0,0.0,1.0,1.0,0.0,1.0,0.0,1.0,0.0,0.0,0.0,0.0,0.0,0.0,0.0,1.0,0.0,0.0,0.0,0.0,0.0,0.0,0.0,0.0,0.0,0.0,0.0,0.0,0.0,0.0,0.0,0.0,0.0,0.0,1.0,,0.0,89775.0,0.0,0.0,0.0,0.0,0.0,-1811.0,-1080.0,-1322.0,-1322.0,60.0,-29.5,4.0,10266.12,156796.2,156217.5,10593.9,156796.2,18.0,-1663.0,365243.0,-1632.5,-1107.5,-852.5,-1102.0,13.5,0.0,0.1000397132248302,986.5,53.0,24.0,12.0,-47.0,0.0,0.0,50.0,15697.845,15697.845,-1426.5,-1417.0,8.5,1.0,0.0,,,,,,,,,,,,,,,,,,,,,8338559089.5,184256325837.0,165457843497.0,51923622610.935,1862.0,1703.0,71124.0,70666.0,9140.0,505577.0,17791.9787000023,17854.03969999911,17305.886399998082,11285.901100000085,11223.729000000092,11171.257500000058,128280.0,662174.0,4135.073500000123,4132.707800000017,3943.5316000000953,13515188.794520143,-601330759.0,-921047711.0,-296211244.0,-1533740676.0416667,43960.0,30663.0,11340.693199999176,11216.599999998967,10701.1964999973,22867.14700000962,22789.01330000958,22175.07120000813,67377.81675867859,157892.67636711086,125989.75717794432,34969.19880002787,34909.61540002831,34356.174300028724,22933.62019999593,22907.067699995507,22554.456799995743,3710761.0,8288.489800000167,8392.905800000079,8116.668300000229,9809.730000000718,9924.58310000216,10283.93719999965,16454.005999999754,16639.045499999702,16236.019499999702,828.1434000001758,813.3246000000457,759.3119000000132,3909.343900000125,3892.568100000161,3725.3295000001567,436045.0,430846.0,,6418.926620002897,631356.0,624916.0,,16317.7775999998,154043.27799999053,154046.02199999007,153937.81149998718,77544.32319999626,77881.80810000659,78282.81750000648,60.0,,4026592.485,1245787768.0349994,431899609.54500014,17157300.209999993,39300.75,28.0,1719.0,-4132986.0,2018162.0,-2124944.0,-2265842.0,-29.5,,0.0,89775.0,0.0,0.0,0.0,0.0,0.0,-1811.0,-1080.0,-1322.0,-1322.0,47649626.57249994,686268143.3249997,770576718.1499999,11801383.425,686268143.3249997,48368.0,-3381994.0,775082530.5,34450904.0,172805793.0,77494104.0,176883738.0,48658.0,756.5,134.71416993057414,1386183.5,430293.0,259616.0,-839529.0,317076.0,1708.0,553840343.1674777,553726334.2724818,-34017350.0,-33753229.0,614335.0,27680.5,,,,,,,,,,,,,,,,,,,,,1465935.0,14725357.0,3229203.0,8546769.0,11596364.0,1414245.0,,801046154.677495,72033480816.7496,21654264207.442616,581630461.1594988,5792395.7475,689.5,94245.0,-276669989.5,21876043.0,-123678684.0,-218506742.0,-2013925.0,,,,,,,,,,,,,,,,,,,,,4268713.5,2476820.0,-8995170.5,921269.0,37582.5,3729911192.504965,3654454803.682463,-260388970.5,-257081405.0,2524178.5,268944.0,3922534519.222457,33226743006.29341,36652709839.207634,1727944913.3625493,48041208268.178215,3984214.0,-247354327.5,102986139128.5,1052973027.0,17259608716.0,3500356765.0,18872708732.0,3668564.5,71849.5,20853.116258659866,89718790.0,-11.01333851333851,3.06975,5.060728744939271,214.13121845710168,15.53517206477733,657.3293078586878,30000.0,-0.2225209339563143,0.9749279121818236,0.0,0.0,0.0,0.0,0.0,0.0,1.0,0.0,0.0,0.0,0.0,0.0,0.0,1.0,0.0,0.0,0.0,0.0,1.0,0.0,1.0,0.0,0.0,0.0,0.0,1.0,0.0,0.0,0.0,0.0,0.0,0.0,0.0,0.0,0.0,0.0,0.0,0.0,0.0,0.0,0.0,0.0,0.0,0.0,0.0,0.0,0.0,0.0,0.0,0.0,0.0,0.0,0.0,0.0,0.0,0.0,0.0,0.0,0.0,0.0,0.0,0.0,0.0,0.0,0.0,0.0,0.0,0.0,0.0,0.0,0.0,0.0,0.0,0.0,0.0,0.0,1.0,0.0,0.0,0.0,0.0,0.0,0.0,0.0,0.0,0.0,0.0,0.0,0.0,0.0,0.0,0.0,0.0,0.0,0.0,0.0,0.0,0.0,0.0,0.0,0.0,0.0,0.0,0.0,0.0,0.0,0.0,1.0,0.0,0.0,1.0,0.0,0.0,0.0,0.0,0.0,0.0,1.0,0.0,0.0
100797,0,0.0,0.0,0.0,1.0,0.0,180000.0,1055655.0,38047.5,891000.0,0.00496,44.55342465753424,-8135.0,-4828.0,-2660.0,,2.0,2.0,2.0,18.0,0.5808189635047194,0.6228880734546164,0.7032033049040319,,,,,,,,,,,,,,,,,,,,,,,,,,,,,,,,,,,,,,,,,,,,,0.0,0.0,0.0,0.0,-1569.0,0.0,0.0,0.0,0.0,1.0,3.0,1.0,1.0,0.0,1.0,0.0,0.0,0.0,0.0,0.0,1.0,1.0,0.0,0.0,1.0,0.0,0.0,0.0,0.0,0.0,0.0,0.0,0.0,0.0,0.0,0.0,0.0,0.0,0.0,0.0,0.0,0.0,0.0,2.0,10005.75,,562500.0,219829.5,0.0,0.0,0.0,0.0,-1556.5,269.5,-159.0,-762.0,103.0,-25.0,5.0,8943.2775,76990.5,71622.0,10548.0,91219.5,12.0,-365.0,365243.0,-565.0,-460.0,-235.0,-443.0,16.0,0.0,0.0994867143768156,82.0,36.0,24.0,10.5,-34.5,0.0,0.0,50.0,3230.145,3230.145,-794.5,-781.0,7.5,1.0,10.0,499707.45,540000.0,0.0,0.0,0.0,0.0,24875.8875,25200.0,23670.0,484393.635,499036.95,499036.95,0.0,0.0,0.0,0.0,3.5,-5.5,0.0,0.0,8338597137.0,184257381492.0,165458734497.0,51923802610.935,1862.0,1703.0,71124.0,70667.0,9140.0,505580.0,,,,,,,128280.0,662176.0,,,,13515233.347944802,-601338894.0,-921050371.0,-296212813.0,-1533745504.0416667,43960.0,30663.0,,,,,,,67378.39757764207,157893.29925518428,125990.46038124926,,,,,,,3710779.0,,,,,,,,,,,,,,,,436045.0,430846.0,,6418.931580002897,631358.0,624918.0,,,,,,,,,51.5,12963447.360000003,,1254034300.3649993,435332614.54500014,17157300.209999993,39300.75,28.0,1719.0,-4161485.0,2011605.0,-2139048.0,-2280844.0,-25.25,0.0,,450000.0,0.0,0.0,0.0,0.0,0.0,-2183.0,-357.0,-302.0,-762.0,48129370.37999995,693953018.3249997,779082161.3999999,11850775.425,693683018.3249997,48855.0,-3407715.0,781472668.0,34797242.0,174436998.0,78398776.0,178515038.0,49034.0,762.0,135.60670822767858,1396615.0,434158.0,262151.0,-846008.0,317076.0,1708.0,560171903.0174797,560045271.3524835,-34259160.0,-33992791.5,617828.0,27879.5,515946251.7900007,1326568500.0,45211677.75,61432965.40500004,1377378.0,14814640.035000002,29333921.1525,65084625.49500036,59759615.92500005,494305031.2949992,513851001.93000007,513870263.86500007,2428.0,5338.0,28.0,2882.0,176939.5,-302556.0,89155.0,330.0,1465937.0,14725460.0,3229213.0,8546805.0,11596414.0,1414250.0,1056948993.7695012,,72034043316.7496,21654484036.942616,581630461.1594988,5792395.7475,689.5,94245.0,-276671546.0,21876312.5,-123678843.0,-218507504.0,-2013950.0,5916493909.822461,18700515000.0,198620720.325,447408244.46249765,1948107.735,256461868.7775008,308793896.99999875,635751540.4049982,458562998.9474992,5701869242.055029,5879823025.6799965,5880066208.424997,13367.0,80730.5,44.0,70255.5,970632.0,-1696681.0,177364.0,6755.0,4268737.5,2476830.5,-8995205.0,921269.0,37582.5,3729914422.649965,3654458033.827463,-260389765.0,-257082186.0,2524186.0,268945.0,3922543462.499957,33226819996.79341,36652781461.207634,1727955461.3625493,48041299487.678215,3984226.0,-247354692.5,102986504371.5,1052972462.0,17259608256.0,3500356530.0,18872708289.0,3668580.5,71849.5,20853.21574537424,89718872.0,-182.5897798548764,5.86475,4.730928444707273,210.7790640214512,27.745712596096983,1236.1665157198058,90000.0,0.6234898018587336,0.7818314824680298,0.0,0.0,0.0,0.0,0.0,0.0,1.0,0.0,0.0,0.0,0.0,0.0,0.0,1.0,0.0,0.0,0.0,0.0,1.0,0.0,1.0,0.0,0.0,0.0,0.0,1.0,0.0,0.0,0.0,0.0,1.0,0.0,0.0,0.0,0.0,0.0,0.0,0.0,0.0,0.0,0.0,0.0,0.0,0.0,0.0,0.0,0.0,0.0,0.0,0.0,0.0,1.0,0.0,0.0,0.0,0.0,0.0,0.0,0.0,0.0,0.0,0.0,0.0,0.0,0.0,0.0,0.0,0.0,0.0,0.0,0.0,0.0,0.0,0.0,0.0,0.0,0.0,0.0,0.0,0.0,0.0,0.0,0.0,0.0,0.0,0.0,0.0,0.0,0.0,0.0,0.0,0.0,0.0,0.0,0.0,0.0,0.0,0.0,0.0,0.0,0.0,0.0,0.0,0.0,0.0,0.0,0.0,0.0,0.0,0.0,0.0,0.0,0.0,0.0,0.0,0.0,0.0,0.0,0.0,0.0
100823,0,0.0,1.0,1.0,1.0,0.0,202500.0,585000.0,29997.0,585000.0,0.0145199999999999,32.54794520547945,-1570.0,-113.0,-3866.0,23.0,2.0,2.0,2.0,11.0,0.7533789892729582,0.5747760919170575,0.7091891096653581,,,,,,,,,,,,,,,,,,,,,,,,,,,,,,,,,,,,,,,,,,,,,1.0,0.0,1.0,0.0,-556.0,0.0,0.0,0.0,0.0,0.0,1.0,1.0,1.0,0.0,1.0,0.0,0.0,0.0,0.0,0.0,0.0,0.0,0.0,0.0,0.0,0.0,0.0,0.0,0.0,1.0,0.0,0.0,0.0,0.0,0.0,0.0,0.0,0.0,0.0,0.0,0.0,0.0,0.0,1.0,0.0,,441000.0,0.0,,0.0,0.0,0.0,-967.0,30905.0,-18.0,,32.0,-15.5,1.0,15427.485,134950.5,149202.0,0.0,134950.5,12.0,-556.0,365243.0,-525.0,-225.0,-195.0,-221.0,17.0,0.0,0.0,4000.0,12.0,12.0,6.5,-12.5,0.0,0.0,12.0,15427.485,15427.485,-369.0,-360.0,6.5,1.0,0.0,,,,,,,,,,,,,,,,,,,,,8338627134.0,184257966492.0,165459319497.0,51924005110.935,1862.0,1703.0,71124.0,70667.0,9140.0,505581.0,,,,,,,128280.0,662178.0,,,,13515265.895890003,-601340464.0,-921054237.0,-296213369.0,-1533745617.0416667,43960.0,30663.0,,,,,,,67379.15095663136,157893.87403127618,125991.16957035886,,,,,,,3710790.0,,,,,,,,,,,,,,,,436046.0,430847.0,1261824.0,6418.946100002897,631360.0,624920.0,,,,,,,,,32.0,13250956.590000004,,1289091073.095,446284205.82000005,,39452.85,29.0,1779.0,-4310103.0,2235620.0,-2213355.0,,-15.5,0.0,,441000.0,0.0,,0.0,0.0,0.0,-967.0,30905.0,-18.0,,49328300.92499994,709024074.5699997,796063401.8999999,12034427.670000002,709024074.5699997,50271.0,-3490306.0,805209995.0,36192476.0,181875438.0,81468784.0,185955581.0,50475.0,783.0,139.1110618357133,1422427.0,445899.0,269898.0,-865210.0,317132.0,1718.0,571901071.6574771,572253828.1874808,-35137085.5,-34861377.5,635084.0,28549.5,,,,,,,,,,,,,,,,,,,,,1465938.0,14725492.0,3229213.0,8546817.0,11596426.0,1414251.0,1056948993.7695012,,72034484316.7496,21654484036.942616,,5792395.7475,689.5,94245.0,-276672513.0,21907217.5,-123678861.0,,-2013965.5,,,,,,,,,,,,,,,,,,,,,4268749.5,2476837.0,-8995217.5,921269.0,37582.5,3729929850.134965,3654473461.3124633,-260390134.0,-257082546.0,2524192.5,268946.0,3922558889.984957,33226954947.29341,36652930663.207634,1727955461.3625493,48041434438.178215,3984238.0,-247355248.5,102986869614.5,1052971937.0,17259608031.0,3500356335.0,18872708068.0,3668597.5,71849.5,20853.21574537424,89722872.0,-48.23653198653199,2.888888888888889,6.750675067506751,219.720602197206,19.501950195019504,634.7484063474841,101250.0,-0.9009688679024191,0.4338837391175582,0.0,0.0,0.0,0.0,0.0,0.0,1.0,0.0,0.0,0.0,0.0,0.0,0.0,1.0,0.0,0.0,0.0,0.0,1.0,0.0,1.0,0.0,0.0,0.0,0.0,1.0,0.0,0.0,0.0,0.0,0.0,0.0,0.0,0.0,0.0,0.0,0.0,0.0,1.0,0.0,0.0,0.0,0.0,0.0,0.0,0.0,0.0,0.0,0.0,0.0,0.0,0.0,0.0,0.0,0.0,0.0,0.0,0.0,0.0,0.0,0.0,0.0,0.0,0.0,0.0,0.0,0.0,0.0,0.0,0.0,0.0,0.0,0.0,0.0,0.0,0.0,0.0,0.0,0.0,0.0,0.0,0.0,0.0,0.0,0.0,0.0,0.0,0.0,0.0,0.0,1.0,0.0,0.0,0.0,0.0,0.0,0.0,0.0,0.0,0.0,0.0,0.0,0.0,0.0,0.0,0.0,0.0,0.0,0.0,0.0,0.0,0.0,0.0,0.0,0.0,0.0,0.0,0.0,0.0,0.0
100826,0,0.0,0.0,0.0,0.0,1.0,202500.0,450000.0,14517.0,450000.0,0.035792,39.254794520547954,-936.0,-2754.0,-2777.0,,3.0,2.0,2.0,18.0,0.6304890833817745,0.6145985115047148,0.5190973382084597,,,,,,,,,,,,,,,,,,,,,,,,,,,,,,,,,,,,,,,,,,,,,3.0,0.0,3.0,0.0,-967.0,0.0,0.0,0.0,0.0,1.0,0.0,1.0,1.0,1.0,1.0,0.0,0.0,0.0,0.0,0.0,0.0,1.0,1.0,0.0,1.0,0.0,0.0,0.0,0.0,0.0,0.0,0.0,0.0,0.0,0.0,0.0,0.0,0.0,0.0,0.0,0.0,0.0,0.0,5.0,5670.0,0.0,112410.0,0.0,0.0,0.0,0.0,0.0,-1165.0,-799.0,-798.0,-1126.0,206.0,-21.5,2.0,16037.595,123750.0,336930.75,,247500.0,18.0,-967.0,365243.0,-937.0,-727.0,113.0,-723.0,12.0,1.0,,0.0,15.0,8.0,4.0,-30.0,0.0,0.0,13.0,15200.19,15200.19,-912.0,-907.0,5.0,1.0,0.0,,,,,,,,,,,,,,,,,,,,,8338641651.0,184258416492.0,165459769497.0,51924207610.935,1862.0,1703.0,71124.0,70668.0,9140.0,505581.0,,,,,,,128281.0,662181.0,,,,13515305.150684524,-601341400.0,-921057014.0,-296214336.0,-1533748371.0416667,43960.0,30663.0,,,,,,,67379.78144571475,157894.4886297877,125991.6886676971,,,,,,,3710808.0,,,,,,,,,,,,,,,,436049.0,430850.0,,6418.9818920028965,631362.0,624922.0,,,,,,,,,39.0,13284279.090000004,4076009.5499999993,1291419762.975,447750476.19000006,17320239.9,39452.85,29.0,1779.0,-4322285.0,2230789.0,-2220506.0,-2377663.0,-19.0,0.0,0.0,59332.5,0.0,0.0,0.0,0.0,0.0,-1312.0,-1128.0,-1126.0,-1668.5,49578996.95999994,712067222.0699997,799738740.8999999,,712067222.0699997,50439.0,-3495976.5,807401453.0,36553228.0,182237870.0,81468445.0,186318035.0,50585.0,786.0,,1427561.0,447098.0,270654.0,-866790.0,317132.0,1718.0,574209164.3399768,574550693.2349807,-35182658.0,-34905772.0,635534.0,28617.0,,,,,,,,,,,,,,,,,,,,,1465943.0,14725698.0,3229213.0,8546832.0,11596439.0,1414253.0,1056954663.7695012,801046154.677495,72034596726.7496,21654484036.942616,581630461.1594988,5792395.7475,689.5,94245.0,-276673678.0,21906418.5,-123679659.0,-218508630.0,-2013987.0,,,,,,,,,,,,,,,,,,,,,4268757.5,2476841.0,-8995247.5,921269.0,37582.5,3729945050.324965,3654488661.5024633,-260391046.0,-257083453.0,2524197.5,268947.0,3922574927.579957,33227078697.29341,36653267593.957634,,48041681938.178215,3984256.0,-247356215.5,102987234857.5,1052971000.0,17259607304.0,3500356448.0,18872707345.0,3668609.5,71850.5,,89722872.0,-23.84422110552764,2.2222222222222223,13.949163050216988,547.5715292698876,30.998140111593305,1216.8256205997504,67500.0,0.6234898018587334,-0.7818314824680299,0.0,0.0,0.0,0.0,0.0,0.0,1.0,0.0,0.0,0.0,0.0,0.0,0.0,1.0,0.0,0.0,0.0,0.0,1.0,0.0,1.0,0.0,0.0,0.0,0.0,1.0,0.0,0.0,0.0,0.0,0.0,0.0,0.0,1.0,0.0,0.0,0.0,0.0,0.0,0.0,0.0,0.0,0.0,0.0,0.0,0.0,0.0,0.0,0.0,1.0,0.0,0.0,0.0,0.0,0.0,0.0,0.0,0.0,0.0,0.0,0.0,0.0,0.0,0.0,0.0,0.0,0.0,0.0,0.0,0.0,0.0,0.0,0.0,0.0,0.0,0.0,0.0,0.0,0.0,0.0,0.0,0.0,0.0,0.0,0.0,0.0,0.0,0.0,0.0,0.0,0.0,0.0,0.0,0.0,0.0,0.0,0.0,0.0,0.0,0.0,0.0,0.0,0.0,0.0,0.0,0.0,0.0,0.0,0.0,0.0,0.0,0.0,0.0,0.0,0.0,0.0,0.0,0.0,0.0,0.0
100830,0,0.0,0.0,0.0,0.0,0.0,112500.0,625536.0,31936.5,540000.0,0.035792,56.2986301369863,,-13202.0,-2610.0,,2.0,2.0,2.0,16.0,,0.6716282339722914,0.5656079814115492,,,,,,,,,,,,,,,,,,,,,,,,,,,,,,,,,,,,,,,,,,,,,1.0,0.0,1.0,0.0,-448.0,0.0,0.0,0.0,0.0,0.0,0.0,1.0,0.0,0.0,1.0,1.0,0.0,0.0,0.0,0.0,0.0,0.0,0.0,0.0,1.0,0.0,0.0,0.0,0.0,0.0,0.0,0.0,0.0,0.0,0.0,0.0,0.0,0.0,0.0,0.0,0.0,0.0,0.0,5.0,0.0,1402.2,150903.0,0.0,85192.605,0.0,0.0,0.0,-1295.0,2358.0,-98.0,-605.0,201.0,-20.0,14.0,29084.67,0.0,0.0,,911250.0,24.0,-437.5,182432.0,-380.0,182479.5,182584.5,182483.0,14.0,0.5,,0.0,6.0,12.0,9.5,-12.5,0.0,0.0,31.0,6933.105,6933.105,-247.0,-233.0,9.0,0.0,14.0,47219.715,225000.0,11250.0,11250.0,0.0,0.0,2396.295,47701.89,18000.0,44798.085,45140.715,45140.715,0.5,0.5,0.0,0.0,3.5,-8.5,0.0,0.0,8338673587.5,184259042028.0,165460309497.0,51924320110.935,1862.0,1703.0,71124.0,70668.0,9140.0,505581.0,,,,,,,128281.0,662183.0,,,,13515361.449314663,,-921059624.0,-296214784.0,-1533761573.0416667,43960.0,30663.0,,,,,,,,157895.16025802167,125992.25427567853,,,,,,,3710824.0,,,,,,,,,,,,,,,,436050.0,430851.0,,6419.017684002895,631364.0,624924.0,,,,,,,,,43.0,13289949.090000004,4101261.84,1295879997.375,449068376.34,17405432.505,39452.85,29.0,1779.0,-4350145.0,2228861.0,-2239463.0,-2395684.0,-21.0,0.0,1402.2,150903.0,0.0,85192.605,0.0,0.0,0.0,-1393.0,2358.0,-605.0,-605.0,49735084.18499993,714699281.0699997,802615721.3999999,,715385531.0699997,50577.0,-3503063.0,809227478.5,36549609.0,182418580.5,81649635.5,186498767.5,50763.5,787.0,,1430961.5,448063.0,271199.0,-868663.5,317140.0,1726.0,575345992.4099753,575651557.0799793,-35238742.0,-34960378.0,636221.0,28714.0,535098195.72000057,1365385500.0,47714127.75,64286210.70000005,1539499.5,15002485.335,30279902.78249999,67678584.39000033,62128803.39750005,512700394.2074993,532845905.1299999,532867057.065,2535.5,5574.5,32.0,3007.0,181768.0,-310508.5,89156.0,331.0,1465948.0,14725899.0,3229227.0,8546838.0,11596470.0,1414267.0,1056954663.7695012,801047556.877495,72034747629.7496,21654484036.942616,581715653.7644991,5792395.7475,689.5,94245.0,-276674973.0,21908776.5,-123679757.0,-218509235.0,-2014007.0,5916541129.537461,18700740000.0,198631970.325,447419494.46249765,1948107.735,256461868.7775008,308796293.2949988,635799242.2949983,458580998.9474992,5701914040.140029,5879868166.394998,5880111349.1399975,13367.5,80731.0,44.0,70255.5,970635.5,-1696689.5,177364.0,6755.0,4268769.5,2476850.5,-8995260.0,921269.0,37582.5,3729951983.429965,3654495594.607464,-260391293.0,-257083686.0,2524206.5,268947.0,3922604012.249957,33227078697.29341,36653267593.957634,,48042593188.178215,3984280.0,-247356653.0,102987417289.5,1052970620.0,17259789783.5,3500539032.5,18872889828.0,3668623.5,71851.0,,89722872.0,,5.56032,3.522615189516697,198.31840966953044,19.58686769057348,1102.7138196536837,56250.0,1.0,0.0,0.0,0.0,0.0,0.0,0.0,0.0,1.0,0.0,0.0,1.0,0.0,0.0,0.0,0.0,0.0,0.0,0.0,0.0,1.0,0.0,1.0,0.0,0.0,0.0,0.0,1.0,0.0,0.0,0.0,0.0,0.0,0.0,0.0,0.0,0.0,0.0,0.0,0.0,0.0,0.0,0.0,0.0,0.0,0.0,0.0,0.0,0.0,0.0,0.0,0.0,0.0,0.0,0.0,0.0,0.0,0.0,0.0,0.0,0.0,0.0,0.0,0.0,0.0,0.0,0.0,0.0,0.0,0.0,0.0,0.0,0.0,0.0,0.0,0.0,0.0,0.0,0.0,0.0,0.0,0.0,0.0,0.0,0.0,0.0,0.0,0.0,0.0,0.0,0.0,0.0,0.0,0.0,0.0,0.0,0.0,0.0,0.0,0.0,0.0,0.0,0.0,0.0,0.0,0.0,0.0,1.0,0.0,0.0,0.0,0.0,0.0,0.0,0.0,0.0,0.0,0.0,0.0,0.0,0.0,0.0
100836,0,0.0,1.0,0.0,0.0,2.0,67500.0,234576.0,20263.5,202500.0,0.01885,36.027397260273965,-1586.0,-2896.0,-4162.0,,4.0,2.0,2.0,13.0,,0.2237184912231269,0.3910549766342248,,,,,,,,,,,,,,,,,,,,,,,,,,,,,,,,,,,,,,,,,,,,,9.0,3.0,9.0,3.0,-373.0,0.0,0.0,0.0,0.0,2.0,0.0,1.0,1.0,1.0,1.0,1.0,0.0,0.0,0.0,0.0,0.0,0.0,0.0,0.0,1.0,0.0,0.0,0.0,0.0,0.0,0.0,0.0,0.0,0.0,0.0,0.0,0.0,0.0,0.0,0.0,0.0,0.0,0.0,12.0,0.0,0.0,106807.5,0.0,0.0,0.0,0.0,0.0,-639.0,-303.0,-190.5,-299.5,243.0,-10.0,2.0,9951.03,73242.0,77746.5,0.0,73242.0,10.0,-295.5,365243.0,-263.0,182585.0,7.0,182587.0,11.5,0.5,0.0,31.0,19.0,10.0,6.0,-6.0,0.0,0.0,17.0,13686.3,13686.3,-169.0,-153.0,5.0,1.0,0.0,,,,,,,,,,,,,,,,,,,,,8338693851.0,184259276604.0,165460511997.0,51924387610.935,1862.0,1703.0,71124.0,70670.0,9140.0,505581.0,,,,,,,128283.0,662187.0,,,,13515397.476711923,-601342986.0,-921063786.0,-296215157.0,-1533764469.0416667,43963.0,30666.0,,,,,,,,157895.38397651288,125992.64533065516,,,,,,,3710837.0,,,,,,,,,,,,,,,,436059.0,430860.0,,6419.036534002897,631366.0,624926.0,,,,,,,,,21.5,13386727.215000004,4115813.8049999992,1301198611.365,450939471.84,17585926.244999994,39452.85,30.0,1779.0,-4404924.0,2210219.0,-2271113.5,-2430531.0,-10.25,0.0,0.0,138960.0,0.0,0.0,0.0,0.0,0.0,-684.0,-509.0,-284.0,-493.0,50281670.33999993,723655516.3199997,811955689.6499999,12216727.170000002,723655516.3199997,51022.0,-3546527.5,816711694.5,36519027.5,183673604.5,82543421.5,188120424.5,51291.0,797.5,140.92861051897756,1438669.0,451097.0,272854.0,-877589.0,317156.0,1727.0,581242616.3699776,581141212.6949807,-35705893.0,-35424428.0,646274.0,28945.0,,,,,,,,,,,,,,,,,,,,,1465960.0,14726142.0,3229227.0,8546857.0,11596487.0,1414269.0,1056954663.7695012,801047556.877495,72034854437.2496,21654484036.942616,581715653.7644991,5792395.7475,689.5,94245.0,-276675612.0,21908473.5,-123679947.5,-218509534.5,-2014017.0,,,,,,,,,,,,,,,,,,,,,4268779.5,2476856.5,-8995266.0,921269.0,37582.5,3729965669.7299647,3654509280.907463,-260391462.0,-257083839.0,2524211.5,268948.0,3922613963.279957,33227151939.29341,36653345340.457634,1727955461.3625493,48042666430.178215,3984290.0,-247356948.5,102987782532.5,1052970357.0,17259972368.5,3500539039.5,18873072415.0,3668635.0,71851.5,20853.21574537424,89722903.0,-44.022053231939175,3.4752,3.331112591605596,120.0113166564756,11.576282478347766,417.0633276445839,16875.0,-0.2225209339563146,-0.9749279121818236,0.0,0.0,0.0,0.0,0.0,0.0,1.0,0.0,0.0,0.0,0.0,0.0,0.0,1.0,0.0,0.0,0.0,1.0,0.0,0.0,1.0,0.0,0.0,0.0,0.0,1.0,0.0,0.0,0.0,0.0,0.0,0.0,0.0,0.0,0.0,0.0,0.0,0.0,1.0,0.0,0.0,0.0,0.0,0.0,0.0,0.0,0.0,0.0,0.0,0.0,0.0,0.0,0.0,0.0,0.0,0.0,0.0,0.0,0.0,0.0,0.0,0.0,0.0,0.0,0.0,0.0,0.0,0.0,0.0,0.0,0.0,0.0,0.0,0.0,0.0,0.0,0.0,0.0,0.0,0.0,0.0,1.0,0.0,0.0,0.0,0.0,0.0,0.0,0.0,0.0,0.0,0.0,0.0,0.0,0.0,0.0,0.0,0.0,0.0,0.0,0.0,0.0,0.0,0.0,0.0,0.0,0.0,0.0,0.0,0.0,0.0,0.0,0.0,0.0,0.0,0.0,0.0,0.0,0.0,0.0
100872,0,0.0,1.0,1.0,1.0,1.0,135000.0,1024740.0,49428.0,900000.0,0.010643,30.3972602739726,-338.0,-4855.0,-3590.0,17.0,3.0,2.0,2.0,13.0,0.0726183845544556,0.7721212606616444,0.6092756673894402,0.0835,0.0372,0.9762,0.6736,0.0086,0.0,0.1379,0.1667,0.2083,0.0662,0.0672,0.0627,0.0039,0.0182,0.0851,0.0386,0.9762,0.6864,0.0087,0.0,0.1379,0.1667,0.2083,0.0677,0.0735,0.0653,0.0039,0.0192,0.0843,0.0372,0.9762,0.6779999999999999,0.0087,0.0,0.1379,0.1667,0.2083,0.0673,0.0684,0.0638,0.0039,0.0185,0.0532,1.0,0.0,0.0,0.0,0.0,-1596.0,0.0,0.0,0.0,0.0,0.0,0.0,1.0,1.0,0.0,1.0,0.0,0.0,0.0,0.0,0.0,0.0,1.0,1.0,0.0,1.0,0.0,0.0,0.0,0.0,0.0,0.0,0.0,0.0,0.0,0.0,0.0,0.0,0.0,0.0,0.0,0.0,0.0,0.0,6.0,0.0,0.0,630000.0,0.0,0.0,0.0,0.0,0.0,-1565.0,-173.5,-456.0,-606.0,267.0,-22.0,2.0,9493.47,78502.5,67482.0,15750.0,78502.5,9.0,-1128.5,365243.0,-1096.5,-1021.5,-856.5,-1007.0,14.5,0.0,0.1795571238314654,834.0,10.0,6.0,2.5,-48.5,0.0,0.0,7.0,12533.94,12533.94,-1489.0,-1474.0,2.0,1.0,0.0,,,,,,,,,,,,,,,,,,,,,8338743279.0,184260301344.0,165461411997.0,51924522610.935,1862.0,1703.0,71124.0,70670.0,9140.0,505581.0,17792.0622000023,17854.12399999911,17305.971499998082,11285.938300000087,11223.766200000093,11171.296100000058,128284.0,662190.0,4135.082100000123,4132.716500000017,3943.540300000095,13515427.873972198,-601343324.0,-921067376.0,-296216753.0,-1533769324.0416667,43963.0,30666.0,11340.693199999176,11216.599999998967,10701.1964999973,22867.284900009618,22789.151200009583,22175.20910000813,67379.8540640993,157896.15609777358,125993.25460632252,34969.365500027874,34909.782100028315,34356.34100002872,22933.82849999593,22907.27599999551,22554.665099995746,3710850.0,8288.556000000166,8392.97310000008,8116.736000000227,9809.797200000718,9924.65150000216,10284.010699999648,16454.068699999752,16639.109299999698,16236.084799999702,828.1473000001757,813.3285000000459,759.3158000000133,3909.362100000125,3892.586600000161,3725.348700000157,436059.0,430860.0,1261841.0,6419.047177002895,631368.0,624928.0,,16317.8307999998,154044.25419999054,154046.99819999005,153938.78769998718,77544.99679999625,77882.48610000659,78283.50390000647,52.0,14265729.225000003,4338538.244999999,1353709091.4299998,470862513.99000007,18278562.105,39452.85,31.0,1779.0,-4601477.0,2304095.0,-2368006.5,-2538344.0,-25.5,0.0,0.0,720000.0,0.0,0.0,0.0,0.0,0.0,-1685.0,-349.0,-456.0,-456.0,51934826.47499993,743975518.7699999,835096993.6499999,12739940.37,743975518.7699999,52433.0,-3672021.0,846650224.5,37890416.0,189816593.0,85777939.0,195363998.0,52940.0,823.0,148.45778320725574,1468280.0,460382.0,278362.5,-900412.5,317293.0,1786.0,594876937.7249838,594628163.324987,-36831205.0,-36540395.0,668847.0,29735.0,,,,,,,,,,,,,,,,,,,,,1465966.0,14726409.0,3229227.0,8546867.0,11596494.0,1414271.0,1056954663.7695012,801047556.877495,72035484437.2496,21654484036.942616,581715653.7644991,5792395.7475,689.5,94245.0,-276677177.0,21908300.0,-123680403.5,-218510140.5,-2014039.0,,,,,,,,,,,,,,,,,,,,,4268785.5,2476859.0,-8995314.5,921269.0,37582.5,3729978203.669965,3654521814.847463,-260392951.0,-257085313.0,2524213.5,268949.0,3922623456.749957,33227230441.79341,36653412822.457634,1727971211.3625493,48042744932.678215,3984299.0,-247358077.0,102988147775.5,1052969260.5,17259971347.0,3500538183.0,18873071408.0,3668649.5,71851.5,20853.39530249808,89723737.0,-11.119423163587204,7.590666666666666,2.7312454479242536,83.02237875265642,20.7319737800437,630.1952029851641,45000.0,0.6234898018587336,0.7818314824680298,0.0,0.0,0.0,0.0,0.0,0.0,1.0,0.0,0.0,0.0,0.0,0.0,0.0,1.0,0.0,1.0,0.0,0.0,0.0,0.0,1.0,0.0,0.0,0.0,0.0,1.0,0.0,0.0,0.0,0.0,0.0,0.0,0.0,0.0,1.0,0.0,0.0,0.0,0.0,0.0,0.0,0.0,0.0,0.0,0.0,0.0,0.0,0.0,0.0,0.0,0.0,0.0,0.0,0.0,0.0,0.0,0.0,0.0,0.0,0.0,0.0,0.0,0.0,0.0,0.0,0.0,0.0,0.0,0.0,0.0,0.0,0.0,0.0,0.0,0.0,0.0,0.0,0.0,0.0,0.0,0.0,0.0,0.0,0.0,0.0,0.0,0.0,0.0,0.0,0.0,1.0,0.0,0.0,0.0,0.0,0.0,0.0,0.0,0.0,0.0,0.0,0.0,0.0,0.0,0.0,0.0,0.0,1.0,0.0,0.0,1.0,0.0,0.0,0.0,0.0,0.0,0.0,0.0,1.0,0.0
100910,0,0.0,0.0,1.0,0.0,0.0,202500.0,67500.0,7218.0,67500.0,0.028663,33.778082191780825,-754.0,-4672.0,-4710.0,2.0,2.0,2.0,2.0,16.0,0.2885273583098383,0.4732614953721929,,0.1412,0.0904,0.9831,,,0.0,0.3448,0.1667,,0.1272,,0.1398,,0.0,0.1439,0.0938,0.9831,,,0.0,0.3448,0.1667,,0.1301,,0.1457,,0.0,0.1426,0.0904,0.9831,,,0.0,0.3448,0.1667,,0.1294,,0.1423,,0.0,0.1355,1.0,0.0,0.0,0.0,0.0,-582.0,0.0,0.0,0.0,0.0,1.0,1.0,1.0,1.0,1.0,1.0,0.0,0.0,0.0,0.0,0.0,0.0,0.0,0.0,0.0,1.0,0.0,0.0,0.0,0.0,0.0,0.0,0.0,0.0,0.0,0.0,0.0,0.0,0.0,0.0,0.0,0.0,0.0,0.0,1.0,0.0,,1746387.0,1420186.5,,0.0,0.0,0.0,-700.0,1126.0,-4.0,,24.0,-11.5,1.0,2436.48,43470.0,53797.5,0.0,43470.0,24.0,-582.0,365243.0,-551.0,-221.0,139.0,-218.0,16.0,0.0,0.0,2000.0,13.0,24.0,18.0,-13.0,0.0,0.0,13.0,2436.48,2436.48,-469.0,-371.0,7.0,1.0,0.0,,,,,,,,,,,,,,,,,,,,,8338750497.0,184260368844.0,165461479497.0,51924725110.935,1862.0,1703.0,71124.0,70671.0,9140.0,505582.0,17792.203400002298,17854.266599999108,17306.11539999808,11286.028700000086,11223.856600000092,11171.389900000058,128284.0,662192.0,,,,13515461.65205439,-601344078.0,-921072086.0,-296217335.0,-1533773996.0416667,43963.0,30666.0,11340.693199999176,11216.599999998967,10701.1964999973,22867.62970000962,22789.49600000958,22175.55390000813,67380.14259145761,157896.62935926893,,34969.53220002788,34909.94880002832,34356.50770002872,,,,3710866.0,8288.683200000167,8393.102500000079,8116.866100000228,,,,16454.20849999975,16639.2515999997,16236.2304999997,,,,3909.362100000125,3892.586600000161,3725.348700000157,436059.0,430860.0,1261843.0,6419.075840002895,631370.0,624930.0,,16317.9662999998,154045.23729999058,154047.98129999006,153939.7707999872,,,,24.0,14649153.525000004,,1422438070.3200002,488202712.6050001,,39452.85,32.0,1779.0,-4785381.0,2414670.0,-2470067.0,,-11.5,0.0,,1746387.0,1420186.5,,0.0,0.0,0.0,-700.0,1126.0,-4.0,,53827306.28999994,769037867.8199997,863638011.8999999,13027602.420000002,769037867.8199997,54298.0,-3795605.0,878964638.0,38524247.0,197420037.0,88655049.0,203335743.0,54592.0,859.0,152.4006913258416,1488686.0,478728.0,289654.0,-932535.0,317505.0,1842.0,617857502.0849801,617729506.9199847,-38423457.0,-38118680.0,700379.0,30868.0,,,,,,,,,,,,,,,,,,,,,1465967.0,14726433.0,3229227.0,8546880.0,11596507.0,1414272.0,1056954663.7695012,,72037230824.2496,21655904223.442616,,5792395.7475,689.5,94245.0,-276677877.0,21909426.0,-123680407.5,,-2014050.5,,,,,,,,,,,,,,,,,,,,,4268809.5,2476877.0,-8995327.5,921269.0,37582.5,3729980640.149965,3654524251.327463,-260393420.0,-257085684.0,2524220.5,268950.0,3922625893.229957,33227273911.79341,36653466619.957634,1727971211.3625493,48042788402.678215,3984323.0,-247358659.0,102988513018.5,1052968709.5,17259971126.0,3500538322.0,18873071190.0,3668665.5,71851.5,20853.39530249808,89725737.0,-22.32216724795198,0.3333333333333333,28.05486284289277,947.6394629863696,9.351620947630924,315.8798209954566,101250.0,-0.2225209339563146,-0.9749279121818236,0.0,0.0,0.0,0.0,0.0,0.0,1.0,0.0,0.0,0.0,0.0,0.0,0.0,1.0,0.0,0.0,0.0,0.0,1.0,1.0,0.0,0.0,0.0,0.0,0.0,1.0,0.0,0.0,0.0,0.0,0.0,0.0,0.0,0.0,0.0,0.0,0.0,0.0,0.0,0.0,1.0,0.0,0.0,0.0,0.0,0.0,0.0,0.0,0.0,0.0,0.0,0.0,0.0,0.0,0.0,0.0,0.0,0.0,0.0,0.0,0.0,0.0,0.0,0.0,0.0,0.0,0.0,0.0,0.0,0.0,0.0,0.0,0.0,0.0,0.0,0.0,0.0,0.0,0.0,0.0,0.0,0.0,0.0,0.0,0.0,0.0,0.0,0.0,0.0,0.0,1.0,0.0,0.0,0.0,0.0,0.0,0.0,0.0,0.0,0.0,0.0,0.0,0.0,0.0,0.0,0.0,0.0,0.0,0.0,0.0,1.0,0.0,0.0,0.0,0.0,0.0,0.0,0.0,1.0,0.0
100913,0,0.0,0.0,0.0,1.0,0.0,157500.0,720000.0,30505.5,720000.0,0.022625,65.04109589041096,,-3183.0,-4851.0,,2.0,2.0,2.0,12.0,0.2908993117962649,0.3092036814482325,0.2301588968634147,0.4845,0.4749,0.9776,0.6940000000000001,0.2281,0.0,1.0,0.1667,0.2083,0.5479999999999999,0.395,0.4617,0.0,0.0,0.4937,0.4929,0.9777,0.706,0.2302,0.0,1.0,0.1667,0.2083,0.5605,0.4316,0.481,0.0,0.0,0.4892,0.4749,0.9776,0.6981,0.2295,0.0,1.0,0.1667,0.2083,0.5576,0.4019,0.47,0.0,0.0,0.4895,1.0,0.0,0.0,0.0,0.0,-1631.0,0.0,0.0,0.0,0.0,1.0,4.0,1.0,0.0,0.0,1.0,1.0,0.0,0.0,0.0,0.0,0.0,0.0,0.0,0.0,1.0,0.0,0.0,0.0,0.0,0.0,0.0,0.0,0.0,0.0,0.0,0.0,0.0,0.0,0.0,0.0,0.0,0.0,0.0,16.0,0.0,0.0,135958.5,0.0,0.0,0.0,0.0,0.0,-954.5,-560.0,-475.0,-751.0,552.0,-19.0,10.0,22071.825,495000.0,553806.0,0.0,562500.0,36.0,-1027.5,365243.0,-1158.0,-817.5,-288.0,-809.0,12.0,0.5,0.0,-1.0,107.0,36.0,27.0,-26.0,0.0,0.0,270.0,10800.0,10800.0,-976.0,-970.0,47.5,0.0,96.0,127980.855,180000.0,0.0,0.0,0.0,0.0,6848.3475,9000.0,9000.0,123837.8175,126820.26,126820.26,0.0,0.0,0.0,0.0,44.0,-48.5,0.0,0.0,8338781002.5,184261088844.0,165462199497.0,51924882610.935,1862.0,1703.0,71124.0,70672.0,9140.0,505586.0,17792.687900002296,17854.755799999108,17306.60909999808,11286.503600000084,11224.331500000091,11171.88280000006,128284.0,662194.0,4135.310200000124,4132.946000000017,3943.770500000095,13515526.69315028,,-921076937.0,-296218966.0,-1533777179.0416667,43963.0,30666.0,11340.693199999176,11216.599999998967,10701.1964999973,22868.62970000962,22790.49600000958,22176.55390000813,67380.43349076941,157896.93856295038,125993.4847652194,34969.69890002788,34910.11550002832,34356.67440002872,22934.03679999593,22907.484299995507,22554.873399995744,3710878.0,8289.23120000017,8393.66010000008,8117.426600000227,9810.192200000718,9925.05340000216,10284.442299999648,16454.67019999975,16639.721599999702,16236.7114999997,828.1473000001757,813.3285000000459,759.3158000000133,3909.362100000125,3892.586600000161,3725.348700000157,436059.0,430860.0,,6419.098465002896,631372.0,624932.0,,16318.4557999998,154046.2148999906,154048.95889999007,153940.74849998718,77545.69079999626,77883.18420000657,78284.20990000648,32.0,14743365.525000004,4469496.704999999,1433825698.3200002,494822649.1050001,18621916.605,39452.85,32.0,1779.0,-4803810.5,2414882.0,-2482234.0,-2659309.0,-15.5,0.0,0.0,136917.0,0.0,0.0,0.0,0.0,0.0,-1743.0,-1213.0,-980.0,-1198.0,54118421.43749996,773459171.8199997,868628390.3999999,13074487.920000002,773537921.8199997,54691.0,-3817012.5,884259938.5,38506254.5,198137309.5,89012723.5,204053109.5,54895.0,861.5,152.9490758416539,1501756.5,483425.0,293053.0,-937702.0,317505.0,1842.0,636897918.2399808,637823533.0949852,-38728874.5,-38418800.0,719955.5,31137.0,609260758.6724999,1507113000.0,52104552.75,84314340.18000005,1589863.5,30585672.45000001,34284473.23500001,88473248.36999984,81434013.75000006,584478333.1124994,606831013.5299993,606853740.4649992,2776.0,6930.0,33.0,4121.0,206894.5,-349211.5,94424.0,355.0,1465983.0,14726985.0,3229323.0,8546987.0,11596777.0,1414282.0,1056954663.7695012,801047556.877495,72037366782.7496,21655904223.442616,581715653.7644991,5792395.7475,689.5,94245.0,-276678831.5,21908866.0,-123680882.5,-218510891.5,-2014069.5,5916669110.392461,18700920000.0,198631970.325,447419494.46249765,1948107.735,256461868.7775008,308803141.64249885,635808242.2949983,458589998.9474992,5702037877.957529,5879994986.654998,5880238169.4,13367.5,80731.0,44.0,70255.5,970679.5,-1696738.0,177364.0,6755.0,4268845.5,2476904.0,-8995353.5,921269.0,37582.5,3729991440.149965,3654535051.327463,-260394396.0,-257086654.0,2524268.0,268950.0,3922647965.054957,33227768911.79341,36654020425.957634,1727971211.3625493,48043350902.678215,3984359.0,-247359686.5,102988878261.5,1052967551.5,17259970308.5,3500538034.0,18873070381.0,3668677.5,71852.0,20853.39530249808,89725736.0,,4.571428571428571,5.1630033928308015,335.8073987556253,23.602301224369374,1535.1195371685724,78750.0,-0.9009688679024191,0.4338837391175582,0.0,0.0,0.0,0.0,0.0,0.0,1.0,0.0,0.0,1.0,0.0,0.0,0.0,0.0,0.0,0.0,0.0,0.0,1.0,0.0,1.0,0.0,0.0,0.0,0.0,1.0,0.0,0.0,0.0,0.0,0.0,0.0,0.0,0.0,0.0,0.0,0.0,0.0,0.0,0.0,0.0,0.0,0.0,0.0,0.0,0.0,0.0,0.0,0.0,0.0,0.0,0.0,0.0,0.0,0.0,0.0,0.0,0.0,0.0,0.0,0.0,0.0,0.0,0.0,0.0,0.0,0.0,0.0,0.0,0.0,0.0,0.0,0.0,0.0,0.0,0.0,0.0,0.0,0.0,0.0,0.0,0.0,0.0,0.0,0.0,0.0,0.0,0.0,0.0,0.0,0.0,0.0,0.0,0.0,0.0,0.0,0.0,0.0,0.0,0.0,0.0,0.0,0.0,0.0,0.0,1.0,0.0,0.0,1.0,0.0,1.0,0.0,0.0,0.0,0.0,0.0,0.0,1.0,0.0,0.0
100918,0,0.0,1.0,1.0,0.0,0.0,180000.0,118512.0,7573.5,90000.0,0.010006,29.457534246575342,-759.0,-1814.0,-432.0,9.0,2.0,2.0,1.0,17.0,0.2662884277368732,0.660574078815472,,0.6639,0.0873,0.996,,,0.48,0.3793,0.625,,,,0.7641,,0.6811,0.6765,0.0906,0.996,,,0.4834,0.3793,0.625,,,,0.7961,,0.7211,0.6703,0.0873,0.996,,,0.48,0.3793,0.625,,,,0.7778,,0.6954,0.7628,1.0,3.0,1.0,3.0,0.0,-134.0,0.0,0.0,0.0,0.0,1.0,0.0,1.0,1.0,0.0,1.0,0.0,0.0,0.0,0.0,0.0,0.0,0.0,0.0,0.0,1.0,0.0,0.0,0.0,0.0,0.0,0.0,0.0,0.0,0.0,0.0,0.0,0.0,0.0,0.0,0.0,0.0,0.0,0.0,1.0,0.0,,99450.0,0.0,,0.0,0.0,0.0,-968.0,-817.0,-814.0,-817.0,32.0,-15.5,3.0,15345.72,166779.0,134545.5,0.0,166779.0,24.0,-702.0,365243.0,-671.0,-43.0,19.0,-37.0,15.0,0.0,0.0,2000.0,50.0,24.0,12.0,-28.0,0.0,0.0,49.0,15345.72,15345.72,-683.0,-671.0,11.0,1.0,0.0,,,,,,,,,,,,,,,,,,,,,8338788576.0,184261207356.0,165462289497.0,51925062610.935,1862.0,1703.0,71124.0,70673.0,9140.0,505586.0,17793.351800002296,17855.42609999911,17307.285599998082,11286.590900000085,11224.41880000009,11171.973400000055,128284.0,662196.0,,,,13515556.150684524,-601344837.0,-921077369.0,-296219100.0,-1533778993.0416667,43964.0,30666.0,11341.173199999175,11217.079999998969,10701.6798999973,22869.00900000962,22790.875300009586,22176.93320000813,67380.69977919715,157897.59913702926,,34970.32390002788,34910.74050002832,34357.29940002872,,,,3710895.0,,,,,,,16455.43429999975,16640.499399999702,16237.5075999997,,,,3910.043200000124,3893.282000000161,3726.0698000001566,436062.0,430863.0,1261852.0,6419.108471002895,631374.0,624933.0,,16319.2185999998,154047.2108999906,154049.9548999901,153941.7444999872,,,,32.0,14753022.525000004,,1443477572.8200002,495524100.1050001,,39862.35,32.0,1828.0,-4825919.0,2408192.0,-2494388.0,-2672981.0,-15.5,0.0,,99450.0,0.0,,0.0,0.0,0.0,-968.0,-817.0,-814.0,-817.0,54413985.59999995,777971609.3699998,873624375.8999999,13083005.970000004,777971609.3699998,54998.0,-3838152.0,889553698.0,38489825.0,198856900.0,89371884.0,205139103.0,55148.0,869.0,153.265162131758,1508422.0,486631.0,295106.5,-942345.0,317505.0,1842.0,644020039.1699778,646411186.4849818,-39238253.0,-38925280.0,736658.0,31550.0,,,,,,,,,,,,,,,,,,,,,1465984.0,14727017.0,3229323.0,8547037.0,11596826.0,1414285.0,1056954663.7695012,,72037466232.7496,21655904223.442616,,5792395.7475,689.5,94245.0,-276679799.5,21908049.0,-123681696.5,-218511708.5,-2014085.0,,,,,,,,,,,,,,,,,,,,,4268869.5,2476916.0,-8995381.5,921269.0,37582.5,3730006785.869965,3654550397.047464,-260395079.0,-257087325.0,2524279.0,268951.0,3922663310.774956,33227935690.79341,36654154971.457634,1727971211.3625493,48043517681.678215,3984383.0,-247360388.5,102989243504.5,1052966880.5,17259970265.5,3500538053.0,18873070344.0,3668692.5,71852.0,20853.39530249808,89727736.0,-25.765904017857142,0.6584,23.767082590612,700.1196493541378,15.648247177658943,460.95877713476426,90000.0,1.0,0.0,0.0,0.0,0.0,0.0,0.0,0.0,1.0,0.0,0.0,0.0,0.0,0.0,0.0,1.0,0.0,0.0,0.0,0.0,1.0,0.0,1.0,0.0,0.0,0.0,0.0,1.0,0.0,0.0,0.0,0.0,0.0,0.0,0.0,0.0,0.0,0.0,0.0,0.0,1.0,0.0,0.0,0.0,0.0,0.0,0.0,0.0,0.0,0.0,0.0,0.0,0.0,1.0,0.0,0.0,0.0,0.0,0.0,0.0,0.0,0.0,0.0,0.0,0.0,0.0,0.0,0.0,0.0,0.0,0.0,0.0,0.0,0.0,0.0,0.0,0.0,0.0,0.0,0.0,0.0,0.0,0.0,0.0,0.0,0.0,0.0,0.0,0.0,0.0,0.0,0.0,0.0,0.0,0.0,0.0,0.0,0.0,0.0,0.0,0.0,0.0,0.0,0.0,0.0,0.0,0.0,0.0,0.0,0.0,0.0,0.0,1.0,0.0,0.0,0.0,1.0,0.0,0.0,0.0,0.0,0.0
100931,0,0.0,1.0,1.0,1.0,0.0,189000.0,260640.0,25906.5,225000.0,0.032561,57.10958904109589,-2797.0,-10800.0,-4163.0,13.0,2.0,1.0,1.0,16.0,0.8738834533983808,0.6815421987040936,0.5762088360175724,0.1,0.0486,0.9806,0.7348,,0.08,0.0345,0.5417,0.5833,0.0087,,0.0945,,0.0048,0.1019,0.0504,0.9801,0.7452,,0.0806,0.0345,0.5417,0.5833,0.0078,,0.0974,,0.0041,0.101,0.0486,0.9806,0.7383,,0.08,0.0345,0.5417,0.5833,0.0088,,0.0953,,0.0049,0.0736,1.0,0.0,0.0,0.0,0.0,-606.0,0.0,0.0,0.0,0.0,0.0,3.0,1.0,1.0,0.0,1.0,1.0,0.0,0.0,0.0,0.0,0.0,0.0,0.0,0.0,0.0,0.0,0.0,0.0,0.0,1.0,0.0,0.0,0.0,0.0,0.0,0.0,0.0,0.0,0.0,0.0,0.0,0.0,0.0,6.0,0.0,24632.19,247500.0,0.0,0.0,0.0,0.0,0.0,-725.0,-162.5,-18.0,-176.5,159.0,-15.0,3.0,10438.92,0.0,0.0,0.0,100210.5,10.0,-346.0,365243.0,-575.0,-305.0,-305.0,-302.0,11.0,0.0,0.0,-1.0,11.0,10.0,5.0,-15.0,0.0,0.0,10.0,10438.92,10438.92,-450.5,-440.0,5.5,1.0,0.0,,,,,,,,,,,,,,,,,,,,,8338814482.5,184261467996.0,165462514497.0,51925251610.935,1862.0,1703.0,71124.0,70673.0,9140.0,505589.0,17793.451800002294,17855.527099999108,17307.387499998084,11286.639500000085,11224.46740000009,11172.023800000055,128284.0,662198.0,,,,13515613.260273565,-601347634.0,-921081532.0,-296219706.0,-1533789793.0416667,43964.0,30666.0,11341.253199999175,11217.159999998968,10701.7604999973,22869.043500009622,22790.909800009584,22176.967700008136,67381.57366265055,157898.28067922793,125994.06097405544,34970.86560002788,34911.28220002832,34357.84110002872,22934.620099995933,22908.067599995506,22555.456699995742,3710911.0,8289.239900000168,8393.668900000079,8117.4344000002275,,,,16455.528799999753,16640.594699999703,16237.6049999997,,,,3910.048000000125,3893.286900000161,3726.0739000001568,436062.0,430863.0,1261865.0,6419.141032002895,631375.0,624934.0,,16319.2921999998,154048.1914999906,154050.9354999901,153942.72459998718,77546.42559999626,77883.92250000658,78284.95510000647,24.0,14753022.525000004,4503125.879999999,1449347437.2150002,497414530.5300001,18724255.605,39862.35,32.0,1828.0,-4876474.0,2417142.0,-2520790.0,-2706723.0,-11.5,0.0,24632.19,315000.0,0.0,0.0,0.0,0.0,0.0,-973.0,-243.0,-242.0,-1468.0,55119579.92999993,785038157.0999997,882010656.8999999,13321235.700000005,785038157.0999997,55762.0,-3911807.0,907810463.0,38790317.0,202826756.0,91521806.0,209476213.0,55940.0,885.0,156.83003595292058,1529178.0,495658.0,300282.0,-961323.0,317579.0,1877.0,654486696.359983,656866577.0699861,-40118866.0,-39805612.5,755410.5,32193.5,,,,,,,,,,,,,,,,,,,,,1465990.0,14727176.0,3229323.0,8547048.0,11596836.0,1414288.0,1056954663.7695012,801072189.0674951,72037713732.7496,21655904223.442616,581715653.7644991,5792395.7475,689.5,94245.0,-276680524.5,21907886.5,-123681714.5,-218511885.0,-2014100.0,,,,,,,,,,,,,,,,,,,,,4268879.5,2476921.0,-8995396.5,921269.0,37582.5,3730017224.7899647,3654560835.967464,-260395529.5,-257087765.0,2524284.5,268952.0,3922673749.694956,33227935690.79341,36654154971.457634,1727971211.3625493,48043617892.178215,3984393.0,-247360734.5,102989608747.5,1052966305.5,17259969960.5,3500537748.0,18873070042.0,3668703.5,71852.0,20853.39530249808,89727735.0,-48.97601343247781,1.379047619047619,7.2954663887441376,416.64108732430566,10.060795553239538,574.5678994719948,94500.0,1.0,0.0,0.0,0.0,0.0,0.0,0.0,0.0,1.0,0.0,1.0,0.0,0.0,0.0,0.0,0.0,0.0,0.0,0.0,0.0,1.0,0.0,1.0,0.0,0.0,0.0,0.0,1.0,0.0,0.0,0.0,0.0,0.0,0.0,0.0,0.0,1.0,0.0,0.0,0.0,0.0,0.0,0.0,0.0,0.0,0.0,0.0,0.0,0.0,0.0,0.0,0.0,0.0,0.0,1.0,0.0,0.0,0.0,0.0,0.0,0.0,0.0,0.0,0.0,0.0,0.0,0.0,0.0,0.0,0.0,0.0,0.0,0.0,0.0,0.0,0.0,0.0,0.0,0.0,0.0,0.0,0.0,0.0,0.0,0.0,0.0,0.0,0.0,0.0,0.0,0.0,0.0,0.0,0.0,0.0,0.0,0.0,0.0,0.0,0.0,0.0,0.0,0.0,0.0,0.0,0.0,0.0,0.0,0.0,0.0,1.0,0.0,1.0,0.0,0.0,0.0,0.0,0.0,0.0,0.0,1.0,0.0
100952,0,0.0,1.0,1.0,1.0,1.0,112500.0,675000.0,34596.0,675000.0,0.026392,32.295890410958904,-3394.0,-5844.0,-2234.0,2.0,3.0,2.0,2.0,14.0,0.3945031655774048,0.6706388088669245,0.4525335592581747,,,,,,,,,,,,,,,,,,,,,,,,,,,,,,,,,,,,,,,,,,,,,0.0,0.0,0.0,0.0,-1536.0,0.0,0.0,0.0,0.0,3.0,1.0,1.0,1.0,0.0,1.0,0.0,0.0,0.0,0.0,0.0,0.0,0.0,0.0,0.0,1.0,0.0,0.0,0.0,0.0,0.0,0.0,0.0,0.0,0.0,0.0,0.0,0.0,0.0,0.0,0.0,0.0,0.0,0.0,10.0,0.0,0.0,72040.5,0.0,0.0,0.0,0.0,0.0,-1702.5,-1398.0,-860.0,-1391.5,543.0,-30.0,6.0,9826.92,82687.5,81517.5,0.0,82687.5,10.0,-1251.5,365243.0,-1218.5,-1083.5,-993.5,-1080.0,13.0,0.0,0.0,180.0,53.0,10.0,6.0,-47.0,0.0,0.0,50.0,10076.985,10076.985,-1476.0,-1456.0,4.5,1.0,0.0,,,,,,,,,,,,,,,,,,,,,8338849078.5,184262142996.0,165463189497.0,51925364110.935,1862.0,1703.0,71124.0,70676.0,9140.0,505590.0,,,,,,,128285.0,662201.0,,,,13515645.556163978,-601351028.0,-921083766.0,-296221242.0,-1533795637.0416667,43964.0,30666.0,,,,,,,67381.96816581613,157898.9513180368,125994.51350761468,,,,,,,3710925.0,,,,,,,,,,,,,,,,436062.0,430863.0,1261867.0,6419.167424002895,631377.0,624936.0,,,,,,,,,56.0,14944131.675000004,4553001.27,1478450152.3050003,509473975.8150001,18964848.779999997,39862.35,33.0,1828.0,-4958988.5,2470252.0,-2556734.0,-2752068.0,-27.5,0.0,0.0,68031.0,0.0,0.0,0.0,0.0,0.0,-1903.0,-1398.0,-878.0,-1398.0,56524340.81249993,804323030.8499997,905383150.65,13626526.950000005,804323030.8499997,57379.0,-4025642.5,934653441.5,40165037.0,208968298.5,93660336.0,215252971.0,57382.5,915.0,161.3832721627129,1605488.5,509031.0,308818.0,-989538.0,317623.0,1885.0,672463271.4074817,675479055.4874843,-41171198.5,-40850654.0,772203.5,33027.5,,,,,,,,,,,,,,,,,,,,,1466000.0,14727719.0,3229323.0,8547101.0,11596886.0,1414294.0,1056954663.7695012,801072189.0674951,72037785773.2496,21655904223.442616,581715653.7644991,5792395.7475,689.5,94245.0,-276682227.0,21906488.5,-123682574.5,-218513276.5,-2014130.0,,,,,,,,,,,,,,,,,,,,,4268889.5,2476927.0,-8995443.5,921269.0,37582.5,3730027301.774965,3654570912.952463,-260397005.5,-257089221.0,2524289.0,268953.0,3922683576.614957,33228018378.29341,36654236488.957634,1727971211.3625493,48043700579.678215,3984403.0,-247361986.0,102989973990.5,1052965087.0,17259968877.0,3500536754.5,18873068962.0,3668716.5,71852.0,20853.39530249808,89727915.0,-105.0907702748558,6.0,3.2518210197710715,105.02045529057916,19.51092611862643,630.1227317434749,37500.0,0.6234898018587336,0.7818314824680298,0.0,0.0,0.0,0.0,0.0,0.0,1.0,0.0,0.0,0.0,0.0,0.0,0.0,1.0,0.0,0.0,0.0,0.0,1.0,0.0,1.0,0.0,0.0,0.0,0.0,0.0,0.0,0.0,0.0,1.0,0.0,0.0,0.0,0.0,0.0,0.0,0.0,0.0,1.0,0.0,0.0,0.0,0.0,0.0,0.0,0.0,0.0,0.0,0.0,0.0,0.0,0.0,0.0,0.0,0.0,0.0,0.0,0.0,0.0,0.0,0.0,0.0,0.0,0.0,1.0,0.0,0.0,0.0,0.0,0.0,0.0,0.0,0.0,0.0,0.0,0.0,0.0,0.0,0.0,0.0,0.0,0.0,0.0,0.0,0.0,0.0,0.0,0.0,0.0,0.0,0.0,0.0,0.0,0.0,0.0,0.0,0.0,0.0,0.0,0.0,0.0,0.0,0.0,0.0,0.0,0.0,0.0,0.0,0.0,0.0,0.0,0.0,0.0,0.0,0.0,0.0,0.0,0.0,0.0,0.0
100953,0,0.0,1.0,0.0,0.0,0.0,225000.0,573408.0,29407.5,495000.0,0.04622,58.994520547945214,,-5195.0,-5090.0,,1.0,1.0,1.0,17.0,0.4022166535769752,0.6251147714443095,0.6801388218428291,,,,,,,,,,,,,,,,,,,,,,,,,,,,,,,,,,,,,,,,,,,,,5.0,0.0,5.0,0.0,0.0,0.0,0.0,0.0,0.0,0.0,3.0,1.0,0.0,0.0,1.0,0.0,0.0,0.0,0.0,0.0,0.0,0.0,0.0,0.0,0.0,0.0,0.0,1.0,0.0,0.0,0.0,0.0,0.0,0.0,0.0,0.0,0.0,0.0,0.0,0.0,0.0,0.0,0.0,6.0,53577.36,0.0,369427.5,0.0,0.0,0.0,0.0,0.0,-1635.5,-1452.0,-1089.0,-1960.5,325.0,-30.0,2.0,40187.1375,394627.5,415120.5,0.0,394627.5,12.0,-1020.0,365243.0,-989.0,-659.0,-659.0,-654.0,14.0,0.0,0.0,785.0,26.0,12.0,6.0,-27.5,0.0,0.0,24.0,40181.76,40181.76,-837.0,-824.0,6.5,1.0,0.0,,,,,,,,,,,,,,,,,,,,,8338878486.0,184262716404.0,165463684497.0,51925589110.935,1862.0,1703.0,71124.0,70676.0,9140.0,505593.0,,,,,,,128285.0,662202.0,,,,13515704.550684528,,-921088856.0,-296221242.0,-1533800832.0416667,43964.0,30666.0,,,,,,,67382.3703824697,157899.57643280824,125995.19364643651,,,,,,,3710942.0,,,,,,,,,,,,,,,,436067.0,430868.0,,6419.213644002895,631378.0,624937.0,,,,,,,,,54.0,15065281.777500004,4553001.27,1482038274.5550003,509543167.8150001,18964848.779999997,39862.35,33.0,1828.0,-4970691.0,2464549.5,-2563749.5,-2759900.5,-26.5,87632.235,0.0,412200.0,0.0,0.0,0.0,0.0,0.0,-2498.0,-2312.0,-1793.0,-2312.0,56608453.46249993,805085506.3499997,906167768.4,13644823.950000005,805085506.3499997,57419.0,-4031907.5,936114413.5,40158980.0,208964315.0,93655401.0,215248998.0,57438.5,916.0,161.59356838932098,1608061.0,509451.0,309065.5,-991435.0,317623.0,1885.0,673255690.0424813,676271474.1224837,-41224380.0,-40902938.0,772396.5,33065.5,,,,,,,,,,,,,,,,,,,,,1466006.0,14728044.0,3229323.0,8547127.0,11596910.0,1414296.0,1057008241.1295012,801072189.0674951,72038155200.7496,21655904223.442616,581715653.7644991,5792395.7475,689.5,94245.0,-276683862.5,21905036.5,-123683663.5,-218515237.0,-2014160.0,,,,,,,,,,,,,,,,,,,,,4268901.5,2476933.0,-8995471.0,921269.0,37582.5,3730067483.5349655,3654611094.712464,-260397842.5,-257090045.0,2524295.5,268954.0,3922723763.752456,33228413005.79341,36654651609.457634,1727971211.3625493,48044095207.178215,3984415.0,-247363006.0,102990339233.5,1052964098.0,17259968218.0,3500536095.5,18873068308.0,3668730.5,71852.0,20853.39530249808,89728700.0,,2.54848,7.651109410864575,451.3735313538272,19.498699311400152,1150.3164171846013,225000.0,-0.2225209339563143,0.9749279121818236,0.0,1.0,0.0,0.0,0.0,0.0,0.0,0.0,0.0,1.0,0.0,0.0,0.0,0.0,0.0,0.0,0.0,0.0,1.0,0.0,0.0,0.0,1.0,0.0,0.0,0.0,1.0,0.0,0.0,0.0,0.0,0.0,0.0,0.0,0.0,0.0,0.0,0.0,0.0,0.0,0.0,0.0,0.0,0.0,0.0,0.0,0.0,0.0,0.0,0.0,0.0,0.0,0.0,0.0,0.0,0.0,0.0,0.0,0.0,0.0,0.0,0.0,0.0,0.0,0.0,0.0,0.0,0.0,0.0,0.0,0.0,0.0,0.0,0.0,0.0,0.0,0.0,0.0,0.0,0.0,0.0,0.0,0.0,0.0,0.0,0.0,0.0,0.0,0.0,0.0,0.0,0.0,0.0,0.0,0.0,0.0,0.0,0.0,0.0,0.0,0.0,0.0,0.0,0.0,0.0,1.0,0.0,0.0,0.0,0.0,0.0,0.0,0.0,0.0,0.0,0.0,0.0,0.0,0.0,0.0
100965,0,0.0,0.0,1.0,0.0,0.0,90000.0,202500.0,13068.0,202500.0,0.00702,50.84657534246576,-569.0,-10857.0,-1649.0,29.0,2.0,2.0,2.0,10.0,0.362168407088305,0.3571062407657783,0.1634256947313434,,,,,,,,,,,,,,,,,,,,,,,,,,,,,,,,,,,,,,,,,,,,,9.0,0.0,9.0,0.0,-885.0,0.0,0.0,0.0,0.0,0.0,1.0,1.0,1.0,1.0,1.0,0.0,0.0,0.0,0.0,0.0,0.0,1.0,1.0,0.0,1.0,0.0,0.0,0.0,0.0,0.0,0.0,0.0,0.0,0.0,0.0,0.0,0.0,0.0,0.0,0.0,0.0,0.0,0.0,4.0,0.0,,141750.0,47387.25,0.0,0.0,0.0,0.0,-254.5,475.5,-144.5,-236.5,36.0,-4.0,1.0,1391.58,15237.0,13711.5,1525.5,15237.0,12.0,-885.0,365243.0,-854.0,-734.0,-524.0,-730.0,11.0,0.0,0.1090377490200289,38.0,6.0,12.0,9.5,-26.5,0.0,0.0,5.0,1391.58,1391.58,-795.0,-794.0,3.0,1.0,0.0,,,,,,,,,,,,,,,,,,,,,8338891554.0,184262918904.0,165463886997.0,51925679110.935,1862.0,1703.0,71124.0,70676.0,9140.0,505594.0,,,,,,,128285.0,662204.0,,,,13515755.397259869,-601351597.0,-921090505.0,-296222127.0,-1533811689.0416667,43964.0,30666.0,,,,,,,67382.73255087678,157899.933539049,125995.35707213126,,,,,,,3710952.0,,,,,,,,,,,,,,,,436076.0,430877.0,1261896.0,6419.220664002895,631380.0,624939.0,,,,,,,,,9.0,16100474.895000003,,1498304236.3200002,512697608.1450001,19324848.779999997,39862.35,34.0,1828.0,-5060460.0,2459533.0,-2616122.0,-2814099.0,-4.0,0.0,,141750.0,0.0,0.0,0.0,0.0,0.0,-287.0,77.0,-161.0,-236.5,57124104.0299999,810711806.8499997,912476255.4,13720666.950000005,810711806.8499997,57947.0,-4070814.0,947983649.0,41224230.0,212594162.0,95463589.0,218879693.0,58201.0,927.0,163.0434297567068,1629266.0,514515.5,312221.0,-1000463.0,317644.0,1906.0,678420694.9799784,681858909.8099812,-41513746.0,-41188648.0,775434.0,33674.0,,,,,,,,,,,,,,,,,,,,,1466010.0,14728080.0,3229323.0,8547133.0,11596915.0,1414297.0,1057008241.1295012,,72038296950.7496,21655951610.692616,581715653.7644991,5792395.7475,689.5,94245.0,-276684117.0,21905512.0,-123683808.0,-218515473.5,-2014164.0,,,,,,,,,,,,,,,,,,,,,4268913.5,2476942.5,-8995497.5,921269.0,37582.5,3730068875.114965,3654612486.2924633,-260398637.5,-257090839.0,2524298.5,268955.0,3922725155.332456,33228428242.79341,36654665320.957634,1727972736.8625493,48044110444.178215,3984427.0,-247363891.0,102990704476.5,1052963244.0,17259967484.0,3500535571.5,18873067578.0,3668741.5,71852.0,20853.50434024709,89728738.0,-11.190527506869982,2.25,6.887052341597795,350.1830257745575,15.49586776859504,787.9118079927545,45000.0,-0.9009688679024191,0.4338837391175582,0.0,0.0,0.0,0.0,0.0,0.0,1.0,0.0,1.0,0.0,0.0,0.0,0.0,0.0,0.0,0.0,0.0,0.0,1.0,0.0,1.0,0.0,0.0,0.0,0.0,1.0,0.0,0.0,0.0,0.0,0.0,0.0,0.0,0.0,0.0,0.0,0.0,0.0,0.0,0.0,0.0,0.0,0.0,0.0,0.0,0.0,1.0,0.0,0.0,0.0,0.0,0.0,0.0,0.0,0.0,0.0,0.0,0.0,0.0,0.0,0.0,0.0,0.0,0.0,0.0,0.0,0.0,0.0,0.0,0.0,0.0,0.0,0.0,0.0,0.0,0.0,0.0,0.0,0.0,0.0,0.0,0.0,0.0,0.0,0.0,0.0,0.0,0.0,1.0,0.0,0.0,0.0,0.0,0.0,0.0,0.0,0.0,0.0,0.0,0.0,0.0,0.0,0.0,0.0,0.0,0.0,0.0,0.0,0.0,0.0,0.0,0.0,0.0,0.0,0.0,0.0,0.0,0.0,0.0,0.0
100970,0,0.0,0.0,0.0,1.0,0.0,112500.0,599778.0,27792.0,477000.0,0.00963,53.2,,-3093.0,-2941.0,,1.0,2.0,2.0,10.0,,0.6014974760619343,0.5954562029091491,,,,,,,,,,,,,,,,,,,,,,,,,,,,,,,,,,,,,,,,,,,,,0.0,0.0,0.0,0.0,-1247.0,0.0,0.0,0.0,0.0,1.0,0.0,1.0,0.0,0.0,1.0,0.0,0.0,0.0,0.0,0.0,0.0,0.0,0.0,0.0,1.0,0.0,0.0,0.0,0.0,0.0,0.0,0.0,0.0,0.0,0.0,0.0,0.0,0.0,0.0,0.0,0.0,0.0,0.0,4.0,,,75561.03,0.0,0.0,0.0,0.0,0.0,-596.5,155.5,-165.5,-168.0,84.0,-11.5,1.0,6824.7,67275.0,66942.0,6727.5,67275.0,12.0,-1247.0,365243.0,-1216.0,-1036.0,-886.0,-1031.0,10.0,0.0,0.0994558004453551,500.0,8.0,12.0,8.5,-37.5,0.0,0.0,8.0,6824.7,6824.7,-1122.0,-1111.0,4.5,1.0,0.0,,,,,,,,,,,,,,,,,,,,,8338919346.0,184263518682.0,165464363997.0,51925791610.935,1862.0,1703.0,71124.0,70677.0,9140.0,505594.0,,,,,,,128285.0,662205.0,,,,13515808.597259868,,-921093446.0,-296223374.0,-1533814782.0416667,43964.0,30666.0,,,,,,,,157900.53503652508,125995.95252833414,,,,,,,3710962.0,,,,,,,,,,,,,,,,436076.0,430877.0,,6419.230294002896,631382.0,624941.0,,,,,,,,,20.0,,,1502126165.88,513776899.3950001,19414848.779999997,39862.35,34.0,1828.0,-5077742.0,2459485.0,-2623692.5,-2822042.0,-9.5,,,61122.06,0.0,0.0,0.0,0.0,0.0,-870.0,72.0,-166.0,-168.0,57233261.60999993,811893026.2499998,913835772.9,13766774.850000003,811893026.2499998,58088.0,-4091235.0,952364285.0,41570523.0,214041871.0,96181259.0,220327450.0,58416.0,933.0,163.8471422724111,1630219.0,516684.0,313397.0,-1005809.5,317644.0,1906.0,680528455.8299812,683993524.8599843,-41798906.0,-41471278.0,781905.0,33808.5,,,,,,,,,,,,,,,,,,,,,1466014.0,14728164.0,3229323.0,8547141.0,11596923.0,1414298.0,,,72038372511.7796,21655951610.692616,581715653.7644991,5792395.7475,689.5,94245.0,-276684713.5,21905667.5,-123683973.5,-218515641.5,-2014175.5,,,,,,,,,,,,,,,,,,,,,4268925.5,2476951.0,-8995535.0,921269.0,37582.5,3730075699.814965,3654619310.992463,-260399759.5,-257091950.0,2524303.0,268956.0,3922731980.032456,33228495517.79341,36654732262.957634,1727979464.3625493,48044177719.178215,3984439.0,-247365138.0,102991069719.5,1052962028.0,17259966448.0,3500534685.5,18873066547.0,3668751.5,71852.0,20853.60379604754,89729238.0,,5.33136,4.0479274611398965,215.3497409326425,21.580958549222803,1148.106994818653,112500.0,-0.2225209339563143,0.9749279121818236,0.0,0.0,0.0,0.0,0.0,0.0,1.0,0.0,0.0,1.0,0.0,0.0,0.0,0.0,0.0,0.0,0.0,0.0,1.0,0.0,0.0,0.0,1.0,0.0,0.0,1.0,0.0,0.0,0.0,0.0,0.0,0.0,0.0,0.0,0.0,0.0,0.0,0.0,0.0,0.0,0.0,0.0,0.0,0.0,0.0,0.0,0.0,0.0,0.0,0.0,0.0,0.0,0.0,0.0,0.0,0.0,0.0,0.0,0.0,0.0,0.0,0.0,0.0,0.0,0.0,0.0,0.0,0.0,0.0,0.0,0.0,0.0,0.0,0.0,0.0,0.0,0.0,0.0,0.0,0.0,0.0,0.0,0.0,0.0,0.0,0.0,0.0,0.0,0.0,0.0,0.0,0.0,0.0,0.0,0.0,0.0,0.0,0.0,0.0,0.0,0.0,0.0,0.0,0.0,0.0,1.0,0.0,0.0,0.0,0.0,0.0,0.0,0.0,0.0,0.0,0.0,0.0,0.0,0.0,0.0
100982,0,0.0,0.0,0.0,1.0,2.0,112500.0,481176.0,23148.0,360000.0,0.031329,23.83287671232877,-1334.0,-2315.0,-1373.0,,4.0,2.0,2.0,11.0,0.1791486534897605,0.5081140442030012,0.4650692149562261,,,,,,,,,,,,,,,,,,,,,,,,,,,,,,,,,,,,,,,,,,,,,1.0,1.0,1.0,1.0,-883.0,0.0,0.0,0.0,0.0,1.0,0.0,1.0,1.0,0.0,1.0,0.0,0.0,0.0,0.0,0.0,0.0,0.0,0.0,0.0,1.0,0.0,0.0,0.0,0.0,0.0,0.0,0.0,0.0,0.0,0.0,0.0,0.0,0.0,0.0,0.0,0.0,0.0,0.0,1.0,,,67500.0,4788.0,0.0,0.0,0.0,0.0,-224.0,949.0,-163.0,,8.0,-3.5,1.0,2837.25,26775.0,27675.0,0.0,26775.0,12.0,-883.0,365243.0,-852.0,-702.0,-522.0,-689.0,11.0,0.0,0.0,150.0,8.0,12.0,8.5,-25.5,0.0,0.0,6.0,2837.25,2837.25,-817.0,-777.0,3.5,1.0,0.0,,,,,,,,,,,,,,,,,,,,,8338942494.0,184263999858.0,165464723997.0,51925904110.935,1862.0,1703.0,71124.0,70678.0,9140.0,505594.0,,,,,,,128287.0,662209.0,,,,13515832.43013658,-601352931.0,-921094819.0,-296224257.0,-1533817097.0416667,43965.0,30667.0,,,,,,,67382.91169953028,157901.04315056928,125996.41759754912,,,,,,,3710973.0,,,,,,,,,,,,,,,,436077.0,430878.0,,6419.261623002895,631384.0,624943.0,,,,,,,,,8.0,,,1510717737.7800002,514678856.0850001,19428348.779999997,39862.35,34.0,1828.0,-5134368.0,2467988.0,-2652598.0,,-3.5,,,67500.0,4788.0,0.0,0.0,0.0,0.0,-224.0,949.0,-163.0,,57740424.43499992,817858061.5499997,920298087.9,13869169.650000004,817858061.5499997,58651.0,-4132297.0,962955922.0,41907373.0,215481385.0,96895503.0,221767182.0,59114.0,945.0,165.77482558012187,1666134.0,521065.0,316123.0,-1013935.5,317761.0,1982.0,685719143.8199822,688870109.9699851,-42078502.5,-41748178.0,784297.5,34112.5,,,,,,,,,,,,,,,,,,,,,1466015.0,14728172.0,3229323.0,8547149.0,11596929.0,1414299.0,,,72038440011.7796,21655956398.692616,581715653.7644991,5792395.7475,689.5,94245.0,-276684937.5,21906616.5,-123684136.5,,-2014179.0,,,,,,,,,,,,,,,,,,,,,4268937.5,2476959.5,-8995560.5,921269.0,37582.5,3730078537.064965,3654622148.242463,-260400576.5,-257092727.0,2524306.5,268957.0,3922734817.282456,33228522292.79341,36654759937.957634,1727979464.3625493,48044204494.178215,3984451.0,-247366021.0,102991434962.5,1052961176.0,17259965746.0,3500534163.5,18873065858.0,3668762.5,71852.0,20853.60379604754,89729388.0,-55.973100356362814,4.27712,4.8600311041990665,115.82852212445938,20.786936236391917,495.41248854896776,28125.0,-0.2225209339563143,0.9749279121818236,0.0,1.0,0.0,0.0,0.0,0.0,0.0,0.0,0.0,0.0,0.0,0.0,0.0,1.0,0.0,0.0,0.0,0.0,1.0,1.0,0.0,0.0,0.0,0.0,0.0,1.0,0.0,0.0,0.0,0.0,0.0,0.0,0.0,0.0,0.0,0.0,0.0,0.0,0.0,0.0,0.0,0.0,0.0,0.0,1.0,0.0,0.0,0.0,0.0,0.0,0.0,0.0,0.0,0.0,0.0,0.0,0.0,0.0,0.0,0.0,0.0,0.0,0.0,0.0,0.0,0.0,0.0,0.0,0.0,0.0,0.0,0.0,0.0,0.0,0.0,0.0,0.0,0.0,0.0,0.0,0.0,0.0,0.0,0.0,0.0,0.0,0.0,0.0,0.0,0.0,0.0,0.0,0.0,0.0,0.0,0.0,0.0,0.0,0.0,1.0,0.0,0.0,0.0,0.0,0.0,0.0,0.0,0.0,0.0,0.0,0.0,0.0,0.0,0.0,0.0,0.0,0.0,0.0,0.0,0.0
100983,1,0.0,1.0,1.0,1.0,0.0,315000.0,625536.0,32067.0,540000.0,0.00733,45.175342465753424,-777.0,-6257.0,-27.0,1.0,2.0,2.0,2.0,12.0,0.0743808094645544,0.6688249694278774,0.2622489709189549,0.067,0.0764,0.9876,,,0.0,0.0345,0.1667,,0.0,,0.0534,,0.1018,0.0683,0.0793,0.9876,,,0.0,0.0345,0.1667,,0.0,,0.0557,,0.1077,0.0677,0.0764,0.9876,,,0.0,0.0345,0.1667,,0.0,,0.0544,,0.1039,0.0472,1.0,1.0,0.0,1.0,0.0,-683.0,0.0,0.0,0.0,0.0,1.0,4.0,1.0,1.0,0.0,1.0,0.0,1.0,0.0,0.0,0.0,0.0,0.0,0.0,0.0,1.0,0.0,0.0,0.0,0.0,0.0,0.0,0.0,0.0,0.0,0.0,0.0,0.0,0.0,0.0,0.0,0.0,0.0,0.0,5.0,0.0,,90000.0,29250.0,0.0,0.0,0.0,0.0,-208.0,297.0,-43.0,,44.0,-5.0,4.0,4115.969999999998,22500.0,22500.0,0.0,85074.75,12.0,-574.0,182338.0,-590.5,365243.0,182641.0,365243.0,15.0,0.0,0.0,-1.0,22.0,24.0,13.0,-11.5,0.0,0.0,57.0,5981.94,5981.94,-300.0,-287.0,14.0,0.0,19.0,131337.81,135000.0,2250.0,2250.0,0.0,0.0,6966.315,7200.0,2250.0,119538.405,127845.54,127845.54,1.0,1.0,0.0,0.0,8.0,-10.0,0.0,0.0,8338974561.0,184264625394.0,165465263997.0,51926219110.935,1862.0,1703.0,71124.0,70679.0,9140.0,505598.0,17793.518800002294,17855.594799999108,17307.455799998083,11286.715900000085,11224.54380000009,11172.103100000057,128287.0,662211.0,,,,13515877.605479049,-601353708.0,-921094846.0,-296224940.0,-1533823354.0416667,43965.0,30667.0,11341.253199999175,11217.159999998968,10701.7604999973,22869.078000009624,22790.944300009585,22177.002200008134,67382.98608033975,157901.71197553872,125996.67984652006,34971.03230002788,34911.44890002832,34358.007800028725,,,,3710985.0,8289.239900000168,8393.668900000079,8117.4344000002275,,,,16455.58219999975,16640.649099999704,16237.660699999702,,,,3910.149800000124,3893.390800000161,3726.181600000157,436078.0,430879.0,1261897.0,6419.2689530028965,631386.0,624945.0,,16319.3393999998,154049.1790999906,154051.9230999901,153943.71219998717,,,,7.0,16209023.985000009,,1511168975.2800002,514774211.0850001,19428348.779999997,39862.35,34.0,1828.0,-5135214.0,2468428.0,-2652789.0,,-5.0,0.0,,225618.75,47677.5,0.0,0.0,0.0,0.0,-433.0,297.0,-43.0,,57745665.40499992,817880561.5499997,920320587.9,13869169.650000004,817965636.2999997,58663.0,-4133230.0,963137976.5,41906517.5,216029249.5,97260765.5,222315046.5,59149.5,945.0,165.77482558012187,1666132.5,521383.0,316330.5,-1014183.5,317761.0,1982.0,685862426.2499825,689013392.3999853,-42087581.0,-41757045.0,784850.0,34115.0,689666635.8449997,1676875500.0,57995727.75,90849827.16,1786693.5,31033154.430000026,38571246.585,96089030.77500014,88260400.12499999,661779884.7899983,686907142.784998,686929869.7199981,3075.0,7377.0,38.0,4264.0,224981.0,-379165.0,148344.0,381.0,1466020.0,14728216.0,3229342.0,8547171.0,11596986.0,1414303.0,1057008241.1295012,,72038530011.7796,21655985648.692616,581715653.7644991,5792395.7475,689.5,94245.0,-276685145.5,21906913.5,-123684179.5,,-2014184.0,5916800448.202461,18701055000.0,198634220.325,447421744.46249765,1948107.735,256461868.7775008,308810107.95749885,635815442.2949983,458592248.9474992,5702157416.362529,5880122832.194998,5880366014.94,13368.5,80732.0,44.0,70255.5,970687.5,-1696748.0,177364.0,6755.0,4268961.5,2476972.5,-8995572.0,921269.0,37582.5,3730084519.004965,3654628130.182463,-260400876.5,-257093014.0,2524320.5,268957.0,3922738933.252456,33228544792.79341,36654782437.957634,1727979464.3625493,48044289568.928215,3984463.0,-247366595.0,102991617300.5,1052960585.5,17260330989.0,3500716804.5,18873431101.0,3668777.5,71852.0,20853.60379604754,89729387.0,-17.19964825034872,1.9858285714285715,9.823182711198433,443.7656430820573,19.50715689026101,881.2424930507228,157500.0,-0.2225209339563143,0.9749279121818236,0.0,0.0,0.0,0.0,0.0,0.0,1.0,0.0,0.0,0.0,0.0,0.0,0.0,1.0,0.0,1.0,0.0,0.0,0.0,0.0,1.0,0.0,0.0,0.0,0.0,1.0,0.0,0.0,0.0,0.0,0.0,0.0,0.0,0.0,1.0,0.0,0.0,0.0,0.0,0.0,0.0,0.0,0.0,0.0,0.0,0.0,0.0,0.0,0.0,0.0,0.0,0.0,0.0,0.0,0.0,0.0,0.0,0.0,0.0,0.0,0.0,0.0,0.0,0.0,0.0,0.0,0.0,0.0,1.0,0.0,0.0,0.0,0.0,0.0,0.0,0.0,0.0,0.0,0.0,0.0,0.0,0.0,0.0,0.0,0.0,0.0,0.0,0.0,0.0,0.0,0.0,0.0,0.0,0.0,0.0,0.0,0.0,0.0,0.0,0.0,0.0,0.0,0.0,0.0,0.0,0.0,0.0,0.0,0.0,0.0,1.0,0.0,0.0,0.0,0.0,0.0,0.0,0.0,1.0,0.0
100984,0,0.0,0.0,0.0,0.0,2.0,180000.0,675000.0,21775.5,675000.0,0.025164,29.663013698630134,-2576.0,-1800.0,-2677.0,,4.0,2.0,2.0,17.0,0.6327391707036271,0.4271099768349541,0.4241303111942548,0.1219,0.0758,0.9955,0.9388,0.0475,0.12,0.1034,0.375,0.4167,0.0126,0.099,0.1306,0.0019,0.0117,0.083,0.0435,0.9965,0.9543,0.0192,0.1208,0.1034,0.375,0.4167,0.008,0.0725,0.0832,0.0,0.0,0.1239,0.0783,0.996,0.9463,0.0511,0.12,0.1034,0.375,0.4167,0.011,0.1018,0.1376,0.0,0.0,0.1693,1.0,3.0,2.0,3.0,2.0,-1479.0,0.0,0.0,0.0,0.0,0.0,4.0,1.0,1.0,1.0,1.0,1.0,0.0,0.0,0.0,0.0,0.0,0.0,0.0,0.0,1.0,0.0,0.0,0.0,0.0,0.0,0.0,0.0,0.0,0.0,0.0,0.0,0.0,0.0,0.0,0.0,0.0,0.0,0.0,14.0,12469.5,0.0,123750.0,0.0,0.0,0.0,0.0,0.0,-1105.0,8976.5,-323.0,-1113.0,555.0,-23.0,10.0,42432.075,92570.4,242289.45,0.0,92570.4,27.0,-1478.0,365243.0,-1076.0,-1016.0,-26.0,-1012.0,12.0,0.0,0.0,41.0,35.0,18.0,9.0,-45.0,0.0,0.0,62.0,33007.095,31648.5,-861.5,-860.0,9.0,0.0,28.0,0.0,0.0,0.0,0.0,0.0,0.0,0.0,3.375,3.375,0.0,0.0,0.0,0.0,0.0,0.0,0.0,5.0,-15.5,0.0,0.0,8338996336.5,184265300394.0,165465938997.0,51926399110.935,1862.0,1703.0,71124.0,70679.0,9140.0,505602.0,17793.640700002292,17855.718699999106,17307.53879999808,11286.791700000083,11224.62210000009,11172.146600000056,128289.0,662215.0,4135.357700000123,4132.997100000017,3943.7897000000953,13515907.268492743,-601356284.0,-921097523.0,-296226419.0,-1533825154.0416667,43967.0,30669.0,11341.373199999174,11217.27999999897,10701.8812999973,22869.181400009624,22791.047700009585,22177.105600008133,67383.61881951045,157902.13908551555,125997.10397683123,34971.40730002788,34911.82390002832,34358.382800028725,22935.03679999593,22908.484299995507,22555.873399995744,3711002.0,8289.252500000168,8393.67990000008,8117.442400000227,9810.291200000718,9925.15520000216,10284.514799999648,16455.712799999754,16640.786699999702,16237.7438999997,828.1492000001758,813.3285000000459,759.3158000000133,3910.161500000124,3893.390800000161,3726.181600000157,436081.0,430882.0,,6419.294117002895,631388.0,624947.0,,16319.5086999998,154050.1745999906,154052.9190999901,153944.70869998715,77547.36439999628,77884.86880000657,78285.90940000648,36.5,16262339.985000009,4616750.52,1515232446.3000002,517185270.5850001,19428348.779999997,39862.35,34.0,1828.0,-5143371.0,2505014.0,-2657652.5,-2864722.0,-17.75,11250.0,0.0,135000.0,0.0,0.0,0.0,0.0,0.0,-1847.0,1230.0,-1353.0,-1353.0,57913362.71999992,819878225.8499997,922855700.6999998,13873777.650000004,819878225.8499997,58783.0,-4141138.5,964051084.0,41903347.0,216209326.0,97623169.0,222495539.0,59239.0,946.0,165.8748371567436,1666837.5,522039.0,316794.0,-1015238.0,317761.0,1982.0,689237696.1149836,692366930.3249866,-42122240.5,-41791342.0,785520.0,34148.0,691447745.0699996,1680655500.0,58132977.75,91120190.535,1919803.5,31033154.430000026,38659448.52,96278799.71250014,88437408.1425,663433911.5849984,688668697.6199981,688691424.554998,3091.0,7394.0,39.0,4264.0,225113.5,-379467.5,148344.0,381.0,1466034.0,14728771.0,3229370.0,8547206.0,11597048.0,1414313.0,1057020710.6295012,801072189.0674951,72038653761.7796,21655985648.692616,581715653.7644991,5792395.7475,689.5,94245.0,-276686250.5,21915890.0,-123684502.5,-218516754.5,-2014207.0,5916800448.202461,18701055000.0,198634220.325,447421744.46249765,1948107.735,256461868.7775008,308810107.95749885,635815445.6699983,458592252.3224992,5702157416.362529,5880122832.194998,5880366014.94,13368.5,80732.0,44.0,70255.5,970692.5,-1696763.5,177364.0,6755.0,4268979.5,2476981.5,-8995617.0,921269.0,37582.5,3730117526.0999646,3654659778.682463,-260401738.0,-257093874.0,2524329.5,268957.0,3922781365.327457,33228637363.193413,36655024727.40764,1727979464.3625493,48044382139.32822,3984490.0,-247368073.0,102991982543.5,1052959509.5,17260329973.0,3500716778.5,18873430089.0,3668789.5,71852.0,20853.60379604754,89729428.0,-86.84215387457283,3.75,8.266170696424881,245.1995346032663,30.998140111593305,919.4982547622484,45000.0,0.6234898018587336,0.7818314824680298,0.0,0.0,0.0,0.0,0.0,0.0,1.0,0.0,0.0,0.0,0.0,0.0,0.0,1.0,0.0,1.0,0.0,0.0,0.0,0.0,1.0,0.0,0.0,0.0,0.0,0.0,1.0,0.0,0.0,0.0,1.0,0.0,0.0,0.0,0.0,0.0,0.0,0.0,0.0,0.0,0.0,0.0,0.0,0.0,0.0,0.0,0.0,0.0,0.0,0.0,1.0,0.0,0.0,0.0,0.0,0.0,0.0,0.0,0.0,0.0,0.0,0.0,0.0,0.0,0.0,0.0,0.0,0.0,0.0,0.0,0.0,0.0,0.0,0.0,0.0,0.0,0.0,0.0,0.0,0.0,0.0,0.0,0.0,0.0,0.0,0.0,0.0,0.0,0.0,0.0,0.0,0.0,0.0,0.0,0.0,0.0,0.0,0.0,0.0,0.0,0.0,0.0,0.0,0.0,0.0,0.0,0.0,0.0,1.0,0.0,1.0,0.0,0.0,0.0,0.0,0.0,0.0,1.0,0.0,0.0
100987,0,0.0,1.0,1.0,1.0,1.0,270000.0,500490.0,59526.0,450000.0,0.018801,32.47671232876712,-2646.0,-278.0,-4306.0,6.0,3.0,2.0,2.0,10.0,0.2141653511239113,0.6049152433304457,0.6023863442690867,,,,,,,,,,,,,,,,,,,,,,,,,,,,,,,,,,,,,,,,,,,,,0.0,0.0,0.0,0.0,-1846.0,0.0,0.0,0.0,0.0,0.0,0.0,1.0,1.0,0.0,1.0,0.0,0.0,0.0,0.0,0.0,0.0,1.0,1.0,0.0,1.0,0.0,0.0,0.0,0.0,0.0,0.0,0.0,0.0,0.0,0.0,0.0,0.0,0.0,0.0,0.0,0.0,0.0,0.0,3.0,5737.5,0.0,68845.5,0.0,57375.0,0.0,0.0,0.0,-1536.0,-1019.0,-668.0,-1033.5,135.0,-22.0,1.0,8154.09,34812.0,40999.5,0.0,34812.0,6.0,-1846.0,365243.0,-1815.0,-1665.0,-1665.0,365243.0,11.0,0.0,0.0,4000.0,66.0,6.0,0.0,-34.5,0.0,0.0,13.0,3419.64,3419.64,-2732.0,-2727.0,5.0,1.0,0.0,,,,,,,,,,,,,,,,,,,,,8339055862.5,184265800884.0,165466388997.0,51926669110.935,1862.0,1703.0,71124.0,70679.0,9140.0,505602.0,,,,,,,128290.0,662218.0,,,,13515939.745205076,-601358930.0,-921101829.0,-296228265.0,-1533825432.0416667,43967.0,30669.0,,,,,,,67383.83298486157,157902.74400075892,125997.7063631755,,,,,,,3711012.0,,,,,,,,,,,,,,,,436081.0,430882.0,1261903.0,6419.312918002896,631390.0,624949.0,,,,,,,,,51.0,16293812.985000009,4629829.77,1521224916.3000002,520594651.3950001,19485723.779999997,39862.35,34.0,1828.0,-5156433.0,2550825.0,-2664681.0,-2871519.0,-25.0,0.0,0.0,68845.5,0.0,114750.0,0.0,0.0,0.0,-1536.0,-1368.0,-668.0,-1397.0,58022846.14499992,822016027.5299996,925518914.0999998,13909340.430000003,822016027.5299996,58861.0,-4152894.0,966241654.0,42259910.0,216567119.0,97984523.0,223585652.0,59341.0,949.0,166.02161219262942,1672895.0,522782.0,317117.0,-1018661.5,328548.0,1984.0,690264622.5299841,693366319.1699867,-42213124.0,-41881521.0,785996.0,34197.0,,,,,,,,,,,,,,,,,,,,,1466037.0,14728906.0,3229370.0,8547272.0,11597061.0,1414314.0,1057026448.1295012,801072189.0674951,72038722607.2796,21655985648.692616,581773028.7644991,5792395.7475,689.5,94245.0,-276687786.5,21914871.0,-123685170.5,-218517788.0,-2014229.0,,,,,,,,,,,,,,,,,,,,,4268985.5,2476981.5,-8995651.5,921269.0,37582.5,3730120945.739965,3654663198.322464,-260404470.0,-257096601.0,2524334.5,268958.0,3922789519.417456,33228672175.193413,36655065726.90764,1727979464.3625493,48044416951.32822,3984496.0,-247369919.0,102992347786.5,1052957694.5,17260328308.0,3500715113.5,18873795332.0,3668800.5,71852.0,20853.60379604754,89733428.0,-81.47376413025141,1.8536666666666664,4.535833081342607,147.3089461540692,8.407922588448745,273.0616831875929,90000.0,-0.2225209339563146,-0.9749279121818236,0.0,1.0,0.0,0.0,0.0,0.0,0.0,0.0,0.0,0.0,0.0,0.0,0.0,1.0,0.0,0.0,0.0,0.0,1.0,0.0,1.0,0.0,0.0,0.0,0.0,1.0,0.0,0.0,0.0,0.0,0.0,0.0,0.0,0.0,0.0,0.0,0.0,0.0,1.0,0.0,0.0,0.0,0.0,0.0,0.0,0.0,0.0,0.0,0.0,0.0,0.0,0.0,0.0,1.0,0.0,0.0,0.0,0.0,0.0,0.0,0.0,0.0,0.0,0.0,0.0,0.0,0.0,0.0,0.0,0.0,0.0,0.0,0.0,0.0,0.0,0.0,0.0,0.0,0.0,0.0,0.0,0.0,0.0,0.0,0.0,0.0,0.0,0.0,0.0,0.0,0.0,0.0,0.0,0.0,0.0,0.0,0.0,0.0,0.0,0.0,0.0,0.0,0.0,0.0,0.0,0.0,0.0,0.0,0.0,0.0,0.0,0.0,0.0,0.0,0.0,0.0,0.0,0.0,0.0,0.0
100997,0,0.0,0.0,0.0,1.0,0.0,180000.0,199152.0,10296.0,135000.0,0.025164,28.145205479452056,-2513.0,-6952.0,-641.0,,1.0,2.0,2.0,13.0,0.2619692240609434,0.5396301110438404,0.4596904504249018,,,,,,,,,,,,,,,,,,,,,,,,,,,,,,,,,,,,,,,,,,,,,2.0,0.0,2.0,0.0,-1034.0,0.0,0.0,0.0,0.0,0.0,1.0,1.0,1.0,0.0,1.0,0.0,1.0,0.0,0.0,0.0,0.0,0.0,0.0,0.0,1.0,0.0,0.0,0.0,0.0,0.0,0.0,0.0,0.0,0.0,0.0,0.0,0.0,0.0,0.0,0.0,0.0,0.0,0.0,4.0,2403.2475,0.0,88195.5,0.0,0.0,0.0,0.0,0.0,-866.5,-535.0,-517.5,-535.0,128.0,-18.0,1.0,11673.09,106119.0,106119.0,0.0,106119.0,10.0,-1034.0,365243.0,-1002.0,-732.0,-732.0,-726.0,13.0,0.0,0.0,200.0,11.0,10.0,5.0,-29.0,0.0,0.0,11.0,11673.09,11673.09,-875.0,-882.0,5.0,1.0,0.0,,,,,,,,,,,,,,,,,,,,,8339066158.5,184266000036.0,165466523997.0,51926849110.935,1862.0,1703.0,71124.0,70679.0,9140.0,505603.0,,,,,,,128290.0,662219.0,,,,13515967.890410556,-601361443.0,-921102470.0,-296229299.0,-1533832384.0416667,43967.0,30669.0,,,,,,,67384.09495408562,157903.28363086993,125998.16605362592,,,,,,,3711025.0,,,,,,,,,,,,,,,,436083.0,430884.0,,6419.338082002895,631392.0,624951.0,,,,,,,,,29.0,16364462.985000009,4671330.569999998,1538597159.8200002,526173109.1550001,19614999.059999995,40492.35,34.0,1842.0,-5213441.0,2596030.0,-2695783.0,-2906540.0,-14.0,0.0,0.0,88195.5,0.0,0.0,0.0,0.0,0.0,-868.0,-535.0,-535.0,-1562.0,58426579.70999991,826736260.6799996,931365318.5999998,14007871.080000006,826736260.6799996,59439.0,-4193455.0,975370155.0,42594135.0,217274305.0,99062921.0,224293660.0,59865.0,957.0,168.06022682596353,1683633.0,527140.0,319832.0,-1028937.0,336360.0,2048.0,694801553.3099847,697525279.0649862,-42703484.0,-42368524.0,796758.0,34485.0,,,,,,,,,,,,,,,,,,,,,1466041.0,14729034.0,3229370.0,8547283.0,11597072.0,1414315.0,1057028851.3770008,801072189.0674951,72038810802.7796,21655985648.692616,581773028.7644991,5792395.7475,689.5,94245.0,-276688653.0,21914336.0,-123685688.0,-218518323.0,-2014247.0,,,,,,,,,,,,,,,,,,,,,4268995.5,2476986.5,-8995680.5,921269.0,37582.5,3730132618.8299646,3654674871.412463,-260405345.0,-257097483.0,2524339.5,268959.0,3922801192.507456,33228778294.193413,36655171845.90764,1727979464.3625493,48044523070.32822,3984506.0,-247370953.0,102992713029.5,1052956692.5,17260327576.0,3500714381.5,18873794606.0,3668813.5,71852.0,20853.60379604754,89733628.0,-89.2869658327655,1.1064,17.482517482517483,492.04904684356745,19.342657342657343,544.403065427723,180000.0,-0.9009688679024191,-0.433883739117558,0.0,0.0,0.0,0.0,0.0,0.0,1.0,0.0,0.0,0.0,1.0,0.0,0.0,0.0,0.0,1.0,0.0,0.0,0.0,0.0,0.0,0.0,1.0,0.0,0.0,1.0,0.0,0.0,0.0,0.0,0.0,0.0,0.0,0.0,0.0,0.0,0.0,0.0,0.0,0.0,0.0,0.0,0.0,0.0,0.0,1.0,0.0,0.0,0.0,0.0,0.0,0.0,0.0,0.0,0.0,0.0,0.0,0.0,0.0,1.0,0.0,0.0,0.0,0.0,0.0,0.0,0.0,0.0,0.0,0.0,0.0,0.0,0.0,0.0,0.0,0.0,0.0,0.0,0.0,0.0,0.0,0.0,0.0,0.0,0.0,0.0,0.0,0.0,0.0,0.0,0.0,0.0,0.0,0.0,0.0,0.0,0.0,0.0,0.0,0.0,0.0,0.0,0.0,0.0,0.0,0.0,0.0,0.0,0.0,0.0,0.0,0.0,0.0,0.0,0.0,0.0,0.0,0.0,0.0,0.0
100998,0,0.0,1.0,1.0,0.0,1.0,112500.0,601470.0,30838.5,450000.0,0.018801,30.531506849315072,-2774.0,-5571.0,-3799.0,35.0,3.0,2.0,2.0,9.0,,0.3288092862889698,0.6347055309763198,,,,,,,,,,,,,,,,,,,,,,,,,,,,,,,,,,,,,,,,,,,,,0.0,0.0,0.0,0.0,0.0,0.0,0.0,0.0,0.0,1.0,0.0,1.0,1.0,0.0,1.0,0.0,0.0,0.0,0.0,0.0,1.0,1.0,1.0,0.0,1.0,0.0,0.0,0.0,0.0,0.0,0.0,0.0,0.0,0.0,0.0,0.0,0.0,0.0,0.0,0.0,0.0,0.0,0.0,1.0,5404.5,,184500.0,178038.0,0.0,0.0,0.0,0.0,-409.0,1417.0,-283.0,,14.0,-6.5,1.0,4437.675,20191.5,21582.0,2020.5,20191.5,6.0,-888.0,365243.0,-857.0,-707.0,-707.0,-699.0,9.0,0.0,0.093231995840194,30.0,8.0,6.0,2.5,-26.5,0.0,0.0,6.0,4437.675,4437.675,-796.0,-782.0,3.5,1.0,0.0,,,,,,,,,,,,,,,,,,,,,8339096997.0,184266601506.0,165466973997.0,51926961610.935,1862.0,1703.0,71124.0,70680.0,9140.0,505603.0,,,,,,,128291.0,662222.0,,,,13515998.421917403,-601364217.0,-921106269.0,-296229299.0,-1533837955.0416667,43967.0,30669.0,,,,,,,,157903.61244015626,125998.80075915687,,,,,,,3711034.0,,,,,,,,,,,,,,,,436083.0,430884.0,1261938.0,6419.356883002895,631394.0,624953.0,,,,,,,,,14.0,16374673.980000008,,1539003597.5700002,526504885.1550001,19614999.059999995,40492.35,34.0,1842.0,-5214524.0,2597608.0,-2696335.0,,-6.5,5404.5,,184500.0,178038.0,0.0,0.0,0.0,0.0,-409.0,1417.0,-283.0,,58431017.38499991,826756452.1799996,931386900.5999998,14009891.580000006,826756452.1799996,59445.0,-4194343.0,975735398.0,42593278.0,217273598.0,99062214.0,224292961.0,59874.0,957.0,168.15345882180372,1683663.0,527217.0,319870.5,-1029203.5,336360.0,2048.0,694875416.5124847,697598151.8174863,-42710621.5,-42375528.5,796800.0,34493.5,,,,,,,,,,,,,,,,,,,,,1466042.0,14729048.0,3229370.0,8547291.0,11597078.0,1414316.0,1057034255.8770008,,72038995302.7796,21656163686.692616,581773028.7644991,5792395.7475,689.5,94245.0,-276689062.0,21915753.0,-123685971.0,,-2014253.5,,,,,,,,,,,,,,,,,,,,,4269001.5,2476989.0,-8995707.0,921269.0,37582.5,3730137056.504965,3654679309.087464,-260406141.0,-257098265.0,2524343.0,268960.0,3922805630.182456,33228798485.693413,36655193427.90764,1727981484.8625493,48044543261.82822,3984512.0,-247371841.0,102993078272.5,1052955835.5,17260326869.0,3500713674.5,18873793907.0,3668822.5,71852.0,20853.69702804338,89733658.0,-90.85696338837042,5.3464,3.648037355902524,111.38007751829517,19.50386691959725,595.4824464438133,37500.0,-0.2225209339563146,-0.9749279121818236,0.0,0.0,0.0,0.0,0.0,1.0,0.0,0.0,0.0,0.0,0.0,0.0,0.0,1.0,0.0,0.0,0.0,0.0,1.0,0.0,1.0,0.0,0.0,0.0,0.0,1.0,0.0,0.0,0.0,0.0,0.0,0.0,0.0,0.0,0.0,0.0,0.0,0.0,1.0,0.0,0.0,0.0,0.0,0.0,0.0,0.0,0.0,0.0,0.0,0.0,0.0,1.0,0.0,0.0,0.0,0.0,0.0,0.0,0.0,0.0,0.0,0.0,0.0,0.0,0.0,0.0,0.0,0.0,0.0,0.0,0.0,0.0,0.0,0.0,0.0,0.0,0.0,0.0,0.0,0.0,0.0,0.0,0.0,0.0,0.0,0.0,0.0,0.0,0.0,0.0,0.0,0.0,0.0,0.0,0.0,0.0,0.0,0.0,0.0,0.0,0.0,0.0,0.0,0.0,0.0,0.0,0.0,0.0,0.0,0.0,0.0,0.0,0.0,0.0,0.0,0.0,0.0,0.0,0.0,0.0
101002,0,0.0,1.0,0.0,1.0,0.0,90000.0,257391.0,27157.5,238500.0,0.0105,53.63561643835617,-711.0,-11775.0,-3123.0,,2.0,3.0,3.0,12.0,0.6598528969544735,0.627591768327591,0.2881295999178507,,,,,,,,,,,,,,,,,,,,,,,,,,,,,,,,,,,,,,,,,,,,,0.0,0.0,0.0,0.0,-1791.0,0.0,0.0,0.0,0.0,1.0,3.0,1.0,1.0,0.0,1.0,1.0,0.0,0.0,0.0,0.0,0.0,0.0,0.0,0.0,1.0,0.0,0.0,0.0,0.0,0.0,0.0,0.0,0.0,0.0,0.0,0.0,0.0,0.0,0.0,0.0,0.0,0.0,0.0,9.0,4009.5,0.0,90000.0,0.0,0.0,0.0,0.0,0.0,-905.0,-701.0,-118.0,-1146.5,407.0,-24.0,3.0,5388.435,35415.0,33975.0,4020.75,35415.0,10.0,-1791.0,365243.0,-1734.0,-1464.0,-1464.0,-1423.0,15.0,0.0,0.1270986466462755,10.0,31.0,10.0,6.0,-53.0,0.0,0.0,28.0,5388.435,5388.435,-1596.0,-1569.0,5.0,1.0,0.0,,,,,,,,,,,,,,,,,,,,,8339124154.5,184266858897.0,165467212497.0,51927051610.935,1862.0,1703.0,71124.0,70681.0,9140.0,505606.0,,,,,,,128291.0,662224.0,,,,13516052.057533842,-601364928.0,-921109392.0,-296231090.0,-1533849730.0416667,43967.0,30669.0,,,,,,,67384.75480698257,157904.24003192456,125999.08888875686,,,,,,,3711046.0,,,,,,,,,,,,,,,,436083.0,430884.0,,6419.3673830028965,631397.0,624956.0,,,,,,,,,30.0,16460513.730000008,4686293.069999998,1547498862.9900002,527891231.6550001,19614999.059999995,40492.35,34.0,1842.0,-5243446.0,2615017.0,-2711391.0,-2924220.5,-14.5,4482.0,0.0,88848.0,0.0,0.0,0.0,0.0,0.0,-1744.0,-1556.0,-1556.0,-1556.0,58639646.6549999,829391319.1799996,934121771.0999998,14068922.580000006,829391319.1799996,59575.0,-4205609.0,979022585.0,42583920.0,217631454.0,99055946.0,224650901.0,60047.0,958.0,168.90219006695622,1688691.0,528283.0,320546.0,-1031525.0,336408.0,2049.0,697690013.5124832,701148967.9874853,-42776718.0,-42440942.0,797233.0,34617.5,,,,,,,,,,,,,,,,,,,,,1466051.0,14729455.0,3229370.0,8547322.0,11597106.0,1414319.0,1057038265.3770008,801072189.0674951,72039085302.7796,21656163686.692616,581773028.7644991,5792395.7475,689.5,94245.0,-276689967.0,21915052.0,-123686089.0,-218519469.5,-2014277.5,,,,,,,,,,,,,,,,,,,,,4269011.5,2476995.0,-8995760.0,921269.0,37582.5,3730142444.939965,3654684697.5224633,-260407737.0,-257099834.0,2524348.0,268961.0,3922811018.617456,33228833900.693413,36655227402.90764,1727985505.6125493,48044578676.82822,3984522.0,-247373632.0,102993443515.5,1052954101.5,17260325405.0,3500712210.5,18873792484.0,3668837.5,71852.0,20853.824126690037,89733668.0,-13.256116871839405,2.8599,3.3140016570008286,177.74852175097325,9.477713338856669,508.3429973556082,45000.0,-0.2225209339563143,0.9749279121818236,0.0,0.0,0.0,0.0,0.0,0.0,1.0,0.0,1.0,0.0,0.0,0.0,0.0,0.0,0.0,0.0,0.0,0.0,1.0,0.0,1.0,0.0,0.0,0.0,0.0,1.0,0.0,0.0,0.0,0.0,0.0,0.0,0.0,0.0,0.0,0.0,0.0,0.0,0.0,0.0,1.0,0.0,0.0,0.0,0.0,0.0,0.0,0.0,0.0,0.0,0.0,0.0,0.0,0.0,0.0,0.0,0.0,0.0,0.0,0.0,0.0,1.0,0.0,0.0,0.0,0.0,0.0,0.0,0.0,0.0,0.0,0.0,0.0,0.0,0.0,0.0,0.0,0.0,0.0,0.0,0.0,0.0,0.0,0.0,0.0,0.0,0.0,0.0,0.0,0.0,0.0,0.0,0.0,0.0,0.0,0.0,0.0,0.0,0.0,0.0,0.0,0.0,0.0,0.0,0.0,0.0,0.0,0.0,0.0,0.0,0.0,0.0,0.0,0.0,0.0,0.0,0.0,0.0,0.0,0.0
101005,1,0.0,1.0,0.0,1.0,1.0,157500.0,900000.0,55062.0,900000.0,0.018209,29.64383561643836,-1328.0,-7464.0,-3492.0,,3.0,3.0,3.0,15.0,0.42200845213092,0.0688151541140421,,,,,,,,,,,,,,,,,,,,,,,,,,,,,,,,,,,,,,,,,,,,,,0.0,0.0,0.0,0.0,-697.0,0.0,0.0,0.0,0.0,1.0,2.0,1.0,1.0,0.0,1.0,0.0,1.0,0.0,0.0,0.0,0.0,0.0,0.0,0.0,1.0,0.0,0.0,0.0,0.0,0.0,0.0,0.0,0.0,0.0,0.0,0.0,0.0,0.0,0.0,0.0,0.0,0.0,0.0,0.0,,,,,,,,,,,,,0.0,,2.0,9176.805,89989.2,99492.75,0.45,89989.2,12.0,-522.5,365243.0,-492.0,-207.0,-162.0,-203.5,12.0,0.5,3.691933710374888e-06,2209.0,22.0,12.0,7.0,-12.5,0.0,0.0,21.0,12040.245,12040.245,-380.0,-366.0,6.0,1.0,0.0,,,,,,,,,,,,,,,,,,,,,8339179216.5,184267758897.0,165468112497.0,51927209110.935,1862.0,1703.0,71124.0,70682.0,9140.0,505608.0,,,,,,,128292.0,662227.0,,,,13516081.70136946,-601366256.0,-921112884.0,-296231787.0,-1533857194.0416667,43967.0,30669.0,,,,,,,67385.17681543472,157904.30884707868,,,,,,,,3711061.0,,,,,,,,,,,,,,,,436083.0,430884.0,,6419.385592002896,631400.0,624959.0,,,,,,,,,,,,,,,,,,,,,,,,,,,,,,,,,,,58766569.96499991,830361283.3799996,935607439.3499998,14082918.030000005,830361283.3799996,59649.0,-4217463.0,982126041.5,42940204.0,218355441.0,99780353.0,225374969.0,60230.5,961.5,169.40482430390932,1695116.5,528850.5,320849.0,-1033963.0,336430.0,2049.0,699682976.6399822,703138110.9299845,-42878629.0,-42542019.0,800059.0,34673.0,,,,,,,,,,,,,,,,,,,,,1466051.0,14729455.0,3229370.0,8547344.0,11597127.0,1414321.0,,,,,,,,,,,,,,,,,,,,,,,,,,,,,,,,,,4269023.5,2477002.0,-8995772.5,921269.0,37582.5,3730154485.1849647,3654696737.767463,-260408117.0,-257100200.0,2524354.0,268962.0,3922820195.422456,33228923889.893414,36655326895.65764,1727985506.0625494,48044668666.02821,3984534.0,-247374154.5,102993808758.5,1052953609.5,17260325198.0,3500712048.5,18873792280.5,3668849.5,71852.5,20853.824130381963,89735877.0,-44.79852125693161,5.7142857142857135,2.860411899313502,84.79358013855365,16.345210853220006,484.534743648878,52500.0,-0.9009688679024191,0.4338837391175582,0.0,1.0,0.0,0.0,0.0,0.0,0.0,0.0,1.0,0.0,0.0,0.0,0.0,0.0,0.0,0.0,0.0,0.0,1.0,0.0,1.0,0.0,0.0,0.0,0.0,1.0,0.0,0.0,0.0,0.0,0.0,0.0,0.0,0.0,0.0,0.0,0.0,0.0,1.0,0.0,0.0,0.0,0.0,0.0,0.0,0.0,0.0,0.0,0.0,0.0,0.0,0.0,0.0,1.0,0.0,0.0,0.0,0.0,0.0,0.0,0.0,0.0,0.0,0.0,0.0,0.0,0.0,0.0,0.0,0.0,0.0,0.0,0.0,0.0,0.0,0.0,0.0,0.0,0.0,0.0,0.0,0.0,0.0,0.0,0.0,0.0,0.0,0.0,0.0,0.0,0.0,0.0,0.0,0.0,0.0,0.0,0.0,0.0,0.0,0.0,0.0,0.0,0.0,0.0,0.0,0.0,0.0,0.0,0.0,0.0,0.0,0.0,0.0,0.0,0.0,0.0,0.0,0.0,0.0,0.0
101008,1,0.0,1.0,0.0,1.0,0.0,135000.0,497520.0,39307.5,450000.0,0.0196889999999999,35.942465753424656,-124.0,-889.0,-3032.0,,1.0,2.0,2.0,15.0,,0.5008055164897282,,,,,,,,,,,,,,,,,,,,,,,,,,,,,,,,,,,,,,,,,,,,,,0.0,0.0,0.0,0.0,-630.0,,,,,,,1.0,1.0,1.0,1.0,1.0,1.0,0.0,0.0,0.0,0.0,1.0,1.0,0.0,1.0,0.0,0.0,0.0,0.0,0.0,0.0,0.0,0.0,0.0,0.0,0.0,0.0,0.0,0.0,0.0,0.0,0.0,0.0,0.0,,,,,,,,,,,,,0.0,,5.0,15899.04,96165.0,96165.0,0.0,160582.5,24.0,-630.0,365243.0,-451.0,182274.0,-151.0,182277.5,17.0,0.0,0.0,0.0,9.0,12.0,9.0,-6.0,0.0,0.0,8.0,8944.29,8944.29,-180.0,-132.0,2.5,1.0,0.0,,,,,,,,,,,,,,,,,,,,,8339218524.0,184268256417.0,165468562497.0,51927344110.935,,,,,,,,,,,,,128292.0,662228.0,,,,13516117.643835211,-601366380.0,-921115916.0,-296232417.0,-1533858083.0416667,43967.0,30669.0,,,,,,,,157904.80965259517,,,,,,,,3711076.0,,,,,,,,,,,,,,,,436083.0,430884.0,,6419.405281002895,631402.0,624961.0,,,,,,,,,,,,,,,,,,,,,,,,,,,,,,,,,,,58980280.25249991,833455801.0799996,939170321.0999998,14082918.480000004,833287051.0799996,59861.0,-4230404.0,984317499.5,42936303.5,218718070.5,99780022.5,225737624.0,60363.0,965.0,169.40482799584302,1697128.0,530162.0,321804.0,-1034845.0,336430.0,2049.0,703620369.2699819,707064670.8899843,-43130387.5,-42792539.5,808016.5,34727.5,,,,,,,,,,,,,,,,,,,,,1466051.0,14729455.0,3229370.0,8547353.0,11597135.0,1414326.0,,,,,,,,,,,,,,,,,,,,,,,,,,,,,,,,,,4269035.5,2477011.0,-8995778.5,921269.0,37582.5,3730163429.4749646,3654705682.057463,-260408297.0,-257100332.0,2524356.5,268963.0,3922836094.462456,33229020054.893414,36655423060.65764,1727985506.0625494,48044829248.52821,3984558.0,-247374784.5,102994174001.5,1052953158.5,17260507472.0,3500711897.5,18873974558.0,3668866.5,71852.5,20853.824130381963,89735877.0,-3.449958076072872,3.685333333333333,3.4344590726960504,123.4429276019164,12.657126502575846,454.92833585559583,135000.0,0.6234898018587336,0.7818314824680298,0.0,1.0,0.0,0.0,0.0,0.0,0.0,0.0,1.0,0.0,0.0,0.0,0.0,0.0,0.0,0.0,0.0,0.0,1.0,0.0,0.0,0.0,1.0,0.0,0.0,1.0,0.0,0.0,0.0,0.0,0.0,0.0,0.0,0.0,0.0,0.0,0.0,0.0,0.0,0.0,0.0,0.0,0.0,0.0,0.0,0.0,0.0,0.0,0.0,0.0,0.0,0.0,0.0,1.0,0.0,0.0,0.0,0.0,0.0,0.0,0.0,0.0,0.0,0.0,0.0,0.0,0.0,0.0,0.0,0.0,0.0,0.0,0.0,0.0,0.0,0.0,0.0,0.0,0.0,0.0,0.0,0.0,0.0,0.0,0.0,0.0,0.0,0.0,0.0,0.0,0.0,0.0,0.0,0.0,0.0,0.0,0.0,0.0,0.0,0.0,0.0,0.0,0.0,0.0,0.0,0.0,0.0,0.0,0.0,0.0,0.0,0.0,0.0,0.0,0.0,0.0,0.0,0.0,0.0,0.0
101020,0,0.0,0.0,0.0,1.0,0.0,90000.0,332946.0,16146.0,238500.0,0.035792,45.613698630136994,-1456.0,-2775.0,-192.0,,2.0,2.0,2.0,9.0,,0.5755134830462117,,,,,,,,,,,,,,,,,,,,,,,,,,,,,,,,,,,,,,,,,,,,,,3.0,0.0,3.0,0.0,-1875.0,0.0,0.0,0.0,0.0,0.0,0.0,1.0,1.0,0.0,1.0,0.0,0.0,0.0,0.0,0.0,0.0,1.0,1.0,0.0,1.0,0.0,0.0,0.0,0.0,0.0,0.0,0.0,0.0,0.0,0.0,0.0,0.0,0.0,0.0,0.0,0.0,0.0,0.0,1.0,0.0,,18589.5,0.0,,0.0,0.0,0.0,-1285.0,-1092.0,-1087.0,-1092.0,43.0,-21.0,9.0,5345.595,42750.0,42750.0,0.0,45337.5,10.0,-1209.0,365243.0,-1290.5,-1110.5,-1080.5,-1103.5,12.0,0.0,0.0,76.0,73.0,10.0,6.0,-36.0,0.0,0.0,89.0,4481.865,4481.865,-583.0,-530.0,6.0,1.0,7.0,28.35,270000.0,0.0,1118.7,0.0,1118.7,293.85,1350.0,1350.0,0.0,0.0,0.0,0.0,1.0,0.0,1.0,3.0,-4.0,0.0,0.0,8339234670.0,184268589363.0,165468800997.0,51927434110.935,1862.0,1703.0,71124.0,70682.0,9140.0,505608.0,,,,,,,128292.0,662230.0,,,,13516163.257533845,-601367836.0,-921116108.0,-296234292.0,-1533860858.0416667,43967.0,30669.0,,,,,,,,157905.38516607822,,,,,,,,3711085.0,,,,,,,,,,,,,,,,436086.0,430887.0,,6419.441073002896,631404.0,624963.0,,,,,,,,,43.0,16818623.685000006,,1581260713.7850006,541414078.11,,44155.35,34.0,1855.0,-5350852.0,2659805.0,-2758243.0,-2977820.0,-21.0,0.0,,18589.5,0.0,,0.0,0.0,0.0,-1285.0,-1092.0,-1087.0,-1092.0,59686274.06999992,844861644.6749996,952093798.6949998,14296429.980000004,844906734.6749996,60572.0,-4273815.0,994907651.5,43267292.0,221247930.0,101218024.5,228633912.5,60968.0,976.0,171.4098606368009,1705293.0,534716.0,324552.0,-1046120.0,336439.0,2049.0,712542033.3599836,716029709.9399862,-43604737.0,-43262328.0,816755.0,35014.0,723992234.6700001,1750000500.0,60879327.75,95310220.815,3089606.4,31307031.810000025,40533338.25000001,101427714.7650002,93381571.52999993,694601567.0549986,721059826.8599982,721084443.7949983,3192.0,7525.0,49.0,4284.0,235513.0,-394684.0,148351.0,388.0,1466052.0,14729498.0,3229377.0,8547426.0,11597224.0,1414335.0,1057038265.3770008,,72039103892.2796,21656163686.692616,,5792395.7475,689.5,94245.0,-276691252.0,21913960.0,-123687176.0,-218520561.5,-2014298.5,5916800476.552462,18701325000.0,198634220.325,447422863.1624976,1948107.735,256462987.4775008,308810401.8074988,635816795.6699983,458593602.3224992,5702157416.362529,5880122832.194998,5880366014.94,13368.5,80733.0,44.0,70256.5,970695.5,-1696767.5,177364.0,6755.0,4269045.5,2477017.0,-8995814.5,921269.0,37582.5,3730167911.339965,3654710163.922464,-260408880.0,-257100862.0,2524362.5,268964.0,3922841440.057456,33229062804.893414,36655465810.65764,1727985506.0625494,48044874586.02821,3984568.0,-247375993.5,102994539244.5,1052951868.0,17260506361.5,3500710817.0,18873973454.5,3668878.5,71852.5,20853.824130381963,89735953.0,-31.92023544957655,3.6994,5.574136008918618,254.2569600342084,20.62095875139353,940.5981979505508,45000.0,-0.9009688679024191,-0.433883739117558,0.0,0.0,0.0,0.0,0.0,0.0,1.0,0.0,0.0,0.0,0.0,0.0,0.0,1.0,0.0,0.0,0.0,0.0,1.0,0.0,1.0,0.0,0.0,0.0,0.0,1.0,0.0,0.0,0.0,0.0,0.0,0.0,0.0,0.0,0.0,0.0,0.0,0.0,0.0,0.0,0.0,0.0,0.0,0.0,0.0,0.0,0.0,0.0,0.0,0.0,0.0,0.0,0.0,1.0,0.0,0.0,0.0,0.0,0.0,0.0,0.0,0.0,0.0,0.0,0.0,0.0,0.0,0.0,0.0,0.0,0.0,0.0,0.0,0.0,0.0,0.0,0.0,0.0,0.0,0.0,0.0,0.0,0.0,0.0,0.0,0.0,0.0,0.0,0.0,0.0,0.0,0.0,0.0,0.0,0.0,0.0,0.0,0.0,0.0,0.0,0.0,0.0,0.0,0.0,0.0,0.0,0.0,0.0,0.0,0.0,0.0,0.0,0.0,0.0,0.0,0.0,0.0,0.0,0.0,0.0
101021,0,0.0,0.0,0.0,1.0,0.0,180000.0,225000.0,23755.5,225000.0,0.018209,47.94520547945206,-4677.0,-6555.0,-1042.0,,2.0,3.0,3.0,11.0,0.5855267879591566,0.2869660785238133,0.7662336700704004,,,,,,,,,,,,,,,,,,,,,,,,,,,,,,,,,,,,,,,,,,,,,9.0,1.0,9.0,0.0,-247.0,0.0,0.0,0.0,0.0,0.0,4.0,1.0,1.0,0.0,1.0,0.0,0.0,0.0,0.0,0.0,0.0,0.0,0.0,0.0,1.0,0.0,0.0,0.0,0.0,0.0,0.0,0.0,0.0,0.0,0.0,0.0,0.0,0.0,0.0,0.0,0.0,0.0,0.0,3.0,0.0,,50580.0,0.0,0.0,0.0,0.0,0.0,-2110.0,-1929.0,-1038.0,-1909.0,163.0,-29.0,11.0,8516.07,67500.0,71955.0,0.0,157500.0,30.0,-770.0,365243.0,-911.5,-761.5,30.0,-757.0,10.0,1.0,0.0,-1.0,72.0,30.0,13.5,-26.5,0.0,0.0,82.0,10706.94,8929.08,-741.5,-725.0,7.0,1.0,0.0,,,,,,,,,,,,,,,,,,,,,8339258425.5,184268814363.0,165469025997.0,51927614110.935,1862.0,1703.0,71124.0,70682.0,9140.0,505612.0,,,,,,,128292.0,662232.0,,,,13516211.202739324,-601372513.0,-921117150.0,-296234539.0,-1533867413.0416667,43968.0,30669.0,,,,,,,67385.76234222266,157905.67213215676,125999.85512242687,,,,,,,3711096.0,,,,,,,,,,,,,,,,436095.0,430896.0,,6419.459282002896,631407.0,624966.0,,,,,,,,,70.0,16818623.685000006,,1581572293.7850006,541414078.11,20475788.445,44155.35,34.0,1855.0,-5353652.0,2657744.0,-2759405.0,-2979856.0,-34.5,0.0,,50580.0,0.0,0.0,0.0,0.0,0.0,-2110.0,-1929.0,-1038.0,-1909.0,59739825.08249992,845616758.1749996,952908847.6949998,14300929.980000004,845650508.1749996,60737.0,-4284829.0,997464352.5,43259434.0,221972367.0,101215729.0,229358375.0,61079.0,977.5,171.6285535904336,1705680.0,536247.0,325618.0,-1048377.5,336447.0,2057.0,713536310.182484,716958530.4374869,-43691811.5,-43347680.0,817583.5,35110.5,,,,,,,,,,,,,,,,,,,,,1466055.0,14729661.0,3229377.0,8547498.0,11597306.0,1414346.0,1057038265.3770008,,72039154472.2796,21656163686.692616,581773028.7644991,5792395.7475,689.5,94245.0,-276693362.0,21912031.0,-123688214.0,-218522470.5,-2014327.5,,,,,,,,,,,,,,,,,,,,,4269075.5,2477030.5,-8995841.0,921269.0,37582.5,3730178618.279965,3654719093.0024633,-260409621.5,-257101587.0,2524369.5,268965.0,3922849956.127456,33229130304.893414,36655537765.65764,1727985506.0625494,48045032086.02821,3984598.0,-247376763.5,102994904487.5,1052950956.5,17260505600.0,3500710847.0,18873972697.5,3668888.5,71853.5,20853.824130381963,89735952.0,-97.54885714285712,1.25,7.57719265012313,363.2900585675473,9.471490812653911,454.1125732094341,90000.0,1.0,0.0,0.0,0.0,0.0,0.0,0.0,0.0,1.0,0.0,0.0,0.0,0.0,0.0,0.0,1.0,0.0,0.0,0.0,0.0,1.0,0.0,1.0,0.0,0.0,0.0,0.0,1.0,0.0,0.0,0.0,0.0,0.0,0.0,0.0,0.0,0.0,0.0,0.0,0.0,0.0,0.0,0.0,0.0,0.0,0.0,0.0,0.0,0.0,0.0,0.0,0.0,0.0,0.0,0.0,0.0,0.0,0.0,0.0,0.0,0.0,0.0,0.0,0.0,0.0,0.0,0.0,0.0,0.0,0.0,0.0,0.0,0.0,0.0,0.0,0.0,0.0,0.0,0.0,0.0,0.0,0.0,0.0,1.0,0.0,0.0,0.0,0.0,0.0,0.0,0.0,0.0,0.0,0.0,0.0,0.0,0.0,0.0,0.0,0.0,0.0,0.0,0.0,0.0,0.0,0.0,0.0,0.0,0.0,0.0,0.0,0.0,0.0,0.0,0.0,0.0,0.0,0.0,0.0,0.0,0.0,0.0
101024,0,0.0,1.0,1.0,0.0,2.0,333000.0,582804.0,29884.5,463500.0,0.005002,33.493150684931514,-5644.0,-3372.0,-3379.0,13.0,4.0,3.0,3.0,11.0,0.2996024313267413,0.6504516342822646,0.4031416766587513,0.001,,0.9861,,,0.0,0.0345,0.0,,,,0.0009,,0.0028,0.0011,,0.9861,,,0.0,0.0345,0.0,,,,0.0009,,0.0029,0.001,,0.9861,,,0.0,0.0345,0.0,,,,0.0009,,0.0028,0.0013,1.0,6.0,1.0,6.0,1.0,-1685.0,0.0,0.0,0.0,0.0,0.0,0.0,1.0,1.0,0.0,1.0,0.0,1.0,0.0,0.0,0.0,0.0,0.0,0.0,0.0,0.0,0.0,0.0,0.0,0.0,1.0,0.0,0.0,0.0,0.0,0.0,0.0,0.0,0.0,0.0,0.0,0.0,0.0,0.0,11.0,8510.31,0.0,103608.0,0.0,0.0,0.0,0.0,0.0,-1160.0,-554.5,-437.0,-672.0,462.0,-25.0,3.0,5557.41,45000.0,45000.0,5958.0,45000.0,10.0,-497.0,365243.0,-467.0,-197.0,-197.0,-190.0,17.0,0.0,0.0454216708762163,150.0,21.0,10.0,5.0,-16.0,0.0,0.0,19.0,15383.115,15383.115,-480.0,-467.0,5.0,1.0,14.0,0.0,90000.0,,0.0,,,0.0,,0.0,0.0,0.0,0.0,,0.0,,,0.0,-9.5,0.0,0.0,8339288310.0,184269397167.0,165469489497.0,51927947110.935,1862.0,1703.0,71124.0,70682.0,9140.0,505612.0,17793.641700002292,17855.71969999911,17307.539899998083,,,,128294.0,662236.0,,,,13516244.695890008,-601378157.0,-921120529.0,-296236224.0,-1533870785.0416667,43969.0,30670.0,11341.373199999174,11217.27999999897,10701.8812999973,22869.215900009625,22791.08220000959,22177.14010000814,67386.06194465401,157906.32258379104,126000.25826410356,34971.40730002788,34911.82390002832,34358.382800028725,,,,3711107.0,,,,,,,16455.71369999975,16640.7875999997,16237.7447999997,,,,3910.164300000125,3893.393600000161,3726.1845000001567,436101.0,430902.0,1261951.0,6419.464284002896,631410.0,624969.0,,16319.5099999998,154051.1606999906,154053.90519999008,153945.69479998722,,,,39.0,16827133.995000005,4727418.93,1584339052.9500003,542593146.285,20493141.614999995,44155.35,34.0,1855.0,-5366273.0,2650459.5,-2764758.0,-2987351.0,-19.0,8510.31,9751.5,121399.92,0.0,0.0,0.0,0.0,0.0,-2370.0,-2168.0,-636.0,-1421.0,59910004.34999992,847779863.1749996,955503187.6949998,14306887.980000004,847779863.1749996,60981.0,-4309518.0,1001296757.0,43607218.0,223422380.0,101936855.0,230808435.0,61287.0,986.0,171.6739752613098,1705987.0,539141.0,327383.0,-1053695.0,336450.0,2060.0,717674021.1899843,720829295.6849867,-44178040.0,-43831008.0,833138.0,35265.0,747895918.3649992,1779723000.0,,95956402.18500002,,,41864861.74500001,,94882994.27999993,717440970.5549977,744967895.9399973,744992512.8749975,,7578.0,,,243810.0,-403332.0,148365.0,394.0,1466066.0,14730123.0,3229391.0,8547519.0,11597325.0,1414349.0,1057046775.687001,801072189.0674951,72039258080.2796,21656163686.692616,581773028.7644991,5792395.7475,689.5,94245.0,-276694522.0,21911476.5,-123688651.0,-218523142.5,-2014352.5,5916800476.552462,18701415000.0,,447422863.1624976,,,308810401.8074988,,458593602.3224992,5702157416.362529,5880122832.194998,5880366014.94,,80733.0,,,970695.5,-1696777.0,177364.0,6755.0,4269085.5,2477035.5,-8995857.0,921269.0,37582.5,3730194001.3949647,3654734476.117463,-260410101.5,-257102054.0,2524374.5,268966.0,3922855513.537456,33229175304.893414,36655582765.65764,1727991464.0625494,48045077086.02821,3984608.0,-247377260.5,102995269730.5,1052950489.5,17260505403.0,3500710650.0,18873972507.5,3668905.5,71853.5,20853.86955205284,89736102.0,-168.51206543967282,1.750162162162162,11.142900165637704,373.2108343148518,19.5018822466496,653.1794807268257,83250.0,1.0,0.0,0.0,0.0,0.0,0.0,0.0,0.0,0.0,0.0,0.0,0.0,1.0,0.0,0.0,0.0,0.0,0.0,0.0,0.0,1.0,0.0,1.0,0.0,0.0,0.0,0.0,1.0,0.0,0.0,0.0,0.0,0.0,0.0,0.0,0.0,0.0,0.0,0.0,0.0,0.0,0.0,0.0,0.0,0.0,0.0,0.0,0.0,0.0,0.0,0.0,0.0,0.0,0.0,0.0,0.0,0.0,0.0,0.0,0.0,0.0,0.0,0.0,0.0,0.0,0.0,0.0,0.0,0.0,0.0,0.0,0.0,0.0,0.0,0.0,0.0,0.0,0.0,0.0,0.0,0.0,0.0,0.0,0.0,0.0,0.0,0.0,0.0,0.0,0.0,0.0,1.0,0.0,0.0,0.0,0.0,0.0,0.0,0.0,0.0,0.0,0.0,0.0,0.0,0.0,0.0,0.0,0.0,0.0,0.0,1.0,0.0,1.0,0.0,0.0,0.0,0.0,0.0,0.0,0.0,0.0,1.0
101025,0,0.0,1.0,1.0,1.0,1.0,81000.0,375408.0,29790.0,297000.0,0.010556,30.054794520547944,-3546.0,-778.0,-3612.0,5.0,3.0,3.0,3.0,17.0,,0.5530220101923051,0.3001077565791181,,,,,,,,,,,,,,,,,,,,,,,,,,,,,,,,,,,,,,,,,,,,,0.0,0.0,0.0,0.0,0.0,0.0,0.0,0.0,0.0,0.0,1.0,1.0,1.0,0.0,1.0,0.0,0.0,0.0,0.0,0.0,0.0,0.0,0.0,0.0,1.0,0.0,0.0,0.0,0.0,0.0,0.0,0.0,0.0,0.0,0.0,0.0,0.0,0.0,0.0,0.0,0.0,0.0,0.0,2.0,16704.0,204870.645,351000.0,101386.395,0.0,0.0,0.0,0.0,-1266.5,-534.5,-58.5,,84.0,-30.5,2.0,15900.3,45000.0,45000.0,0.0,90000.0,6.0,-446.5,365243.0,-539.0,-389.0,-389.0,-381.0,11.5,0.0,0.0,10.0,8.0,6.0,2.5,-15.5,0.0,0.0,6.0,15900.3,15900.3,-466.5,-464.0,3.5,1.0,0.0,,,,,,,,,,,,,,,,,,,,,8339318100.0,184269772575.0,165469786497.0,51928028110.935,1862.0,1703.0,71124.0,70682.0,9140.0,505613.0,,,,,,,128295.0,662239.0,,,,13516274.750684528,-601381703.0,-921124141.0,-296236224.0,-1533871563.0416667,43969.0,30670.0,,,,,,,,157906.87560580124,126000.55837186016,,,,,,,3711124.0,,,,,,,,,,,,,,,,436101.0,430902.0,1261956.0,6419.474840002896,631413.0,624972.0,,,,,,,,,42.0,16843837.995000005,4943620.169999999,1585565351.3700006,542829792.8249999,20493141.614999995,44155.35,34.0,1855.0,-5373397.5,2646680.0,-2768561.0,,-20.5,16704.0,204870.645,417600.0,0.0,0.0,0.0,0.0,0.0,-2211.0,-1478.0,-112.0,,59941296.76499992,847989018.6749996,955724128.6949998,14312845.980000004,847989018.6749996,60997.0,-4310746.5,1002027243.0,43606212.0,223421794.0,101936269.0,230807864.0,61322.5,987.0,171.71939693218604,1706157.5,539268.0,327443.0,-1053875.5,336450.0,2060.0,717868190.8124844,721023465.3074868,-44182844.5,-43835672.5,833198.0,35277.5,,,,,,,,,,,,,,,,,,,,,1466068.0,14730207.0,3229391.0,8547527.0,11597331.0,1414351.0,1057063479.687001,801277059.7124951,72039609080.2796,21656265073.087616,581773028.7644991,5792395.7475,689.5,94245.0,-276695788.5,21910942.0,-123688709.5,,-2014383.0,,,,,,,,,,,,,,,,,,,,,4269091.5,2477038.0,-8995872.5,921269.0,37582.5,3730209901.694965,3654750376.4174633,-260410568.0,-257102518.0,2524378.0,268967.0,3922871413.837456,33229220304.893414,36655627765.65764,1727991464.0625494,48045167086.02821,3984614.0,-247377707.0,102995634973.5,1052949950.5,17260505014.0,3500710261.0,18873972126.5,3668917.0,71853.5,20853.86955205284,89736112.0,-117.9845031905196,4.634666666666667,2.7190332326283992,81.71998510118776,12.601812688821752,378.7448909489715,27000.0,-0.2225209339563143,0.9749279121818236,0.0,0.0,0.0,0.0,0.0,0.0,1.0,0.0,0.0,0.0,0.0,0.0,0.0,1.0,0.0,0.0,0.0,0.0,1.0,0.0,1.0,0.0,0.0,0.0,0.0,0.0,0.0,0.0,0.0,1.0,0.0,0.0,0.0,0.0,0.0,0.0,0.0,0.0,0.0,0.0,0.0,0.0,0.0,0.0,0.0,0.0,1.0,0.0,0.0,0.0,0.0,0.0,0.0,1.0,0.0,0.0,0.0,0.0,0.0,0.0,0.0,0.0,0.0,0.0,0.0,0.0,0.0,0.0,0.0,0.0,0.0,0.0,0.0,0.0,0.0,0.0,0.0,0.0,0.0,0.0,0.0,0.0,0.0,0.0,0.0,0.0,0.0,0.0,0.0,0.0,0.0,0.0,0.0,0.0,0.0,0.0,0.0,0.0,0.0,0.0,0.0,0.0,0.0,0.0,0.0,0.0,0.0,0.0,0.0,0.0,0.0,0.0,0.0,0.0,0.0,0.0,0.0,0.0,0.0,0.0
101026,0,0.0,0.0,0.0,0.0,0.0,193500.0,450000.0,22977.0,450000.0,0.031329,59.48493150684931,-2790.0,-12190.0,-5096.0,,1.0,2.0,2.0,9.0,,0.251988312656815,0.6785676886853644,,,,,,,,,,,,,,,,,,,,,,,,,,,,,,,,,,,,,,,,,,,,,0.0,0.0,0.0,0.0,-1656.0,0.0,0.0,0.0,0.0,2.0,7.0,1.0,1.0,0.0,1.0,0.0,0.0,0.0,0.0,0.0,0.0,1.0,1.0,0.0,1.0,0.0,0.0,0.0,0.0,0.0,0.0,0.0,0.0,0.0,0.0,0.0,0.0,0.0,0.0,0.0,0.0,0.0,0.0,8.0,5602.5,0.0,270000.0,0.0,0.0,0.0,0.0,0.0,-1159.5,-140.0,-276.5,-840.5,329.0,-22.0,9.0,21436.3125,225000.0,249232.5,27405.0,360000.0,20.0,-362.0,365243.0,-1093.0,-1001.0,-55.0,-50.0,10.0,0.0,0.1078904210876557,-1.0,42.0,24.0,10.0,-21.5,0.0,0.0,82.0,15707.52,15707.52,-626.0,-625.0,14.0,0.5,38.0,0.0,0.0,0.0,0.0,0.0,0.0,0.0,1624.32,1624.32,0.0,0.0,0.0,0.0,0.0,0.0,0.0,4.0,-19.5,0.0,0.0,8339341077.0,184270222575.0,165470236497.0,51928221610.935,1862.0,1703.0,71124.0,70684.0,9140.0,505620.0,,,,,,,128295.0,662240.0,,,,13516334.235616036,-601384493.0,-921129237.0,-296237880.0,-1533883753.0416667,43969.0,30670.0,,,,,,,,157907.1275941139,126001.23693954883,,,,,,,3711133.0,,,,,,,,,,,,,,,,436101.0,430902.0,,6419.506169002895,631415.0,624974.0,,,,,,,,,38.5,16877542.995000005,4943620.169999999,1586938608.810001,543261950.3249999,20493141.614999995,44155.35,34.0,1855.0,-5380467.0,2643398.5,-2773244.0,-2995206.5,-18.75,0.0,0.0,270000.0,0.0,0.0,0.0,0.0,0.0,-1644.0,-1280.0,-1288.0,-1650.0,60049732.76999992,850859681.1749996,958940899.6949998,14340250.980000004,850859681.1749996,61076.0,-4314800.0,1002391346.0,43603494.0,223419618.0,102300337.0,231171937.0,61376.0,987.0,171.8272873532737,1706870.0,539669.0,327629.0,-1054758.5,336450.0,2060.0,718155600.7724861,721310875.2674882,-44209780.0,-43862556.5,834072.0,35280.5,747898867.3049995,1781658000.0,61531377.75,95978902.18500002,3089606.4,31323471.840000022,41871698.1,103126313.34000014,95076844.1999998,717440970.5549977,744967895.9399973,744992512.8749975,3237.0,7579.0,49.0,4293.0,243883.0,-403714.5,148365.0,394.0,1466076.0,14730536.0,3229429.0,8547569.0,11597413.0,1414360.0,1057069082.187001,801277059.7124951,72039879080.2796,21656265073.087616,581773028.7644991,5792395.7475,689.5,94245.0,-276696948.0,21910802.0,-123688986.0,-218523983.0,-2014405.0,5916800476.552462,18701415000.0,198634220.325,447422863.1624976,1948107.735,256462987.4775008,308810401.8074988,635818419.9899982,458595226.6424992,5702157416.362529,5880122832.194998,5880366014.94,13368.5,80733.0,44.0,70256.5,970699.5,-1696796.5,177364.0,6755.0,4269115.5,2477048.0,-8995894.0,921269.0,37582.5,3730225609.214965,3654766083.9374633,-260411194.0,-257103143.0,2524392.0,268967.5,3922892850.149956,33229445304.893414,36655876998.15764,1728018869.0625494,48045527086.02821,3984634.0,-247378069.0,102996000216.5,1052948857.5,17260504013.0,3500710206.0,18873972076.5,3668927.0,71853.5,20853.97744247393,89736111.0,-46.90263448784082,2.3255813953488373,8.421464943204073,500.9502653338269,19.584802193497847,1165.0006170554116,193500.0,-0.9009688679024191,-0.433883739117558,0.0,0.0,0.0,0.0,0.0,0.0,1.0,0.0,0.0,0.0,0.0,0.0,0.0,1.0,0.0,1.0,0.0,0.0,0.0,0.0,0.0,0.0,0.0,1.0,0.0,1.0,0.0,0.0,0.0,0.0,0.0,0.0,0.0,0.0,0.0,0.0,0.0,0.0,0.0,0.0,1.0,0.0,0.0,0.0,0.0,0.0,0.0,0.0,0.0,0.0,0.0,0.0,0.0,0.0,0.0,0.0,0.0,0.0,0.0,1.0,0.0,0.0,0.0,0.0,0.0,0.0,0.0,0.0,0.0,0.0,0.0,0.0,0.0,0.0,0.0,0.0,0.0,0.0,0.0,0.0,0.0,0.0,0.0,0.0,0.0,0.0,0.0,0.0,0.0,0.0,0.0,0.0,0.0,0.0,0.0,0.0,0.0,0.0,0.0,0.0,0.0,0.0,0.0,0.0,0.0,0.0,0.0,0.0,0.0,0.0,0.0,0.0,0.0,0.0,0.0,0.0,0.0,0.0,0.0,0.0
101031,0,0.0,1.0,0.0,0.0,0.0,180000.0,174132.0,18414.0,157500.0,0.010643,57.02465753424657,,-10450.0,-4313.0,,2.0,2.0,2.0,17.0,,0.5909638900333266,0.6863823354047934,0.0495,0.0531,0.9781,0.7008,0.0052,0.0,0.0345,0.125,0.1667,0.0606,0.0403,0.0298,0.0,0.0,0.0504,0.0551,0.9782,0.7125,0.0052,0.0,0.0345,0.125,0.1667,0.062,0.0441,0.0311,0.0,0.0,0.05,0.0531,0.9781,0.7048,0.0052,0.0,0.0345,0.125,0.1667,0.0617,0.041,0.0304,0.0,0.0,0.0263,1.0,0.0,0.0,0.0,0.0,-1536.0,0.0,0.0,0.0,0.0,1.0,2.0,1.0,0.0,0.0,1.0,0.0,0.0,0.0,0.0,0.0,0.0,0.0,0.0,0.0,1.0,0.0,0.0,0.0,0.0,0.0,0.0,0.0,0.0,0.0,0.0,0.0,0.0,0.0,0.0,0.0,0.0,0.0,0.0,1.0,,0.0,50448.33,0.0,0.0,0.0,0.0,0.0,-750.0,-414.0,-408.0,-414.0,25.0,-12.0,3.0,6234.615,99625.5,120667.5,0.0,99625.5,18.0,-999.0,365243.0,-967.0,-277.0,-277.0,-275.0,12.0,0.0,0.0,2586.0,52.0,18.0,12.0,-26.5,0.0,0.0,50.0,6181.4925,6181.4925,-795.0,-772.0,9.0,1.0,0.0,,,,,,,,,,,,,,,,,,,,,8339359491.0,184270396707.0,165470393997.0,51928401610.935,1862.0,1703.0,71124.0,70685.0,9140.0,505622.0,17793.691200002293,17855.769699999106,17307.590299998083,11286.844800000084,11224.675200000089,11172.201700000056,128295.0,662242.0,4135.362900000123,4133.002300000017,3943.794900000096,13516391.260273568,,-921133550.0,-296239416.0,-1533894203.0416667,43969.0,30670.0,11341.373199999174,11217.27999999897,10701.8812999973,22869.25040000963,22791.11670000959,22177.17460000814,,157907.71855800392,126001.92332188426,34971.53230002788,34911.94890002832,34358.507800028725,22935.20349999593,22908.65099999551,22556.040099995746,3711150.0,8289.313100000169,8393.74160000008,8117.504400000227,9810.33150000072,9925.19620000216,10284.558899999647,16455.74349999975,16640.8179999997,16237.7758999997,828.1492000001758,813.3285000000459,759.3158000000133,3910.164300000125,3893.393600000161,3726.1845000001567,436101.0,430902.0,,6419.516812002896,631417.0,624976.0,,16319.5362999998,154052.1387999906,154054.88329999012,153946.6729999872,77548.06519999629,77885.57360000657,78286.62190000647,25.0,,4943620.169999999,1593753925.1400006,544012685.3249999,20827714.5,44155.35,34.0,1855.0,-5392539.0,2670994.0,-2777065.0,-3000049.0,-12.0,,0.0,50448.33,0.0,0.0,0.0,0.0,0.0,-750.0,-414.0,-408.0,-414.0,60231312.22499992,852808910.1749996,960941680.6949998,14493079.980000004,852808910.1749996,61279.0,-4327051.0,1006041616.0,43593096.0,224508484.0,102661647.0,232627918.0,61570.0,991.0,172.46111915736438,1718674.0,542084.0,328957.0,-1058019.0,336450.0,2060.0,720172114.9199862,723399389.4149885,-44419011.5,-44069791.5,838487.0,35448.5,,,,,,,,,,,,,,,,,,,,,1466077.0,14730561.0,3229429.0,8547621.0,11597463.0,1414363.0,,801277059.7124951,72039929528.6096,21656265073.087616,581773028.7644991,5792395.7475,689.5,94245.0,-276697698.0,21910388.0,-123689394.0,-218524397.0,-2014417.0,,,,,,,,,,,,,,,,,,,,,4269133.5,2477060.0,-8995920.5,921269.0,37582.5,3730231790.7074647,3654772265.4299626,-260411989.0,-257103915.0,2524401.0,268968.5,3922899084.764957,33229544930.393414,36655997665.65764,1728018869.0625494,48045626711.52821,3984652.0,-247379068.0,102996365459.5,1052947890.5,17260503736.0,3500709929.0,18873971801.5,3668939.0,71853.5,20853.97744247393,89738697.0,,0.9674,9.775171065493646,557.4257823484513,9.456500488758554,539.2537018438918,90000.0,0.6234898018587336,0.7818314824680298,0.0,0.0,0.0,0.0,0.0,0.0,1.0,0.0,0.0,1.0,0.0,0.0,0.0,0.0,0.0,0.0,0.0,0.0,1.0,0.0,1.0,0.0,0.0,0.0,0.0,0.0,1.0,0.0,0.0,0.0,0.0,0.0,0.0,0.0,0.0,0.0,0.0,0.0,0.0,0.0,0.0,0.0,0.0,0.0,0.0,0.0,0.0,0.0,0.0,0.0,0.0,0.0,0.0,0.0,0.0,0.0,0.0,0.0,0.0,0.0,0.0,0.0,0.0,0.0,0.0,0.0,0.0,0.0,0.0,0.0,0.0,0.0,0.0,0.0,0.0,0.0,0.0,0.0,0.0,0.0,0.0,0.0,0.0,0.0,0.0,0.0,0.0,0.0,0.0,0.0,0.0,0.0,0.0,0.0,0.0,0.0,0.0,0.0,0.0,0.0,0.0,0.0,0.0,0.0,0.0,1.0,0.0,0.0,1.0,0.0,1.0,0.0,0.0,0.0,0.0,0.0,0.0,0.0,1.0,0.0
101041,0,0.0,0.0,0.0,1.0,0.0,202500.0,454500.0,17262.0,454500.0,0.010006,48.28767123287671,-496.0,-6030.0,-569.0,,1.0,2.0,2.0,10.0,0.6662611615594792,0.71093391551603,0.4311917977993083,0.1619,0.1254,0.9881,0.8368,0.0,0.16,0.1379,0.375,0.4167,0.0374,0.132,0.196,0.0,0.0035,0.1649,0.1301,0.9881,0.8432,0.0,0.1611,0.1379,0.375,0.4167,0.0382,0.1442,0.2042,0.0,0.0037,0.1634,0.1254,0.9881,0.8390000000000001,0.0,0.16,0.1379,0.375,0.4167,0.038,0.1342,0.1995,0.0,0.0036,0.1835,1.0,2.0,0.0,2.0,0.0,-1700.0,0.0,0.0,0.0,0.0,0.0,0.0,1.0,1.0,1.0,1.0,1.0,0.0,0.0,0.0,0.0,0.0,0.0,0.0,0.0,1.0,0.0,0.0,0.0,0.0,0.0,0.0,0.0,0.0,0.0,0.0,0.0,0.0,0.0,0.0,0.0,0.0,0.0,0.0,3.0,12800.25,,337500.0,320103.0,0.0,0.0,0.0,0.0,-354.0,1474.0,-22.0,,48.0,-7.5,1.0,29605.95,161086.5,151389.0,16110.0,161086.5,6.0,-1700.0,365243.0,-1668.0,-1518.0,-1518.0,-1509.0,17.0,0.0,0.1047484136947357,946.0,7.0,6.0,3.0,-53.0,0.0,0.0,6.0,29605.95,29605.95,-1609.5,-1593.0,3.5,1.0,0.0,,,,,,,,,,,,,,,,,,,,,8339376753.0,184270851207.0,165470848497.0,51928604110.935,1862.0,1703.0,71124.0,70685.0,9140.0,505622.0,17793.853100002292,17855.933099999107,17307.755199998082,11286.970200000083,11224.80060000009,11172.331800000056,128295.0,662243.0,4135.362900000123,4133.002300000017,3943.794900000096,13516439.5479448,-601384989.0,-921134119.0,-296241116.0,-1533900233.0416667,43969.0,30670.0,11341.533199999174,11217.43999999897,10702.0423999973,22869.38830000963,22791.25460000959,22177.312500008135,67386.72820581554,157908.4294919195,126002.35451368205,34971.90730002788,34912.32390002832,34358.882800028725,22935.62019999593,22909.067699995507,22556.456799995743,3711160.0,8289.350500000168,8393.77960000008,8117.542600000227,9810.463500000718,9925.33040000216,10284.703099999648,16455.93949999975,16641.0174999997,16237.9800999997,828.1492000001758,813.3285000000459,759.3158000000133,3910.167800000124,3893.397200000161,3726.188200000157,436103.0,430904.0,,6419.526818002895,631419.0,624978.0,,16319.7197999998,154053.1268999906,154055.8713999901,153947.66109998722,77548.90199999628,77886.41260000659,78287.46510000648,12.0,17254645.470000006,,1608912380.790001,550794342.8249999,20828132.684999995,44191.35,34.0,1872.0,-5434211.0,2692776.0,-2797265.0,,-5.5,0.0,,337500.0,320103.0,0.0,0.0,0.0,0.0,-541.0,16178.5,-22.0,,60862589.09999991,861808051.7549995,971979999.9749998,14580908.280000005,861808051.7549995,61987.0,-4369444.0,1014073608.0,43927963.0,226679544.0,104106274.0,235165699.0,62249.0,1001.0,173.6140544436557,1728759.0,549306.0,333228.0,-1069565.0,341785.0,2065.0,726922584.8099837,730402370.5499865,-44862761.5,-44508903.0,847316.5,35778.5,,,,,,,,,,,,,,,,,,,,,1466080.0,14730609.0,3229429.0,8547628.0,11597469.0,1414364.0,1057081882.437001,,72040267028.6096,21656585176.087616,581773028.7644991,5792395.7475,689.5,94245.0,-276698052.0,21911862.0,-123689416.0,,-2014424.5,,,,,,,,,,,,,,,,,,,,,4269139.5,2477063.0,-8995973.5,921269.0,37582.5,3730261396.657465,3654801871.3799615,-260413598.5,-257105508.0,2524404.5,268969.5,3922928690.714955,33229706016.893414,36656149054.65764,1728034979.0625494,48045787798.02821,3984658.0,-247380768.0,102996730702.5,1052946222.5,17260502218.0,3500708411.0,18873970292.5,3668956.0,71853.5,20854.08219088762,89739643.0,-10.271773049645391,2.2444444444444445,11.73096976016684,566.4612110217548,26.32950990615225,1271.39071807105,202500.0,-0.9009688679024191,-0.433883739117558,0.0,0.0,0.0,0.0,0.0,0.0,1.0,0.0,0.0,0.0,0.0,0.0,0.0,1.0,0.0,1.0,0.0,0.0,0.0,0.0,0.0,1.0,0.0,0.0,0.0,1.0,0.0,0.0,0.0,0.0,0.0,0.0,0.0,1.0,0.0,0.0,0.0,0.0,0.0,0.0,0.0,0.0,0.0,0.0,0.0,0.0,0.0,0.0,0.0,0.0,0.0,0.0,0.0,0.0,0.0,0.0,0.0,0.0,0.0,1.0,0.0,0.0,0.0,0.0,0.0,0.0,0.0,0.0,0.0,0.0,0.0,0.0,0.0,0.0,0.0,0.0,0.0,0.0,0.0,0.0,0.0,0.0,0.0,0.0,0.0,0.0,0.0,0.0,0.0,0.0,0.0,0.0,0.0,0.0,0.0,0.0,0.0,0.0,0.0,0.0,0.0,0.0,0.0,0.0,0.0,0.0,0.0,0.0,1.0,0.0,1.0,0.0,0.0,0.0,0.0,0.0,0.0,1.0,0.0,0.0
101051,0,0.0,0.0,0.0,0.0,0.0,180000.0,400392.0,41157.0,360000.0,0.035792,44.16164383561644,-2632.0,-10037.0,-4630.0,,2.0,2.0,2.0,12.0,0.6347068540021077,0.7830381148168827,0.5709165417729987,0.0928,,0.9801,,,,0.2069,0.1667,,,,0.0897,,0.0901,0.0945,,0.9801,,,,0.2069,0.1667,,,,0.0935,,0.0954,0.0937,,0.9801,,,,0.2069,0.1667,,,,0.0914,,0.092,0.0902,1.0,2.0,0.0,2.0,0.0,-2346.0,0.0,0.0,0.0,0.0,0.0,2.0,1.0,1.0,0.0,1.0,0.0,0.0,0.0,0.0,0.0,0.0,0.0,0.0,0.0,0.0,0.0,0.0,0.0,0.0,1.0,0.0,0.0,0.0,0.0,0.0,0.0,0.0,0.0,0.0,0.0,0.0,0.0,0.0,5.0,0.0,0.0,270000.0,44149.5,0.0,0.0,0.0,0.0,-1126.0,-761.0,-726.0,-1278.0,246.0,-28.0,3.0,22500.0,82255.5,450000.0,27000.0,671127.75,10.0,-1036.0,365243.0,-1006.0,-436.0,-316.0,-429.0,14.0,0.0,0.3387178858876972,-1.0,31.0,24.0,10.0,-29.0,0.0,0.0,70.0,13993.0425,12383.91,-492.0,-490.5,11.0,0.0,34.0,128629.575,450000.0,0.0,0.0,0.0,5827.5,7610.1975,18000.0,7875.0,123633.6075,126336.89250000002,126336.89250000002,0.0,0.0,0.0,1.0,3.5,-17.5,0.0,0.0,8339417910.0,184271251599.0,165471208497.0,51928784110.935,1862.0,1703.0,71124.0,70685.0,9140.0,505624.0,17793.94590000229,17856.02679999911,17307.84969999808,,,,128295.0,662245.0,,,,13516483.709588636,-601387621.0,-921138749.0,-296243462.0,-1533910270.0416667,43969.0,30670.0,,,,22869.59520000963,22791.46150000959,22177.519400008143,67387.36291266956,157909.21253003424,126002.9254302238,34972.07400002788,34912.49060002832,34359.049500028734,,,,3711172.0,,,,,,,16456.02919999975,16641.1088999997,16238.0735999997,,,,3910.257900000124,3893.489200000161,3726.2836000001575,436105.0,430906.0,,6419.562610002896,631421.0,624980.0,,16319.8099999998,154054.10699999062,154056.8514999901,153948.64119998718,,,,38.0,17305061.445000004,5000234.759999999,1616595443.5050006,553023109.53,20841632.684999995,44191.35,34.0,1872.0,-5465385.0,2713878.0,-2813702.0,-3037816.0,-18.5,0.0,0.0,270000.0,0.0,0.0,0.0,0.0,0.0,-2366.0,-1271.0,-891.0,-1278.0,61583942.24999992,870941763.8549995,982636453.5749998,14700135.780000005,871571763.8549995,62681.0,-4424110.0,1026490621.0,44621894.0,229572724.0,105544700.0,238424530.0,63101.0,1019.0,176.65049335459344,1734248.0,553633.0,336119.0,-1080698.0,342294.0,2081.0,734918534.6849816,738348423.3449836,-45178072.0,-44821253.0,850135.0,36083.0,765222677.5049998,1831711500.0,63987702.75,99241552.62,3089606.4,32034157.11000003,42836580.135,106731926.5949996,98571410.0099996,734131209.9149977,762173713.3949974,762198330.3299974,3318.0,7725.0,49.0,4357.0,246476.0,-410181.5,148379.0,394.0,1466085.0,14730855.0,3229463.0,8547659.0,11597539.0,1414367.0,1057081882.437001,801277059.7124951,72040537028.6096,21656629325.587616,581773028.7644991,5792395.7475,689.5,94245.0,-276699178.0,21911101.0,-123690142.0,-218525675.0,-2014452.5,5916929106.1274605,18701865000.0,198634220.325,447422863.1624976,1948107.735,256468814.9775008,308818012.0049988,635836419.9899982,458603101.6424992,5702281049.970029,5880249169.087498,5880492351.8325,13368.5,80733.0,44.0,70257.5,970703.0,-1696814.0,177364.0,6755.0,4269163.5,2477073.0,-8996002.5,921269.0,37582.5,3730275389.699965,3654814255.289962,-260414090.5,-257105998.5,2524415.5,268969.5,3922951190.714955,33229788272.393414,36656599054.65764,1728061979.0625494,48046458925.77821,3984668.0,-247381804.0,102997095945.5,1052945216.5,17260501782.0,3500708095.0,18873969863.5,3668970.0,71853.5,20854.420908773507,89739642.0,-59.59923072150878,2.2244,4.373496610540127,193.14079963094883,9.728405860485458,429.62239469908246,90000.0,0.6234898018587336,0.7818314824680298,0.0,1.0,0.0,0.0,0.0,0.0,0.0,0.0,0.0,0.0,1.0,0.0,0.0,0.0,0.0,0.0,0.0,0.0,1.0,0.0,1.0,0.0,0.0,0.0,0.0,1.0,0.0,0.0,0.0,0.0,1.0,0.0,0.0,0.0,0.0,0.0,0.0,0.0,0.0,0.0,0.0,0.0,0.0,0.0,0.0,0.0,0.0,0.0,0.0,0.0,0.0,0.0,0.0,0.0,0.0,0.0,0.0,0.0,0.0,0.0,0.0,0.0,0.0,0.0,0.0,0.0,0.0,0.0,0.0,0.0,0.0,0.0,0.0,0.0,0.0,0.0,0.0,0.0,0.0,0.0,0.0,0.0,0.0,0.0,0.0,0.0,0.0,0.0,0.0,0.0,0.0,0.0,0.0,0.0,0.0,0.0,0.0,0.0,1.0,0.0,0.0,0.0,0.0,0.0,0.0,0.0,0.0,0.0,0.0,0.0,1.0,0.0,0.0,0.0,0.0,0.0,0.0,1.0,0.0,0.0
101055,0,0.0,0.0,0.0,1.0,0.0,90000.0,157500.0,11457.0,157500.0,0.028663,39.1013698630137,-249.0,-7233.0,-4256.0,,1.0,2.0,2.0,13.0,,0.6388003264024186,0.4489622731076524,0.068,0.0612,0.9767,0.6804,0.0069,0.0,0.1379,0.1667,0.2083,0.0601,0.0538,0.051,0.0077,0.0583,0.0693,0.0635,0.9767,0.6929,0.0069,0.0,0.1379,0.1667,0.2083,0.0615,0.0588,0.0531,0.0078,0.0617,0.0687,0.0612,0.9767,0.6847,0.0069,0.0,0.1379,0.1667,0.2083,0.0612,0.0547,0.0519,0.0078,0.0596,0.0671,1.0,5.0,3.0,5.0,3.0,-293.0,0.0,0.0,0.0,0.0,1.0,0.0,1.0,1.0,0.0,1.0,0.0,0.0,0.0,0.0,0.0,0.0,0.0,0.0,0.0,1.0,0.0,0.0,0.0,0.0,0.0,0.0,0.0,0.0,0.0,0.0,0.0,0.0,0.0,0.0,0.0,0.0,0.0,0.0,3.0,0.0,,135000.0,0.0,0.0,0.0,0.0,0.0,-989.0,-88.0,-114.0,-180.0,84.0,-14.5,2.0,7997.4000000000015,90877.5,93192.75,0.0,90877.5,17.0,-151.0,365243.0,-263.0,-23.0,7.0,-12.0,15.5,1.0,0.0,29.0,9.0,10.0,6.0,-6.0,0.0,0.0,9.0,6170.85,6170.85,-149.0,-143.0,5.0,1.0,0.0,,,,,,,,,,,,,,,,,,,,,8339429367.0,184271409099.0,165471365997.0,51928874110.935,1862.0,1703.0,71124.0,70686.0,9140.0,505624.0,17794.01390000229,17856.095499999108,17307.91899999808,11287.031400000084,11224.86180000009,11172.395300000057,128295.0,662246.0,4135.369800000123,4133.009200000017,3943.801800000095,13516522.8109585,-601387870.0,-921143005.0,-296243755.0,-1533917503.0416667,43972.0,30673.0,11341.533199999174,11217.43999999897,10702.0423999973,22869.733100009627,22791.5994000096,22177.657300008144,,157909.85133036063,126003.37439249692,34972.24070002788,34912.657300028324,34359.21620002873,22935.82849999593,22909.27599999551,22556.665099995746,3711185.0,8289.410600000168,8393.84080000008,8117.604100000227,9810.517300000718,9925.38510000216,10284.761899999648,16456.08019999975,16641.1607999997,16238.1266999997,828.1569000001758,813.336300000046,759.3236000000132,3910.316200000125,3893.548800000161,3726.345300000157,436110.0,430911.0,,6419.591273002896,631423.0,624982.0,,16319.8770999998,154055.08369999062,154057.8281999901,153949.61789998718,77549.58239999627,77887.09730000659,78288.15800000647,33.0,17397711.945000004,,1620401710.0050006,555058289.115,20841632.684999995,44191.35,34.0,1872.0,-5474553.0,2711886.0,-2816790.0,-3041730.5,-16.0,0.0,,135000.0,0.0,0.0,0.0,0.0,0.0,-989.0,-88.0,-114.0,-85.0,61757166.86999992,873142871.3549995,984815407.5749998,14831018.280000005,873142871.3549995,62789.0,-4428571.5,1028682079.0,44618658.0,229936039.0,105543984.0,238787880.0,63201.0,1022.0,177.51363666145969,1735517.5,554328.0,336583.0,-1081381.0,342294.0,2081.0,737910072.8099811,741785569.9199831,-45375417.0,-45017858.0,856506.0,36180.0,,,,,,,,,,,,,,,,,,,,,1466088.0,14730939.0,3229463.0,8547668.0,11597548.0,1414369.0,1057081882.437001,,72040672028.6096,21656629325.587616,581773028.7644991,5792395.7475,689.5,94245.0,-276700167.0,21911013.0,-123690256.0,-218525855.0,-2014467.0,,,,,,,,,,,,,,,,,,,,,4269173.5,2477079.0,-8996008.5,921269.0,37582.5,3730281560.549965,3654820426.1399617,-260414239.5,-257106141.5,2524420.5,268970.5,3922959188.1149545,33229879149.893414,36656692247.40764,1728061979.0625494,48046549803.27821,3984685.0,-247381955.0,102997461188.5,1052944953.5,17260501759.0,3500708102.0,18873969851.5,3668985.5,71854.5,20854.420908773507,89739671.0,-6.368063340807175,1.75,7.855459544383347,307.1592290888743,13.747054202670856,537.5286509055301,90000.0,-0.9009688679024191,-0.433883739117558,0.0,0.0,0.0,0.0,0.0,0.0,1.0,0.0,0.0,0.0,0.0,0.0,0.0,1.0,0.0,0.0,0.0,0.0,1.0,0.0,0.0,0.0,1.0,0.0,0.0,1.0,0.0,0.0,0.0,0.0,0.0,0.0,0.0,0.0,0.0,0.0,0.0,0.0,0.0,0.0,0.0,0.0,0.0,0.0,0.0,0.0,0.0,0.0,0.0,0.0,0.0,0.0,0.0,1.0,0.0,0.0,0.0,0.0,0.0,0.0,0.0,0.0,0.0,0.0,0.0,0.0,0.0,0.0,0.0,0.0,0.0,0.0,0.0,0.0,0.0,0.0,0.0,0.0,0.0,0.0,0.0,0.0,0.0,0.0,0.0,0.0,0.0,0.0,0.0,0.0,0.0,0.0,0.0,0.0,0.0,0.0,0.0,0.0,0.0,0.0,0.0,0.0,0.0,0.0,0.0,0.0,0.0,0.0,1.0,0.0,1.0,0.0,0.0,0.0,0.0,0.0,0.0,0.0,1.0,0.0
101056,1,0.0,0.0,1.0,0.0,1.0,112500.0,358344.0,28440.0,283500.0,0.035792,26.246575342465757,-1009.0,-640.0,-1913.0,13.0,3.0,2.0,2.0,11.0,0.2901176994524472,0.2102101596526336,0.1428725230413196,,,,,,,,,,,,,,,,,,,,,,,,,,,,,,,,,,,,,,,,,,,,,0.0,0.0,0.0,0.0,-449.0,0.0,0.0,0.0,0.0,3.0,0.0,1.0,1.0,0.0,1.0,0.0,0.0,0.0,0.0,0.0,0.0,0.0,0.0,0.0,1.0,0.0,0.0,0.0,0.0,0.0,0.0,0.0,0.0,0.0,0.0,0.0,0.0,0.0,0.0,0.0,0.0,0.0,0.0,2.0,19208.25,,162000.0,57631.5,,0.0,0.0,0.0,-234.0,69.0,-3.0,,16.0,-3.5,3.0,14913.18,0.0,0.0,34020.0,170100.0,12.0,-395.0,365243.0,-399.0,-69.0,-69.0,-67.0,10.0,0.0,0.2038254059345778,-1.0,13.0,12.0,5.5,-9.0,0.0,0.0,12.0,14913.18,14913.18,-260.0,-234.0,6.5,1.0,0.0,,,,,,,,,,,,,,,,,,,,,8339457807.0,184271767443.0,165471649497.0,51928986610.935,1862.0,1703.0,71124.0,70689.0,9140.0,505624.0,,,,,,,128296.0,662249.0,,,,13516549.057533842,-601388879.0,-921144918.0,-296244204.0,-1533918143.0416667,43972.0,30673.0,,,,,,,67387.65303036901,157910.06154052028,126003.51726501994,,,,,,,3711196.0,,,,,,,,,,,,,,,,436110.0,430911.0,1261969.0,6419.627065002896,631425.0,624984.0,,,,,,,,,8.0,17426523.195000004,,1620869710.0050006,555331263.615,,44191.35,34.0,1872.0,-5475893.0,2712225.0,-2816909.0,,-3.5,19208.25,,162000.0,57631.5,,0.0,0.0,0.0,-234.0,69.0,-3.0,,61776992.02499992,873380471.3549995,985030665.0749998,14865038.280000005,873380471.3549995,62813.0,-4429420.0,1029047322.0,44618259.0,229935970.0,105543915.0,238787813.0,63236.0,1022.0,177.7174620673943,1736250.0,554446.0,336654.0,-1081478.0,342294.0,2081.0,738037543.4999808,741913040.609983,-45377372.5,-45019643.5,856578.5,36191.5,,,,,,,,,,,,,,,,,,,,,1466090.0,14730955.0,3229463.0,8547681.0,11597560.0,1414372.0,1057101090.687001,,72040834028.6096,21656686957.087616,,5792395.7475,689.5,94245.0,-276700401.0,21911082.0,-123690259.0,,-2014470.5,,,,,,,,,,,,,,,,,,,,,4269185.5,2477084.5,-8996017.5,921269.0,37582.5,3730296473.729964,3654835339.3199615,-260414499.5,-257106375.5,2524427.0,268971.5,3922974101.294955,33229879149.893414,36656692247.40764,1728095999.0625494,48046719903.27821,3984697.0,-247382350.0,102997826431.5,1052944554.5,17260501690.0,3500708033.0,18873969784.5,3668995.5,71854.5,20854.62473417944,89739670.0,-38.443110647181626,3.18528,3.9556962025316458,103.8234784116525,12.6,330.7068493150685,37500.0,-0.9009688679024191,0.4338837391175582,0.0,0.0,0.0,0.0,0.0,1.0,0.0,0.0,1.0,0.0,0.0,0.0,0.0,0.0,0.0,0.0,0.0,0.0,1.0,0.0,1.0,0.0,0.0,0.0,0.0,0.0,0.0,0.0,0.0,1.0,0.0,0.0,0.0,0.0,0.0,0.0,0.0,0.0,0.0,0.0,0.0,0.0,0.0,0.0,1.0,0.0,0.0,0.0,0.0,0.0,0.0,0.0,0.0,0.0,0.0,0.0,0.0,0.0,0.0,0.0,0.0,0.0,0.0,0.0,0.0,0.0,0.0,0.0,0.0,0.0,0.0,0.0,0.0,0.0,0.0,0.0,0.0,0.0,0.0,0.0,0.0,0.0,0.0,0.0,0.0,0.0,0.0,0.0,0.0,0.0,1.0,0.0,0.0,0.0,0.0,0.0,0.0,0.0,0.0,0.0,0.0,0.0,0.0,0.0,0.0,0.0,0.0,0.0,0.0,0.0,0.0,0.0,0.0,0.0,0.0,0.0,0.0,0.0,0.0,0.0
101057,0,0.0,1.0,1.0,1.0,0.0,112500.0,202500.0,16128.0,202500.0,0.015221,28.87397260273973,-820.0,-4901.0,-3206.0,11.0,2.0,2.0,2.0,13.0,,0.7283523753674924,0.3859146722745145,,,,,,,,,,,,,,,,,,,,,,,,,,,,,,,,,,,,,,,,,,,,,3.0,0.0,3.0,0.0,-606.0,0.0,0.0,0.0,0.0,0.0,0.0,1.0,1.0,0.0,1.0,0.0,0.0,0.0,0.0,0.0,1.0,1.0,0.0,0.0,1.0,0.0,0.0,0.0,0.0,0.0,0.0,0.0,0.0,0.0,0.0,0.0,0.0,0.0,0.0,0.0,0.0,0.0,0.0,4.0,8775.0,0.0,104517.0,40146.75,0.0,0.0,0.0,0.0,-408.5,-109.0,-74.0,-154.0,57.0,-7.0,14.0,10536.75,0.0,0.0,0.0,156802.5,6.0,-442.5,365243.0,-206.0,365243.0,124.0,365243.0,12.0,0.0,0.0,-1.0,20.0,12.0,7.5,-9.5,0.0,0.0,19.0,14700.78,14700.78,-313.0,-305.0,5.0,1.0,13.0,0.0,180000.0,,0.0,,,0.0,,0.0,0.0,0.0,0.0,,0.0,,,0.0,-7.0,0.0,0.0,8339473935.0,184271969943.0,165471851997.0,51929099110.935,1862.0,1703.0,71124.0,70689.0,9140.0,505624.0,,,,,,,128296.0,662251.0,,,,13516577.931506446,-601389699.0,-921148124.0,-296244810.0,-1533923044.0416667,43972.0,30673.0,,,,,,,,157910.78989289567,126003.90317969222,,,,,,,3711209.0,,,,,,,,,,,,,,,,436113.0,430914.0,1261980.0,6419.642286002895,631427.0,624986.0,,,,,,,,,14.0,17444903.445000004,5000234.759999999,1621294960.0050006,555491850.615,20936838.645,44191.35,34.0,1872.0,-5476985.0,2743012.0,-2817027.0,-3042012.0,-6.5,8775.0,0.0,74034.0,0.0,0.0,0.0,0.0,0.0,-448.0,-109.0,-132.0,-170.0,61812489.59999993,873559076.3549995,985223827.5749998,14865038.280000005,873784076.3549995,62867.0,-4432688.5,1029777808.0,44617684.0,230300968.0,105543794.0,239152819.0,63336.0,1022.0,177.7174620673943,1736340.5,554638.0,336749.5,-1081673.5,342294.0,2081.0,738266567.4449803,742142064.5549824,-45383319.0,-45025338.0,856669.0,36207.0,775551222.8099997,1855921500.0,,99836164.62,,,43568804.20499998,,99456020.0099996,744023085.9749976,772499200.0949973,772526337.0299972,,7754.0,,,251262.0,-415205.0,148385.0,400.0,1466094.0,14731012.0,3229476.0,8547701.0,11597579.0,1414386.0,1057109865.687001,801277059.7124951,72040938545.6096,21656727103.837616,581773028.7644991,5792395.7475,689.5,94245.0,-276700809.5,21910973.0,-123690333.0,-218526009.0,-2014477.5,5916929106.1274605,18702045000.0,,447422863.1624976,,,308818012.0049988,,458603101.6424992,5702281049.970029,5880249169.087498,5880492351.8325,,80733.0,,,970703.0,-1696821.0,177364.0,6755.0,4269197.5,2477092.0,-8996027.0,921269.0,37582.5,3730311174.509965,3654850040.0999618,-260414812.5,-257106680.5,2524432.0,268972.5,3922984638.044955,33229879149.893414,36656692247.40764,1728095999.0625494,48046876705.77821,3984703.0,-247382792.5,102998191674.5,1052944348.5,17260866933.0,3500708157.0,18874335027.5,3669007.5,71854.5,20854.62473417944,89739669.0,-28.3992788689629,1.8,6.975446428571429,201.4088490704501,12.555803571428571,362.53592832681016,56250.0,-0.2225209339563146,-0.9749279121818236,0.0,0.0,0.0,0.0,0.0,0.0,1.0,0.0,0.0,0.0,0.0,0.0,0.0,1.0,0.0,1.0,0.0,0.0,0.0,0.0,1.0,0.0,0.0,0.0,0.0,1.0,0.0,0.0,0.0,0.0,0.0,0.0,0.0,0.0,0.0,0.0,0.0,0.0,1.0,0.0,0.0,0.0,0.0,0.0,0.0,0.0,0.0,0.0,0.0,0.0,0.0,0.0,0.0,0.0,0.0,0.0,0.0,0.0,0.0,0.0,0.0,0.0,0.0,0.0,0.0,0.0,0.0,0.0,0.0,0.0,0.0,0.0,0.0,0.0,0.0,0.0,0.0,0.0,0.0,0.0,0.0,0.0,0.0,0.0,0.0,0.0,0.0,0.0,0.0,0.0,1.0,0.0,0.0,0.0,0.0,0.0,0.0,0.0,0.0,0.0,0.0,0.0,0.0,0.0,0.0,0.0,0.0,0.0,0.0,0.0,0.0,0.0,0.0,0.0,0.0,0.0,0.0,0.0,0.0,0.0
101064,0,0.0,0.0,1.0,1.0,0.0,63000.0,112500.0,12244.5,112500.0,0.008068,60.31506849315068,,-6410.0,-4904.0,14.0,2.0,3.0,3.0,5.0,0.3566106074309156,0.4438649094230312,0.5478104658520093,,,,,,,,,,,,,,,,,,,,,,,,,,,,,,,,,,,,,,,,,,,,,4.0,0.0,4.0,0.0,-1601.0,0.0,0.0,0.0,0.0,1.0,1.0,1.0,0.0,0.0,1.0,1.0,0.0,0.0,0.0,0.0,0.0,0.0,0.0,0.0,1.0,0.0,0.0,0.0,0.0,0.0,0.0,0.0,0.0,0.0,0.0,0.0,0.0,0.0,0.0,0.0,0.0,0.0,0.0,7.0,0.0,0.0,146880.0,0.0,0.0,0.0,0.0,0.0,-467.0,-202.5,-297.0,-757.0,229.0,-18.0,2.0,5032.035,14658.75,12019.5,9000.0,29317.5,6.0,-955.5,365243.0,-1569.0,-1419.0,-1419.0,-1409.0,5.0,0.0,0.2966741784502611,34.5,8.0,6.0,3.5,-49.5,0.0,0.0,6.0,5032.035,5032.035,-1505.0,-1494.0,3.5,1.0,0.0,,,,,,,,,,,,,,,,,,,,,8339486179.5,184272082443.0,165471964497.0,51929162110.935,1862.0,1703.0,71124.0,70690.0,9140.0,505625.0,,,,,,,128296.0,662253.0,,,,13516638.246574936,,-921153028.0,-296246411.0,-1533929454.0416667,43972.0,30673.0,,,,,,,67388.00964097644,157911.2337578051,126004.45099015806,,,,,,,3711214.0,,,,,,,,,,,,,,,,436117.0,430918.0,1261994.0,6419.650354002895,631430.0,624989.0,,,,,,,,,16.0,17483139.945000004,5011323.929999999,1639103753.2950006,563369830.1100001,21035141.1,44191.35,34.0,1872.0,-5544557.0,2749994.0,-2851953.0,-3084832.5,-7.5,11529.0,0.0,146880.0,0.0,0.0,0.0,0.0,0.0,-1393.0,-1209.0,-1210.0,-2338.0,62121094.55999994,879122448.3599995,991440246.7349998,14933181.375000006,879137107.1099995,63269.0,-4465724.5,1037079814.0,44956886.0,231012348.0,106259074.0,239864688.0,63778.5,1028.0,178.9764969600012,1746089.0,556969.0,338042.0,-1089549.0,343893.0,2081.0,742490680.4324796,746339124.2174819,-45710029.5,-45349908.5,861756.5,36380.5,,,,,,,,,,,,,,,,,,,,,1466101.0,14731241.0,3229476.0,8547709.0,11597585.0,1414388.0,1057109865.687001,801277059.7124951,72041085425.6096,21656727103.837616,581773028.7644991,5792395.7475,689.5,94245.0,-276701276.5,21910770.5,-123690630.0,-218526766.0,-2014495.5,,,,,,,,,,,,,,,,,,,,,4269203.5,2477095.5,-8996076.5,921269.0,37582.5,3730316206.544964,3654855072.1349616,-260416317.5,-257108174.5,2524435.5,268973.5,3922989670.0799546,33229893808.643414,36656704266.90764,1728104999.0625494,48046906023.27821,3984709.0,-247383748.0,102998556917.5,1052942779.5,17260865514.0,3500706738.0,18874333618.5,3669012.5,71854.5,20854.92140835789,89739703.5,,1.7857142857142858,5.145167217934583,310.33111315843786,9.187798603454612,554.1627020686392,31500.0,-0.2225209339563143,0.9749279121818236,0.0,0.0,0.0,0.0,0.0,1.0,0.0,0.0,0.0,1.0,0.0,0.0,0.0,0.0,0.0,0.0,0.0,0.0,1.0,0.0,1.0,0.0,0.0,0.0,0.0,1.0,0.0,0.0,0.0,0.0,0.0,0.0,0.0,0.0,0.0,0.0,0.0,0.0,0.0,0.0,0.0,0.0,0.0,0.0,0.0,0.0,0.0,0.0,0.0,0.0,0.0,0.0,0.0,0.0,0.0,0.0,0.0,0.0,0.0,0.0,0.0,0.0,0.0,0.0,0.0,0.0,0.0,0.0,0.0,0.0,0.0,0.0,0.0,0.0,0.0,0.0,0.0,0.0,0.0,0.0,0.0,0.0,0.0,0.0,0.0,0.0,0.0,0.0,0.0,0.0,0.0,0.0,0.0,0.0,0.0,0.0,0.0,0.0,0.0,0.0,0.0,0.0,0.0,0.0,0.0,1.0,0.0,0.0,0.0,0.0,0.0,0.0,0.0,0.0,0.0,0.0,0.0,0.0,0.0,0.0
101079,0,0.0,0.0,1.0,1.0,0.0,135000.0,547344.0,26460.0,472500.0,0.0088659999999999,55.37808219178083,-503.0,-11133.0,-3729.0,8.0,1.0,2.0,2.0,13.0,,0.33683552080635,0.3217352821966848,0.0918,,0.9846,0.7892,0.0,0.0,0.2069,0.1667,0.2083,0.0,0.0748,0.0864,0.0,0.0,0.0935,,0.9846,0.7975,0.0,0.0,0.2069,0.1667,0.2083,0.0,0.0817,0.09,0.0,0.0,0.0926,,0.9846,0.792,0.0,0.0,0.2069,0.1667,0.2083,0.0,0.0761,0.088,0.0,0.0,0.068,1.0,0.0,0.0,0.0,0.0,-474.0,0.0,0.0,0.0,0.0,1.0,0.0,1.0,1.0,0.0,1.0,0.0,0.0,0.0,0.0,0.0,0.0,0.0,0.0,0.0,1.0,0.0,0.0,0.0,0.0,0.0,0.0,0.0,0.0,0.0,0.0,0.0,0.0,0.0,0.0,0.0,0.0,0.0,0.0,10.0,0.0,0.0,161955.0,0.0,0.0,0.0,0.0,0.0,-969.0,-224.5,-333.0,-645.0,361.0,-19.0,2.0,5351.22,29436.75,27607.5,1829.25,29436.75,6.0,-325.5,365243.0,-279.5,182485.5,-129.5,182487.5,15.5,0.0,0.0544947629918087,107.5,14.0,6.0,3.5,-9.5,0.0,0.0,11.0,6709.32,6709.32,-294.0,-272.0,3.0,1.0,0.0,,,,,,,,,,,,,,,,,,,,,8339512639.5,184272629787.0,165472436997.0,51929297110.935,1862.0,1703.0,71124.0,70691.0,9140.0,505625.0,17794.10570000229,17856.188099999108,17308.01249999808,,,,128296.0,662254.0,4135.369800000123,4133.009200000017,3943.801800000095,13516693.624657128,-601390202.0,-921156757.0,-296246885.0,-1533940587.0416667,43972.0,30673.0,11341.533199999174,11217.43999999897,10702.0423999973,22869.940000009632,22791.806300009597,22177.864200008145,,157911.57059332592,126004.77272544029,34972.407400027885,34912.82400002833,34359.38290002873,22936.03679999593,22909.484299995507,22556.873399995744,3711227.0,8289.410600000168,8393.84080000008,8117.604100000227,9810.592100000718,9925.46120000216,10284.843599999647,16456.16659999975,16641.2487999997,16238.2166999997,828.1569000001758,813.336300000046,759.3236000000132,3910.316200000125,3893.548800000161,3726.345300000157,436117.0,430918.0,1262002.0,6419.659220002895,631432.0,624991.0,,16319.9450999998,154056.06829999055,154058.8127999901,153950.60249998714,77550.37159999627,77887.88930000659,78288.95550000647,32.5,17918999.594999995,5083823.024999999,1666941993.1350005,572985083.745,21081250.035,44191.35,37.0,1872.0,-5649452.0,2776541.5,-2909797.5,-3144203.0,-15.75,0.0,0.0,90000.0,0.0,0.0,0.0,0.0,0.0,-1296.0,-645.0,-333.0,-865.0,63794795.01749996,902839256.5499996,1017209066.9399998,15252388.110000009,902839256.5499996,64516.0,-4565071.0,1055889097.5,45633578.0,233160512.0,107681093.0,242013127.0,65329.5,1043.0,183.1227139255508,1774787.5,561793.0,340825.0,-1104358.5,343927.0,2115.0,753184311.8849771,756681507.8549805,-46104507.0,-45736573.0,864436.0,36830.0,,,,,,,,,,,,,,,,,,,,,1466111.0,14731602.0,3229476.0,8547723.0,11597596.0,1414390.0,1057109865.687001,801277059.7124951,72041247380.6096,21656727103.837616,581773028.7644991,5792395.7475,689.5,94245.0,-276702245.5,21910546.0,-123690963.0,-218527411.0,-2014514.5,,,,,,,,,,,,,,,,,,,,,4269209.5,2477099.0,-8996086.0,921269.0,37582.5,3730322915.864965,3654861781.454962,-260416611.5,-257108446.5,2524438.5,268974.5,3922995021.299955,33229923245.393414,36656731874.40764,1728106828.3125494,48046935460.02821,3984715.0,-247384073.5,102998922160.5,1052942500.0,17261047999.5,3500706608.5,18874516106.0,3669028.0,71854.5,20854.975903120885,89739811.0,-9.083015880868748,4.0544,5.1020408163265305,282.5412356723511,20.68571428571429,1145.5351859099806,135000.0,0.6234898018587336,0.7818314824680298,0.0,0.0,0.0,0.0,0.0,0.0,1.0,0.0,0.0,0.0,0.0,0.0,0.0,1.0,0.0,0.0,0.0,0.0,1.0,0.0,0.0,0.0,0.0,1.0,0.0,1.0,0.0,0.0,0.0,0.0,0.0,0.0,0.0,0.0,0.0,0.0,0.0,0.0,0.0,0.0,1.0,0.0,0.0,0.0,0.0,0.0,0.0,0.0,0.0,0.0,0.0,0.0,0.0,1.0,0.0,0.0,0.0,0.0,0.0,0.0,0.0,0.0,0.0,0.0,0.0,0.0,0.0,0.0,0.0,0.0,0.0,0.0,0.0,0.0,0.0,0.0,0.0,0.0,0.0,0.0,0.0,0.0,0.0,0.0,0.0,0.0,0.0,0.0,0.0,0.0,0.0,0.0,0.0,0.0,0.0,0.0,0.0,0.0,0.0,0.0,0.0,0.0,0.0,0.0,0.0,0.0,0.0,0.0,1.0,0.0,1.0,0.0,0.0,0.0,0.0,0.0,0.0,1.0,0.0,0.0
101087,0,0.0,1.0,1.0,1.0,2.0,211500.0,135000.0,14305.5,135000.0,0.020246,39.20821917808219,-6144.0,-5368.0,-1243.0,3.0,4.0,3.0,3.0,13.0,0.3706371733684625,0.4210428633544573,0.5046813193144684,,,,,,,,,,,,,,,,,,,,,,,,,,,,,,,,,,,,,,,,,,,,,3.0,0.0,3.0,0.0,-1802.0,1.0,0.0,0.0,0.0,1.0,2.0,1.0,1.0,1.0,1.0,1.0,0.0,0.0,0.0,0.0,0.0,0.0,0.0,0.0,0.0,0.0,0.0,0.0,0.0,1.0,0.0,0.0,0.0,0.0,0.0,0.0,0.0,0.0,0.0,0.0,0.0,0.0,0.0,22.0,0.0,0.0,47202.75,0.0,0.0,0.0,0.0,0.0,-1609.5,-1581.0,-755.0,-1182.0,1075.0,-28.0,6.0,11592.9675,107054.7975,100437.75,8059.095,107054.7975,10.0,-2477.5,365243.0,-2286.0,-2016.0,-2016.0,-1995.0,12.5,0.0,0.1002708010246807,135.5,47.0,10.0,5.0,-68.0,0.0,0.0,45.0,13154.265,13154.265,-2075.0,-2076.0,5.0,1.0,0.0,,,,,,,,,,,,,,,,,,,,,8339526945.0,184272764787.0,165472571997.0,51929508610.935,1862.0,1704.0,71124.0,70692.0,9140.0,505627.0,,,,,,,128298.0,662258.0,,,,13516732.832876304,-601396346.0,-921158000.0,-296248687.0,-1533945955.0416667,43972.0,30673.0,,,,,,,67388.38027814981,157911.99163618928,126005.2774067596,,,,,,,3711240.0,,,,,,,,,,,,,,,,436120.0,430921.0,1262005.0,6419.679466002895,631435.0,624994.0,,,,,,,,,53.0,17996993.594999995,5090403.014999999,1677673293.8400006,576091095.2099999,21097591.605,44191.35,37.0,1872.0,-5708372.5,2766295.0,-2941484.0,-3182007.5,-26.0,0.0,0.0,24570.0,0.0,0.0,0.0,0.0,0.0,-2256.0,-1980.0,-1036.0,-1874.0,64096799.28749997,905896463.6699996,1021286123.3699998,15326034.300000008,905896463.6699996,64838.0,-4595864.0,1063011336.0,46342411.0,235334277.0,108395311.0,244187080.0,65686.5,1050.0,184.2957001969556,1792684.5,564289.0,342373.0,-1110284.0,343929.0,2117.0,755600415.2549756,759079764.2249789,-46258878.0,-45888202.0,865419.0,36990.0,,,,,,,,,,,,,,,,,,,,,1466133.0,14732677.0,3229476.0,8547770.0,11597641.0,1414396.0,1057109865.687001,801277059.7124951,72041294583.3596,21656727103.837616,581773028.7644991,5792395.7475,689.5,94245.0,-276703855.0,21908965.0,-123691718.0,-218528593.0,-2014542.5,,,,,,,,,,,,,,,,,,,,,4269219.5,2477104.0,-8996154.0,921269.0,37582.5,3730336070.129965,3654874935.7199616,-260418686.5,-257110522.5,2524443.5,268975.5,3923006614.267455,33230030300.19092,36656832312.15764,1728114887.4075494,48047042514.825714,3984725.0,-247386551.0,102999287403.5,1052940214.0,17261045983.5,3500704592.5,18874514111.0,3669040.5,71854.5,20855.07617392191,89739946.5,-156.70183774718743,0.6382978723404256,14.784523435042464,579.6748352846375,9.436929852154766,370.0052140114708,52875.0,0.6234898018587334,-0.7818314824680299,0.0,0.0,0.0,0.0,0.0,0.0,1.0,0.0,0.0,0.0,0.0,0.0,0.0,1.0,0.0,1.0,0.0,0.0,0.0,0.0,1.0,0.0,0.0,0.0,0.0,1.0,0.0,0.0,0.0,0.0,0.0,0.0,0.0,0.0,0.0,0.0,0.0,0.0,0.0,0.0,1.0,0.0,0.0,0.0,0.0,0.0,0.0,0.0,0.0,0.0,0.0,0.0,1.0,0.0,0.0,0.0,0.0,0.0,0.0,0.0,0.0,0.0,0.0,0.0,0.0,0.0,0.0,0.0,0.0,0.0,0.0,0.0,0.0,0.0,0.0,0.0,0.0,0.0,0.0,0.0,0.0,0.0,0.0,0.0,0.0,0.0,0.0,0.0,0.0,0.0,0.0,0.0,0.0,0.0,0.0,0.0,0.0,0.0,0.0,0.0,0.0,0.0,0.0,0.0,0.0,0.0,0.0,0.0,0.0,0.0,0.0,0.0,0.0,0.0,0.0,0.0,0.0,0.0,0.0,0.0
101090,0,0.0,0.0,0.0,1.0,0.0,180000.0,460692.0,19363.5,301500.0,0.018801,58.32054794520548,,-9996.0,-4287.0,,1.0,2.0,2.0,8.0,,0.5514376897546482,0.7503751495159068,0.0773,0.0676,0.9767,0.6804,0.0592,0.0,0.1724,0.1667,0.0417,0.0643,0.063,0.0444,0.0193,0.149,0.0788,0.0702,0.9767,0.6929,0.0598,0.0,0.1724,0.1667,0.0417,0.0658,0.0689,0.0463,0.0195,0.1577,0.0781,0.0676,0.9767,0.6847,0.0596,0.0,0.1724,0.1667,0.0417,0.0655,0.0641,0.0452,0.0194,0.1521,0.0673,1.0,4.0,1.0,4.0,0.0,-1435.0,0.0,0.0,0.0,0.0,1.0,6.0,1.0,0.0,0.0,1.0,0.0,0.0,0.0,0.0,0.0,0.0,0.0,0.0,0.0,1.0,0.0,0.0,0.0,0.0,0.0,0.0,0.0,0.0,0.0,0.0,0.0,0.0,0.0,0.0,0.0,0.0,0.0,0.0,4.0,0.0,0.0,152527.5,0.0,0.0,0.0,0.0,0.0,-2266.0,-1551.5,-1587.0,-1313.0,301.0,-37.0,15.0,25512.21,0.0,135000.0,,463500.0,24.0,-496.0,365243.0,-1078.5,182415.5,-7.0,182418.0,9.0,0.5,,-1.0,57.0,24.0,15.0,-30.0,0.0,0.0,149.0,25123.5,22928.04,-654.0,-652.0,22.0,0.0,37.0,36398.025,450000.0,0.0,29537.19,0.0,7262.775,2450.9025,43393.5,35267.67,34833.6,34833.6,34833.6,0.0,3.0,0.0,2.0,17.5,-19.0,0.0,0.0,8339546308.5,184273225479.0,165472873497.0,51929688610.935,1862.0,1704.0,71124.0,70693.0,9140.0,505633.0,17794.18300000229,17856.26619999911,17308.091299998083,11287.099000000086,11224.92940000009,11172.465500000057,128298.0,662259.0,4135.429000000123,4133.068800000016,3943.861600000095,13516791.153424252,,-921162287.0,-296250122.0,-1533955951.0416667,43973.0,30673.0,11341.533199999174,11217.43999999897,10702.0423999973,22870.112400009628,22791.978700009597,22178.036600008145,,157912.54307387903,126006.0277819091,34972.57410002789,34912.99070002833,34359.54960002873,22936.07849999593,22909.52599999551,22556.915099995746,3711248.0,8289.474900000168,8393.906300000079,8117.669900000227,9810.655100000718,9925.52530000216,10284.91249999965,16456.210999999752,16641.2939999997,16238.2629999997,828.176200000176,813.3557000000459,759.3431000000132,3910.465200000124,3893.700900000161,3726.503000000158,436124.0,430925.0,,6419.698267002896,631437.0,624996.0,,16320.0123999998,154057.04499999055,154059.7894999901,153951.57919998714,77551.05199999629,77888.57400000659,78289.64840000648,75.0,18053963.594999995,5116488.119999999,1684305084.2850006,577459239.2099999,21097591.605,44191.35,37.0,4348.0,-5748574.0,2743338.0,-2963449.5,-3205086.0,-37.0,0.0,0.0,135000.0,0.0,0.0,0.0,0.0,0.0,-2853.0,-1790.0,-1861.0,-1313.0,64620731.42999996,913351435.9199996,1029623889.8699998,,913778935.9199996,65242.0,-4629261.0,1068304143.5,46317924.0,236411363.0,109476518.0,245631342.5,66080.0,1055.5,,1797712.0,566980.0,344070.0,-1117626.0,343929.0,2117.0,760661415.6749747,764361631.214978,-46595069.0,-46221093.0,872467.0,37166.0,789129279.2700003,1921509000.0,65875452.75,102143545.74,3620606.4,32586417.99000003,44361153.74250001,109741862.11499998,101368008.80999956,757089077.354998,786000929.6699983,786028066.6049982,3386.0,7898.0,52.5,4458.5,255938.0,-423998.0,148393.0,401.0,1466137.0,14732978.0,3229513.0,8547827.0,11597790.0,1414411.0,1057109865.687001,801277059.7124951,72041447110.8596,21656727103.837616,581773028.7644991,5792395.7475,689.5,94245.0,-276706121.0,21907413.5,-123693305.0,-218529906.0,-2014579.5,5916965504.152461,18702495000.0,198634220.325,447452400.3524976,1948107.735,256476077.7525008,308820462.90749884,635879813.4899982,458638369.3124992,5702315883.570029,5880284002.687498,5880527185.432499,13368.5,80736.0,44.0,70259.5,970720.5,-1696840.0,177364.0,6755.0,4269243.5,2477119.0,-8996184.0,921269.0,37582.5,3730361193.629965,3654897863.7599616,-260419340.5,-257111174.5,2524465.5,268975.5,3923032126.477455,33230030300.19092,36656967312.15764,,48047506014.825714,3984749.0,-247387047.0,102999652646.5,1052939135.5,17261228399.0,3500704585.5,18874696529.0,3669049.5,71855.0,,89739945.5,,2.5594,9.29584011155008,542.1384889166208,23.79177318150128,1387.5492485331988,180000.0,1.0,0.0,0.0,0.0,0.0,0.0,0.0,0.0,1.0,0.0,0.0,1.0,0.0,0.0,0.0,0.0,0.0,0.0,0.0,0.0,1.0,0.0,0.0,1.0,0.0,0.0,0.0,1.0,0.0,0.0,0.0,0.0,0.0,0.0,0.0,0.0,0.0,0.0,0.0,0.0,0.0,0.0,0.0,0.0,0.0,0.0,0.0,0.0,0.0,0.0,0.0,0.0,0.0,0.0,0.0,0.0,0.0,0.0,0.0,0.0,0.0,0.0,0.0,0.0,0.0,0.0,0.0,0.0,0.0,0.0,0.0,0.0,0.0,0.0,0.0,0.0,0.0,0.0,0.0,0.0,0.0,0.0,0.0,0.0,0.0,0.0,0.0,0.0,0.0,0.0,0.0,0.0,0.0,0.0,0.0,0.0,0.0,0.0,0.0,0.0,0.0,0.0,0.0,0.0,0.0,0.0,0.0,1.0,0.0,0.0,1.0,0.0,1.0,0.0,0.0,0.0,0.0,0.0,0.0,1.0,0.0,0.0
101092,0,0.0,0.0,0.0,1.0,2.0,81000.0,1024740.0,49428.0,900000.0,0.002134,33.38082191780822,-2739.0,-646.0,-2178.0,,4.0,3.0,3.0,9.0,,0.4309453869519295,0.4101025731788671,,,,,,,,,,,,,,,,,,,,,,,,,,,,,,,,,,,,,,,,,,,,,0.0,0.0,0.0,0.0,-1239.0,0.0,1.0,0.0,0.0,1.0,2.0,1.0,1.0,0.0,1.0,0.0,0.0,0.0,0.0,0.0,0.0,0.0,0.0,0.0,1.0,0.0,0.0,0.0,0.0,0.0,0.0,0.0,0.0,0.0,0.0,0.0,0.0,0.0,0.0,0.0,0.0,0.0,0.0,4.0,0.0,,717750.0,153337.5,0.0,0.0,0.0,0.0,-477.0,1005.0,-127.0,-187.0,88.0,-14.5,3.0,38066.175,337500.0,405391.5,23490.0,337500.0,12.0,-942.0,365243.0,-912.0,-582.0,-582.0,-580.0,9.0,1.0,0.2008498337910102,20.0,39.0,12.0,9.0,-25.0,0.0,0.0,37.0,38066.175,38066.175,-743.0,-732.0,7.0,1.0,0.0,,,,,,,,,,,,,,,,,,,,,8339595736.5,184274250219.0,165473773497.0,51929769610.935,1863.0,1704.0,71124.0,70694.0,9140.0,505635.0,,,,,,,128300.0,662263.0,,,,13516824.534246167,-601399085.0,-921164465.0,-296251361.0,-1533956597.0416667,43973.0,30673.0,,,,,,,,157912.974019266,126006.43788448226,,,,,,,3711257.0,,,,,,,,,,,,,,,,436124.0,430925.0,,6419.700401002896,631440.0,624999.0,,,,,,,,,16.5,18079816.094999995,,1686176139.2850006,577612576.7099999,21097591.605,44191.35,37.0,4348.0,-5753423.0,2741951.0,-2965955.5,-3206678.0,-7.75,0.0,,1035000.0,0.0,0.0,0.0,0.0,0.0,-1445.0,-184.0,-166.0,-184.0,64762258.18499997,916080636.4199996,1032628022.3699998,15410209.050000008,916080636.4199996,65422.0,-4636611.0,1069947183.0,46313713.0,236774022.0,109474597.0,245994023.0,66170.0,1058.0,185.579140986281,1797975.0,568142.0,344814.0,-1119574.0,343929.0,2117.0,763598855.8799753,767220839.4599781,-46666958.0,-46291816.0,874998.0,37235.0,,,,,,,,,,,,,,,,,,,,,1466141.0,14733066.0,3229513.0,8547866.0,11597827.0,1414414.0,1057109865.687001,,72042164860.8596,21656880441.337616,581773028.7644991,5792395.7475,689.5,94245.0,-276706598.0,21908418.5,-123693432.0,-218530093.0,-2014594.0,,,,,,,,,,,,,,,,,,,,,4269255.5,2477128.0,-8996209.0,921269.0,37582.5,3730399259.804965,3654935929.934962,-260420083.5,-257111906.5,2524472.5,268976.5,3923070192.652455,33230367800.19092,36657372703.65764,1728138377.4075494,48047843514.825714,3984761.0,-247387989.0,103000017889.5,1052938223.5,17261227817.0,3500704003.5,18874695949.0,3669058.5,71856.0,20855.2770237557,89739965.5,-82.05310242941563,12.651111111111112,1.638747268754552,54.70273074659031,20.7319737800437,692.050324756308,20250.0,-0.2225209339563146,-0.9749279121818236,0.0,0.0,0.0,0.0,0.0,0.0,1.0,0.0,0.0,0.0,0.0,0.0,0.0,1.0,0.0,1.0,0.0,0.0,0.0,0.0,1.0,0.0,0.0,0.0,0.0,1.0,0.0,0.0,0.0,0.0,0.0,0.0,0.0,0.0,0.0,0.0,0.0,0.0,0.0,0.0,0.0,0.0,0.0,0.0,0.0,0.0,0.0,0.0,0.0,0.0,0.0,0.0,0.0,0.0,0.0,0.0,0.0,0.0,0.0,0.0,0.0,0.0,0.0,0.0,1.0,0.0,0.0,0.0,0.0,0.0,0.0,0.0,0.0,0.0,0.0,0.0,0.0,0.0,0.0,0.0,0.0,0.0,0.0,0.0,0.0,0.0,0.0,0.0,0.0,0.0,0.0,0.0,0.0,0.0,0.0,0.0,0.0,0.0,0.0,0.0,0.0,0.0,0.0,0.0,0.0,0.0,0.0,0.0,0.0,0.0,0.0,0.0,0.0,0.0,0.0,0.0,0.0,0.0,0.0,0.0
101097,0,0.0,0.0,0.0,1.0,0.0,135000.0,755550.0,30465.0,562500.0,0.035792,50.96164383561644,-1233.0,-173.0,-838.0,,1.0,2.0,2.0,11.0,,0.6968615362900487,0.3280631605201915,,,,,,,,,,,,,,,,,,,,,,,,,,,,,,,,,,,,,,,,,,,,,3.0,0.0,2.0,0.0,-679.0,0.0,0.0,0.0,0.0,1.0,1.0,1.0,1.0,0.0,1.0,0.0,0.0,0.0,0.0,0.0,0.0,0.0,0.0,0.0,1.0,0.0,0.0,0.0,0.0,0.0,0.0,0.0,0.0,0.0,0.0,0.0,0.0,0.0,0.0,0.0,0.0,0.0,0.0,2.0,15750.36,3482.415,260525.25,204446.2275,30017.2725,0.0,0.0,0.0,-392.0,1312.0,-20.5,,26.0,-6.0,4.0,13220.865,121709.25,134561.25,0.0,128115.0,12.0,-478.5,182484.0,-442.0,182447.5,182462.5,182449.5,12.0,0.0,0.0,72.5,12.0,12.0,6.5,-16.5,0.0,0.0,27.0,13220.865,13220.865,-208.0,-208.0,7.0,0.0,9.0,320606.82,337500.0,6750.0,6750.0,0.0,0.0,17201.655,18000.0,18000.0,312598.485,320601.69,320601.69,1.0,1.0,0.0,0.0,4.0,-5.0,0.0,0.0,8339626201.5,184275005769.0,165474335997.0,51929904610.935,1863.0,1704.0,71124.0,70695.0,9140.0,505636.0,,,,,,,128300.0,662264.0,,,,13516875.495890005,-601400318.0,-921165303.0,-296252040.0,-1533956770.0416667,43973.0,30673.0,,,,,,,,157913.6708808023,126006.7659476428,,,,,,,3711268.0,,,,,,,,,,,,,,,,436127.0,430927.0,,6419.736193002896,631442.0,625001.0,,,,,,,,,13.0,18099202.454999994,5119970.534999998,1688366208.2850006,579355536.9375,21127608.8775,44191.35,37.0,4348.0,-5758111.0,2745482.0,-2967284.5,,-6.0,7272.0,3482.415,296050.5,243927.0,0.0,0.0,0.0,0.0,-514.0,1312.0,-26.0,,64922772.10499997,917881149.4199996,1034724405.8699998,15415271.550000008,917881149.4199996,65580.0,-4647578.0,1073416716.5,46669730.0,237863488.0,110200860.0,246718238.0,66327.0,1061.0,185.77621176579987,1798209.5,570933.0,346792.0,-1122993.0,343934.0,2122.0,765982445.9849766,769456124.3249787,-46767034.0,-46390701.0,876050.0,37378.0,791519440.8600005,1929402000.0,66265152.75,103192974.99,4142606.4,32749293.24000003,44496622.935,110738146.905,102334785.8399996,759391055.2799982,788359676.8949983,788386813.8299985,3406.0,7960.0,62.0,4492.0,256180.0,-424469.0,148393.0,401.0,1466143.0,14733092.0,3229522.0,8547878.0,11597854.0,1414418.0,1057125616.047001,801280542.127495,72042425386.1096,21657084887.56512,581803046.036999,5792395.7475,689.5,94245.0,-276706990.0,21909730.5,-123693452.5,,-2014600.0,5917286110.972461,18702832500.0,198640970.325,447459150.3524976,1948107.735,256476077.7525008,308837664.56249875,635897813.4899982,458656369.3124992,5702628482.055029,5880604604.377498,5880847787.122498,13369.5,80737.0,44.0,70259.5,970724.5,-1696845.0,177364.0,6755.0,4269267.5,2477134.5,-8996225.5,921269.0,37582.5,3730412480.669964,3654949150.7999616,-260420291.5,-257112114.5,2524479.5,268976.5,3923083413.517455,33230489509.44092,36657507264.90764,1728138377.4075494,48047971629.825714,3984773.0,-247388467.5,103000200373.5,1052937781.5,17261410264.5,3500886466.0,18874878398.5,3669070.5,71856.0,20855.2770237557,89740038.0,-24.194666953389607,5.596666666666668,4.431314623338257,225.82707755812305,24.800590841949774,1263.878877400295,135000.0,1.0,0.0,0.0,0.0,0.0,0.0,0.0,0.0,1.0,0.0,0.0,0.0,0.0,0.0,0.0,1.0,0.0,0.0,0.0,0.0,1.0,0.0,0.0,0.0,1.0,0.0,0.0,1.0,0.0,0.0,0.0,0.0,0.0,1.0,0.0,0.0,0.0,0.0,0.0,0.0,0.0,0.0,0.0,0.0,0.0,0.0,0.0,0.0,0.0,0.0,0.0,0.0,0.0,0.0,0.0,0.0,0.0,0.0,0.0,0.0,0.0,1.0,0.0,0.0,0.0,0.0,0.0,0.0,0.0,0.0,0.0,0.0,0.0,0.0,0.0,0.0,0.0,0.0,0.0,0.0,0.0,0.0,0.0,0.0,0.0,0.0,0.0,0.0,0.0,0.0,0.0,0.0,0.0,0.0,0.0,0.0,0.0,0.0,0.0,0.0,0.0,0.0,0.0,0.0,0.0,0.0,0.0,0.0,0.0,0.0,0.0,0.0,0.0,0.0,0.0,0.0,0.0,0.0,0.0,0.0,0.0,0.0
101099,0,0.0,0.0,0.0,1.0,0.0,99000.0,186700.5,8982.0,186700.5,0.01885,68.42465753424658,,-11138.0,-4706.0,,1.0,2.0,2.0,11.0,,0.6724331292832124,0.646329897706246,0.1536,0.1613,0.9846,0.7892,0.0649,0.0,0.3448,0.1667,0.2083,0.0728,0.1252,0.1402,0.0,0.0,0.1565,0.1674,0.9846,0.7975,0.0655,0.0,0.3448,0.1667,0.2083,0.0744,0.1368,0.1461,0.0,0.0,0.1551,0.1613,0.9846,0.792,0.0653,0.0,0.3448,0.1667,0.2083,0.074,0.1274,0.1427,0.0,0.0,0.1457,1.0,4.0,0.0,4.0,0.0,-2450.0,0.0,0.0,0.0,0.0,0.0,2.0,1.0,0.0,0.0,1.0,1.0,0.0,0.0,0.0,0.0,0.0,0.0,0.0,0.0,1.0,0.0,0.0,0.0,0.0,0.0,0.0,0.0,0.0,0.0,0.0,0.0,0.0,0.0,0.0,0.0,0.0,0.0,0.0,16.0,1948.5,0.0,233352.0,0.0,0.0,0.0,0.0,0.0,-1381.5,-373.0,-852.5,-1430.5,696.0,-23.0,8.0,8543.655,80385.75,87099.75,0.0,93271.5,12.0,-1484.0,365243.0,-1538.0,-1328.0,-1039.0,-1320.0,11.5,1.0,0.0,-1.0,50.0,11.0,6.0,-51.5,0.0,0.0,43.0,8086.32,8086.32,-1718.0,-1603.0,4.0,1.0,0.0,,,,,,,,,,,,,,,,,,,,,8339635183.5,184275192469.5,165474522697.5,51930003610.935,1863.0,1704.0,71124.0,70695.0,9140.0,505638.0,17794.33660000229,17856.42129999911,17308.24779999808,11287.260300000084,11225.09070000009,11172.632900000057,128300.0,662265.0,4135.493900000123,4133.1341000000175,3943.927100000096,13516943.92054754,,-921170009.0,-296254490.0,-1533967908.0416667,43973.0,30673.0,11341.533199999174,11217.43999999897,10702.0423999973,22870.45720000963,22792.32350000959,22178.381400008144,,157914.34331393155,126007.41227754053,34972.74080002789,34913.15740002833,34359.71630002873,22936.28679999593,22909.734299995507,22557.123399995744,3711279.0,8289.547700000168,8393.980300000081,8117.744300000229,9810.78030000072,9925.65270000216,10285.04929999965,16456.351199999754,16641.4366999997,16238.4090999997,828.176200000176,813.3557000000459,759.3431000000132,3910.465200000124,3893.700900000161,3726.503000000158,436131.0,430931.0,,6419.755043002896,631444.0,625003.0,,16320.1580999998,154058.02959999058,154060.77409999009,153952.56379998714,77551.84119999628,77889.36600000659,78290.44590000648,46.0,18830252.564999998,5119970.534999998,1690828510.0950005,579588054.165,21273345.99,44191.35,37.0,4348.0,-5782324.0,2734937.5,-2983862.0,-3225070.5,-22.5,0.0,0.0,149139.0,0.0,0.0,0.0,0.0,0.0,-1671.0,-1048.0,-1197.0,-1436.0,65019329.14499998,918987537.4199996,1035931166.3699998,15415271.550000008,919021287.4199996,65700.0,-4656496.5,1075790796.0,46660635.0,237855833.0,110194990.0,246710637.0,66424.0,1065.0,185.77621176579987,1799801.5,571789.5,347360.0,-1125127.5,343934.0,2122.0,767665316.2049767,770847695.7299793,-46840549.0,-46462939.0,876477.0,37454.0,,,,,,,,,,,,,,,,,,,,,1466159.0,14733788.0,3229522.0,8547928.0,11597897.0,1414426.0,1057127564.547001,801280542.127495,72042658738.1096,21657084887.56512,581803046.036999,5792395.7475,689.5,94245.0,-276708371.5,21909357.5,-123694305.0,-218531523.5,-2014623.0,,,,,,,,,,,,,,,,,,,,,4269278.5,2477140.5,-8996277.0,921269.0,37582.5,3730420566.989965,3654957237.1199617,-260422009.5,-257113717.5,2524483.5,268977.5,3923091957.172455,33230569895.19092,36657594364.65764,1728138377.4075494,48048064901.325714,3984785.0,-247389951.5,103000565616.5,1052936243.5,17261408936.5,3500885427.0,18874877078.5,3669082.0,71857.0,20855.2770237557,89740037.0,,1.8858636363636363,11.02204408817635,754.179592060834,20.78607214428858,1422.2798679550883,99000.0,-0.9009688679024191,0.4338837391175582,0.0,0.0,0.0,0.0,0.0,0.0,1.0,0.0,0.0,1.0,0.0,0.0,0.0,0.0,0.0,0.0,0.0,0.0,1.0,0.0,0.0,0.0,1.0,0.0,0.0,1.0,0.0,0.0,0.0,0.0,0.0,0.0,0.0,0.0,0.0,0.0,0.0,0.0,0.0,0.0,0.0,0.0,0.0,0.0,0.0,0.0,0.0,0.0,0.0,0.0,0.0,0.0,0.0,0.0,0.0,0.0,0.0,0.0,0.0,0.0,0.0,0.0,0.0,0.0,0.0,0.0,0.0,0.0,0.0,0.0,0.0,0.0,0.0,0.0,0.0,0.0,0.0,0.0,0.0,0.0,0.0,0.0,0.0,0.0,0.0,0.0,0.0,0.0,0.0,0.0,0.0,0.0,0.0,0.0,0.0,0.0,0.0,0.0,0.0,0.0,0.0,0.0,0.0,0.0,0.0,1.0,0.0,0.0,1.0,0.0,1.0,0.0,0.0,0.0,0.0,0.0,0.0,1.0,0.0,0.0
101107,0,0.0,0.0,0.0,1.0,1.0,157500.0,525735.0,48348.0,450000.0,0.008019,46.05479452054794,-765.0,-4852.0,-347.0,,3.0,2.0,2.0,15.0,,0.4234060941261305,0.7958031328748403,,,,,,,,,,,,,,,,,,,,,,,,,,,,,,,,,,,,,,,,,,,,,1.0,1.0,1.0,1.0,0.0,0.0,0.0,0.0,0.0,0.0,0.0,1.0,1.0,0.0,1.0,0.0,0.0,0.0,0.0,0.0,0.0,0.0,0.0,0.0,1.0,0.0,0.0,0.0,0.0,0.0,0.0,0.0,0.0,0.0,0.0,0.0,0.0,0.0,0.0,0.0,0.0,0.0,0.0,1.0,,697.5,33795.0,,,0.0,0.0,0.0,-2524.0,-2336.0,-2288.0,-2336.0,83.0,-41.0,0.0,,,,,,,,,,,,,,,,,0.0,,,,,,0.0,,,,,,,0.0,,,,,,,,,,,,,,,,,,,,,8339683531.5,184275718204.5,165474972697.5,51930161110.935,1863.0,1704.0,71124.0,70695.0,9140.0,505638.0,,,,,,,128301.0,662268.0,,,,13516989.97534206,-601401083.0,-921170356.0,-296254490.0,-1533972760.0416667,43974.0,30674.0,,,,,,,,157914.7667200257,126008.20808067336,,,,,,,3711294.0,,,,,,,,,,,,,,,,436132.0,430932.0,,6419.763062002896,631446.0,625005.0,,,,,,,,,83.0,,5120668.034999998,1706840567.5950005,,,44191.35,37.0,4348.0,-5814918.0,2768474.0,-2999013.0,-3244170.0,-41.0,,697.5,33795.0,,,0.0,0.0,0.0,-2524.0,-2336.0,-2288.0,-2336.0,,,,,,,,,,,,,,,,,,,,,,,,,,,,,,,,,,,,,,,,,,,,,,,,1466160.0,14733871.0,3229522.0,8547928.0,11597897.0,1414426.0,,801281239.627495,72042692533.1096,,,5792395.7475,689.5,94245.0,-276710895.5,21907021.5,-123696593.0,-218533859.5,-2014664.0,,,,,,,,,,,,,,,,,,,,,,,,,,,,,,,,,,,,,,,,,,,,,,,,-16.610648423557407,3.338,3.2576321667907675,150.02958006507615,10.87397617274758,500.7987382572242,52500.0,-0.9009688679024191,-0.433883739117558,0.0,0.0,0.0,0.0,0.0,0.0,1.0,0.0,0.0,0.0,0.0,0.0,0.0,1.0,0.0,0.0,0.0,0.0,1.0,0.0,1.0,0.0,0.0,0.0,0.0,1.0,0.0,0.0,0.0,0.0,0.0,0.0,0.0,0.0,0.0,0.0,0.0,0.0,1.0,0.0,0.0,0.0,0.0,0.0,0.0,0.0,0.0,0.0,0.0,0.0,0.0,0.0,0.0,0.0,0.0,0.0,0.0,0.0,0.0,0.0,0.0,0.0,0.0,0.0,0.0,0.0,0.0,0.0,1.0,0.0,0.0,0.0,0.0,0.0,0.0,0.0,0.0,0.0,0.0,0.0,0.0,0.0,0.0,0.0,0.0,0.0,0.0,0.0,0.0,0.0,0.0,0.0,0.0,0.0,0.0,0.0,0.0,0.0,0.0,0.0,0.0,0.0,0.0,0.0,0.0,0.0,0.0,0.0,0.0,0.0,0.0,0.0,0.0,0.0,0.0,0.0,0.0,0.0,0.0,0.0
101118,0,0.0,0.0,0.0,1.0,0.0,157500.0,651960.0,27535.5,450000.0,0.02461,45.7013698630137,-2603.0,-3142.0,-236.0,,2.0,2.0,2.0,9.0,0.4800692377791097,0.5422637669150823,0.633031641417419,,,,,,,,,,,,,,,,,,,,,,,,,,,,,,,,,,,,,,,,,,,,,0.0,0.0,0.0,0.0,0.0,0.0,0.0,0.0,0.0,1.0,1.0,1.0,1.0,0.0,1.0,0.0,0.0,0.0,0.0,0.0,0.0,0.0,0.0,0.0,1.0,0.0,0.0,0.0,0.0,0.0,0.0,0.0,0.0,0.0,0.0,0.0,0.0,0.0,0.0,0.0,0.0,0.0,0.0,8.0,0.0,0.0,87675.75,0.0,0.0,0.0,0.0,0.0,-1757.5,-754.0,-517.0,-1001.0,408.0,-26.0,4.0,7842.735,45490.5,45081.0,1111.5,45490.5,6.0,-1908.0,365243.0,-984.5,181728.0,-774.5,181732.0,17.0,0.5,0.0252539855938278,70.0,9.0,4.0,3.0,-59.0,0.0,0.0,7.0,9416.34,9416.34,-1795.0,-1787.0,2.0,1.0,0.0,,,,,,,,,,,,,,,,,,,,,8339711067.0,184276370164.5,165475422697.5,51930318610.935,1863.0,1704.0,71124.0,70696.0,9140.0,505639.0,,,,,,,128301.0,662270.0,,,,13517035.676711924,-601403686.0,-921170592.0,-296254490.0,-1533975902.0416667,43974.0,30674.0,,,,,,,67388.86034738758,157915.30898379267,126008.8411123148,,,,,,,3711303.0,,,,,,,,,,,,,,,,436132.0,430932.0,,6419.787672002895,631448.0,625007.0,,,,,,,,,58.5,19187847.314999998,5193916.605,1735817279.1300006,601069492.98,21524755.86,44191.35,37.0,4348.0,-5883812.0,2820499.0,-3031732.5,-3281548.0,-28.75,0.0,0.0,78916.5,0.0,0.0,0.0,0.0,0.0,-1777.0,-1001.0,-564.0,-1001.0,66908979.53999998,951127584.7949996,1071266118.1199998,16006903.425000008,951127584.7949996,67663.0,-4770569.0,1098248266.5,47314793.0,241264524.5,111973168.0,250489405.5,68030.0,1088.5,192.4253571273396,1821693.5,581303.0,353208.0,-1148972.0,351916.0,2212.0,782442339.389967,785618837.1899701,-47763910.0,-47377023.0,888053.0,38563.0,,,,,,,,,,,,,,,,,,,,,1466168.0,14734279.0,3229522.0,8547937.0,11597904.0,1414430.0,1057127564.547001,801281239.627495,72042780208.8596,21657084887.56512,581803046.036999,5792395.7475,689.5,94245.0,-276712653.0,21906267.5,-123697110.0,-218534860.5,-2014690.0,,,,,,,,,,,,,,,,,,,,,4269282.5,2477143.5,-8996336.0,921269.0,37582.5,3730429983.3299646,3654966653.459962,-260423804.5,-257115504.5,2524485.5,268978.5,3923099799.907456,33230615385.69092,36657639445.65764,1728139488.9075494,48048110391.825714,3984791.0,-247391859.5,103000930859.5,1052935259.0,17261590664.5,3500884652.5,18875058810.5,3669099.0,71857.5,20855.30227774129,89740107.0,-56.95671722318807,4.139428571428572,5.719888870730512,261.40675685659085,23.677071416898197,1082.0745980966535,78750.0,1.0,0.0,0.0,0.0,0.0,0.0,0.0,0.0,1.0,0.0,0.0,0.0,0.0,0.0,0.0,1.0,0.0,0.0,0.0,0.0,1.0,0.0,1.0,0.0,0.0,0.0,0.0,1.0,0.0,0.0,0.0,0.0,0.0,0.0,0.0,0.0,0.0,0.0,0.0,0.0,0.0,0.0,0.0,0.0,0.0,0.0,1.0,0.0,0.0,0.0,0.0,0.0,0.0,0.0,0.0,0.0,0.0,0.0,0.0,0.0,0.0,0.0,0.0,0.0,0.0,0.0,0.0,0.0,0.0,0.0,0.0,0.0,0.0,0.0,0.0,0.0,0.0,0.0,0.0,0.0,0.0,0.0,0.0,0.0,0.0,0.0,0.0,0.0,0.0,0.0,0.0,0.0,1.0,0.0,0.0,0.0,0.0,0.0,0.0,0.0,0.0,0.0,0.0,0.0,0.0,0.0,0.0,0.0,0.0,0.0,0.0,0.0,0.0,0.0,0.0,0.0,0.0,0.0,0.0,0.0,0.0,0.0
101125,0,0.0,1.0,1.0,1.0,1.0,225000.0,1024740.0,52452.0,900000.0,0.035792,38.67397260273973,-1334.0,-1093.0,-2101.0,3.0,3.0,2.0,2.0,11.0,0.2748273758041381,0.4762987996249837,0.3490552510751822,,,,,,,,,,,,,,,,,,,,,,,,,,,,,,,,,,,,,,,,,,,,,0.0,0.0,0.0,0.0,-376.0,0.0,0.0,0.0,0.0,3.0,1.0,1.0,1.0,0.0,1.0,0.0,0.0,0.0,0.0,0.0,0.0,0.0,0.0,0.0,1.0,0.0,0.0,0.0,0.0,0.0,0.0,0.0,0.0,0.0,0.0,0.0,0.0,0.0,0.0,0.0,0.0,0.0,0.0,3.0,27675.0,,628200.0,467797.5,0.0,0.0,0.0,0.0,-868.0,689.0,-40.0,-380.0,79.0,-13.0,6.0,5752.62,24738.75,24468.75,2475.0,58230.0,24.0,-376.0,365243.0,-520.0,-400.0,-92.0,-395.0,14.0,0.0,0.0500208768267223,-1.0,15.0,10.0,10.0,-16.0,0.0,0.0,14.0,13666.815,18904.095,-458.0,-445.0,2.0,1.0,0.0,,,,,,,,,,,,,,,,,,,,,8339763519.0,184277394904.5,165476322697.5,51930543610.935,1863.0,1704.0,71124.0,70699.0,9140.0,505640.0,,,,,,,128302.0,662273.0,,,,13517074.350684524,-601405020.0,-921172693.0,-296254866.0,-1533976995.0416667,43974.0,30674.0,,,,,,,67389.13517476339,157915.78528259226,126009.19016756587,,,,,,,3711314.0,,,,,,,,,,,,,,,,436132.0,430932.0,1262008.0,6419.823464002896,631450.0,625009.0,,,,,,,,,29.0,19228000.814999998,,1739480057.235,602631501.48,21659755.86,586225.35,37.0,5134.0,-5903567.0,2845829.0,-3043130.0,-3291731.0,-14.0,30393.0,,628200.0,467797.5,0.0,0.0,0.0,0.0,-868.0,689.0,-40.0,-380.0,67128725.11500001,954122337.0449996,1075049457.12,16139275.425000008,954147075.7949996,67945.0,-4798808.5,1105004813.0,47657758.0,242525193.0,112688439.0,252116076.0,68366.0,1093.0,194.80974254371023,1832718.0,584233.0,354796.0,-1157901.0,358491.0,2223.0,784006385.6699657,787097067.5699693,-47991475.5,-47601423.0,889766.0,38737.5,,,,,,,,,,,,,,,,,,,,,1466171.0,14734358.0,3229522.0,8547952.0,11597918.0,1414436.0,1057155239.547001,,72043408408.8596,21657552685.06512,581803046.036999,5792395.7475,689.5,94245.0,-276713521.0,21906956.5,-123697150.0,-218535240.5,-2014703.0,,,,,,,,,,,,,,,,,,,,,4269292.5,2477153.5,-8996352.0,921269.0,37582.5,3730443650.1449647,3654985557.5549617,-260424262.5,-257115949.5,2524487.5,268979.5,3923105552.527455,33230640124.44092,36657663914.40764,1728141963.9075494,48048168621.825714,3984815.0,-247392235.5,103001296102.5,1052934739.0,17261590264.5,3500884560.5,18875058415.5,3669113.0,71857.5,20855.352298618123,89740106.0,-34.493482572966855,4.5544,4.289636238846946,165.89727437688626,19.53671928620453,755.5625464220908,75000.0,-0.2225209339563143,0.9749279121818236,0.0,0.0,0.0,0.0,0.0,1.0,0.0,0.0,1.0,0.0,0.0,0.0,0.0,0.0,0.0,1.0,0.0,0.0,0.0,0.0,1.0,0.0,0.0,0.0,0.0,1.0,0.0,0.0,0.0,0.0,0.0,0.0,0.0,0.0,1.0,0.0,0.0,0.0,0.0,0.0,0.0,0.0,0.0,0.0,0.0,0.0,0.0,0.0,0.0,0.0,0.0,0.0,0.0,1.0,0.0,0.0,0.0,0.0,0.0,0.0,0.0,0.0,0.0,0.0,0.0,0.0,0.0,0.0,0.0,0.0,0.0,0.0,0.0,0.0,0.0,0.0,0.0,0.0,0.0,0.0,0.0,0.0,0.0,0.0,0.0,0.0,0.0,0.0,0.0,0.0,0.0,0.0,0.0,0.0,0.0,0.0,0.0,0.0,0.0,0.0,0.0,0.0,0.0,0.0,0.0,0.0,0.0,0.0,0.0,0.0,0.0,0.0,0.0,0.0,0.0,0.0,0.0,0.0,0.0,0.0
101126,0,0.0,0.0,0.0,0.0,1.0,99000.0,431280.0,22149.0,360000.0,0.04622,39.624657534246566,-2812.0,-8513.0,-5206.0,,3.0,1.0,1.0,11.0,0.439441533036169,0.6597400615388779,0.6817058776720116,,,,,,,,,,,,,,,,,,,,,,,,,,,,,,,,,,,,,,,,,,,,,0.0,0.0,0.0,0.0,-2127.0,0.0,0.0,0.0,0.0,1.0,1.0,1.0,1.0,0.0,1.0,1.0,0.0,0.0,0.0,0.0,0.0,1.0,1.0,0.0,1.0,0.0,0.0,0.0,0.0,0.0,0.0,0.0,0.0,0.0,0.0,0.0,0.0,0.0,0.0,0.0,0.0,0.0,0.0,2.0,26550.0,0.0,132750.0,0.0,265500.0,0.0,0.0,0.0,-1236.0,9389.0,-609.5,-1178.0,82.0,-20.0,5.0,16626.96,85455.0,80716.5,7242.75,98955.0,6.0,-287.0,365243.0,-2081.0,-1961.0,-1931.0,-1959.0,11.0,1.0,0.083366593534541,-1.0,22.0,6.0,5.0,-66.5,0.0,0.0,20.0,16626.96,16626.96,-1998.0,-1976.0,4.0,1.0,0.0,,,,,,,,,,,,,,,,,,,,,8339785668.0,184277826184.5,165476682697.5,51930642610.935,1863.0,1704.0,71124.0,70700.0,9140.0,505641.0,,,,,,,128303.0,662276.0,,,,13517113.97534206,-601407832.0,-921177899.0,-296256993.0,-1533985508.0416667,43974.0,30674.0,,,,,,,67389.57461629642,157916.44502265382,126009.87187344355,,,,,,,3711325.0,,,,,,,,,,,,,,,,436132.0,430932.0,,6419.869684002895,631451.0,625010.0,,,,,,,,,41.0,19269747.314999998,5197163.984999999,1741023107.235,603309439.98,21925255.86,586225.35,37.0,5134.0,-5906320.0,2855979.0,-3043767.0,-3292909.0,-20.0,26550.0,0.0,0.0,0.0,265500.0,0.0,0.0,0.0,-1570.0,9389.0,-1178.0,-1178.0,67187594.97,954831030.7949996,1075844024.37,16153265.925000008,954831030.7949996,67999.0,-4802228.0,1106100542.0,47655074.0,242885561.0,112686962.0,252476453.0,68436.0,1095.0,194.99526208798667,1832966.0,584465.0,354969.0,-1158418.0,358491.0,2223.0,784791001.4849657,788151683.3849691,-48004830.0,-47614476.5,889825.5,38767.5,,,,,,,,,,,,,,,,,,,,,1466173.0,14734440.0,3229522.0,8547974.0,11597938.0,1414441.0,1057181789.547001,801281239.627495,72043541158.8596,21657552685.06512,582068546.036999,5792395.7475,689.5,94245.0,-276714757.0,21916345.5,-123697759.5,-218536418.5,-2014723.0,,,,,,,,,,,,,,,,,,,,,4269298.5,2477158.5,-8996418.5,921269.0,37582.5,3730460277.1049647,3655002184.5149617,-260426260.5,-257117925.5,2524491.5,268980.5,3923122179.487456,33230725579.44092,36657744630.90764,1728149206.6575494,48048267576.825714,3984821.0,-247392522.5,103001661345.5,1052932658.0,17261588303.5,3500882629.5,18875056456.5,3669124.0,71858.5,20855.43566521166,89740105.0,-70.9659130194289,4.356363636363636,4.469727752945957,177.11143148180102,19.471759447379117,771.5617996916278,33000.0,-0.2225209339563146,-0.9749279121818236,0.0,0.0,0.0,0.0,0.0,0.0,1.0,0.0,1.0,0.0,0.0,0.0,0.0,0.0,0.0,0.0,0.0,0.0,1.0,0.0,1.0,0.0,0.0,0.0,0.0,1.0,0.0,0.0,0.0,0.0,0.0,0.0,0.0,0.0,0.0,0.0,0.0,0.0,0.0,0.0,0.0,0.0,0.0,0.0,0.0,0.0,0.0,0.0,0.0,0.0,0.0,0.0,0.0,1.0,0.0,0.0,0.0,0.0,0.0,0.0,0.0,0.0,0.0,0.0,0.0,0.0,0.0,0.0,0.0,0.0,0.0,0.0,0.0,0.0,0.0,0.0,0.0,0.0,0.0,0.0,0.0,0.0,0.0,0.0,0.0,0.0,0.0,0.0,0.0,0.0,0.0,0.0,0.0,0.0,0.0,0.0,0.0,0.0,0.0,0.0,0.0,0.0,0.0,0.0,0.0,0.0,0.0,0.0,0.0,0.0,0.0,0.0,0.0,0.0,0.0,0.0,0.0,0.0,0.0,0.0
101128,0,0.0,1.0,1.0,1.0,0.0,337500.0,675000.0,69165.0,675000.0,0.00963,47.41643835616439,-4870.0,-635.0,-820.0,3.0,2.0,2.0,2.0,11.0,,0.7462131793813276,0.6496203111237195,,,,,,,,,,,,,,,,,,,,,,,,,,,,,,,,,,,,,,,,,,,,,0.0,0.0,0.0,0.0,-598.0,0.0,0.0,0.0,0.0,0.0,0.0,1.0,1.0,0.0,1.0,0.0,0.0,1.0,1.0,1.0,1.0,1.0,1.0,0.0,1.0,0.0,0.0,0.0,0.0,0.0,0.0,0.0,0.0,0.0,0.0,0.0,0.0,0.0,0.0,0.0,0.0,0.0,0.0,6.0,0.0,3015.0,213186.33,0.0,0.0,0.0,0.0,0.0,-1579.5,-888.0,-863.5,-888.0,318.0,-30.0,3.0,46703.3625,450000.0,473760.0,0.0,562027.5,15.0,-357.0,365243.0,-445.0,182533.0,-25.0,182536.0,10.0,0.5,0.0,-1.0,26.0,18.0,9.0,-10.0,0.0,0.0,27.0,43136.055,15521.445,-288.0,-293.0,6.0,2.0,0.0,,,,,,,,,,,,,,,,,,,,,8339854833.0,184278501184.5,165477357697.5,51930980110.935,1863.0,1704.0,71124.0,70700.0,9140.0,505641.0,,,,,,,128303.0,662278.0,,,,13517161.391780416,-601412702.0,-921178719.0,-296257591.0,-1533986143.0416667,43974.0,30674.0,,,,,,,,157917.19123583313,126010.52149375466,,,,,,,3711336.0,,,,,,,,,,,,,,,,436132.0,430932.0,1262011.0,6419.879314002896,631453.0,625012.0,,,,,,,,,52.5,19376154.314999998,5205007.484999999,1745590474.3950002,603766185.48,21925255.86,586225.35,37.0,5134.0,-5912955.0,2872302.0,-3046569.5,-3295010.0,-25.75,0.0,6030.0,156372.66,0.0,0.0,0.0,0.0,0.0,-2244.0,-888.0,-885.0,-888.0,67353581.9925,957832463.2949996,1079095782.87,16158580.425000008,957495435.7949996,68134.0,-4810478.0,1107743607.5,47648768.5,243249147.5,113048578.5,252840072.5,68572.0,1097.0,195.11461842211705,1833215.0,585856.0,355820.0,-1160246.0,358491.0,2223.0,786498447.779966,789814666.4849696,-48066450.0,-47675356.0,890791.0,38864.0,,,,,,,,,,,,,,,,,,,,,1466179.0,14734758.0,3229522.0,8548000.0,11597965.0,1414444.0,1057181789.547001,801284254.627495,72043754345.1896,21657552685.06512,582068546.036999,5792395.7475,689.5,94245.0,-276716336.5,21915457.5,-123698623.0,-218537306.5,-2014753.0,,,,,,,,,,,,,,,,,,,,,4269316.5,2477167.5,-8996428.5,921269.0,37582.5,3730503413.159965,3655017705.959962,-260426548.5,-257118218.5,2524497.5,268982.5,3923168882.849956,33231175579.44092,36658218390.90764,1728149206.6575494,48048829604.325714,3984836.0,-247392879.5,103002026588.5,1052932213.0,17261770836.5,3500882604.5,18875238992.5,3669134.0,71859.0,20855.43566521166,89740104.0,-102.70699716877564,2.0,4.879635653871178,231.3749431823246,9.759271307742356,462.7498863646492,168750.0,-0.2225209339563143,0.9749279121818236,0.0,0.0,0.0,0.0,0.0,0.0,1.0,0.0,0.0,0.0,0.0,0.0,0.0,1.0,0.0,0.0,0.0,0.0,1.0,0.0,1.0,0.0,0.0,0.0,0.0,1.0,0.0,0.0,0.0,0.0,0.0,0.0,0.0,0.0,0.0,0.0,0.0,0.0,0.0,0.0,0.0,0.0,0.0,0.0,0.0,0.0,0.0,0.0,0.0,0.0,0.0,0.0,0.0,0.0,0.0,0.0,0.0,0.0,0.0,0.0,0.0,0.0,0.0,0.0,0.0,0.0,0.0,0.0,0.0,0.0,0.0,0.0,0.0,0.0,0.0,0.0,0.0,0.0,0.0,0.0,0.0,0.0,0.0,0.0,0.0,0.0,0.0,0.0,1.0,0.0,0.0,0.0,0.0,0.0,0.0,0.0,0.0,0.0,0.0,0.0,0.0,0.0,0.0,0.0,0.0,0.0,0.0,0.0,0.0,0.0,0.0,0.0,0.0,0.0,0.0,0.0,0.0,0.0,0.0,0.0
101136,0,0.0,0.0,1.0,1.0,0.0,94500.0,104256.0,11358.0,90000.0,0.002042,24.34246575342466,-1392.0,-3455.0,-1556.0,8.0,1.0,3.0,3.0,12.0,0.5240696598698944,0.1048850600448158,,,,,,,,,,,,,,,,,,,,,,,,,,,,,,,,,,,,,,,,,,,,,,7.0,0.0,7.0,0.0,-468.0,,,,,,,1.0,1.0,0.0,1.0,0.0,1.0,0.0,0.0,0.0,0.0,0.0,0.0,0.0,1.0,0.0,0.0,0.0,0.0,0.0,0.0,0.0,0.0,0.0,0.0,0.0,0.0,0.0,0.0,0.0,0.0,0.0,0.0,0.0,,,,,,,,,,,,,0.0,,6.0,13456.575,77850.0,75451.5,3735.0,81000.0,6.0,-306.0,365243.0,-326.5,-191.5,-116.5,-182.0,13.5,0.0,0.0544545454545454,360.0,21.0,6.0,4.0,-15.0,0.0,0.0,27.0,12455.1,12455.1,-165.0,-163.0,4.0,1.0,6.0,0.0,0.0,0.0,0.0,0.0,0.0,0.0,238.5,238.5,0.0,0.0,0.0,0.0,0.0,0.0,0.0,0.0,-3.5,0.0,0.0,8339866191.0,184278605440.5,165477447697.5,51931074610.935,,,,,,,,,,,,,128303.0,662279.0,,,,13517185.734246168,-601414094.0,-921180275.0,-296258059.0,-1533989598.0416667,43974.0,30674.0,,,,,,,67390.09868595628,157917.2961208932,,,,,,,,3711348.0,,,,,,,,,,,,,,,,436139.0,430939.0,1262019.0,6419.881356002896,631456.0,625015.0,,,,,,,,,,,,,,,,,,,,,,,,,,,,,,,,,,,67666806.53999999,961320395.2949996,1083003078.87,16209304.425000008,961320395.2949996,68511.0,-4839843.5,1115045986.0,47626505.0,244695152.0,113403054.0,254286186.5,68913.0,1107.0,195.92846019621345,1842008.0,589286.0,358036.0,-1168825.0,358538.0,2270.0,791666758.3949664,795597692.5799705,-48574577.0,-48179118.0,897752.0,39163.0,803233757.565001,1979104500.0,67544727.75,104914553.35500002,4142606.4,33191132.17500002,45177705.045,112654420.9200006,104108406.0749996,770596773.5699984,800005645.9799997,800036247.9149997,3477.0,8147.0,62.0,4608.0,261545.0,-439064.0,148400.0,408.0,1466179.0,14734758.0,3229528.0,8548021.0,11597992.0,1414450.0,,,,,,,,,,,,,,5917286110.972461,18702832500.0,198640970.325,447459150.3524976,1948107.735,256476077.7525008,308837664.56249875,635898051.9899982,458656607.8124992,5702628482.055029,5880604604.377498,5880847787.122498,13369.5,80737.0,44.0,70259.5,970724.5,-1696848.5,177364.0,6755.0,4269322.5,2477171.5,-8996443.5,921269.0,37582.5,3730515868.259965,3655030161.059962,-260426713.5,-257118381.5,2524501.5,268983.5,3923182339.424955,33231253429.44092,36658293842.40764,1728152941.6575494,48048910604.325714,3984842.0,-247393185.5,103002391831.5,1052931886.5,17261770645.0,3500882488.0,18875238810.5,3669147.5,71859.0,20855.49011975712,89740464.0,-57.18401800787844,1.1032380952380951,8.320126782884309,202.53240127651264,9.179080824088748,223.4414606082973,94500.0,0.6234898018587334,-0.7818314824680299,0.0,0.0,0.0,0.0,0.0,0.0,1.0,0.0,0.0,0.0,0.0,0.0,0.0,1.0,0.0,0.0,1.0,0.0,0.0,0.0,0.0,0.0,1.0,0.0,0.0,0.0,0.0,0.0,0.0,1.0,0.0,0.0,0.0,0.0,0.0,0.0,0.0,0.0,0.0,0.0,0.0,0.0,0.0,0.0,0.0,0.0,0.0,0.0,0.0,0.0,0.0,0.0,0.0,1.0,0.0,0.0,0.0,0.0,0.0,0.0,0.0,0.0,0.0,0.0,0.0,0.0,0.0,0.0,0.0,0.0,0.0,0.0,0.0,0.0,0.0,0.0,0.0,0.0,0.0,0.0,0.0,0.0,0.0,0.0,0.0,0.0,0.0,0.0,0.0,0.0,0.0,0.0,0.0,0.0,0.0,0.0,0.0,0.0,0.0,0.0,0.0,0.0,0.0,0.0,0.0,0.0,0.0,0.0,0.0,0.0,0.0,0.0,0.0,0.0,0.0,0.0,0.0,0.0,0.0,0.0
101140,1,0.0,0.0,0.0,0.0,0.0,112500.0,450000.0,35554.5,450000.0,0.018634,33.30958904109589,-4636.0,-5729.0,-3648.0,,2.0,2.0,2.0,12.0,,0.4948085192895179,0.213966852261798,,,,,,,,,,,,,,,,,,,,,,,,,,,,,,,,,,,,,,,,,,,,,0.0,0.0,0.0,0.0,-365.0,0.0,0.0,0.0,0.0,1.0,0.0,1.0,1.0,0.0,1.0,1.0,0.0,0.0,0.0,0.0,0.0,1.0,1.0,0.0,0.0,0.0,0.0,0.0,0.0,1.0,0.0,0.0,0.0,0.0,0.0,0.0,0.0,0.0,0.0,0.0,0.0,0.0,0.0,34.0,0.0,0.0,51882.75,0.0,0.0,0.0,0.0,0.0,-1250.5,-472.0,-544.5,-876.0,1234.0,-20.0,2.0,4455.3600000000015,62997.75,69412.5,0.0,62997.75,9.0,-365.0,365243.0,182454.5,365243.0,182709.5,365243.0,19.0,0.0,0.0,2000.0,12.0,18.0,12.5,-6.5,0.0,0.0,12.0,6660.72,6660.72,-174.5,-169.0,6.5,1.0,12.0,0.0,180000.0,,0.0,,,0.0,,0.0,0.0,0.0,0.0,,0.0,,,0.0,-6.5,0.0,0.0,8339901745.5,184279055440.5,165477897697.5,51931187110.935,1863.0,1704.0,71124.0,70701.0,9140.0,505641.0,,,,,,,128303.0,662281.0,,,,13517219.04383521,-601418730.0,-921183923.0,-296258424.0,-1533995327.0416667,43974.0,30674.0,,,,,,,,157917.7909294125,126010.73546060691,,,,,,,3711360.0,,,,,,,,,,,,,,,,436139.0,430939.0,,6419.899990002896,631458.0,625017.0,,,,,,,,,41.5,19420443.314999998,5239853.819999998,1758576743.64,606658137.48,22091755.86,586225.35,38.0,5134.0,-5988436.5,2944054.0,-3085258.5,-3341557.5,-20.25,0.0,0.0,126553.5,0.0,0.0,0.0,0.0,0.0,-1358.0,-979.0,-608.0,-1206.0,67934230.28999999,964461815.2349997,1086449831.37,16246482.61500001,964461815.2349997,68812.0,-4866641.5,1120522117.5,48703325.0,246688819.5,114852640.0,256647044.5,69377.5,1111.0,196.6751713692217,1851284.0,591205.0,359274.5,-1173322.5,358563.0,2295.0,793952247.2849674,797970196.6199714,-48829909.5,-48433244.0,902766.5,39579.5,803444295.0150009,1987677000.0,,105020438.35500002,,,45206813.02500001,,104232819.8249996,770789655.5399983,800213901.2099999,800244503.145,,8153.0,,,262203.0,-442325.5,148400.0,408.0,1466213.0,14735992.0,3229540.0,8548033.0,11598004.0,1414452.0,1057181789.547001,801284254.627495,72043806227.9396,21657552685.06512,582068546.036999,5792395.7475,689.5,94245.0,-276717587.0,21914985.5,-123699167.5,-218538182.5,-2014773.0,5917286110.972461,18703012500.0,,447459150.3524976,,,308837664.56249875,,458656607.8124992,5702628482.055029,5880604604.377498,5880847787.122498,,80737.0,,,970724.5,-1696855.0,177364.0,6755.0,4269340.5,2477184.0,-8996450.0,921269.0,37582.5,3730522528.979964,3655036821.7799616,-260426888.0,-257118550.5,2524508.0,268984.5,3923186794.784957,33231316427.19092,36658363254.90764,1728152941.6575494,48048973602.075714,3984851.0,-247393550.5,103002757074.5,1053114341.0,17262135888.0,3501065197.5,18875604053.5,3669166.5,71859.0,20855.49011975712,89742464.0,-139.17914130613588,4.0,3.1641564358941907,105.39675054137416,12.656625743576765,421.5870021654966,56250.0,0.6234898018587336,0.7818314824680298,0.0,0.0,0.0,0.0,0.0,0.0,1.0,0.0,0.0,0.0,0.0,0.0,0.0,1.0,0.0,0.0,0.0,0.0,1.0,0.0,1.0,0.0,0.0,0.0,0.0,1.0,0.0,0.0,0.0,0.0,0.0,0.0,0.0,0.0,0.0,0.0,0.0,0.0,1.0,0.0,0.0,0.0,0.0,0.0,0.0,0.0,0.0,0.0,0.0,0.0,0.0,0.0,0.0,0.0,0.0,0.0,0.0,0.0,0.0,0.0,0.0,0.0,0.0,0.0,0.0,0.0,0.0,0.0,0.0,0.0,0.0,0.0,0.0,0.0,0.0,0.0,0.0,0.0,0.0,0.0,0.0,0.0,0.0,0.0,0.0,0.0,0.0,0.0,0.0,0.0,0.0,0.0,0.0,0.0,0.0,0.0,0.0,0.0,0.0,0.0,0.0,1.0,0.0,0.0,0.0,0.0,0.0,0.0,0.0,0.0,0.0,0.0,0.0,0.0,0.0,0.0,0.0,0.0,0.0,0.0
101149,0,0.0,0.0,0.0,0.0,0.0,135000.0,407520.0,24930.0,360000.0,0.00963,51.813698630136976,,-2133.0,-2437.0,,1.0,2.0,2.0,11.0,,0.1679388683584478,,0.1351,0.1602,0.9826,,,0.0,0.3103,0.1667,0.2083,,0.1101,0.1235,0.0,0.0,0.1376,0.1662,0.9826,,,0.0,0.3103,0.1667,0.2083,,0.1203,0.1287,0.0,0.0,0.1364,0.1602,0.9826,,,0.0,0.3103,0.1667,0.2083,,0.112,0.1257,0.0,0.0,0.1074,1.0,0.0,0.0,0.0,0.0,0.0,,,,,,,1.0,0.0,0.0,1.0,1.0,0.0,0.0,0.0,0.0,0.0,0.0,0.0,0.0,1.0,0.0,0.0,0.0,0.0,0.0,0.0,0.0,0.0,0.0,0.0,0.0,0.0,0.0,0.0,0.0,0.0,0.0,0.0,0.0,,,,,,,,,,,,,0.0,,2.0,12782.5425,82390.5,76536.0,13191.75,82390.5,9.0,-1299.5,365243.0,-1268.5,-1043.5,-1028.5,-1039.0,14.0,0.0,0.1372521901817442,875.0,18.0,11.0,4.5,-58.5,0.0,0.0,17.0,5425.65,5425.65,-1773.0,-1767.0,5.0,1.0,0.0,,,,,,,,,,,,,,,,,,,,,8339926675.5,184279462960.5,165478257697.5,51931322110.935,,,,,,,17794.47170000229,17856.557699999106,17308.385399998082,11287.420500000086,11225.25090000009,11172.799100000057,128303.0,662282.0,,,,13517270.85753384,,-921186360.0,-296258424.0,-1533997460.0416667,43974.0,30674.0,11341.533199999174,11217.43999999897,10702.0423999973,22870.767500009628,22792.633800009597,22178.691700008145,,157917.95886828087,,34972.90750002788,34913.32410002833,34359.88300002873,22936.495099995933,22909.942599995506,22557.331699995742,3711371.0,,,,9810.89040000072,9925.76470000216,10285.16959999965,16456.474699999755,16641.5623999997,16238.5377999997,828.176200000176,813.3557000000459,759.3431000000132,3910.465200000124,3893.700900000161,3726.503000000158,436139.0,430939.0,,6419.909620002895,631460.0,625019.0,,16320.2654999998,154059.01219999054,154061.75669999007,153953.54639998716,,,,,,,,,,,,,,,,,,,,,,,,,,,,,,68322207.68999998,968076113.2199996,1090745427.1049998,16329554.86500001,968076113.2199996,69115.0,-4890066.0,1127826185.5,48684932.5,247955026.5,115207705.5,258278613.0,69779.5,1121.0,197.84397452957248,1856797.0,594718.5,361398.5,-1178147.5,358564.0,2296.0,799108200.9899758,802878995.9249793,-49166964.0,-48767795.0,914943.0,39804.0,,,,,,,,,,,,,,,,,,,,,1466213.0,14735992.0,3229540.0,8548051.0,11598021.0,1414454.0,,,,,,,,,,,,,,,,,,,,,,,,,,,,,,,,,,4269351.5,2477188.5,-8996508.5,921269.0,37582.5,3730527954.629965,3655042247.4299617,-260428661.0,-257120317.5,2524513.0,268985.5,3923199577.327457,33231398817.69092,36658439790.90764,1728166133.4075494,48049055992.575714,3984860.0,-247394850.0,103003122317.5,1053113072.5,17262134844.5,3501064169.0,18875603014.5,3669180.5,71859.0,20855.627371947296,89743339.0,,3.018666666666667,5.415162454873647,280.57959547005584,16.346570397111915,846.9762721922754,135000.0,-0.2225209339563143,0.9749279121818236,0.0,0.0,0.0,0.0,0.0,0.0,1.0,0.0,0.0,1.0,0.0,0.0,0.0,0.0,0.0,0.0,0.0,0.0,1.0,0.0,0.0,1.0,0.0,0.0,0.0,1.0,0.0,0.0,0.0,0.0,0.0,0.0,0.0,0.0,0.0,0.0,0.0,0.0,0.0,0.0,0.0,0.0,0.0,0.0,0.0,0.0,0.0,0.0,0.0,0.0,0.0,0.0,0.0,0.0,0.0,0.0,0.0,0.0,0.0,0.0,0.0,0.0,0.0,0.0,0.0,0.0,0.0,0.0,0.0,0.0,0.0,0.0,0.0,0.0,0.0,0.0,0.0,0.0,0.0,0.0,0.0,0.0,0.0,0.0,0.0,0.0,0.0,0.0,0.0,0.0,0.0,0.0,0.0,0.0,0.0,0.0,0.0,0.0,0.0,0.0,0.0,0.0,0.0,0.0,0.0,1.0,0.0,0.0,1.0,0.0,1.0,0.0,0.0,0.0,0.0,0.0,0.0,0.0,1.0,0.0
101160,0,0.0,0.0,0.0,1.0,0.0,225000.0,573408.0,31234.5,495000.0,0.009549,59.35342465753425,,-6858.0,-5226.0,,1.0,2.0,2.0,12.0,,0.4375317570961017,,0.0165,,0.9707,,,,0.1034,0.0417,,0.0262,,0.0176,,0.0,0.0168,,0.9707,,,,0.1034,0.0417,,0.0268,,0.0183,,0.0,0.0167,,0.9707,,,,0.1034,0.0417,,0.0266,,0.0179,,0.0,0.0157,1.0,0.0,0.0,0.0,0.0,-391.0,,,,,,,1.0,0.0,0.0,1.0,0.0,0.0,0.0,0.0,0.0,0.0,0.0,0.0,0.0,0.0,0.0,0.0,1.0,0.0,0.0,0.0,0.0,0.0,0.0,0.0,0.0,0.0,0.0,0.0,0.0,0.0,0.0,0.0,0.0,,,,,,,,,,,,,0.0,,4.0,6165.315,22500.0,22500.0,,90000.0,12.0,-339.5,365243.0,-360.0,-240.0,330.0,-233.0,11.0,0.0,,-1.0,6.0,24.0,21.5,-10.5,0.0,0.0,5.0,10080.63,10080.63,-302.0,-300.0,3.0,1.0,0.0,,,,,,,,,,,,,,,,,,,,,8339957910.0,184280036368.5,165478752697.5,51931547110.935,,,,,,,17794.48820000229,17856.574399999106,17308.40219999808,,,,128303.0,662283.0,,,,13517330.210958498,,-921191586.0,-296258815.0,-1534004318.0416667,43974.0,30674.0,,,,22870.870900009628,22792.737200009597,22178.795100008145,,157918.39640003798,,34972.949200027884,34913.36580002833,34359.924700028736,,,,3711383.0,8289.573900000169,8394.006900000079,8117.771100000227,,,,16456.492299999754,16641.5802999997,16238.5560999997,,,,3910.465200000124,3893.700900000161,3726.503000000158,436139.0,430939.0,,6419.919169002896,631462.0,625021.0,,16320.2811999998,154059.98289999054,154062.72739999008,153954.51709998716,,,,,,,,,,,,,,,,,,,,,,,,,,,,,,68800540.50000001,974368224.7199996,1097666724.1049998,,974345724.7199996,69693.0,-4928184.0,1138235611.0,49023513.0,250125106.0,115556741.0,260448962.0,70306.5,1129.0,,1865212.5,598234.5,363753.0,-1186089.0,358599.0,2307.0,802788813.8099757,806633761.3199794,-49376270.0,-48975208.0,916230.0,40044.0,,,,,,,,,,,,,,,,,,,,,1466213.0,14735992.0,3229540.0,8548057.0,11598026.0,1414458.0,,,,,,,,,,,,,,,,,,,,,,,,,,,,,,,,,,4269375.5,2477210.0,-8996519.0,921269.0,37582.5,3730538035.259965,3655052328.059962,-260428963.0,-257120617.5,2524516.0,268986.5,3923205742.642456,33231421317.69092,36658462290.90764,,48049145992.575714,3984872.0,-247395189.5,103003487560.5,1053112712.5,17262134604.5,3501064499.0,18875602781.5,3669191.5,71859.0,,89743338.0,,2.54848,7.203572972194206,427.556725670179,18.358161648177497,1089.6197642359375,225000.0,0.6234898018587336,0.7818314824680298,0.0,0.0,0.0,0.0,0.0,0.0,1.0,0.0,0.0,1.0,0.0,0.0,0.0,0.0,0.0,0.0,0.0,0.0,1.0,0.0,0.0,0.0,1.0,0.0,0.0,0.0,1.0,0.0,0.0,0.0,0.0,0.0,0.0,0.0,0.0,0.0,0.0,0.0,0.0,0.0,0.0,0.0,0.0,0.0,0.0,0.0,0.0,0.0,0.0,0.0,0.0,0.0,0.0,0.0,0.0,0.0,0.0,0.0,0.0,0.0,0.0,0.0,0.0,0.0,0.0,0.0,0.0,0.0,0.0,0.0,0.0,0.0,0.0,0.0,0.0,0.0,0.0,0.0,0.0,0.0,0.0,0.0,0.0,0.0,0.0,0.0,0.0,0.0,0.0,0.0,0.0,0.0,0.0,0.0,0.0,0.0,0.0,0.0,0.0,0.0,0.0,0.0,0.0,0.0,0.0,1.0,0.0,0.0,0.0,0.0,1.0,0.0,0.0,0.0,0.0,0.0,0.0,0.0,1.0,0.0
101169,0,0.0,1.0,1.0,1.0,0.0,225000.0,717021.0,52308.0,612000.0,0.010032,56.0958904109589,-1949.0,-2999.0,-4011.0,20.0,2.0,2.0,2.0,3.0,,0.1696446898638028,,,,,,,,,,,,,,,,,,,,,,,,,,,,,,,,,,,,,,,,,,,,,,3.0,0.0,3.0,0.0,-1821.0,0.0,0.0,0.0,0.0,0.0,4.0,1.0,1.0,0.0,1.0,1.0,0.0,0.0,0.0,0.0,0.0,1.0,1.0,0.0,1.0,0.0,0.0,0.0,0.0,0.0,0.0,0.0,0.0,0.0,0.0,0.0,0.0,0.0,0.0,0.0,0.0,0.0,0.0,1.0,14454.0,,454500.0,0.0,,0.0,0.0,0.0,-2822.0,-1726.0,-2196.0,-2198.0,93.0,-46.0,9.0,13567.59,87705.0,274288.5,0.0,236250.0,6.0,-1438.0,365243.0,-1021.0,-991.0,-545.0,-983.0,7.0,1.0,0.0,1.0,53.0,42.0,20.0,-29.0,0.0,0.0,130.0,19264.86,17932.455,-373.0,-373.0,20.0,0.0,22.0,16382.52,900000.0,0.0,39905.4375,0.0,11414.25,2727.3375,40295.43,40295.43,16028.64,17182.845,17182.845,0.0,3.0,0.0,2.0,8.5,-11.5,0.0,0.0,8340010218.0,184280753389.5,165479364697.5,51931772110.935,1863.0,1704.0,71124.0,70701.0,9140.0,505645.0,,,,,,,128303.0,662285.0,,,,13517386.306848908,-601420679.0,-921195597.0,-296260636.0,-1534007317.0416667,43974.0,30674.0,,,,,,,,157918.56604472786,,,,,,,,3711386.0,,,,,,,,,,,,,,,,436142.0,430942.0,1262039.0,6419.929201002896,631464.0,625023.0,,,,,,,,,93.0,19632773.834999997,,1791212093.4600005,619477151.3100003,,586231.47,40.0,5138.0,-6098261.0,3112547.0,-3146872.0,-3397985.0,-46.0,14454.0,,454500.0,0.0,,0.0,0.0,0.0,-2822.0,-1726.0,-2196.0,-2198.0,69398698.81500001,985832559.7199996,1110179730.1049998,16528979.11500001,985788707.2199996,70317.0,-4958449.0,1146634878.0,49005738.0,251208561.0,116282793.0,261898322.0,70962.0,1137.0,201.3531097942974,1870818.0,602867.0,367092.0,-1190804.0,358609.0,2317.0,809942527.9574738,814667339.0024779,-49516685.0,-49113311.0,919800.0,40332.0,817289095.3425014,2029887000.0,68505477.75,106863320.65500002,4147241.4,34172246.295000024,46009874.11499997,114564893.53500016,105728867.86499964,784174845.6224985,814041768.0824997,814072370.0174997,3506.0,8459.0,63.0,4890.0,266039.5,-452747.5,148418.0,408.0,1466214.0,14736085.0,3229562.0,8548110.0,11598156.0,1414467.0,1057196243.547001,,72044260727.9396,21657552685.06512,,5792395.7475,689.5,94245.0,-276720409.0,21913259.5,-123701363.5,-218540380.5,-2014819.0,5917302493.492461,18703912500.0,198640970.325,447499055.7899976,1948107.735,256487492.0025008,308840391.89999866,635938347.4199983,458696903.2424992,5702644510.695029,5880621787.222498,5880864969.967499,13369.5,80740.0,44.0,70261.5,970733.0,-1696866.5,177364.0,6755.0,4269417.5,2477230.0,-8996548.0,921269.0,37582.5,3730557300.119965,3655070260.5149617,-260429336.0,-257120990.5,2524536.0,268986.5,3923219310.232456,33231509022.69092,36658736579.40764,1728166133.4075494,48049382242.575714,3984878.0,-247396627.5,103003852803.5,1053111691.5,17262133613.5,3501063954.0,18875601798.5,3669198.5,71860.0,20855.627371947296,89743339.0,-34.744078144078145,3.18676,4.301445285615967,241.2934033506491,13.70767377838954,768.9441660617147,112500.0,-0.9009688679024191,0.4338837391175582,0.0,0.0,0.0,0.0,0.0,0.0,1.0,0.0,0.0,0.0,0.0,0.0,0.0,1.0,0.0,0.0,0.0,0.0,1.0,0.0,1.0,0.0,0.0,0.0,0.0,1.0,0.0,0.0,0.0,0.0,0.0,0.0,0.0,0.0,0.0,0.0,0.0,0.0,1.0,0.0,0.0,0.0,0.0,0.0,0.0,0.0,0.0,0.0,0.0,0.0,0.0,0.0,0.0,0.0,0.0,0.0,0.0,0.0,0.0,0.0,0.0,0.0,0.0,0.0,0.0,0.0,0.0,0.0,0.0,0.0,0.0,0.0,0.0,0.0,0.0,0.0,0.0,0.0,0.0,0.0,0.0,0.0,0.0,0.0,0.0,0.0,0.0,0.0,0.0,0.0,0.0,0.0,0.0,0.0,0.0,0.0,0.0,0.0,0.0,0.0,0.0,0.0,1.0,0.0,0.0,0.0,0.0,0.0,0.0,0.0,0.0,0.0,0.0,0.0,0.0,0.0,0.0,0.0,0.0,0.0
101181,0,0.0,0.0,0.0,1.0,3.0,225000.0,1085058.0,52330.5,891000.0,0.0038179999999999,45.336986301369855,-3686.0,-4393.0,-103.0,,5.0,2.0,2.0,4.0,0.6372280857247977,0.5613630412628833,0.5638350489514956,0.0021,,0.9925,,,,,0.0,,,,,,,0.0021,,0.9926,,,,,0.0,,,,,,,0.0021,,0.9925,,,,,0.0,,,,,,,0.0016,1.0,0.0,0.0,0.0,0.0,-419.0,0.0,0.0,0.0,0.0,1.0,2.0,1.0,1.0,0.0,1.0,1.0,0.0,0.0,0.0,0.0,0.0,0.0,0.0,0.0,1.0,0.0,0.0,0.0,0.0,0.0,0.0,0.0,0.0,0.0,0.0,0.0,0.0,0.0,0.0,0.0,0.0,0.0,0.0,6.0,10190.79,0.0,133740.0,17316.0,0.0,0.0,0.0,0.0,-398.0,73.5,-209.0,-410.0,87.0,-7.0,11.0,13992.9975,0.0,0.0,3372.75,105642.0,24.0,-236.0,365243.0,-389.0,-239.0,1021.0,-233.0,7.0,0.0,0.0499983851747908,-1.0,16.0,9.0,7.5,-71.5,0.0,0.0,15.0,7999.92,7999.92,-2146.0,-2149.0,4.0,1.0,13.0,0.0,90000.0,,0.0,,,0.0,,0.0,0.0,0.0,0.0,,0.0,,,0.0,-8.0,0.0,0.0,8340062548.5,184281838447.5,165480255697.5,51931997110.935,1863.0,1704.0,71124.0,70702.0,9140.0,505647.0,17794.490300002293,17856.576499999108,17308.40429999808,,,,128306.0,662290.0,,,,13517431.64383521,-601424365.0,-921195700.0,-296261055.0,-1534011710.0416667,43974.0,30674.0,,,,,,,67390.735914042,157919.1274077691,126011.29929565586,34972.949200027884,34913.36580002833,34359.924700028736,,,,3711390.0,,,,,,,,,,,,,,,,436142.0,430942.0,,6419.933019002896,631466.0,625025.0,,16320.2827999998,154060.97539999054,154063.71989999007,153955.50969998716,,,,13.5,19702572.929999992,5369369.04,1817340771.1500003,626733550.9800003,23224632.21,586231.47,40.0,5138.0,-6209688.5,3137248.5,-3211775.0,-3463428.0,-6.25,10190.79,0.0,135000.0,0.0,0.0,0.0,0.0,0.0,-653.0,-288.0,-410.0,-410.0,70278444.76499999,995869247.2199996,1121870955.1049998,16748781.61500001,996064889.2199996,71119.0,-5016527.0,1159416752.0,49696523.0,254101941.0,117720239.0,264791922.0,71649.0,1154.0,203.78800212339135,1899854.0,609683.5,371141.5,-1203354.5,358749.0,2327.0,822530094.6599759,826762913.2799793,-49943629.0,-49536196.0,925586.0,40808.0,823081230.3600012,2059398000.0,,107945278.92000002,,,46363972.31999997,,106598105.27999976,789811679.6099987,819821079.4949995,819851681.4299996,,8561.0,,,266412.0,-459416.0,148418.0,408.0,1466220.0,14736172.0,3229575.0,8548126.0,11598171.0,1414478.0,1057206434.337001,801284254.627495,72044394467.9396,21657570001.06512,582068546.036999,5792395.7475,689.5,94245.0,-276720807.0,21913333.0,-123701572.5,-218540790.5,-2014826.0,5917302493.492461,18704002500.0,,447499055.7899976,,,308840391.89999866,,458696903.2424992,5702644510.695029,5880621787.222498,5880864969.967499,,80740.0,,,970733.0,-1696874.5,177364.0,6755.0,4269426.5,2477237.5,-8996619.5,921269.0,37582.5,3730565300.0399647,3655078260.434962,-260431482.0,-257123139.5,2524540.0,268987.5,3923233303.229956,33231509022.69092,36658736579.40764,1728169506.1575494,48049487884.575714,3984902.0,-247396863.5,103004218046.5,1053111302.5,17262133374.5,3501064975.0,18875601565.5,3669205.5,71860.0,20855.67737033247,89743338.0,-81.3022721779067,4.8224800000000005,4.2995958379912285,194.9307176084352,20.734714936795942,940.0494870523268,45000.0,0.6234898018587336,0.7818314824680298,0.0,0.0,0.0,0.0,0.0,0.0,1.0,0.0,0.0,0.0,0.0,0.0,0.0,1.0,0.0,1.0,0.0,0.0,0.0,0.0,1.0,0.0,0.0,0.0,0.0,1.0,0.0,0.0,0.0,0.0,0.0,0.0,0.0,0.0,0.0,0.0,0.0,0.0,1.0,0.0,0.0,0.0,0.0,0.0,0.0,0.0,0.0,0.0,0.0,0.0,0.0,0.0,0.0,1.0,0.0,0.0,0.0,0.0,0.0,0.0,0.0,0.0,0.0,0.0,0.0,0.0,0.0,0.0,0.0,0.0,0.0,0.0,0.0,0.0,0.0,0.0,0.0,0.0,0.0,0.0,0.0,0.0,0.0,0.0,0.0,0.0,0.0,0.0,0.0,0.0,0.0,0.0,0.0,0.0,0.0,0.0,0.0,0.0,0.0,0.0,0.0,0.0,0.0,0.0,0.0,0.0,0.0,0.0,0.0,0.0,0.0,0.0,0.0,0.0,0.0,0.0,0.0,0.0,0.0,0.0
101186,0,0.0,0.0,1.0,1.0,0.0,157500.0,305640.0,33043.5,270000.0,0.010032,43.93150684931507,-1529.0,-4232.0,-5095.0,16.0,2.0,2.0,2.0,10.0,0.4979962610810048,0.571635826695548,0.6940926425266661,,,,,,,,,,,,,,,,,,,,,,,,,,,,,,,,,,,,,,,,,,,,,0.0,0.0,0.0,0.0,-361.0,0.0,0.0,0.0,0.0,0.0,1.0,1.0,1.0,0.0,1.0,1.0,1.0,0.0,0.0,0.0,0.0,0.0,0.0,0.0,1.0,0.0,0.0,0.0,0.0,0.0,0.0,0.0,0.0,0.0,0.0,0.0,0.0,0.0,0.0,0.0,0.0,0.0,0.0,6.0,19228.5,0.0,213750.0,0.0,22500.0,0.0,0.0,0.0,-612.5,833.5,-71.0,-272.5,113.0,-9.0,1.0,27155.25,336315.96,269050.5,67265.46,336315.96,12.0,-361.0,365243.0,-327.0,-237.0,3.0,-232.0,6.0,0.0,0.2178255262754052,80.0,5.0,12.0,10.0,-10.0,0.0,0.0,5.0,27155.25,112189.5,-269.0,-267.0,3.0,1.0,0.0,,,,,,,,,,,,,,,,,,,,,8340095592.0,184282144087.5,165480525697.5,51932154610.935,1863.0,1704.0,71124.0,70702.0,9140.0,505648.0,,,,,,,128306.0,662292.0,,,,13517475.57534206,-601425894.0,-921200795.0,-296261416.0,-1534015942.0416667,43974.0,30674.0,,,,,,,67391.23391030308,157919.6990435958,126011.9933882984,,,,,,,3711400.0,,,,,,,,,,,,,,,,436142.0,430942.0,1262055.0,6419.943051002895,631468.0,625027.0,,,,,,,,,21.0,19780380.71999999,5369369.04,1822351138.6500003,628623483.4800003,23449632.21,586231.47,40.0,5138.0,-6230362.5,3150634.5,-3219802.0,-3472422.0,-10.0,19228.5,0.0,202500.0,0.0,45000.0,0.0,0.0,0.0,-613.0,95.0,-27.0,-430.0,70404484.49999999,998435911.6799996,1124713906.6049998,16837246.57500001,998435911.6799996,71323.0,-5026932.0,1162703939.0,50055371.0,254827532.0,117718946.0,265517544.0,71807.0,1158.0,204.38937623461564,1901611.0,610767.0,371895.0,-1205656.0,358749.0,2327.0,824815479.4649737,829166381.1899773,-50165824.0,-49757469.0,930763.0,40894.0,,,,,,,,,,,,,,,,,,,,,1466226.0,14736285.0,3229575.0,8548131.0,11598176.0,1414479.0,1057225662.837001,801284254.627495,72044608217.9396,21657570001.06512,582091046.036999,5792395.7475,689.5,94245.0,-276721419.5,21914166.5,-123701643.5,-218541063.0,-2014835.0,,,,,,,,,,,,,,,,,,,,,4269438.5,2477247.5,-8996629.5,921269.0,37582.5,3730592455.2899647,3655190449.934962,-260431751.0,-257123406.5,2524543.0,268988.5,3923260458.479956,33231845338.65092,36659005629.90764,1728236771.6175494,48049824200.53571,3984914.0,-247397224.5,103004583289.5,1053110975.5,17262133137.5,3501064978.0,18875601333.5,3669211.5,71860.0,20855.895195858742,89743418.0,-34.804178359837856,1.9405714285714288,4.766444232602479,209.3970774514541,9.249625493667438,406.3499857286503,78750.0,1.0,0.0,0.0,0.0,0.0,0.0,0.0,0.0,1.0,0.0,1.0,0.0,0.0,0.0,0.0,0.0,0.0,1.0,0.0,0.0,0.0,0.0,1.0,0.0,0.0,0.0,0.0,1.0,0.0,0.0,0.0,0.0,1.0,0.0,0.0,0.0,0.0,0.0,0.0,0.0,0.0,0.0,0.0,0.0,0.0,0.0,0.0,0.0,0.0,0.0,0.0,0.0,0.0,0.0,0.0,0.0,0.0,0.0,0.0,0.0,0.0,0.0,0.0,0.0,0.0,0.0,0.0,0.0,0.0,0.0,0.0,0.0,0.0,0.0,0.0,0.0,0.0,0.0,0.0,0.0,0.0,0.0,0.0,0.0,0.0,0.0,0.0,0.0,0.0,0.0,0.0,0.0,0.0,0.0,0.0,0.0,0.0,0.0,0.0,0.0,0.0,0.0,0.0,1.0,0.0,0.0,0.0,0.0,0.0,0.0,0.0,0.0,0.0,0.0,0.0,0.0,0.0,0.0,0.0,0.0,0.0,0.0
101190,0,0.0,0.0,1.0,0.0,1.0,135000.0,252000.0,11227.5,252000.0,0.018209,43.638356164383566,-1982.0,-3212.0,-1202.0,31.0,3.0,3.0,3.0,10.0,0.4197548023131129,0.4448799639131193,0.3842068130556564,,,,,,,,,,,,,,,,,,,,,,,,,,,,,,,,,,,,,,,,,,,,,5.0,0.0,5.0,0.0,0.0,0.0,0.0,0.0,0.0,1.0,2.0,1.0,1.0,0.0,1.0,0.0,0.0,0.0,0.0,0.0,0.0,0.0,0.0,0.0,1.0,0.0,0.0,0.0,0.0,0.0,0.0,0.0,0.0,0.0,0.0,0.0,0.0,0.0,0.0,0.0,0.0,0.0,0.0,8.0,0.0,0.0,62021.25,0.0,0.0,0.0,0.0,0.0,-586.5,-76.5,-70.5,-876.0,242.0,-19.5,2.0,8022.5775,47371.5,118809.0,0.0,94743.0,6.0,-1508.5,181273.5,-1469.5,181599.5,182643.0,365243.0,10.5,0.5,0.0,400.0,18.0,12.0,5.5,-9.5,0.0,0.0,117.0,358.65,358.65,-1466.0,-1466.0,41.0,0.0,89.0,0.0,135000.0,0.0,0.0,0.0,0.0,0.0,358.65,0.0,0.0,0.0,0.0,0.0,0.0,0.0,0.0,8.0,-45.0,0.0,0.0,8340106819.5,184282396087.5,165480777697.5,51932289610.935,1863.0,1704.0,71124.0,70703.0,9140.0,505650.0,,,,,,,128307.0,662295.0,,,,13517519.213698223,-601427876.0,-921201997.0,-296261416.0,-1534019154.0416667,43974.0,30674.0,,,,,,,67391.65366510539,157920.14392355972,126012.37759511144,,,,,,,3711410.0,,,,,,,,,,,,,,,,436147.0,430947.0,1262086.0,6419.961260002896,631471.0,625030.0,,,,,,,,,20.0,19802907.71999999,5369369.04,1824310148.4000003,628961633.6850003,23472132.21,586231.47,40.0,5138.0,-6244560.0,3150146.0,-3225214.5,-3478125.0,-9.5,0.0,0.0,43884.0,0.0,0.0,0.0,0.0,0.0,-1633.0,-1268.0,-1175.0,-1178.0,70824503.5425,1003534965.1799996,1130521062.1049998,16842853.57500001,1003582336.6799996,71728.0,-5056416.5,1166899623.5,50038406.5,255362666.5,118441218.5,266786040.5,72188.5,1162.5,204.4617692606347,1910980.0,612631.0,373128.5,-1210051.0,358789.0,2367.0,827681066.6399742,831942871.7399777,-50452098.0,-50042173.0,936424.0,41013.0,829113189.8400009,2077137000.0,68988777.75,108343528.92000002,4147241.4,35169154.560000025,46725460.69499997,116340140.88000052,107369166.95999976,795555852.5249982,825848744.0849996,825879346.0199996,3543.0,8592.0,63.0,4986.0,269325.0,-468187.0,148422.0,412.0,1466234.0,14736527.0,3229664.0,8548149.0,11598293.0,1414481.0,1057225662.837001,801284254.627495,72044670239.1896,21657570001.06512,582091046.036999,5792395.7475,689.5,94245.0,-276722006.0,21914090.0,-123701714.0,-218541939.0,-2014854.5,5917302493.492461,18704137500.0,198640970.325,447499055.7899976,1948107.735,256487492.0025008,308840391.89999866,635938706.0699981,458696903.2424992,5702644510.695029,5880621787.222498,5880864969.967499,13369.5,80740.0,44.0,70261.5,970741.0,-1696919.5,177364.0,6755.0,4269450.5,2477253.0,-8996639.0,921269.0,37582.5,3730592813.939965,3655190808.584962,-260433217.0,-257124872.5,2524584.0,268988.5,3923268481.057456,33231892710.15092,36659124438.90764,1728236771.6175494,48049918943.53571,3984920.0,-247398733.0,103004764563.0,1053109506.0,17262314737.0,3501247621.0,18875966576.5,3669222.0,71860.5,20855.895195858742,89743818.0,-45.418759417378205,1.8666666666666667,12.024048096192384,524.7096933593214,22.444889779559123,979.4580942707332,45000.0,-0.2225209339563143,0.9749279121818236,0.0,0.0,0.0,0.0,0.0,0.0,1.0,0.0,0.0,0.0,0.0,0.0,0.0,1.0,0.0,0.0,0.0,0.0,1.0,0.0,1.0,0.0,0.0,0.0,0.0,1.0,0.0,0.0,0.0,0.0,0.0,0.0,0.0,0.0,0.0,0.0,0.0,0.0,0.0,0.0,0.0,0.0,0.0,0.0,1.0,0.0,0.0,0.0,0.0,0.0,0.0,0.0,0.0,1.0,0.0,0.0,0.0,0.0,0.0,0.0,0.0,0.0,0.0,0.0,0.0,0.0,0.0,0.0,0.0,0.0,0.0,0.0,0.0,0.0,0.0,0.0,0.0,0.0,0.0,0.0,0.0,0.0,0.0,0.0,0.0,0.0,0.0,0.0,0.0,0.0,0.0,0.0,0.0,0.0,0.0,0.0,0.0,0.0,0.0,0.0,0.0,0.0,0.0,0.0,0.0,0.0,0.0,0.0,0.0,0.0,0.0,0.0,0.0,0.0,0.0,0.0,0.0,0.0,0.0,0.0
101193,0,0.0,1.0,0.0,1.0,1.0,94500.0,364896.0,22450.5,315000.0,0.035792,26.136986301369863,-206.0,-4248.0,-2219.0,,3.0,2.0,2.0,12.0,0.4198258515800346,0.6015656151748854,,,,,,,,,,,,,,,,,,,,,,,,,,,,,,,,,,,,,,,,,,,,,,0.0,0.0,0.0,0.0,-757.0,,,,,,,1.0,1.0,0.0,1.0,0.0,0.0,0.0,0.0,0.0,0.0,0.0,0.0,0.0,1.0,0.0,0.0,0.0,0.0,0.0,0.0,0.0,0.0,0.0,0.0,0.0,0.0,0.0,0.0,0.0,0.0,0.0,0.0,0.0,,,,,,,,,,,,,0.0,,3.0,9437.31,116505.0,129604.5,0.0,148252.5,30.0,-41.0,365243.0,-726.0,-36.0,-36.0,-30.0,13.0,0.0,0.0,-1.0,24.0,24.0,12.5,-13.5,0.0,0.0,24.0,5969.205,5969.205,-391.5,-381.0,12.5,1.0,0.0,,,,,,,,,,,,,,,,,,,,,8340129270.0,184282760983.5,165481092697.5,51932384110.935,,,,,,,,,,,,,128308.0,662298.0,,,,13517545.350684524,-601428082.0,-921204216.0,-296262173.0,-1534023402.0416667,43974.0,30674.0,,,,,,,67392.07349095697,157920.74548917488,,,,,,,,3711422.0,,,,,,,,,,,,,,,,436147.0,430947.0,,6419.997052002896,631473.0,625032.0,,,,,,,,,,,,,,,,,,,,,,,,,,,,,,,,,,,71091473.60250002,1006454233.0799996,1133747152.6049998,16876244.47500001,1006395980.5799996,71952.0,-5084787.0,1172560890.0,50380778.0,255892213.0,118788975.0,267315671.0,72435.0,1169.0,205.09846354391544,1912316.0,614920.0,374382.5,-1218375.0,358837.0,2372.0,831163976.9774753,835610955.0524777,-50781191.0,-50369504.0,939908.5,41249.5,,,,,,,,,,,,,,,,,,,,,1466234.0,14736527.0,3229664.0,8548173.0,11598317.0,1414484.0,,,,,,,,,,,,,,,,,,,,,,,,,,,,,,,,,,4269474.5,2477265.5,-8996652.5,921269.0,37582.5,3730598783.1449647,3655196777.789962,-260433608.5,-257125253.5,2524596.5,268989.5,3923277918.367456,33232009215.15092,36659254043.40764,1728236771.6175494,48050067196.03571,3984950.0,-247398774.0,103005129806.0,1053108780.0,17262314701.0,3501247585.0,18875966546.5,3669235.0,71860.5,20855.895195858742,89743817.0,-7.881551362683438,3.8613333333333335,4.2092603728202045,110.01738070330067,16.25335738624975,424.8137793556784,31500.0,0.6234898018587336,0.7818314824680298,0.0,1.0,0.0,0.0,0.0,0.0,0.0,0.0,0.0,0.0,0.0,0.0,0.0,1.0,0.0,0.0,0.0,0.0,1.0,0.0,1.0,0.0,0.0,0.0,0.0,1.0,0.0,0.0,0.0,0.0,0.0,0.0,0.0,0.0,0.0,0.0,0.0,0.0,0.0,0.0,0.0,0.0,0.0,0.0,0.0,0.0,0.0,0.0,0.0,0.0,0.0,0.0,0.0,1.0,0.0,0.0,0.0,0.0,0.0,0.0,0.0,0.0,0.0,0.0,0.0,0.0,0.0,0.0,0.0,0.0,0.0,0.0,0.0,0.0,0.0,0.0,0.0,0.0,0.0,0.0,0.0,0.0,0.0,0.0,0.0,0.0,0.0,0.0,0.0,0.0,0.0,0.0,0.0,0.0,0.0,0.0,0.0,0.0,0.0,0.0,0.0,0.0,0.0,0.0,0.0,0.0,0.0,0.0,0.0,0.0,0.0,0.0,0.0,0.0,0.0,0.0,0.0,0.0,0.0,0.0
101194,0,0.0,0.0,1.0,0.0,2.0,67500.0,343800.0,11871.0,225000.0,0.030755,34.21095890410959,-3781.0,-6628.0,-2407.0,22.0,4.0,2.0,2.0,15.0,0.1709923476993232,0.189677159012256,0.5406544504453575,0.0402,0.0635,0.9762,0.6736,0.0241,0.0,0.1034,0.125,,0.0376,0.0303,0.0307,0.0116,0.0537,0.041,0.0659,0.9762,0.6864,0.0243,0.0,0.1034,0.125,,0.0385,0.0331,0.032,0.0117,0.0568,0.0406,0.0635,0.9762,0.6779999999999999,0.0242,0.0,0.1034,0.125,,0.0383,0.0308,0.0313,0.0116,0.0548,0.049,1.0,0.0,0.0,0.0,0.0,-1827.0,0.0,0.0,0.0,0.0,0.0,2.0,1.0,1.0,1.0,1.0,1.0,0.0,0.0,0.0,0.0,0.0,0.0,0.0,0.0,1.0,0.0,0.0,0.0,0.0,0.0,0.0,0.0,0.0,0.0,0.0,0.0,0.0,0.0,0.0,0.0,0.0,0.0,0.0,11.0,0.0,,36337.5,0.0,0.0,0.0,0.0,0.0,-1267.0,-992.0,-940.0,-1213.0,474.0,-22.0,4.0,2379.51,17820.0,15367.5,1840.5,17955.0,10.0,-1933.5,365243.0,-1949.5,-1739.5,-1739.5,-1735.5,13.0,0.0,0.1089090909090909,47.0,18.0,10.0,4.0,-61.5,0.0,0.0,16.0,2379.51,2379.51,-1908.0,-1880.0,4.5,1.0,0.0,,,,,,,,,,,,,,,,,,,,,8340141141.0,184283104783.5,165481317697.5,51932451610.935,1863.0,1704.0,71124.0,70703.0,9140.0,505652.0,17794.530500002293,17856.617099999108,17308.445299998082,11287.484000000086,11225.31440000009,11172.865000000056,128310.0,662302.0,4135.518000000124,4133.158300000016,3943.951400000096,13517579.56164343,-601431863.0,-921206623.0,-296264000.0,-1534030030.0416667,43974.0,30674.0,11341.533199999174,11217.43999999897,10702.0423999973,22870.974300009628,22792.8406000096,22178.898500008145,67392.24448330468,157920.93516633392,126012.91824956187,34973.074200027884,34913.49080002833,34360.049700028736,,,,3711437.0,8289.611500000168,8394.045200000079,8117.809600000227,9810.92070000072,9925.79550000216,10285.202699999649,16456.522999999754,16641.6115999997,16238.5880999997,828.1878000001759,813.3673000000459,759.3548000000133,3910.518900000124,3893.755700000161,3726.5598000001582,436147.0,430947.0,1262108.0,6420.027807002895,631475.0,625034.0,,16320.3317999998,154061.95159999054,154064.69609999008,153956.48589998714,77552.51479999626,77890.04400000659,78291.13230000647,42.0,19828287.71999999,,1825860171.8250003,629018531.2350003,23472132.21,586321.47,40.0,5168.0,-6263374.0,3141485.0,-3237142.0,-3488222.0,-20.5,0.0,,36337.5,0.0,0.0,0.0,0.0,0.0,-1519.5,-1291.0,-1210.0,-1213.0,71099125.29000004,1006490323.0799996,1133780947.6049998,16879853.47500001,1006490323.0799996,71984.0,-5089251.0,1173108754.5,50377776.0,255889556.0,118786318.0,267313020.5,72477.5,1169.0,205.3087494058508,1912409.5,615291.0,374537.0,-1219111.0,358837.0,2372.0,831252838.0949755,835699816.1699783,-50802214.5,-50390195.5,940113.5,41269.5,,,,,,,,,,,,,,,,,,,,,1466245.0,14737001.0,3229664.0,8548191.0,11598333.0,1414488.0,1057225662.837001,,72044706576.6896,21657570001.06512,582091046.036999,5792395.7475,689.5,94245.0,-276723273.0,21913098.0,-123702654.0,-218543152.0,-2014876.5,,,,,,,,,,,,,,,,,,,,,4269484.5,2477269.5,-8996714.0,921269.0,37582.5,3730601162.654965,3655199157.2999625,-260435516.5,-257127133.5,2524601.0,268990.5,3923280297.877456,33232027035.15092,36659269410.90764,1728238612.1175494,48050085151.03571,3984960.0,-247400707.5,103005495049.0,1053106830.5,17262312961.5,3501245845.5,18875964811.0,3669248.0,71860.5,20856.00410494965,89743864.0,-110.52014094658443,5.093333333333334,5.686125852918877,194.5278178778028,28.96133434420015,990.7950190576088,16875.0,0.6234898018587336,0.7818314824680298,0.0,1.0,0.0,0.0,0.0,0.0,0.0,0.0,0.0,0.0,0.0,0.0,0.0,1.0,0.0,0.0,0.0,0.0,1.0,0.0,1.0,0.0,0.0,0.0,0.0,1.0,0.0,0.0,0.0,0.0,0.0,0.0,0.0,0.0,0.0,0.0,0.0,0.0,0.0,0.0,0.0,0.0,0.0,0.0,0.0,0.0,0.0,0.0,0.0,0.0,0.0,0.0,0.0,0.0,0.0,0.0,0.0,0.0,0.0,0.0,0.0,0.0,0.0,0.0,0.0,0.0,0.0,0.0,0.0,0.0,0.0,0.0,0.0,0.0,0.0,0.0,0.0,0.0,0.0,0.0,0.0,0.0,0.0,0.0,0.0,0.0,0.0,1.0,0.0,0.0,0.0,0.0,0.0,0.0,0.0,0.0,0.0,0.0,0.0,0.0,0.0,0.0,0.0,0.0,0.0,0.0,0.0,0.0,0.0,0.0,1.0,0.0,0.0,0.0,0.0,0.0,0.0,0.0,1.0,0.0
101198,0,0.0,1.0,0.0,1.0,1.0,135000.0,405000.0,37273.5,405000.0,0.032561,33.10410958904109,-1644.0,-6187.0,-4278.0,,2.0,1.0,1.0,12.0,,0.6252070094646313,0.2366108235287817,,,0.9851,0.7959999999999999,0.0296,0.16,0.069,0.4583,,0.0229,,0.2689,,0.0,,,0.9851,0.804,0.0098,0.1611,0.069,0.4583,,0.0,,0.2464,,0.0,,,0.9851,0.7987,0.0298,0.16,0.069,0.4583,,0.0233,,0.2832,,0.0,0.1913,1.0,5.0,0.0,5.0,0.0,0.0,0.0,0.0,0.0,0.0,5.0,3.0,1.0,1.0,0.0,1.0,0.0,0.0,0.0,0.0,0.0,0.0,0.0,0.0,0.0,1.0,0.0,0.0,0.0,0.0,0.0,0.0,0.0,0.0,0.0,0.0,0.0,0.0,0.0,0.0,0.0,0.0,0.0,0.0,1.0,,,81897.48,74409.3,,0.0,0.0,0.0,-83.0,283.0,-31.0,,3.0,-1.0,11.0,7488.405000000002,45000.0,45000.0,6012.0,60120.0,9.0,-372.0,365243.0,-585.5,-255.5,-255.5,-250.5,15.0,0.0,0.0894859128559911,2400.0,32.0,12.0,5.0,-20.5,0.0,0.0,36.0,6461.595,5467.77,-631.0,-631.0,5.0,1.0,12.0,0.0,45000.0,,0.0,,,0.0,,0.0,0.0,0.0,0.0,,0.0,,,0.0,-7.5,0.0,0.0,8340178414.5,184283509783.5,165481722697.5,51932586610.935,1863.0,1704.0,71124.0,70708.0,9140.0,505655.0,,,,,,,128311.0,662304.0,4135.547600000124,4133.188100000017,3943.9612000000952,13517612.665753018,-601433507.0,-921210901.0,-296264000.0,-1534036217.0416667,43974.0,30674.0,11341.693199999176,11217.599999998967,10702.203499997298,22871.043300009627,22792.90960000959,22178.967500008144,,157921.56037334335,126013.15486038545,34973.53250002788,34913.94910002833,34360.50800002873,,,,3711449.0,8289.634400000168,8394.068500000081,8117.809600000227,,,,16456.791899999753,16641.8947999997,16238.8344999997,,,,3910.518900000124,3893.755700000161,3726.5598000001582,436152.0,430952.0,,6420.060368002895,631476.0,625035.0,,16320.5230999998,154062.93669999053,154065.68119999007,153957.47099998716,77553.31079999628,77890.84270000659,78291.93630000648,3.0,,,1831380170.8050003,630613592.5500003,,586321.47,41.0,5168.0,-6293133.0,3163846.0,-3254548.0,,-1.0,,,81897.48,74409.3,,0.0,0.0,0.0,-83.0,283.0,-31.0,,71379793.41750006,1010587723.8299996,1137864886.6049998,17002167.97500001,1010520223.8299996,72331.0,-5109506.0,1178222066.5,51100738.5,257710799.5,119513900.5,269134366.5,72954.0,1169.0,206.41355525483223,1966261.0,616548.0,375270.0,-1221803.5,358844.0,2379.0,832560686.5724733,836978373.5624763,-50880658.0,-50467674.5,940694.0,41376.5,829362424.5900009,2084809500.0,,108703474.92000002,,,46732278.19499997,,107621234.45999976,795792858.1199982,826095848.0849997,826126450.0199997,,8595.0,,,269635.0,-470221.0,148422.0,412.0,1466246.0,14737004.0,3229676.0,8548223.0,11598369.0,1414499.0,,,72044788474.1696,21657644410.36512,,5792395.7475,689.5,94245.0,-276723356.0,21913381.0,-123702685.0,,-2014877.5,5917302493.492461,18704182500.0,,447499055.7899976,,,308840391.89999866,,458696903.2424992,5702644510.695029,5880621787.222498,5880864969.967499,,80740.0,,,970741.0,-1696927.0,177364.0,6755.0,4269496.5,2477274.5,-8996734.5,921269.0,37582.5,3730607624.2499647,3655204625.0699625,-260436147.5,-257127764.5,2524606.0,268991.5,3923287786.282456,33232072035.15092,36659314410.90764,1728244624.1175494,48050145271.03571,3984969.0,-247401079.5,103005860292.0,1053106245.0,17262312706.0,3501245590.0,18875964560.5,3669263.0,71860.5,20856.09359086251,89746264.0,-49.66150790366631,3.0,3.621876131836291,119.89898438624084,10.865628395508873,359.6969531587225,67500.0,0.6234898018587336,0.7818314824680298,0.0,0.0,0.0,0.0,0.0,0.0,1.0,0.0,1.0,0.0,0.0,0.0,0.0,0.0,0.0,0.0,0.0,0.0,1.0,0.0,0.0,0.0,1.0,0.0,0.0,1.0,0.0,0.0,0.0,0.0,0.0,0.0,0.0,0.0,0.0,0.0,1.0,0.0,0.0,0.0,0.0,0.0,0.0,0.0,0.0,0.0,0.0,0.0,0.0,0.0,0.0,0.0,1.0,0.0,0.0,0.0,0.0,0.0,0.0,0.0,0.0,0.0,0.0,0.0,0.0,0.0,0.0,0.0,0.0,0.0,0.0,0.0,0.0,0.0,0.0,0.0,0.0,0.0,0.0,0.0,0.0,0.0,0.0,0.0,0.0,0.0,0.0,0.0,0.0,0.0,0.0,0.0,0.0,0.0,0.0,0.0,0.0,0.0,0.0,0.0,0.0,0.0,0.0,0.0,0.0,0.0,0.0,0.0,0.0,0.0,1.0,0.0,0.0,0.0,0.0,0.0,0.0,0.0,1.0,0.0
101200,0,0.0,0.0,0.0,0.0,0.0,292500.0,270000.0,17253.0,270000.0,0.032561,42.72054794520548,-8540.0,-9674.0,-4818.0,,1.0,1.0,1.0,18.0,,0.7179512737440328,0.3506958432829587,0.268,0.193,0.9816,,,0.28,0.2414,0.3333,,0.27,,0.2707,,0.0152,0.2731,0.2003,0.9816,,,0.282,0.2414,0.3333,,0.2761,,0.2821,,0.0161,0.2706,0.193,0.9816,,,0.28,0.2414,0.3333,,0.2747,,0.2756,,0.0155,0.2163,1.0,0.0,0.0,0.0,0.0,-3172.0,0.0,0.0,0.0,0.0,1.0,5.0,1.0,1.0,0.0,1.0,1.0,0.0,0.0,0.0,0.0,0.0,1.0,1.0,0.0,0.0,0.0,0.0,0.0,0.0,1.0,0.0,0.0,0.0,0.0,0.0,0.0,0.0,0.0,0.0,0.0,0.0,0.0,0.0,7.0,0.0,,236146.5,0.0,0.0,0.0,0.0,0.0,-2445.0,-2050.0,-641.0,-2212.5,452.0,-38.0,8.0,20500.3125,23715.0,21343.5,4743.0,450000.0,27.0,-441.0,182271.0,-810.0,182204.0,182219.0,182207.0,16.0,0.0,0.1089090909090909,-1.0,10.0,6.0,2.0,-31.5,0.0,0.0,63.0,4388.625,4388.625,-447.0,-447.0,27.0,0.0,23.0,116859.285,450000.0,0.0,16828.29,0.0,16828.29,5893.335,10737.0225,9172.89,113901.435,116188.785,116188.785,0.0,2.0,0.0,2.0,10.0,-12.0,0.0,0.0,8340195667.5,184283779783.5,165481992697.5,51932879110.935,1863.0,1704.0,71124.0,70709.0,9140.0,505660.0,17794.798500002293,17856.887699999108,17308.71839999808,11287.677000000083,11225.50740000009,11173.065300000057,128311.0,662305.0,,,,13517655.386300962,-601442047.0,-921215719.0,-296267172.0,-1534045891.0416667,43974.0,30674.0,11341.973199999176,11217.87999999897,10702.4854999973,22871.28470000963,22793.15100000959,22179.208900008143,,157922.2783246171,126013.50555622872,34973.86580002789,34914.28240002833,34360.84130002873,,,,3711467.0,8289.904400000169,8394.343200000081,8118.085700000227,,,,16457.062599999754,16642.1703999997,16239.1165999997,,,,3910.534100000124,3893.771200000161,3726.5759000001576,436152.0,430952.0,,6420.092929002895,631477.0,625036.0,,16320.7393999998,154063.91829999056,154066.66279999007,153958.45259998715,,,,80.0,19859742.71999999,,1836319642.9650004,634582295.5500003,23606473.68,586321.47,41.0,5168.0,-6307554.0,3156176.0,-3261026.0,-3517535.5,-40.5,0.0,,116223.66,0.0,0.0,0.0,0.0,0.0,-2585.0,-2347.0,-904.0,-2347.0,71657043.27750008,1013146583.5799996,1140669750.1049998,17083104.97500001,1013371583.5799996,72532.0,-5126565.5,1181508552.5,51087969.5,258066083.5,119869199.5,269489719.5,73220.5,1172.0,207.46660523931664,1979989.5,617433.0,375715.0,-1225698.5,358852.0,2387.0,834456698.0999748,838534443.3449769,-51010373.0,-50596732.0,942076.0,41469.0,830587800.4200008,2090457000.0,69213777.75,108951408.09000003,4282187.4,35417087.73000003,46804420.21499998,116908420.50000076,107938195.42499976,796986130.0949984,827319496.3199995,827350098.2549995,3545.0,8623.0,64.0,5014.0,269758.0,-470399.0,148422.0,412.0,1466253.0,14737456.0,3229699.0,8548233.0,11598432.0,1414507.0,1057225662.837001,,72045024620.6696,21657644410.36512,582091046.036999,5792395.7475,689.5,94245.0,-276725801.0,21911331.0,-123703326.0,-218545364.5,-2014915.5,5917419352.777461,18704632500.0,198640970.325,447515884.07999766,1948107.735,256504320.2925008,308846285.2349987,635949443.0924982,458706076.1324992,5702758412.13003,5880737976.007498,5880981158.7525,13369.5,80742.0,44.0,70263.5,970751.0,-1696939.0,177364.0,6755.0,4269502.5,2477276.5,-8996766.0,921269.0,37582.5,3730612012.8749647,3655209013.6949625,-260436594.5,-257128211.5,2524633.0,268991.5,3923308286.594957,33232095750.15092,36659335754.40764,1728249367.1175494,48050595271.03571,3984996.0,-247401520.5,103006042563.0,1053105435.0,17262494910.0,3501427809.0,18876146767.5,3669279.0,71860.5,20856.20249995342,89746263.0,-199.90380298852048,0.9230769230769232,16.95357329160146,724.2659406464154,15.64945226917058,668.5531759813065,292500.0,-0.9009688679024191,-0.433883739117558,0.0,0.0,0.0,0.0,0.0,0.0,1.0,0.0,0.0,0.0,0.0,0.0,0.0,1.0,0.0,0.0,0.0,0.0,1.0,0.0,0.0,1.0,0.0,0.0,0.0,1.0,0.0,0.0,0.0,0.0,0.0,0.0,0.0,0.0,0.0,0.0,0.0,0.0,0.0,0.0,0.0,0.0,1.0,0.0,0.0,0.0,0.0,0.0,0.0,0.0,0.0,0.0,0.0,0.0,0.0,0.0,0.0,0.0,0.0,0.0,0.0,0.0,0.0,0.0,0.0,0.0,0.0,0.0,0.0,0.0,0.0,0.0,0.0,0.0,0.0,0.0,0.0,0.0,0.0,0.0,0.0,0.0,0.0,0.0,0.0,0.0,0.0,0.0,0.0,0.0,0.0,1.0,0.0,0.0,0.0,0.0,0.0,0.0,0.0,0.0,0.0,0.0,0.0,0.0,0.0,0.0,0.0,0.0,0.0,0.0,1.0,0.0,0.0,0.0,0.0,0.0,0.0,1.0,0.0,0.0
101204,0,0.0,1.0,1.0,0.0,1.0,180000.0,622413.0,30073.5,495000.0,0.035792,43.24383561643835,-2696.0,-1187.0,-4750.0,10.0,3.0,2.0,2.0,12.0,,0.7178627028002169,0.7503751495159068,,,,,,,,,,,,,,,,,,,,,,,,,,,,,,,,,,,,,,,,,,,,,4.0,1.0,4.0,1.0,0.0,0.0,0.0,0.0,0.0,1.0,0.0,1.0,1.0,0.0,1.0,0.0,0.0,0.0,0.0,0.0,0.0,1.0,1.0,0.0,1.0,0.0,0.0,0.0,0.0,0.0,0.0,0.0,0.0,0.0,0.0,0.0,0.0,0.0,0.0,0.0,0.0,0.0,0.0,2.0,0.0,0.0,136649.25,0.0,0.0,0.0,0.0,0.0,-1442.5,-377.0,-844.5,-848.0,96.0,-23.5,1.0,21968.775,239886.0,239886.0,0.0,239886.0,12.0,-438.0,365243.0,-408.0,-168.0,-78.0,-164.0,10.0,0.0,0.0,145.0,22.0,16.0,6.5,-85.5,0.0,0.0,21.0,3582.45,3582.45,-2625.0,-2617.0,8.0,1.0,0.0,,,,,,,,,,,,,,,,,,,,,8340225741.0,184284402196.5,165482487697.5,51933059110.935,1863.0,1704.0,71124.0,70710.0,9140.0,505660.0,,,,,,,128312.0,662308.0,,,,13517698.63013658,-601444743.0,-921220469.0,-296267172.0,-1534047078.0416667,43975.0,30675.0,,,,,,,,157922.9961873199,126014.25593137824,,,,,,,3711479.0,,,,,,,,,,,,,,,,436156.0,430956.0,1262118.0,6420.128721002896,631479.0,625038.0,,,,,,,,,48.0,19881738.71999999,5369481.09,1839192404.8050003,635416249.0500003,23689067.49,586321.47,41.0,5168.0,-6316948.0,3152021.5,-3266717.5,-3524282.5,-23.5,0.0,0.0,120298.5,0.0,0.0,0.0,0.0,0.0,-1838.0,-1533.0,-1533.0,-1533.0,71765939.65500008,1014336181.0799996,1142102095.6049998,17111724.97500001,1014336181.0799996,72610.0,-5131084.0,1183882632.0,51450454.0,258794742.0,120232869.0,270218394.0,73349.0,1173.0,207.7552234998977,1985311.0,617843.0,375931.5,-1226753.0,358852.0,2387.0,835356021.839974,839433767.0849763,-51044208.0,-50629887.0,943105.0,41512.0,,,,,,,,,,,,,,,,,,,,,1466255.0,14737552.0,3229699.0,8548255.0,11598453.0,1414508.0,1057225662.837001,801284254.627495,72045161269.9196,21657644410.36512,582091046.036999,5792395.7475,689.5,94245.0,-276727243.5,21910954.0,-123704170.5,-218546212.5,-2014939.0,,,,,,,,,,,,,,,,,,,,,4269518.5,2477283.0,-8996851.5,921269.0,37582.5,3730615595.324965,3655212596.144962,-260439219.5,-257130828.5,2524641.0,268992.5,3923330255.369956,33232335636.15092,36659575640.40764,1728249367.1175494,48050835157.03571,3985008.0,-247401958.5,103006407806.0,1053105027.0,17262494742.0,3501427731.0,18876146603.5,3669289.0,71860.5,20856.20249995342,89746408.0,-62.34414597060314,3.45785,5.985335926978903,258.8288829354383,20.696393835104,894.9914528583053,60000.0,-0.2225209339563143,0.9749279121818236,0.0,1.0,0.0,0.0,0.0,0.0,0.0,0.0,0.0,0.0,0.0,0.0,0.0,1.0,0.0,0.0,0.0,0.0,1.0,0.0,1.0,0.0,0.0,0.0,0.0,1.0,0.0,0.0,0.0,0.0,0.0,0.0,0.0,0.0,0.0,0.0,0.0,0.0,0.0,0.0,0.0,0.0,0.0,0.0,0.0,0.0,0.0,0.0,0.0,0.0,0.0,0.0,0.0,0.0,0.0,0.0,0.0,0.0,0.0,0.0,0.0,0.0,0.0,0.0,0.0,0.0,0.0,0.0,0.0,0.0,0.0,0.0,0.0,0.0,0.0,0.0,0.0,0.0,0.0,0.0,0.0,0.0,0.0,0.0,0.0,0.0,0.0,0.0,0.0,0.0,1.0,0.0,0.0,0.0,0.0,0.0,0.0,0.0,0.0,0.0,0.0,0.0,0.0,0.0,0.0,0.0,0.0,0.0,0.0,0.0,0.0,0.0,0.0,0.0,0.0,0.0,0.0,0.0,0.0,0.0
101211,0,0.0,0.0,0.0,0.0,0.0,198000.0,378706.5,19336.5,306000.0,0.019101,53.70958904109589,,-11918.0,-3139.0,,2.0,2.0,2.0,17.0,,0.3072174462013025,0.6296742509538716,,,,,,,,,,,,,,,,,,,,,,,,,,,,,,,,,,,,,,,,,,,,,5.0,0.0,5.0,0.0,-925.0,0.0,0.0,0.0,0.0,1.0,9.0,1.0,0.0,0.0,1.0,0.0,0.0,0.0,0.0,0.0,0.0,0.0,0.0,0.0,1.0,0.0,0.0,0.0,0.0,0.0,0.0,0.0,0.0,0.0,0.0,0.0,0.0,0.0,0.0,0.0,0.0,0.0,0.0,7.0,1829.25,,294750.0,106908.75,0.0,0.0,0.0,0.0,-1142.0,-164.0,-145.0,-1286.0,333.0,-23.0,8.0,7086.532499999998,14602.5,10602.0,7875.0,105747.75,24.0,-411.0,365243.0,-1530.5,-1350.5,-840.5,-1343.0,11.0,0.5,0.2789652503799476,-1.0,40.0,42.0,35.5,-19.5,0.0,0.0,32.0,9512.2575,9512.2575,-497.0,-472.0,4.5,1.0,0.0,,,,,,,,,,,,,,,,,,,,,8340245077.5,184284780903.0,165482793697.5,51933257110.935,1863.0,1704.0,71124.0,70711.0,9140.0,505669.0,,,,,,,128312.0,662310.0,,,,13517752.33972562,,-921223608.0,-296268097.0,-1534058996.0416667,43975.0,30675.0,,,,,,,,157923.3034047661,126014.88560562918,,,,,,,3711496.0,,,,,,,,,,,,,,,,436161.0,430961.0,,6420.147822002896,631481.0,625040.0,,,,,,,,,38.0,19889339.21999999,,1852227436.0950005,638378113.6800003,24034133.835,586321.47,41.0,5168.0,-6354610.0,3143824.0,-3285901.0,-3542335.0,-18.5,0.0,,294750.0,0.0,0.0,0.0,0.0,0.0,-1808.0,-712.0,-278.0,-1286.0,72147533.98500006,1020221168.1299996,1148903427.1049998,17262537.52500001,1020221168.1299996,73123.0,-5163229.5,1190638610.5,52160664.0,260606408.5,121316208.0,272030217.5,73796.0,1179.0,210.5418028092681,1989903.5,620039.0,377253.0,-1232974.5,358852.0,2387.0,838290563.3699738,842330981.6999763,-51229647.0,-50813537.0,946066.0,41675.0,,,,,,,,,,,,,,,,,,,,,1466262.0,14737885.0,3229699.0,8548295.0,11598485.0,1414516.0,1057227492.087001,,72045456019.9196,21657751319.11512,582091046.036999,5792395.7475,689.5,94245.0,-276728385.5,21910790.0,-123704315.5,-218547498.5,-2014962.0,,,,,,,,,,,,,,,,,,,,,4269560.5,2477318.5,-8996871.0,921269.0,37582.5,3730625107.5824647,3655222108.402464,-260439716.5,-257131300.5,2524645.5,268993.5,3923337341.902456,33232350238.65092,36659586242.40764,1728257242.1175494,48050940904.78571,3985032.0,-247402369.5,103006773049.0,1053103496.5,17262493391.5,3501426890.5,18876145260.5,3669300.0,71861.0,20856.4814652038,89746407.0,,1.9126590909090908,10.239702117756574,549.9701926479448,19.585059343728183,1051.905488697116,99000.0,-0.9009688679024191,-0.433883739117558,0.0,0.0,0.0,0.0,0.0,0.0,1.0,0.0,0.0,1.0,0.0,0.0,0.0,0.0,0.0,0.0,0.0,0.0,1.0,0.0,1.0,0.0,0.0,0.0,0.0,1.0,0.0,0.0,0.0,0.0,0.0,0.0,0.0,0.0,0.0,0.0,0.0,0.0,0.0,0.0,0.0,0.0,0.0,0.0,0.0,0.0,0.0,0.0,0.0,0.0,0.0,0.0,0.0,0.0,0.0,0.0,0.0,0.0,0.0,0.0,0.0,0.0,0.0,0.0,0.0,0.0,0.0,0.0,0.0,0.0,0.0,0.0,0.0,0.0,0.0,0.0,0.0,0.0,0.0,0.0,0.0,0.0,0.0,0.0,0.0,0.0,0.0,0.0,0.0,0.0,0.0,0.0,0.0,0.0,0.0,0.0,0.0,0.0,0.0,0.0,0.0,0.0,0.0,0.0,0.0,1.0,0.0,0.0,0.0,0.0,0.0,0.0,0.0,0.0,0.0,0.0,0.0,0.0,0.0,0.0
101213,0,0.0,0.0,0.0,1.0,1.0,90000.0,272520.0,16803.0,225000.0,0.020246,31.55890410958904,-2674.0,-499.0,-4162.0,,3.0,3.0,3.0,5.0,0.3226665642763258,0.5649942608905311,0.3016248916841194,,,,,,,,,,,,,,,,,,,,,,,,,,,,,,,,,,,,,,,,,,,,,5.0,0.0,5.0,0.0,-2865.0,0.0,0.0,0.0,0.0,0.0,1.0,1.0,1.0,1.0,1.0,1.0,0.0,0.0,0.0,0.0,0.0,0.0,0.0,0.0,1.0,0.0,0.0,0.0,0.0,0.0,0.0,0.0,0.0,0.0,0.0,0.0,0.0,0.0,0.0,0.0,0.0,0.0,0.0,20.0,0.0,0.0,74616.75,0.0,0.0,0.0,0.0,0.0,-1317.5,-963.0,-721.5,-1214.0,950.0,-25.0,1.0,13072.185,90000.0,110146.5,,90000.0,12.0,-697.0,365243.0,-667.0,-337.0,-337.0,-334.0,12.0,1.0,,-1.0,12.0,12.0,5.5,-16.5,0.0,0.0,13.0,9043.02,9043.02,-524.0,-517.0,6.0,3.0,0.0,,,,,,,,,,,,,,,,,,,,,8340261880.5,184285053423.0,165483018697.5,51933347110.935,1863.0,1704.0,71124.0,70711.0,9140.0,505670.0,,,,,,,128313.0,662313.0,,,,13517783.89862973,-601447417.0,-921227770.0,-296270962.0,-1534059495.0416667,43975.0,30675.0,,,,,,,67392.56714986895,157923.86839902698,126015.18723052088,,,,,,,3711501.0,,,,,,,,,,,,,,,,436166.0,430966.0,,6420.168068002896,631484.0,625043.0,,,,,,,,,44.0,19918440.71999999,5406413.984999999,1854840684.7350004,639412546.6800003,24034133.835,586321.47,41.0,5168.0,-6381076.0,3159287.0,-3297541.0,-3560590.0,-21.5,0.0,0.0,81733.5,0.0,0.0,0.0,0.0,0.0,-1833.0,-1177.0,-910.0,-1357.0,72292919.71500005,1022022077.1299996,1151077318.6049998,,1022022077.1299996,73300.0,-5178388.0,1194838905.0,52513486.0,261690942.0,121673072.0,273114814.0,73982.0,1183.0,,1993641.0,621624.0,378319.0,-1237001.5,358877.0,2387.0,839359703.924975,843377884.1999773,-51353460.0,-50936329.0,946738.0,41791.0,,,,,,,,,,,,,,,,,,,,,1466282.0,14738835.0,3229699.0,8548307.0,11598498.0,1414517.0,1057227492.087001,801284254.627495,72045530636.6696,21657751319.11512,582091046.036999,5792395.7475,689.5,94245.0,-276729703.0,21909827.0,-123705037.0,-218548712.5,-2014987.0,,,,,,,,,,,,,,,,,,,,,4269572.5,2477324.0,-8996887.5,921269.0,37582.5,3730634150.6024647,3655231151.422464,-260440240.5,-257131817.5,2524651.5,268996.5,3923350414.087456,33232440238.65092,36659696388.90764,,48051030904.78571,3985044.0,-247403066.5,103007138292.0,1053102829.5,17262493054.5,3501426553.5,18876144926.5,3669312.0,71862.0,,89746406.0,-84.73044535115895,3.028,5.3561863952865565,169.0353728419338,16.218532404927693,511.8391089653756,30000.0,-0.9009688679024191,-0.433883739117558,0.0,0.0,0.0,0.0,0.0,0.0,1.0,0.0,0.0,0.0,1.0,0.0,0.0,0.0,0.0,1.0,0.0,0.0,0.0,0.0,1.0,0.0,0.0,0.0,0.0,1.0,0.0,0.0,0.0,0.0,0.0,0.0,0.0,0.0,0.0,0.0,0.0,0.0,0.0,0.0,0.0,0.0,0.0,0.0,0.0,0.0,0.0,0.0,0.0,0.0,0.0,0.0,0.0,0.0,0.0,0.0,0.0,0.0,0.0,1.0,0.0,0.0,0.0,0.0,0.0,0.0,0.0,0.0,0.0,0.0,0.0,0.0,0.0,0.0,0.0,0.0,0.0,0.0,0.0,0.0,0.0,0.0,0.0,0.0,0.0,0.0,0.0,0.0,0.0,0.0,0.0,0.0,0.0,0.0,0.0,0.0,0.0,0.0,0.0,0.0,0.0,0.0,0.0,0.0,0.0,0.0,0.0,0.0,0.0,0.0,0.0,0.0,0.0,0.0,0.0,0.0,0.0,0.0,0.0,0.0
101223,0,0.0,0.0,0.0,1.0,0.0,157500.0,180000.0,14350.5,180000.0,0.018634,28.756164383561643,-970.0,-888.0,-1424.0,,2.0,2.0,2.0,13.0,0.2777224132904239,0.7412116369900852,,0.0763,0.0726,0.9846,,,0.0,0.1724,0.1667,,0.0369,,0.0674,,0.0,0.0777,0.0754,0.9846,,,0.0,0.1724,0.1667,,0.0377,,0.0703,,0.0,0.077,0.0726,0.9846,,,0.0,0.1724,0.1667,,0.0375,,0.0687,,0.0,0.078,1.0,3.0,0.0,3.0,0.0,-1077.0,0.0,0.0,0.0,0.0,0.0,2.0,1.0,1.0,1.0,1.0,1.0,0.0,0.0,0.0,0.0,0.0,0.0,0.0,0.0,0.0,0.0,0.0,1.0,0.0,0.0,0.0,0.0,0.0,0.0,0.0,0.0,0.0,0.0,0.0,0.0,0.0,0.0,0.0,2.0,45558.0,0.0,1834299.0,1543460.2425,0.0,0.0,0.0,0.0,-777.0,2070.0,-20.5,-448.0,52.0,-12.5,1.0,3165.66,39208.5,31365.0,7843.5,39208.5,12.0,-380.0,365243.0,-341.0,-251.0,-11.0,-246.0,9.0,0.0,0.2178681802531222,53.0,5.0,12.0,10.0,-10.0,0.0,0.0,4.0,3165.66,3165.66,-348.5,-296.0,2.5,1.0,0.0,,,,,,,,,,,,,,,,,,,,,8340276231.0,184285233423.0,165483198697.5,51933504610.935,1863.0,1704.0,71124.0,70711.0,9140.0,505672.0,17794.874800002293,17856.96469999911,17308.796099998082,11287.749600000085,11225.580000000087,11173.140700000056,128313.0,662315.0,,,,13517812.654794116,-601448387.0,-921229194.0,-296272039.0,-1534060383.0416667,43975.0,30675.0,11341.973199999176,11217.87999999897,10702.4854999973,22871.45710000963,22793.32340000959,22179.381300008143,67392.84487228224,157924.60961066402,,34974.03250002788,34914.44910002833,34361.00800002873,,,,3711514.0,8289.941300000168,8394.380700000082,8118.123400000227,,,,16457.129999999754,16642.2390999997,16239.1868999997,,,,3910.534100000124,3893.771200000161,3726.5759000001576,436169.0,430969.0,,6420.186702002896,631486.0,625045.0,,16320.8173999998,154064.90289999056,154067.64739999006,153959.43719998715,,,,26.0,20245364.099999998,5421587.984999999,1883271852.3150003,648432095.4225001,24034133.835,586321.47,41.0,5168.0,-6429509.0,3240480.0,-3319090.5,-3586832.0,-12.5,45558.0,0.0,3600000.0,3086920.485,0.0,0.0,0.0,0.0,-922.0,4560.0,-23.0,-448.0,72644053.32000005,1027379529.6299996,1157467138.6049998,17318432.02500001,1027379529.6299996,73730.0,-5205337.0,1201044730.0,52858370.0,263502903.0,122760122.0,275658702.0,74422.0,1187.0,211.57444515355647,2000525.0,625144.0,380645.0,-1244601.0,358902.0,2387.0,843867813.509974,848523077.4149759,-51768128.0,-51351739.5,951910.5,42068.5,,,,,,,,,,,,,,,,,,,,,1466284.0,14738887.0,3229699.0,8548312.0,11598502.0,1414518.0,1057273050.087001,801284254.627495,72047364935.6696,21659294779.357616,582091046.036999,5792395.7475,689.5,94245.0,-276730480.0,21911897.0,-123705057.5,-218549160.5,-2014999.5,,,,,,,,,,,,,,,,,,,,,4269584.5,2477334.0,-8996897.5,921269.0,37582.5,3730637316.262465,3655234317.0824623,-260440589.0,-257132113.5,2524654.0,268997.5,3923353579.747456,33232479447.15092,36659727753.90764,1728265085.6175494,48051070113.28571,3985056.0,-247403446.5,103007503535.0,1053102488.5,17262492803.5,3501426542.5,18876144680.5,3669321.0,71862.0,20856.69933338405,89746459.0,-33.73189786585366,1.1428571428571428,10.975227343994982,315.6054416508804,12.543116964565694,360.6919333152919,78750.0,1.0,0.0,0.0,0.0,0.0,0.0,0.0,0.0,1.0,0.0,0.0,0.0,0.0,0.0,0.0,1.0,0.0,0.0,0.0,0.0,1.0,0.0,1.0,0.0,0.0,0.0,0.0,1.0,0.0,0.0,0.0,0.0,0.0,0.0,0.0,0.0,0.0,0.0,0.0,0.0,0.0,0.0,0.0,0.0,0.0,0.0,1.0,0.0,0.0,0.0,0.0,0.0,0.0,0.0,0.0,1.0,0.0,0.0,0.0,0.0,0.0,0.0,0.0,0.0,0.0,0.0,0.0,0.0,0.0,0.0,0.0,0.0,0.0,0.0,0.0,0.0,0.0,0.0,0.0,0.0,0.0,0.0,0.0,0.0,0.0,0.0,0.0,0.0,0.0,0.0,0.0,0.0,0.0,0.0,0.0,0.0,0.0,0.0,0.0,0.0,0.0,0.0,0.0,0.0,0.0,0.0,0.0,0.0,0.0,0.0,0.0,0.0,1.0,0.0,0.0,0.0,0.0,0.0,0.0,0.0,1.0,0.0
101225,0,0.0,0.0,1.0,1.0,0.0,216000.0,502497.0,36693.0,454500.0,0.00733,29.334246575342465,-119.0,-4861.0,-1270.0,35.0,2.0,2.0,2.0,15.0,0.3802355568487776,0.5960285482706527,,,,,,,,,,,,,,,,,,,,,,,,,,,,,,,,,,,,,,,,,,,,,,0.0,0.0,0.0,0.0,-817.0,,,,,,,1.0,1.0,0.0,1.0,0.0,0.0,0.0,0.0,0.0,1.0,1.0,0.0,0.0,1.0,0.0,0.0,0.0,0.0,0.0,0.0,0.0,0.0,0.0,0.0,0.0,0.0,0.0,0.0,0.0,0.0,0.0,0.0,0.0,,,,,,,,,,,,,0.0,,3.0,4543.965,45000.0,45000.0,0.0,59062.5,9.0,-555.0,182431.5,-558.5,182483.5,182483.5,182485.0,17.0,0.0,0.0,-1.0,18.0,18.0,9.0,-17.5,0.0,0.0,48.0,4777.627500000001,4777.627500000001,-285.0,-276.5,12.0,0.0,18.0,31308.9975,92250.0,0.0,0.0,0.0,0.0,1441.44,5011.47,158.96249999999995,30911.265,31308.9975,31308.9975,0.0,0.0,0.0,0.0,1.5,-9.5,0.0,0.0,8340312924.0,184285735920.0,165483653197.5,51933720610.935,,,,,,,,,,,,,128313.0,662317.0,,,,13517841.98904069,-601448506.0,-921230464.0,-296272856.0,-1534065244.0416667,43975.0,30675.0,,,,,,,67393.22510783907,157925.20563921225,,,,,,,,3711529.0,,,,,,,,,,,,,,,,436169.0,430969.0,1262153.0,6420.194032002895,631488.0,625047.0,,,,,,,,,,,,,,,,,,,,,,,,,,,,,,,,,,,72800329.63500006,1029124854.6299996,1159333536.1049998,17318432.02500001,1029088292.1299996,73811.0,-5210239.0,1202322700.5,52856175.0,264597975.0,123124926.0,276753782.5,74578.0,1189.0,211.57444515355647,2000648.0,625891.0,381123.5,-1245188.5,358902.0,2387.0,844948086.2099737,849602717.2349756,-51783078.5,-51366274.5,952500.0,42103.0,838103828.7824996,2138033250.0,70280727.75,111247071.48000002,4282187.4,36645801.12000004,47269202.84999998,118792008.40500072,109638429.72749975,804200848.1324985,834814276.9424982,834848028.8774983,3591.0,8832.0,64.0,5177.0,273264.5,-477533.0,178678.0,421.0,1466284.0,14738887.0,3229717.0,8548330.0,11598550.0,1414521.0,,,,,,,,,,,,,,5917450661.7749605,18704724750.0,198640970.325,447515884.07999766,1948107.735,256504320.2925008,308847726.6749987,635954454.5624982,458706235.0949992,5702789323.39503,5880769285.004997,5881012467.749999,13369.5,80742.0,44.0,70263.5,970752.5,-1696948.5,177364.0,6755.0,4269602.5,2477343.0,-8996915.0,921269.0,37582.5,3730642093.889965,3655239094.709962,-260440874.0,-257132390.0,2524666.0,268997.5,3923358123.712456,33232524447.15092,36659772753.90764,1728265085.6175494,48051129175.78571,3985065.0,-247404001.5,103007685966.5,1053101930.0,17262675287.0,3501609026.0,18876327165.5,3669338.0,71862.0,20856.69933338405,89746458.0,-4.056691883814326,2.326375,5.886681383370125,172.6813632102573,13.694628403237676,401.7216063382624,108000.0,0.6234898018587334,-0.7818314824680299,0.0,0.0,0.0,0.0,0.0,0.0,1.0,0.0,0.0,0.0,0.0,0.0,0.0,1.0,0.0,0.0,0.0,0.0,1.0,0.0,1.0,0.0,0.0,0.0,0.0,1.0,0.0,0.0,0.0,0.0,0.0,0.0,0.0,0.0,0.0,0.0,0.0,0.0,0.0,0.0,0.0,0.0,0.0,0.0,1.0,0.0,0.0,0.0,0.0,0.0,0.0,0.0,0.0,0.0,0.0,0.0,0.0,0.0,0.0,0.0,0.0,0.0,0.0,0.0,0.0,0.0,0.0,0.0,0.0,0.0,0.0,0.0,0.0,0.0,0.0,0.0,0.0,0.0,0.0,0.0,0.0,0.0,0.0,0.0,0.0,0.0,0.0,0.0,0.0,0.0,0.0,0.0,0.0,0.0,0.0,1.0,0.0,0.0,0.0,0.0,0.0,0.0,0.0,0.0,0.0,0.0,0.0,0.0,0.0,0.0,0.0,0.0,0.0,0.0,0.0,0.0,0.0,0.0,0.0,0.0
101237,0,0.0,0.0,1.0,1.0,0.0,112500.0,311877.0,15003.0,252000.0,0.028663,57.11780821917807,,-458.0,-312.0,65.0,1.0,2.0,2.0,13.0,0.5611670883947703,0.4515698961711286,0.3589512285783967,,,,,,,,,,,,,,,,,,,,,,,,,,,,,,,,,,,,,,,,,,,,,2.0,0.0,2.0,0.0,-245.0,0.0,0.0,0.0,0.0,0.0,3.0,1.0,0.0,0.0,1.0,0.0,0.0,0.0,0.0,0.0,0.0,0.0,0.0,0.0,1.0,0.0,0.0,0.0,0.0,0.0,0.0,0.0,0.0,0.0,0.0,0.0,0.0,0.0,0.0,0.0,0.0,0.0,0.0,8.0,6409.35,0.0,50368.5,0.0,0.0,0.0,0.0,0.0,-926.5,-242.0,-242.0,-681.5,227.0,-15.0,7.0,7568.1,45000.0,65227.5,0.0,55113.75,6.0,-882.0,365243.0,-562.5,-412.5,-412.5,-407.5,14.0,0.5,0.0,50.0,21.0,6.0,3.0,-28.0,0.0,0.0,19.0,5449.86,5449.86,-854.0,-850.0,4.0,1.0,30.0,0.0,225000.0,,0.0,,,0.0,,0.0,0.0,0.0,0.0,,0.0,,,0.0,-16.5,0.0,0.0,8340327927.0,184286047797.0,165483905197.5,51933833110.935,1863.0,1704.0,71124.0,70711.0,9140.0,505675.0,,,,,,,128313.0,662318.0,,,,13517899.106848909,,-921230776.0,-296273101.0,-1534065702.0416667,43975.0,30675.0,,,,,,,67393.78627492746,157925.6572091084,126015.54618174944,,,,,,,3711542.0,,,,,,,,,,,,,,,,436171.0,430971.0,1262218.0,6420.222695002895,631490.0,625049.0,,,,,,,,,31.0,20255894.099999998,5468089.77,1908903009.915,657930689.1450003,24266341.44,586321.47,41.0,5168.0,-6490471.5,3232485.0,-3353577.5,-3625900.0,-15.0,5798.7,0.0,42750.0,0.0,0.0,0.0,0.0,0.0,-1030.0,-516.0,-516.0,-847.0,73682187.00750008,1045587051.6299996,1177798084.6049998,17379092.02500001,1045596929.1299996,74725.0,-5255909.0,1213276474.5,53185230.5,266763636.5,124202920.5,279286282.5,75296.0,1199.0,212.75828930785303,2006383.0,631895.0,384994.0,-1256457.0,358923.0,2401.0,855032183.9099796,861617683.8899808,-52446187.0,-52025571.0,965922.0,42512.0,855371822.5799997,2173662000.0,,112280878.8,,,48296703.82499997,,110688938.50499974,820733770.4399986,852066846.0899981,852100598.0249982,,8902.0,,,278301.0,-486904.5,210260.0,421.0,1466292.0,14739114.0,3229747.0,8548351.0,11598569.0,1414528.0,1057279459.437001,801284254.627495,72047415304.1696,21659294779.357616,582091046.036999,5792395.7475,689.5,94245.0,-276731406.5,21911655.0,-123705299.5,-218549842.0,-2015014.5,5917450661.7749605,18704949750.0,,447515884.07999766,,,308847726.6749987,,458706235.0949992,5702789323.39503,5880769285.004997,5881012467.749999,,80742.0,,,970752.5,-1696965.0,177364.0,6755.0,4269608.5,2477346.0,-8996943.0,921269.0,37582.5,3730647543.7499647,3655244544.5699625,-260441728.0,-257133240.0,2524670.0,268998.5,3923365691.812456,33232569447.15092,36659837981.40764,1728265085.6175494,48051184289.53571,3985071.0,-247404883.5,103008051209.5,1053101367.5,17262674874.5,3501608613.5,18876326758.0,3669352.0,71862.5,20856.69933338405,89746508.0,,2.77224,7.498500299940012,428.29790206342295,20.7876424715057,1187.3445760163036,112500.0,-0.9009688679024191,-0.433883739117558,0.0,0.0,0.0,0.0,0.0,0.0,1.0,0.0,0.0,1.0,0.0,0.0,0.0,0.0,0.0,0.0,0.0,0.0,1.0,0.0,0.0,0.0,0.0,1.0,0.0,1.0,0.0,0.0,0.0,0.0,0.0,0.0,0.0,0.0,0.0,0.0,0.0,0.0,0.0,0.0,0.0,0.0,0.0,0.0,0.0,0.0,0.0,0.0,0.0,0.0,0.0,0.0,0.0,0.0,0.0,0.0,0.0,0.0,0.0,0.0,0.0,0.0,0.0,0.0,0.0,0.0,0.0,0.0,0.0,0.0,0.0,0.0,0.0,0.0,0.0,0.0,0.0,0.0,0.0,0.0,0.0,0.0,0.0,0.0,0.0,0.0,0.0,0.0,0.0,0.0,0.0,0.0,0.0,0.0,0.0,0.0,0.0,0.0,0.0,0.0,0.0,0.0,0.0,0.0,0.0,1.0,0.0,0.0,0.0,0.0,0.0,0.0,0.0,0.0,0.0,0.0,0.0,0.0,0.0,0.0
101243,0,0.0,0.0,0.0,1.0,0.0,90000.0,314055.0,13329.0,238500.0,0.010966,59.15068493150685,,-401.0,-185.0,,2.0,2.0,2.0,12.0,,0.1726567589730378,0.6594055320683344,,,,,,,,,,,,,,,,,,,,,,,,,,,,,,,,,,,,,,,,,,,,,3.0,1.0,3.0,1.0,-1334.0,0.0,0.0,0.0,0.0,0.0,1.0,1.0,0.0,0.0,1.0,0.0,0.0,0.0,0.0,0.0,0.0,0.0,0.0,0.0,1.0,0.0,0.0,0.0,0.0,0.0,0.0,0.0,0.0,0.0,0.0,0.0,0.0,0.0,0.0,0.0,0.0,0.0,0.0,1.0,17410.5,,474300.0,379566.0,0.0,0.0,0.0,0.0,-304.0,792.0,-29.0,,11.0,-5.0,10.0,16346.7,111960.0,114484.5,0.0,147420.0,12.0,-1183.5,365243.0,-1303.0,-1303.0,-1033.0,-1300.0,14.5,1.0,0.0,-1.0,48.0,24.0,8.0,-31.5,0.0,0.0,47.0,43687.44,43124.04,-931.0,-931.0,7.0,1.0,0.0,,,,,,,,,,,,,,,,,,,,,8340341256.0,184286361852.0,165484143697.5,51933923110.935,1863.0,1704.0,71124.0,70711.0,9140.0,505676.0,,,,,,,128313.0,662320.0,,,,13517958.25753384,,-921230961.0,-296274435.0,-1534066103.0416667,43976.0,30676.0,,,,,,,,157925.8298658674,126016.20558728153,,,,,,,3711554.0,,,,,,,,,,,,,,,,436174.0,430974.0,,6420.233661002895,631492.0,625051.0,,,,,,,,,11.0,20293849.259999994,,1915453109.8350005,661296516.2550001,24521470.605,586321.47,42.0,5168.0,-6515453.0,3252325.0,-3369719.0,,-5.0,17410.5,,474300.0,379566.0,0.0,0.0,0.0,0.0,-304.0,792.0,-29.0,,73993862.61000004,1049888174.1299996,1182419856.8549998,17437713.52500001,1050270674.1299996,75131.0,-5283260.0,1219302984.0,53168998.0,267844862.0,124192742.0,280367617.0,75712.5,1205.0,213.69460608425487,2007189.5,635781.0,387021.0,-1263664.0,358924.0,2402.0,857809184.4899824,864277238.6549832,-52665933.0,-52243482.0,967968.0,42714.0,,,,,,,,,,,,,,,,,,,,,1466293.0,14739125.0,3229747.0,8548399.0,11598616.0,1414538.0,1057296869.937001,,72047889604.1696,21659674345.357616,582091046.036999,5792395.7475,689.5,94245.0,-276731710.5,21912447.0,-123705328.5,,-2015019.5,,,,,,,,,,,,,,,,,,,,,4269632.5,2477354.0,-8996974.5,921269.0,37582.5,3730691231.189965,3655287668.6099625,-260442659.0,-257134171.0,2524677.0,268999.5,3923382038.512456,33232681407.15092,36659952465.90764,1728265085.6175494,48051331709.53571,3985083.0,-247406067.0,103008416452.5,1053100064.5,17262673571.5,3501607580.5,18876325458.0,3669366.5,71863.5,20856.69933338405,89746507.0,,3.4895,6.75219446320054,399.3969272890402,23.561782579338285,1393.6955777751057,45000.0,-0.9009688679024191,-0.433883739117558,0.0,0.0,0.0,0.0,0.0,0.0,1.0,0.0,0.0,1.0,0.0,0.0,0.0,0.0,0.0,0.0,0.0,0.0,1.0,0.0,1.0,0.0,0.0,0.0,0.0,1.0,0.0,0.0,0.0,0.0,0.0,0.0,0.0,0.0,0.0,0.0,0.0,0.0,0.0,0.0,0.0,0.0,0.0,0.0,0.0,0.0,0.0,0.0,0.0,0.0,0.0,0.0,0.0,0.0,0.0,0.0,0.0,0.0,0.0,0.0,0.0,0.0,0.0,0.0,0.0,0.0,0.0,0.0,0.0,0.0,0.0,0.0,0.0,0.0,0.0,0.0,0.0,0.0,0.0,0.0,0.0,0.0,0.0,0.0,0.0,0.0,0.0,0.0,0.0,0.0,0.0,0.0,0.0,0.0,0.0,0.0,0.0,0.0,0.0,0.0,0.0,0.0,0.0,0.0,0.0,1.0,0.0,0.0,0.0,0.0,0.0,0.0,0.0,0.0,0.0,0.0,0.0,0.0,0.0,0.0
101244,0,0.0,0.0,0.0,1.0,1.0,81000.0,225000.0,27994.5,225000.0,0.018209,28.01095890410959,-1842.0,-4718.0,-2820.0,,3.0,3.0,3.0,9.0,0.1892836143116776,0.3040570780640598,,,,,,,,,,,,,,,,,,,,,,,,,,,,,,,,,,,,,,,,,,,,,,0.0,0.0,0.0,0.0,-1271.0,0.0,0.0,0.0,0.0,1.0,1.0,1.0,1.0,0.0,1.0,1.0,1.0,0.0,0.0,0.0,0.0,0.0,0.0,0.0,1.0,0.0,0.0,0.0,0.0,0.0,0.0,0.0,0.0,0.0,0.0,0.0,0.0,0.0,0.0,0.0,0.0,0.0,0.0,1.0,0.0,,52146.0,0.0,,0.0,0.0,0.0,-1927.0,-1618.0,-1361.0,-1616.0,64.0,-31.5,1.0,11034.675,119173.5,156298.5,0.0,119173.5,18.0,-1271.0,365243.0,-1240.0,-730.0,-730.0,-724.0,14.0,0.0,0.0,150.0,21.0,18.0,8.0,-34.0,0.0,0.0,19.0,11034.675,11034.675,-1028.0,-1000.0,9.0,1.0,0.0,,,,,,,,,,,,,,,,,,,,,8340369250.5,184286586852.0,165484368697.5,51934004110.935,1863.0,1704.0,71124.0,70712.0,9140.0,505677.0,,,,,,,128314.0,662323.0,,,,13517986.268492743,-601450348.0,-921233781.0,-296275706.0,-1534070821.0416667,43976.0,30676.0,,,,,,,67393.97555854179,157926.13392294545,,,,,,,,3711563.0,,,,,,,,,,,,,,,,436174.0,430974.0,,6420.251870002896,631495.0,625054.0,,,,,,,,,64.0,20293849.259999994,,1915505255.8350005,661296516.2550001,,586321.47,42.0,5168.0,-6517380.0,3250707.0,-3371080.0,-3642238.0,-31.5,0.0,,52146.0,0.0,,0.0,0.0,0.0,-1927.0,-1618.0,-1361.0,-1616.0,74114586.22500004,1052309736.6299996,1185134245.6049998,17438613.52500001,1052309736.6299996,75249.0,-5289813.0,1220398713.0,53164006.0,267844132.0,124189661.0,280366893.0,75794.0,1206.0,213.74833528549271,2007502.0,636423.0,387438.0,-1264908.0,358924.0,2402.0,858811257.2249827,865235623.9499835,-52701363.0,-52278429.0,968232.0,42749.0,,,,,,,,,,,,,,,,,,,,,1466294.0,14739189.0,3229747.0,8548420.0,11598635.0,1414539.0,1057296869.937001,,72047941750.1696,21659674345.357616,,5792395.7475,689.5,94245.0,-276733637.5,21910829.0,-123706689.5,-218551458.0,-2015051.0,,,,,,,,,,,,,,,,,,,,,4269650.5,2477362.0,-8997008.5,921269.0,37582.5,3730702265.864965,3655298703.284962,-260443687.0,-257135171.0,2524686.0,269000.5,3923393073.187456,33232800580.65092,36660108764.40764,1728265085.6175494,48051450883.03571,3985101.0,-247407338.0,103008781695.5,1053098824.5,17262672841.5,3501606850.5,18876324734.0,3669380.5,71863.5,20856.69933338405,89746657.0,-65.7599765258216,2.7777777777777777,2.8934254942935222,81.04762261275881,8.037293039704227,225.1322850354412,27000.0,-0.2225209339563143,0.9749279121818236,0.0,0.0,0.0,0.0,0.0,0.0,1.0,0.0,0.0,0.0,0.0,0.0,0.0,1.0,0.0,0.0,0.0,0.0,1.0,0.0,1.0,0.0,0.0,0.0,0.0,1.0,0.0,0.0,0.0,0.0,0.0,0.0,0.0,0.0,0.0,0.0,0.0,0.0,1.0,0.0,0.0,0.0,0.0,0.0,0.0,0.0,0.0,0.0,0.0,0.0,0.0,0.0,0.0,1.0,0.0,0.0,0.0,0.0,0.0,0.0,0.0,0.0,0.0,0.0,0.0,0.0,0.0,0.0,0.0,0.0,0.0,0.0,0.0,0.0,0.0,0.0,0.0,0.0,0.0,0.0,0.0,0.0,0.0,0.0,0.0,0.0,0.0,0.0,0.0,0.0,0.0,0.0,0.0,0.0,0.0,0.0,0.0,0.0,0.0,0.0,0.0,0.0,0.0,0.0,0.0,0.0,0.0,0.0,0.0,0.0,0.0,0.0,0.0,0.0,0.0,0.0,0.0,0.0,0.0,0.0
101258,0,0.0,0.0,0.0,1.0,0.0,135000.0,500490.0,52686.0,450000.0,0.011703,67.25479452054795,,-3968.0,-4531.0,,2.0,2.0,2.0,10.0,,0.7014609820675967,0.4740512892789932,,,,,,,,,,,,,,,,,,,,,,,,,,,,,,,,,,,,,,,,,,,,,5.0,0.0,4.0,0.0,-336.0,0.0,0.0,0.0,0.0,1.0,0.0,1.0,0.0,0.0,1.0,0.0,0.0,0.0,0.0,0.0,0.0,0.0,0.0,0.0,1.0,0.0,0.0,0.0,0.0,0.0,0.0,0.0,0.0,0.0,0.0,0.0,0.0,0.0,0.0,0.0,0.0,0.0,0.0,7.0,6813.0,0.0,225000.0,0.0,0.0,0.0,0.0,0.0,-413.0,-152.0,-148.0,-572.0,140.0,-9.5,1.0,15391.935,95580.0,86022.0,9558.0,95580.0,6.0,-336.0,365243.0,-297.0,-147.0,-147.0,-141.0,13.0,0.0,0.1089090909090909,100.0,7.0,6.0,3.0,-8.0,0.0,0.0,6.0,15391.935,15391.935,-237.5,-222.0,3.5,1.0,0.0,,,,,,,,,,,,,,,,,,,,,8340421936.5,184287087342.0,165484818697.5,51934139110.935,1863.0,1704.0,71124.0,70713.0,9140.0,505677.0,,,,,,,128314.0,662325.0,,,,13518053.523287265,,-921238312.0,-296276042.0,-1534074789.0416667,43976.0,30676.0,,,,,,,,157926.8353839275,126016.6796385708,,,,,,,3711573.0,,,,,,,,,,,,,,,,436179.0,430978.0,,6420.263573002895,631497.0,625056.0,,,,,,,,,14.0,20347196.759999994,5614736.94,1931448408.4800005,670393698.3450001,25066238.039999995,586321.47,43.0,5168.0,-6572689.0,3223446.0,-3399062.0,-3666376.5,-6.5,0.0,0.0,225000.0,0.0,0.0,0.0,0.0,0.0,-1020.0,-777.0,-286.0,-777.0,74611145.16000001,1059239803.0949996,1193300221.86,17607788.235000007,1059239803.0949996,76025.0,-5343023.0,1231720774.0,53491316.0,270006273.0,124894233.0,282529238.0,76473.0,1216.0,216.5514611907796,2026784.0,641162.0,390258.0,-1278573.0,358969.0,2447.0,863401234.3874838,869616640.0124843,-53112664.5,-52686560.5,971458.5,43104.5,,,,,,,,,,,,,,,,,,,,,1466301.0,14739329.0,3229747.0,8548427.0,11598641.0,1414540.0,1057303682.937001,801284254.627495,72048166750.1696,21659674345.357616,582091046.036999,5792395.7475,689.5,94245.0,-276734050.5,21910677.0,-123706837.5,-218552030.0,-2015060.5,,,,,,,,,,,,,,,,,,,,,4269656.5,2477365.0,-8997016.5,921269.0,37582.5,3730717657.799965,3655314095.2199626,-260443924.5,-257135393.0,2524689.5,269001.5,3923408465.122456,33232896160.65092,36660194786.40764,1728274643.6175494,48051546463.03571,3985107.0,-247407674.0,103009146938.5,1053098527.5,17262672694.5,3501606703.5,18876324593.0,3669393.5,71863.5,20856.808242474963,89746757.0,,3.707333333333333,2.5623505295524427,172.33035835466674,9.49948752989409,638.8860818735345,67500.0,1.0,0.0,0.0,0.0,0.0,0.0,0.0,0.0,1.0,0.0,0.0,1.0,0.0,0.0,0.0,0.0,0.0,0.0,0.0,0.0,1.0,0.0,1.0,0.0,0.0,0.0,0.0,1.0,0.0,0.0,0.0,0.0,0.0,0.0,0.0,0.0,0.0,0.0,0.0,0.0,0.0,0.0,0.0,0.0,0.0,0.0,0.0,0.0,0.0,0.0,0.0,0.0,0.0,0.0,0.0,0.0,0.0,0.0,0.0,0.0,0.0,0.0,0.0,0.0,0.0,0.0,0.0,0.0,0.0,0.0,0.0,0.0,0.0,0.0,0.0,0.0,0.0,0.0,0.0,0.0,0.0,0.0,0.0,0.0,0.0,0.0,0.0,0.0,0.0,0.0,0.0,0.0,0.0,0.0,0.0,0.0,0.0,0.0,0.0,0.0,0.0,0.0,0.0,0.0,0.0,0.0,0.0,1.0,0.0,0.0,0.0,0.0,0.0,0.0,0.0,0.0,0.0,0.0,0.0,0.0,0.0,0.0
101259,0,0.0,0.0,0.0,0.0,0.0,81000.0,318069.0,25632.0,265500.0,0.002134,27.27671232876712,-1631.0,-2610.0,-2623.0,,2.0,3.0,3.0,9.0,,0.3978144427503533,0.3409064264152384,,,,,,,,,,,,,,,,,,,,,,,,,,,,,,,,,,,,,,,,,,,,,0.0,0.0,0.0,0.0,-1550.0,0.0,0.0,0.0,0.0,1.0,7.0,1.0,1.0,0.0,1.0,0.0,0.0,0.0,0.0,0.0,1.0,1.0,0.0,0.0,1.0,0.0,0.0,0.0,0.0,0.0,0.0,0.0,0.0,0.0,0.0,0.0,0.0,0.0,0.0,0.0,0.0,0.0,0.0,2.0,0.0,0.0,27893.25,27893.25,0.0,0.0,0.0,0.0,-141.5,299.0,-93.0,-180.0,11.0,-4.0,7.0,9080.055,38695.5,44001.0,5899.5,79276.5,12.0,-570.0,365243.0,-1070.0,-418.0,-388.0,-416.0,12.0,0.0,0.0838072446151947,20.0,69.0,12.0,7.0,-27.0,0.0,0.0,69.0,10037.61,9080.055,-861.0,-834.0,7.0,1.0,0.0,,,,,,,,,,,,,,,,,,,,,8340447568.5,184287405411.0,165485084197.5,51934220110.935,1863.0,1704.0,71124.0,70714.0,9140.0,505684.0,,,,,,,128314.0,662327.0,,,,13518080.799999597,-601451979.0,-921240935.0,-296277592.0,-1534077399.0416667,43976.0,30676.0,,,,,,,,157927.23319837026,126017.0205449972,,,,,,,3711582.0,,,,,,,,,,,,,,,,436179.0,430978.0,,6420.265707002895,631500.0,625059.0,,,,,,,,,5.5,20360822.759999994,5614736.94,1933245377.7300005,671842315.8450001,25066238.039999995,586321.47,43.0,5168.0,-6573950.5,3226463.0,-3399358.0,-3667097.0,-2.25,0.0,0.0,0.0,0.0,0.0,0.0,0.0,0.0,-277.0,299.0,-180.0,-180.0,74635021.71000001,1059423826.0949996,1193490967.86,17615622.735000007,1059423826.0949996,76055.0,-5346858.0,1232816503.0,53488096.0,270003833.0,124891823.0,282526808.0,76518.0,1216.0,216.6841414690128,2027033.0,641563.0,390463.0,-1279733.0,358969.0,2447.0,863753389.9199842,869954242.6349847,-53146260.0,-52719616.0,971681.0,43143.0,,,,,,,,,,,,,,,,,,,,,1466303.0,14739340.0,3229747.0,8548496.0,11598710.0,1414547.0,1057303682.937001,801284254.627495,72048194643.4196,21659702238.607616,582091046.036999,5792395.7475,689.5,94245.0,-276734192.0,21910976.0,-123706930.5,-218552210.0,-2015064.5,,,,,,,,,,,,,,,,,,,,,4269668.5,2477372.0,-8997043.5,921269.0,37582.5,3730727695.409965,3655323175.274962,-260444785.5,-257136227.0,2524696.5,269002.5,3923417545.177456,33232934856.15092,36660238787.40764,1728280543.1175494,48051625739.53571,3985119.0,-247408244.0,103009512181.5,1053097457.5,17262672276.5,3501606315.5,18876324177.0,3669405.5,71863.5,20856.89204971958,89746777.0,-59.79459622338289,3.9267777777777777,3.1601123595505616,86.19747575804216,12.409058988764045,338.4783323072187,40500.0,-0.2225209339563143,0.9749279121818236,0.0,0.0,0.0,0.0,0.0,0.0,1.0,0.0,0.0,0.0,0.0,0.0,0.0,1.0,0.0,0.0,0.0,0.0,1.0,1.0,0.0,0.0,0.0,0.0,0.0,0.0,0.0,0.0,0.0,1.0,0.0,0.0,0.0,0.0,0.0,0.0,0.0,0.0,0.0,0.0,0.0,0.0,0.0,0.0,0.0,0.0,0.0,0.0,0.0,1.0,0.0,0.0,0.0,0.0,0.0,0.0,0.0,0.0,0.0,0.0,0.0,0.0,0.0,0.0,0.0,0.0,0.0,0.0,0.0,0.0,0.0,0.0,0.0,0.0,0.0,0.0,0.0,0.0,0.0,0.0,0.0,0.0,0.0,0.0,0.0,0.0,0.0,0.0,0.0,0.0,0.0,0.0,0.0,0.0,0.0,0.0,0.0,0.0,0.0,0.0,0.0,0.0,0.0,0.0,0.0,0.0,0.0,0.0,0.0,0.0,0.0,0.0,0.0,0.0,0.0,0.0,0.0,0.0,0.0,0.0
101268,0,0.0,1.0,0.0,1.0,0.0,157500.0,292500.0,34843.5,292500.0,0.028663,45.649315068493145,-1417.0,-8234.0,-188.0,,2.0,2.0,2.0,13.0,0.4190208218268325,0.371655650385435,0.4938628816996244,0.0935,,0.9841,,,0.06,0.1034,0.2917,,,,0.0815,,0.0,0.0756,,0.9772,,,0.0403,0.0345,0.1667,,,,0.0585,,0.0,0.0833,,0.9876,,,0.06,0.069,0.3333,,,,0.0856,,0.0,0.0597,1.0,0.0,0.0,0.0,0.0,-1347.0,0.0,0.0,0.0,0.0,0.0,5.0,1.0,1.0,0.0,1.0,0.0,0.0,0.0,0.0,0.0,0.0,0.0,0.0,0.0,1.0,0.0,0.0,0.0,0.0,0.0,0.0,0.0,0.0,0.0,0.0,0.0,0.0,0.0,0.0,0.0,0.0,0.0,0.0,11.0,0.0,0.0,22500.0,0.0,0.0,0.0,0.0,0.0,-305.0,-238.5,-220.0,-247.5,104.0,-5.0,13.0,15710.175,60435.0,60435.0,3217.5,83925.0,8.0,-740.0,365243.0,-786.5,-546.5,-546.5,-543.0,12.0,0.5,0.0544545454545454,-1.0,30.0,10.0,5.0,-24.5,0.0,0.0,75.0,22500.0,12685.5,-332.0,-332.0,9.0,0.0,12.0,48077.7975,171000.0,2250.0,85057.56,0.0,72830.1825,3484.71,55752.75,52889.85,47494.8,47623.14,47623.14,0.5,40.5,0.0,40.5,5.5,-6.5,0.0,0.0,8340482412.0,184287697911.0,165485376697.5,51934377610.935,1863.0,1704.0,71124.0,70714.0,9140.0,505689.0,17794.968300002292,17857.047999999108,17308.871699998082,,,,128314.0,662329.0,,,,13518126.449314663,-601453396.0,-921241123.0,-296278939.0,-1534085633.0416667,43976.0,30676.0,11342.033199999174,11217.93999999897,10702.525799997298,22871.56050000963,22793.39240000959,22179.415800008144,67394.39457936361,157927.60485402064,126017.51440787892,34974.324200027884,34914.78240002833,34361.174700028736,,,,3711595.0,,,,,,,16457.211499999754,16642.3246999997,16239.245399999698,,,,3910.534100000124,3893.771200000161,3726.5759000001576,436179.0,430978.0,,6420.294370002895,631502.0,625061.0,,16320.8770999998,154065.88699999056,154068.63499999006,153960.41439998714,,,,11.0,20360822.759999994,5614736.94,1940815933.6050005,674277431.5350003,25066238.039999995,586321.47,43.0,5168.0,-6614276.0,3238074.0,-3422255.0,-3690167.5,-5.0,0.0,0.0,22500.0,0.0,0.0,0.0,0.0,0.0,-334.0,-278.0,-265.0,-267.0,75038267.07000002,1064008218.4199996,1198980783.135,17706787.785000008,1063976043.4199996,76463.0,-5377863.0,1240303603.5,53832210.0,271450106.0,125609394.0,284338461.5,76951.0,1221.5,217.7409593424537,2117478.0,645461.0,392635.0,-1287257.0,359126.0,2459.0,868755874.8599821,875230541.4149827,-53376492.0,-52946404.0,974204.0,43438.0,863558761.4324996,2198979000.0,72115152.75,114328255.8375,4732187.4,37426729.65750004,48711661.06499997,122021444.29500093,112427532.26999974,828709113.5774987,860217720.7724981,860251472.7074982,3690.0,9168.5,71.0,5407.5,278460.5,-487556.5,210260.0,421.0,1466314.0,14739444.0,3229759.0,8548526.0,11598785.0,1414560.0,1057303682.937001,801284254.627495,72048217143.4196,21659702238.607616,582091046.036999,5792395.7475,689.5,94245.0,-276734497.0,21910737.5,-123707150.5,-218552457.5,-2015069.5,5917498739.572461,18705120750.0,198643220.325,447600941.63999766,1948107.735,256577150.4750008,308851211.3849987,636010207.3124982,458759124.9449992,5702836818.195029,5880816908.145,5881060090.889999,13370.0,80782.5,44.0,70304.0,970758.0,-1696971.5,177364.0,6755.0,4269678.5,2477377.0,-8997068.0,921269.0,37582.5,3730750195.409965,3655335860.774962,-260445117.5,-257136559.0,2524705.5,269002.5,3923433255.352456,33232995291.15092,36660299222.40764,1728283760.6175494,48051709664.53571,3985127.0,-247408984.0,103009877424.5,1053096671.0,17262671730.0,3501605769.0,18876323634.0,3669417.5,71864.0,20856.94650426504,89746776.0,-31.04099147761373,1.8571428571428568,4.520211804210256,206.34457282671585,8.3946790649619,383.2113495353293,78750.0,-0.9009688679024191,0.4338837391175582,0.0,0.0,0.0,0.0,0.0,0.0,1.0,0.0,0.0,0.0,0.0,0.0,0.0,1.0,0.0,0.0,0.0,0.0,1.0,0.0,1.0,0.0,0.0,0.0,0.0,1.0,0.0,0.0,0.0,0.0,0.0,0.0,0.0,0.0,0.0,0.0,1.0,0.0,0.0,0.0,0.0,0.0,0.0,0.0,0.0,0.0,0.0,0.0,0.0,0.0,0.0,0.0,0.0,0.0,0.0,0.0,0.0,0.0,0.0,0.0,0.0,0.0,0.0,0.0,0.0,0.0,0.0,0.0,0.0,0.0,0.0,0.0,0.0,0.0,0.0,0.0,0.0,0.0,0.0,0.0,0.0,0.0,0.0,0.0,0.0,0.0,0.0,0.0,0.0,0.0,0.0,0.0,0.0,0.0,0.0,0.0,0.0,0.0,0.0,1.0,0.0,0.0,0.0,0.0,0.0,0.0,0.0,0.0,0.0,0.0,0.0,0.0,0.0,0.0,0.0,0.0,0.0,1.0,0.0,0.0
101269,0,0.0,0.0,1.0,1.0,0.0,171000.0,171000.0,13360.5,171000.0,0.02461,59.13972602739726,-624.0,-1939.0,-4221.0,4.0,2.0,2.0,2.0,12.0,,0.6535873100549613,0.7610263695502636,0.1278,0.1428,0.9752,0.66,0.0572,0.0,0.2414,0.1667,0.2083,0.1373,0.0992,0.0967,0.0232,0.1079,0.1303,0.1482,0.9752,0.6733,0.0578,0.0,0.2414,0.1667,0.2083,0.1404,0.1084,0.1008,0.0233,0.1142,0.1291,0.1428,0.9752,0.6645,0.0576,0.0,0.2414,0.1667,0.2083,0.1397,0.1009,0.0984,0.0233,0.1101,0.1225,1.0,1.0,0.0,1.0,0.0,-585.0,0.0,0.0,0.0,0.0,0.0,6.0,1.0,1.0,0.0,1.0,0.0,0.0,0.0,0.0,0.0,0.0,0.0,0.0,0.0,1.0,0.0,0.0,0.0,0.0,0.0,0.0,0.0,0.0,0.0,0.0,0.0,0.0,0.0,0.0,0.0,0.0,0.0,0.0,3.0,0.0,,945027.0,0.0,0.0,0.0,0.0,0.0,-1310.0,-214.0,-468.0,-1530.5,154.0,-27.5,10.0,17623.9125,0.0,0.0,0.0,405000.0,35.0,-360.0,365243.0,-364.0,365243.0,1406.0,365243.0,11.0,0.0,0.0,-1.0,21.0,60.0,50.0,-11.0,0.0,0.0,49.0,9160.785,9657.945,-236.0,-226.0,8.0,0.0,13.0,70921.98,225000.0,10125.0,13500.0,0.0,0.0,2250.0,11250.0,4500.0,69741.09,70921.98,70921.98,1.0,1.0,0.0,0.0,4.0,-7.0,0.0,0.0,8340495772.5,184287868911.0,165485547697.5,51934548610.935,1863.0,1704.0,71124.0,70714.0,9140.0,505695.0,17795.09610000229,17857.177099999106,17309.001999998083,11287.892400000082,11225.722800000089,11173.288900000056,128314.0,662331.0,4135.604800000123,4133.245700000017,3944.0190000000953,13518185.589040693,-601454020.0,-921245344.0,-296279524.0,-1534087572.0416667,43976.0,30676.0,11342.033199999174,11217.93999999897,10702.525799997298,22871.80190000963,22793.63380000959,22179.657200008143,,157928.2584413307,126018.27543424848,34974.490900027886,34914.94910002833,34361.34140002874,22936.703399995928,22910.150899995504,22557.539999995737,3711607.0,8290.078600000168,8394.520400000081,8118.263800000227,9811.01990000072,9925.89640000216,10285.31109999965,16457.308199999752,16642.423099999698,16239.346199999698,828.2110000001759,813.3906000000459,759.3781000000133,3910.642000000124,3893.881300000161,3726.6901000001576,436180.0,430979.0,1262222.0,6420.318980002896,631504.0,625063.0,,16320.9995999998,154066.86219999054,154069.61019999007,153961.38959998713,77553.97079999628,77891.50720000657,78292.60960000647,44.0,20360822.759999994,,1941965242.6050005,674303081.5350003,25066238.039999995,586321.47,43.0,5168.0,-6619779.0,3234460.0,-3426113.0,-3694169.5,-21.5,0.0,,82782.0,0.0,0.0,0.0,0.0,0.0,-2697.0,-2528.0,-2513.0,-2528.0,75143655.495,1064636868.4199996,1200139713.135,17706787.785000008,1064974368.4199996,76533.0,-5384589.0,1241216711.0,53830120.0,271814072.0,125973450.0,284702439.0,77086.5,1223.0,217.7409593424537,2118069.5,645850.0,392921.0,-1287728.0,359126.0,2459.0,869707308.9599829,876033756.0899829,-53409654.0,-52978833.0,974762.0,43506.0,864497330.9549996,2201251500.0,72477402.75,115121845.125,4732187.4,37858068.94500004,48753629.32499997,122392912.05000092,112768239.77999976,829623763.8449987,861144018.2549982,861177770.1899983,3701.0,9383.0,71.0,5611.0,278518.0,-487644.0,210260.0,421.0,1466317.0,14739598.0,3229772.0,8548547.0,11598834.0,1414570.0,1057303682.937001,,72049162170.4196,21659702238.607616,582091046.036999,5792395.7475,689.5,94245.0,-276735807.0,21910523.5,-123707618.5,-218553988.0,-2015097.0,5917569661.552461,18705345750.0,198653345.325,447614441.63999766,1948107.735,256577150.4750008,308853461.3849987,636021457.3124982,458763624.9449992,5702906559.285029,5880887830.124998,5881131012.869999,13371.0,80783.5,44.0,70304.0,970762.0,-1696978.5,177364.0,6755.0,4269738.5,2477427.0,-8997079.0,921269.0,37582.5,3730759356.194965,3655345518.7199626,-260445353.5,-257136785.0,2524713.5,269002.5,3923450879.264957,33232995291.15092,36660299222.40764,1728283760.6175494,48052114664.53571,3985162.0,-247409344.0,103010242667.5,1053096307.0,17263036973.0,3501607175.0,18876688877.0,3669428.5,71864.0,20856.94650426504,89746775.0,-10.551283239136476,1.0,12.7989221960256,756.9247521189276,12.7989221960256,756.9247521189276,85500.0,-0.2225209339563143,0.9749279121818236,0.0,0.0,0.0,0.0,0.0,1.0,0.0,0.0,0.0,0.0,0.0,0.0,0.0,1.0,0.0,0.0,0.0,0.0,1.0,0.0,1.0,0.0,0.0,0.0,0.0,1.0,0.0,0.0,0.0,0.0,0.0,0.0,0.0,0.0,0.0,0.0,0.0,0.0,0.0,0.0,0.0,0.0,0.0,0.0,1.0,0.0,0.0,0.0,0.0,0.0,0.0,0.0,0.0,0.0,0.0,0.0,0.0,0.0,0.0,0.0,0.0,0.0,0.0,0.0,0.0,0.0,0.0,0.0,0.0,0.0,0.0,0.0,0.0,0.0,0.0,0.0,0.0,0.0,0.0,0.0,0.0,0.0,0.0,0.0,0.0,0.0,0.0,0.0,0.0,0.0,1.0,0.0,0.0,0.0,0.0,0.0,0.0,0.0,0.0,0.0,0.0,0.0,0.0,0.0,0.0,0.0,0.0,0.0,1.0,0.0,1.0,0.0,0.0,0.0,0.0,0.0,0.0,0.0,1.0,0.0
101271,0,0.0,0.0,0.0,1.0,0.0,135000.0,509400.0,28444.5,450000.0,0.020246,46.42465753424658,-10134.0,-1223.0,-492.0,,2.0,3.0,3.0,12.0,0.6561270850332214,0.1368268642948388,0.4561097392782771,,,,,,,,,,,,,,,,,,,,,,,,,,,,,,,,,,,,,,,,,,,,,0.0,0.0,0.0,0.0,-409.0,0.0,0.0,0.0,0.0,0.0,0.0,1.0,1.0,1.0,1.0,1.0,0.0,0.0,0.0,0.0,0.0,0.0,0.0,0.0,1.0,0.0,0.0,0.0,0.0,0.0,0.0,0.0,0.0,0.0,0.0,0.0,0.0,0.0,0.0,0.0,0.0,0.0,0.0,11.0,0.0,0.0,51835.5,0.0,0.0,0.0,0.0,0.0,-2081.0,-1769.0,-1700.0,-1754.5,601.0,-29.0,8.0,13040.1675,99472.5,128373.75,0.0,121545.0,11.0,-710.0,365243.0,-629.0,-448.5,-398.5,-444.5,11.0,0.0,0.0,145.0,78.0,12.0,5.0,-58.5,0.0,0.0,86.0,10992.1725,10992.1725,-568.0,-554.0,6.0,1.0,23.0,0.0,225000.0,0.0,0.0,0.0,0.0,0.0,5.13,0.0,0.0,0.0,0.0,0.0,0.0,0.0,0.0,4.0,-12.0,0.0,0.0,8340524217.0,184288378311.0,165485997697.5,51934683610.935,1863.0,1704.0,71124.0,70714.0,9140.0,505695.0,,,,,,,128314.0,662333.0,,,,13518232.013698226,-601464154.0,-921245836.0,-296279933.0,-1534088795.0416667,43976.0,30676.0,,,,,,,67395.05070644863,157928.395268195,126018.73154398776,,,,,,,3711619.0,,,,,,,,,,,,,,,,436180.0,430979.0,,6420.339226002896,631507.0,625066.0,,,,,,,,,69.0,20398649.759999994,5625937.17,1944221173.6050005,675498843.1350003,25201238.039999995,586321.47,43.0,5168.0,-6630541.0,3229182.0,-3434261.0,-3699363.5,-34.0,0.0,0.0,51835.5,0.0,0.0,0.0,0.0,0.0,-2081.0,-1769.0,-1757.0,-1760.0,75261081.32999998,1067326999.9199996,1203270124.635,17731636.785000008,1067288299.9199996,76708.0,-5391998.0,1243590435.5,53823873.5,272540034.5,125971453.0,285428623.5,77209.5,1224.0,218.19142274181,2119274.5,647330.0,394033.0,-1290054.5,359800.0,2459.0,871063432.537483,877656441.3074827,-53478330.5,-53046724.0,975267.0,43602.5,865108445.4899995,2203681500.0,72612402.75,115275344.625,4732187.4,37876568.44500004,48783253.27499996,122547047.35500091,112906104.61499973,830212288.0199988,861745865.1749983,861779617.1099982,3705.0,9389.0,71.0,5613.0,278607.0,-487804.0,210260.0,421.0,1466328.0,14740199.0,3229795.0,8548625.0,11598920.0,1414578.0,1057303682.937001,801284254.627495,72049214005.9196,21659702238.607616,582091046.036999,5792395.7475,689.5,94245.0,-276737888.0,21908754.5,-123709318.5,-218555742.5,-2015126.0,5917569661.552461,18705570750.0,198653345.325,447614441.63999766,1948107.735,256577150.4750008,308853461.3849987,636021462.4424982,458763624.9449992,5702906559.285029,5880887830.124998,5881131012.869999,13371.0,80783.5,44.0,70304.0,970766.0,-1696990.5,177364.0,6755.0,4269750.5,2477432.0,-8997137.5,921269.0,37582.5,3730770348.367465,3655356510.892463,-260445921.5,-257137339.0,2524719.5,269003.5,3923463919.432456,33233094763.65092,36660427596.15764,1728283760.6175494,48052236209.53571,3985173.0,-247410054.0,103010607910.5,1053095678.0,17263036524.5,3501606776.5,18876688432.5,3669439.5,71864.0,20856.94650426504,89746920.0,-218.28917084685744,3.773333333333333,4.7460844803037485,220.33534662670425,17.908558772346147,831.3987079380972,67500.0,0.6234898018587334,-0.7818314824680299,0.0,0.0,0.0,0.0,1.0,0.0,0.0,0.0,0.0,0.0,0.0,0.0,0.0,1.0,0.0,0.0,0.0,0.0,1.0,0.0,1.0,0.0,0.0,0.0,0.0,1.0,0.0,0.0,0.0,0.0,0.0,0.0,0.0,0.0,0.0,0.0,0.0,0.0,1.0,0.0,0.0,0.0,0.0,0.0,0.0,0.0,0.0,0.0,0.0,0.0,0.0,0.0,1.0,0.0,0.0,0.0,0.0,0.0,0.0,0.0,0.0,0.0,0.0,0.0,0.0,0.0,0.0,0.0,0.0,0.0,0.0,0.0,0.0,0.0,0.0,0.0,0.0,0.0,0.0,0.0,0.0,0.0,0.0,0.0,0.0,0.0,0.0,0.0,0.0,0.0,0.0,0.0,0.0,0.0,0.0,0.0,0.0,0.0,0.0,0.0,0.0,0.0,0.0,0.0,0.0,0.0,0.0,0.0,0.0,0.0,0.0,0.0,0.0,0.0,0.0,0.0,0.0,0.0,0.0,0.0
101279,0,0.0,0.0,0.0,1.0,0.0,67500.0,334152.0,14287.5,270000.0,0.018634,64.42739726027398,,-8299.0,-4545.0,,2.0,2.0,2.0,9.0,0.6362262178497362,0.4656365666027724,,,,,,,,,,,,,,,,,,,,,,,,,,,,,,,,,,,,,,,,,,,,,,2.0,0.0,2.0,0.0,-1981.0,,,,,,,1.0,0.0,0.0,1.0,1.0,0.0,0.0,0.0,0.0,0.0,0.0,0.0,0.0,1.0,0.0,0.0,0.0,0.0,0.0,0.0,0.0,0.0,0.0,0.0,0.0,0.0,0.0,0.0,0.0,0.0,0.0,0.0,0.0,,,,,,,,,,,,,0.0,,6.0,22662.3375,161313.75,160080.75,19665.0,323313.75,23.0,-865.0,365243.0,-1494.0,-1344.0,-1344.0,-1339.0,14.0,1.0,0.102146830483705,-1.0,64.0,54.0,21.5,-32.5,0.0,0.0,63.0,24749.55,24749.55,-963.0,-933.0,16.0,1.0,0.0,,,,,,,,,,,,,,,,,,,,,8340538504.5,184288712463.0,165486267697.5,51934751110.935,,,,,,,,,,,,,128314.0,662335.0,,,,13518296.441095484,,-921250381.0,-296281914.0,-1534097094.0416667,43976.0,30676.0,,,,,,,67395.68693266649,157928.8609047616,,,,,,,,3711628.0,,,,,,,,,,,,,,,,436182.0,430981.0,,6420.357860002896,631509.0,625068.0,,,,,,,,,,,,,,,,,,,,,,,,,,,,,,,,,,,75992256.80999999,1079482984.9199996,1216950552.135,17845851.285000008,1079644298.6699996,77882.0,-5457479.0,1255095085.0,54144098.0,273965686.0,126670043.0,286854647.0,78020.5,1236.0,220.25916456937784,2136082.5,654911.0,398640.5,-1305529.5,359841.0,2500.0,877071973.2749786,883181130.4799796,-53937933.0,-53502010.0,978749.0,43991.0,,,,,,,,,,,,,,,,,,,,,1466328.0,14740199.0,3229795.0,8548689.0,11598983.0,1414584.0,,,,,,,,,,,,,,,,,,,,,,,,,,,,,,,,,,4269804.5,2477453.5,-8997170.0,921269.0,37582.5,3730795097.9174647,3655381260.442464,-260446884.5,-257138272.0,2524735.5,269004.5,3923486581.769956,33233256077.40092,36660587676.90764,1728303425.6175494,48052559523.28571,3985196.0,-247410919.0,103010973153.5,1053094184.0,17263035180.5,3501605432.5,18876687093.5,3669453.5,71865.0,20857.04865109552,89746919.0,,4.9504,4.724409448818896,304.3814043792472,23.387716535433068,1506.809704239025,33750.0,0.6234898018587336,0.7818314824680298,0.0,0.0,0.0,0.0,0.0,0.0,1.0,0.0,0.0,1.0,0.0,0.0,0.0,0.0,0.0,0.0,0.0,1.0,0.0,0.0,1.0,0.0,0.0,0.0,0.0,1.0,0.0,0.0,0.0,0.0,0.0,0.0,0.0,0.0,0.0,0.0,0.0,0.0,0.0,0.0,0.0,0.0,0.0,0.0,0.0,0.0,0.0,0.0,0.0,0.0,0.0,0.0,0.0,0.0,0.0,0.0,0.0,0.0,0.0,0.0,0.0,0.0,0.0,0.0,0.0,0.0,0.0,0.0,0.0,0.0,0.0,0.0,0.0,0.0,0.0,0.0,0.0,0.0,0.0,0.0,0.0,0.0,0.0,0.0,0.0,0.0,0.0,0.0,0.0,0.0,0.0,0.0,0.0,0.0,0.0,0.0,0.0,0.0,0.0,0.0,0.0,0.0,0.0,0.0,0.0,1.0,0.0,0.0,0.0,0.0,0.0,0.0,0.0,0.0,0.0,0.0,0.0,0.0,0.0,0.0
101281,0,0.0,0.0,0.0,1.0,0.0,225000.0,248760.0,25618.5,225000.0,0.02461,67.66301369863014,,-729.0,-4827.0,,1.0,2.0,2.0,12.0,,0.1187969741694665,,,,,,,,,,,,,,,,,,,,,,,,,,,,,,,,,,,,,,,,,,,,,,0.0,0.0,0.0,0.0,-163.0,0.0,0.0,0.0,0.0,0.0,6.0,1.0,0.0,0.0,1.0,0.0,1.0,0.0,0.0,0.0,0.0,0.0,0.0,0.0,1.0,0.0,0.0,0.0,0.0,0.0,0.0,0.0,0.0,0.0,0.0,0.0,0.0,0.0,0.0,0.0,0.0,0.0,0.0,2.0,4500.0,,9000.0,4500.0,,270.0,0.0,0.0,-73.0,,-43.5,,5.0,-1.0,14.0,8981.82,8975.25,8743.5,0.0,90000.0,12.0,-571.5,365243.0,-552.0,-522.0,138.0,-517.0,10.0,1.0,0.0,-1.0,31.0,9.0,7.0,-68.0,0.0,0.0,29.0,8981.82,8981.82,-2042.0,-2042.0,4.0,1.0,0.0,,,,,,,,,,,,,,,,,,,,,8340564123.0,184288961223.0,165486492697.5,51934976110.935,1863.0,1704.0,71124.0,70714.0,9140.0,505701.0,,,,,,,128314.0,662336.0,,,,13518364.104109185,,-921255208.0,-296282077.0,-1534097823.0416667,43976.0,30676.0,,,,,,,,157928.97970173575,,,,,,,,3711640.0,,,,,,,,,,,,,,,,436182.0,430981.0,,6420.382470002895,631511.0,625070.0,,,,,,,,,2.5,20414913.66,,1950228217.7100008,677085195.9150003,,586591.47,43.0,5168.0,-6675416.5,,-3459136.0,,-0.75,9000.0,,9000.0,9000.0,,0.0,0.0,0.0,-117.0,,-79.0,,76103209.52999999,1080994683.4199996,1218493350.135,17895351.285000008,1081039683.4199996,78035.0,-5471440.0,1258017029.0,54132896.0,273958153.0,126661901.0,286847157.0,78173.5,1240.0,220.6797295626125,2139191.5,656229.0,399499.0,-1309053.0,359841.0,2500.0,878689708.1099781,884798865.3149791,-54036037.0,-53599130.0,979327.0,44065.0,,,,,,,,,,,,,,,,,,,,,1466330.0,14740204.0,3229795.0,8548720.0,11599012.0,1414598.0,1057308182.937001,,72049223005.9196,21659706738.607616,,5792665.7475,689.5,94245.0,-276737961.0,,-123709362.0,,-2015127.0,,,,,,,,,,,,,,,,,,,,,4269813.5,2477460.5,-8997238.0,921269.0,37582.5,3730804079.737466,3655390242.262463,-260448926.5,-257140314.0,2524739.5,269005.5,3923495563.589956,33233265052.65092,36660596420.40764,1728303425.6175494,48052649523.28571,3985208.0,-247411490.5,103011338396.5,1053093632.0,17263034658.5,3501605570.5,18876686576.5,3669463.5,71866.0,20857.04865109552,89746918.0,,1.1056,8.782715615668364,594.2650070141414,9.710170384682945,657.0193917548347,225000.0,-0.2225209339563146,-0.9749279121818236,0.0,0.0,0.0,0.0,0.0,0.0,1.0,0.0,0.0,1.0,0.0,0.0,0.0,0.0,0.0,0.0,0.0,0.0,1.0,0.0,0.0,0.0,0.0,1.0,0.0,1.0,0.0,0.0,0.0,0.0,0.0,0.0,0.0,0.0,0.0,0.0,0.0,0.0,0.0,0.0,0.0,0.0,0.0,0.0,0.0,0.0,0.0,0.0,0.0,0.0,0.0,0.0,0.0,0.0,0.0,0.0,0.0,0.0,0.0,0.0,0.0,0.0,0.0,0.0,0.0,0.0,0.0,0.0,0.0,0.0,0.0,0.0,0.0,0.0,0.0,0.0,0.0,0.0,0.0,0.0,0.0,0.0,0.0,0.0,0.0,0.0,0.0,0.0,0.0,0.0,0.0,0.0,0.0,0.0,0.0,0.0,0.0,0.0,0.0,0.0,0.0,0.0,0.0,0.0,0.0,1.0,0.0,0.0,0.0,0.0,0.0,0.0,0.0,0.0,0.0,0.0,0.0,0.0,0.0,0.0
101287,0,0.0,0.0,0.0,0.0,2.0,157500.0,500490.0,52686.0,450000.0,0.010643,32.580821917808215,-1344.0,-3188.0,-4320.0,,4.0,2.0,2.0,14.0,0.6575735716415978,0.690364982535084,,0.1814,0.1265,0.9851,0.7959999999999999,0.031,0.2,0.1724,0.3333,0.375,0.1171,0.1479,0.1874,0.0,0.0,0.1849,0.1312,0.9851,0.804,0.0312,0.2014,0.1724,0.3333,0.375,0.1198,0.1616,0.1952,0.0,0.0,0.1832,0.1265,0.9851,0.7987,0.0311,0.2,0.1724,0.3333,0.375,0.1191,0.1505,0.1908,0.0,0.0,0.1474,1.0,3.0,1.0,3.0,0.0,-332.0,0.0,0.0,0.0,0.0,1.0,2.0,1.0,1.0,0.0,1.0,0.0,0.0,0.0,0.0,0.0,0.0,0.0,0.0,0.0,1.0,0.0,0.0,0.0,0.0,0.0,0.0,0.0,0.0,0.0,0.0,0.0,0.0,0.0,0.0,0.0,0.0,0.0,0.0,2.0,12928.5,162542.25,527753.25,,,0.0,0.0,0.0,-2236.5,-45.0,-1030.5,-2037.0,149.0,-37.0,1.0,8243.55,90045.0,90045.0,0.0,90045.0,12.0,-332.0,365243.0,-302.0,-152.0,28.0,-144.0,13.0,0.0,0.0,2000.0,7.0,12.0,9.0,-8.0,0.0,0.0,6.0,8243.55,8243.55,-283.0,-227.0,3.5,1.0,0.0,,,,,,,,,,,,,,,,,,,,,8340616809.0,184289461713.0,165486942697.5,51935133610.935,1863.0,1704.0,71124.0,70715.0,9140.0,505703.0,17795.277500002292,17857.360299999105,17309.186899998083,11288.018900000085,11225.849300000087,11173.420100000056,128316.0,662340.0,4135.635800000124,4133.276800000017,3944.050200000095,13518396.684931103,-601465498.0,-921259528.0,-296282409.0,-1534101011.0416667,43977.0,30676.0,11342.233199999177,11218.13999999897,10702.727199997298,22871.974300009628,22793.80620000959,22179.829600008143,67396.34450623814,157929.67006671827,,34974.824200027884,34915.28240002833,34361.674700028736,22937.078399995928,22910.525899995504,22557.914999995737,3711654.0,8290.195700000168,8394.639500000081,8118.3836000002275,9811.16780000072,9926.04690000216,10285.47269999965,16457.49559999975,16642.6138999997,16239.541399999698,828.2110000001759,813.3906000000459,759.3781000000133,3910.642000000124,3893.881300000161,3726.6901000001576,436185.0,430984.0,,6420.393113002896,631513.0,625072.0,,16321.1469999998,154067.84729999054,154070.59529999006,153962.37469998712,77554.76679999627,77892.30590000657,78293.41360000648,74.5,20427842.16,5887656.72,1953294708.915001,,,586861.47,43.0,5168.0,-6692942.5,3207221.0,-3468912.5,-3736986.0,-36.75,12928.5,212890.5,450000.0,,,0.0,0.0,0.0,-2435.0,-1704.0,-2037.0,-2037.0,76490664.02999999,1088203912.9199996,1226269246.635,17907492.285000008,1088203912.9199996,78743.0,-5499760.0,1263130052.0,54484545.0,275772135.0,127021230.0,288295647.0,78685.0,1247.0,220.98691835473588,2144719.0,659834.0,402120.0,-1313529.0,359864.0,2503.0,880581648.9599769,886624053.1649783,-54159671.5,-53720821.0,980389.5,44224.5,,,,,,,,,,,,,,,,,,,,,1466332.0,14740353.0,3229795.0,8548727.0,11599018.0,1414599.0,1057321111.437001,801446796.877495,72049750759.1696,,,5792665.7475,689.5,94245.0,-276740197.5,21908709.5,-123710392.5,-218557779.5,-2015164.0,,,,,,,,,,,,,,,,,,,,,4269825.5,2477469.5,-8997246.0,921269.0,37582.5,3730812323.2874656,3655398485.8124633,-260449209.5,-257140541.0,2524743.0,269006.5,3923503807.139957,33233355097.65092,36660686465.40764,1728303425.6175494,48052739568.28571,3985220.0,-247411822.5,103011703639.5,1053093330.0,17263034506.5,3501605598.5,18876686432.5,3669476.5,71866.0,20857.04865109552,89748918.0,-41.25126135216952,3.177714285714286,2.9894089511445165,97.39740067674136,9.49948752989409,309.50111152191926,39375.0,-0.9009688679024191,0.4338837391175582,0.0,0.0,0.0,0.0,0.0,0.0,1.0,0.0,1.0,0.0,0.0,0.0,0.0,0.0,0.0,0.0,0.0,0.0,1.0,0.0,1.0,0.0,0.0,0.0,0.0,0.0,0.0,0.0,0.0,1.0,0.0,0.0,0.0,0.0,0.0,0.0,0.0,0.0,0.0,0.0,0.0,0.0,0.0,0.0,1.0,0.0,0.0,0.0,0.0,0.0,0.0,0.0,0.0,1.0,0.0,0.0,0.0,0.0,0.0,0.0,0.0,0.0,0.0,0.0,0.0,0.0,0.0,0.0,0.0,0.0,0.0,0.0,0.0,0.0,0.0,0.0,0.0,0.0,0.0,0.0,0.0,0.0,0.0,0.0,0.0,0.0,0.0,0.0,0.0,0.0,0.0,0.0,0.0,0.0,0.0,0.0,0.0,0.0,0.0,0.0,0.0,0.0,0.0,0.0,0.0,0.0,0.0,0.0,1.0,0.0,1.0,0.0,0.0,0.0,0.0,0.0,0.0,1.0,0.0,0.0
101292,0,0.0,0.0,0.0,1.0,0.0,126000.0,521568.0,22054.5,360000.0,0.022625,61.44657534246576,,-11719.0,-3716.0,,1.0,2.0,2.0,12.0,,0.7412871321329234,,0.0196,,0.0,,,0.0,0.1379,0.125,,,,,,0.0326,0.02,,0.0,,,0.0,0.1379,0.125,,,,,,0.0345,0.0198,,0.0,,,0.0,0.1379,0.125,,,,,,0.0333,0.0363,1.0,0.0,0.0,0.0,0.0,-1569.0,,,,,,,1.0,0.0,0.0,1.0,0.0,0.0,0.0,0.0,0.0,0.0,0.0,0.0,0.0,1.0,0.0,0.0,0.0,0.0,0.0,0.0,0.0,0.0,0.0,0.0,0.0,0.0,0.0,0.0,0.0,0.0,0.0,0.0,0.0,,,,,,,,,,,,,0.0,,9.0,5039.73,45000.0,46602.0,2070.0,49500.0,12.0,-763.0,365243.0,-1092.0,-403.0,-403.0,-395.0,10.0,1.0,0.1108366854384553,0.0,65.0,12.0,8.0,-24.0,0.0,0.0,145.0,3725.235,3725.235,-763.0,-762.0,12.0,0.0,51.0,35438.85,45000.0,0.0,0.0,0.0,0.0,2250.0,4500.0,4500.0,34178.805,35438.85,35438.85,0.0,0.0,0.0,0.0,24.0,-26.0,0.0,0.0,8340638863.5,184289983281.0,165487302697.5,51935259610.935,,,,,,,17795.29710000229,17857.380099999104,17309.206899998084,,,,128316.0,662341.0,,,,13518458.131506445,,-921263244.0,-296283978.0,-1534112730.0416667,43977.0,30676.0,11342.233199999177,11218.13999999897,10702.727199997298,22872.11220000963,22793.94410000959,22179.967500008144,,157930.41135385042,,34974.949200027884,34915.40740002833,34361.799700028736,,,,3711666.0,,,,,,,,,,,,,3910.674600000124,3893.914600000161,3726.7246000001583,436185.0,430984.0,,6420.415738002896,631515.0,625074.0,,16321.1832999998,154067.84729999054,154070.59529999006,153962.37469998712,,,,,,,,,,,,,,,,,,,,,,,,,,,,,,76681613.61,1090418790.4199996,1228594603.635,17952276.285000008,1090572969.4199996,78969.0,-5517861.0,1266780791.0,55205217.0,277589848.0,128113061.0,290113421.0,78926.0,1251.0,221.417958476756,2159978.0,662203.0,403626.0,-1316582.0,359864.0,2503.0,881513437.7699754,887542151.7599767,-54285737.0,-53844875.0,983708.0,44309.0,867849691.2299992,2213986500.0,72968352.75,115750832.625,4732187.4,37983056.44500004,48908957.26499996,122817067.56000093,113147878.09499972,832831437.0599988,864455762.1599977,864489514.0949979,3719.0,9409.0,71.0,5619.0,279241.0,-489360.0,210615.0,421.0,1466332.0,14740353.0,3229846.0,8548792.0,11599163.0,1414608.0,,,,,,,,,,,,,,5917605100.402461,18705615750.0,198653345.325,447614441.63999766,1948107.735,256577150.4750008,308855711.3849987,636025962.4424982,458768124.9449992,5702940738.090032,5880923268.9749975,5881166451.719999,13371.0,80783.5,44.0,70304.0,970790.0,-1697016.5,177364.0,6755.0,4269837.5,2477477.5,-8997270.0,921269.0,37582.5,3730816048.5224657,3655402211.047464,-260449972.5,-257141303.0,2524755.0,269006.5,3923508846.869956,33233400097.65092,36660733067.40764,1728305495.6175494,48052789068.28571,3985232.0,-247412585.5,103012068882.5,1053092238.0,17263034103.5,3501605195.5,18876686037.5,3669486.5,71867.0,20857.15948778096,89748918.0,,4.139428571428572,5.713119771475209,351.0516444784822,23.649051214037947,1453.1532072012144,126000.0,-0.2225209339563143,0.9749279121818236,0.0,0.0,0.0,0.0,0.0,0.0,1.0,0.0,0.0,1.0,0.0,0.0,0.0,0.0,0.0,0.0,0.0,0.0,1.0,0.0,0.0,1.0,0.0,0.0,0.0,1.0,0.0,0.0,0.0,0.0,0.0,0.0,0.0,0.0,0.0,0.0,0.0,0.0,0.0,0.0,0.0,0.0,0.0,0.0,0.0,0.0,0.0,0.0,0.0,0.0,0.0,0.0,0.0,0.0,0.0,0.0,0.0,0.0,0.0,0.0,0.0,0.0,0.0,0.0,0.0,0.0,0.0,0.0,0.0,0.0,0.0,0.0,0.0,0.0,0.0,0.0,0.0,0.0,0.0,0.0,0.0,0.0,0.0,0.0,0.0,0.0,0.0,0.0,0.0,0.0,0.0,0.0,0.0,0.0,0.0,0.0,0.0,0.0,0.0,0.0,0.0,0.0,0.0,0.0,0.0,1.0,0.0,0.0,0.0,0.0,1.0,0.0,0.0,0.0,0.0,0.0,0.0,0.0,1.0,0.0
101294,0,0.0,0.0,0.0,1.0,0.0,135000.0,395766.0,20335.5,283500.0,0.031329,44.597260273972594,-5899.0,-1066.0,-5820.0,,2.0,2.0,2.0,9.0,0.6821432795107677,0.3194918873852569,0.6528965519806539,0.0082,0.0,0.9727,0.626,0.0006,0.0,0.0345,0.0417,0.0417,0.0192,0.0067,0.0036,0.0,0.0,0.0084,0.0,0.9727,0.6406,0.0006,0.0,0.0345,0.0417,0.0417,0.0197,0.0073,0.0037,0.0,0.0,0.0083,0.0,0.9727,0.631,0.0006,0.0,0.0345,0.0417,0.0417,0.0196,0.0068,0.0036,0.0,0.0,0.0041,1.0,1.0,0.0,1.0,0.0,0.0,0.0,0.0,0.0,0.0,0.0,0.0,1.0,1.0,0.0,1.0,0.0,0.0,0.0,0.0,0.0,0.0,0.0,0.0,0.0,1.0,0.0,0.0,0.0,0.0,0.0,0.0,0.0,0.0,0.0,0.0,0.0,0.0,0.0,0.0,0.0,0.0,0.0,0.0,1.0,57685.5,0.0,2250000.0,1647732.06,0.0,0.0,0.0,0.0,-700.0,1126.0,-31.0,,24.0,-11.5,2.0,14355.99,101250.0,118325.25,4500.0,101250.0,11.0,-1980.5,365243.0,-1950.0,-1680.0,-1650.0,-1677.0,13.5,0.5,0.0601873948102187,19.5,22.0,10.0,5.0,-60.0,0.0,0.0,20.0,14355.99,14355.99,-1833.0,-1815.0,5.5,1.0,0.0,,,,,,,,,,,,,,,,,,,,,8340659199.0,184290379047.0,165487586197.5,51935394610.935,1863.0,1704.0,71124.0,70715.0,9140.0,505703.0,17795.305300002292,17857.388399999105,17309.215299998083,11288.018900000085,11225.849300000087,11173.420100000056,128316.0,662343.0,4135.636400000123,4133.277400000017,3944.050800000095,13518502.72876672,-601471397.0,-921269064.0,-296283978.0,-1534113796.0416667,43977.0,30676.0,11342.233199999177,11218.13999999897,10702.727199997298,22872.146700009627,22793.97860000959,22180.002000008142,67397.02664951765,157930.7308457378,126019.38444053972,34974.990900027886,34915.44910002833,34361.84140002874,22937.120099995933,22910.567599995506,22557.956699995742,3711675.0,8290.214900000168,8394.659100000079,8118.403300000227,9811.17450000072,9926.053700002158,10285.479999999648,16457.49919999975,16642.6174999997,16239.545099999696,828.2110000001759,813.3906000000459,759.3781000000133,3910.674600000124,3893.914600000161,3726.7246000001583,436186.0,430985.0,,6420.447067002896,631517.0,625076.0,,16321.1873999998,154068.81999999055,154071.56799999005,153963.3473999871,77555.39279999628,77892.93690000658,78294.05420000647,24.0,20549229.66,5994101.97,1959816748.5450008,681208598.2500001,25484370.795,586861.47,44.0,5168.0,-6730550.0,3253983.0,-3484217.0,,-11.5,57685.5,0.0,2250000.0,1647732.06,0.0,0.0,0.0,0.0,-700.0,1126.0,-31.0,,76741777.4625,1091040289.9199996,1229209926.885,18003846.285000008,1091040289.9199996,79022.0,-5527054.0,1268789627.5,55196735.5,277585868.5,128106407.5,290109456.0,79007.0,1254.0,221.94225087874423,2161181.0,662726.0,403881.0,-1318696.0,359864.0,2503.0,882260828.8424754,888285041.6624768,-54371137.0,-53929408.5,984779.5,44404.5,,,,,,,,,,,,,,,,,,,,,1466333.0,14740377.0,3229846.0,8548814.0,11599183.0,1414610.0,1057378796.937001,801446796.877495,72052000759.1696,21661354470.66761,582091046.036999,5792665.7475,689.5,94245.0,-276740897.5,21909835.5,-123710423.5,,-2015175.5,,,,,,,,,,,,,,,,,,,,,4269847.5,2477482.5,-8997330.0,921269.0,37582.5,3730830404.5124655,3655416567.037463,-260451805.5,-257143118.0,2524760.5,269007.5,3923523202.859956,33233501347.65092,36660851392.65764,1728309995.6175494,48052890318.28571,3985243.0,-247414566.0,103012434125.5,1053090288.0,17263032423.5,3501603545.5,18876684360.5,3669500.0,71867.5,20857.21967517577,89748937.5,-132.27269934881434,2.9316,6.638636866563399,296.0650162025178,19.46182783801726,867.9442014993012,67500.0,-0.9009688679024191,0.4338837391175582,0.0,0.0,0.0,0.0,0.0,0.0,1.0,0.0,1.0,0.0,0.0,0.0,0.0,0.0,0.0,0.0,0.0,0.0,1.0,0.0,1.0,0.0,0.0,0.0,0.0,1.0,0.0,0.0,0.0,0.0,0.0,0.0,0.0,0.0,0.0,0.0,0.0,0.0,0.0,0.0,0.0,0.0,0.0,0.0,0.0,0.0,0.0,0.0,0.0,0.0,0.0,0.0,0.0,0.0,0.0,0.0,0.0,0.0,0.0,0.0,0.0,0.0,0.0,0.0,1.0,0.0,0.0,0.0,0.0,0.0,0.0,0.0,0.0,0.0,0.0,0.0,0.0,0.0,0.0,0.0,0.0,0.0,0.0,0.0,0.0,0.0,0.0,0.0,0.0,0.0,0.0,0.0,0.0,0.0,0.0,0.0,0.0,0.0,0.0,0.0,0.0,0.0,0.0,0.0,0.0,0.0,0.0,0.0,1.0,0.0,1.0,0.0,0.0,0.0,0.0,0.0,0.0,0.0,1.0,0.0
101296,0,0.0,0.0,1.0,1.0,0.0,90000.0,817560.0,30951.0,675000.0,0.01885,57.78630136986301,,-1961.0,-4576.0,16.0,2.0,2.0,2.0,10.0,,0.5369181219522664,0.3774042489507649,,,,,,,,,,,,,,,,,,,,,,,,,,,,,,,,,,,,,,,,,,,,,0.0,0.0,0.0,0.0,-598.0,0.0,0.0,0.0,0.0,0.0,4.0,1.0,0.0,0.0,1.0,0.0,0.0,0.0,0.0,0.0,0.0,0.0,0.0,0.0,0.0,0.0,0.0,1.0,0.0,0.0,0.0,0.0,0.0,0.0,0.0,0.0,0.0,0.0,0.0,0.0,0.0,0.0,0.0,5.0,2250.0,0.0,135000.0,67870.08,0.0,0.0,0.0,0.0,-727.0,564.0,-24.0,-308.5,110.0,-11.0,5.0,15514.4475,95643.0,76513.5,19129.5,385321.5,36.0,-267.0,365243.0,-468.0,-258.0,-138.0,-254.0,9.0,0.5,0.2178284301564625,100.0,18.0,12.0,7.5,-12.5,0.0,0.0,16.0,5693.085,5693.085,-375.0,-363.0,4.5,1.0,0.0,,,,,,,,,,,,,,,,,,,,,8340690150.0,184291196607.0,165488261197.5,51935484610.935,1863.0,1704.0,71124.0,70715.0,9140.0,505707.0,,,,,,,128316.0,662345.0,,,,13518560.51506809,,-921273640.0,-296284576.0,-1534115757.0416667,43977.0,30676.0,,,,,,,,157931.26776385974,126019.76184478868,,,,,,,3711685.0,,,,,,,,,,,,,,,,436186.0,430985.0,1262238.0,6420.465917002895,631519.0,625078.0,,,,,,,,,24.0,20553101.91,5994101.97,1960334248.5450008,681322434.7500001,25484370.795,586861.47,44.0,5168.0,-6733021.0,3254263.0,-3484498.0,-3757898.0,-11.5,0.0,0.0,135000.0,0.0,0.0,0.0,0.0,0.0,-822.0,-92.0,-84.0,-526.0,76928205.78,1092924704.7449996,1231577495.46,18037191.285000008,1093262204.7449996,79249.0,-5542447.0,1272442057.5,55549927.0,278307180.0,128463259.0,290830819.5,79188.0,1260.5,222.4376718972144,2161401.0,664477.0,404889.0,-1323487.0,359870.0,2509.0,884015475.9524758,889907376.712477,-54513067.0,-54070448.0,985626.0,44524.5,,,,,,,,,,,,,,,,,,,,,1466338.0,14740487.0,3229846.0,8548832.0,11599199.0,1414615.0,1057381046.937001,801446796.877495,72052135759.1696,21661422340.74762,582091046.036999,5792665.7475,689.5,94245.0,-276741624.5,21910399.5,-123710447.5,-218558088.0,-2015186.5,,,,,,,,,,,,,,,,,,,,,4269859.5,2477490.0,-8997342.5,921269.0,37582.5,3730836097.5974655,3655422260.122463,-260452180.5,-257143481.0,2524765.0,269008.5,3923538717.307456,33233596990.65092,36660927906.15764,1728329125.1175494,48053275639.78571,3985279.0,-247414833.0,103012799368.5,1053089820.0,17263032165.5,3501603407.5,18876684106.5,3669509.0,71868.0,20857.43750360592,89749037.5,,9.084,2.907822041291073,168.03228080797618,26.414655423088107,1526.4052388596554,45000.0,0.6234898018587336,0.7818314824680298,0.0,0.0,0.0,0.0,0.0,0.0,1.0,0.0,0.0,1.0,0.0,0.0,0.0,0.0,0.0,0.0,0.0,0.0,1.0,0.0,1.0,0.0,0.0,0.0,0.0,1.0,0.0,0.0,0.0,0.0,0.0,0.0,0.0,0.0,0.0,0.0,0.0,0.0,0.0,0.0,0.0,0.0,0.0,0.0,0.0,0.0,0.0,0.0,0.0,0.0,0.0,0.0,0.0,0.0,0.0,0.0,0.0,0.0,0.0,0.0,0.0,0.0,0.0,0.0,0.0,0.0,0.0,0.0,0.0,0.0,0.0,0.0,0.0,0.0,0.0,0.0,0.0,0.0,0.0,0.0,0.0,0.0,0.0,0.0,0.0,0.0,0.0,0.0,0.0,0.0,0.0,0.0,0.0,0.0,0.0,0.0,0.0,0.0,0.0,0.0,0.0,0.0,0.0,0.0,0.0,1.0,0.0,0.0,0.0,0.0,0.0,0.0,0.0,0.0,0.0,0.0,0.0,0.0,0.0,0.0
101297,0,0.0,0.0,0.0,1.0,0.0,202500.0,225000.0,22383.0,225000.0,0.018209,40.90684931506849,-443.0,-1161.0,-4556.0,,2.0,3.0,3.0,10.0,0.5244598870380854,0.4505357261709305,0.7394117535524816,,,,,,,,,,,,,,,,,,,,,,,,,,,,,,,,,,,,,,,,,,,,,0.0,0.0,0.0,0.0,-1768.0,0.0,0.0,0.0,0.0,0.0,6.0,1.0,1.0,0.0,1.0,0.0,1.0,0.0,0.0,0.0,0.0,0.0,0.0,0.0,1.0,0.0,0.0,0.0,0.0,0.0,0.0,0.0,0.0,0.0,0.0,0.0,0.0,0.0,0.0,0.0,0.0,0.0,0.0,6.0,0.0,,113703.75,0.0,0.0,0.0,0.0,0.0,-1921.0,-841.0,-787.0,-987.0,367.0,-32.0,10.0,13351.5,152059.5,152059.5,0.0,180000.0,12.0,-443.5,365243.0,-410.0,365243.0,100.0,-126.0,11.0,0.0,0.0,-1.0,55.0,18.0,10.0,-20.0,0.0,0.0,53.0,7499.655,7499.655,-599.0,-590.0,8.0,1.0,7.0,0.0,18000.0,,0.0,,,0.0,,0.0,0.0,0.0,0.0,,0.0,,,0.0,-4.0,0.0,0.0,8340712533.0,184291421607.0,165488486197.5,51935687110.935,1863.0,1704.0,71124.0,70715.0,9140.0,505713.0,,,,,,,128316.0,662347.0,,,,13518601.421917403,-601471840.0,-921278196.0,-296286344.0,-1534116918.0416667,43977.0,30676.0,,,,,,,67397.55110940468,157931.71829958592,126020.50125654224,,,,,,,3711695.0,,,,,,,,,,,,,,,,436186.0,430985.0,,6420.484126002895,631522.0,625081.0,,,,,,,,,64.0,20561474.16,,1961434762.4700007,681640311.3300003,25485834.105,586861.47,44.0,5168.0,-6740282.5,3253621.0,-3486605.5,-3761972.0,-31.5,0.0,,89977.5,0.0,0.0,0.0,0.0,0.0,-2733.0,-2612.0,-904.0,-2547.0,77034453.93,1095186827.7449996,1234158218.46,18037191.285000008,1096156577.7449996,79405.0,-5546628.5,1273720408.0,55911961.0,278670878.0,128827017.0,290829666.0,79269.0,1261.0,222.4376718972144,2168131.5,665215.0,405248.0,-1324794.0,359870.0,2509.0,884117592.1349773,890009492.8949783,-54550979.0,-54108167.0,985999.0,44559.0,868689298.0799992,2222748000.0,,115795832.625,,,48963032.50499995,,113243849.59499972,833638064.3099989,865292678.0099977,865326429.9449979,,9411.0,,,279727.0,-490896.0,210784.0,421.0,1466344.0,14740854.0,3229853.0,8548887.0,11599252.0,1414625.0,1057381046.937001,,72052249462.9196,21661422340.74762,582091046.036999,5792665.7475,689.5,94245.0,-276743545.5,21909558.5,-123711234.5,-218559075.0,-2015218.5,5917605100.402461,18705633750.0,,447614441.63999766,,,308855711.3849987,,458768124.9449992,5702940738.090032,5880923268.9749975,5881166451.719999,,80783.5,,,970790.0,-1697020.5,177364.0,6755.0,4269877.5,2477500.0,-8997362.5,921269.0,37582.5,3730843597.2524657,3655429759.777464,-260452779.5,-257144071.0,2524773.0,269009.5,3923552068.807456,33233749050.15092,36661079965.65764,1728329125.1175494,48053455639.78571,3985291.0,-247415276.5,103013164611.5,1053089410.0,17263397408.5,3501603507.5,18876683980.5,3669520.0,71868.0,20857.43750360592,89749036.5,-10.829482285178488,1.1111111111111112,9.047044632086852,370.0860915114761,10.052271813429837,411.2067683460845,101250.0,1.0,0.0,0.0,0.0,0.0,0.0,0.0,0.0,1.0,0.0,1.0,0.0,0.0,0.0,0.0,0.0,0.0,1.0,0.0,0.0,0.0,1.0,0.0,0.0,0.0,0.0,0.0,1.0,0.0,0.0,0.0,0.0,0.0,0.0,0.0,1.0,0.0,0.0,0.0,0.0,0.0,0.0,0.0,0.0,0.0,0.0,0.0,0.0,0.0,0.0,0.0,0.0,0.0,0.0,0.0,0.0,0.0,0.0,0.0,0.0,0.0,0.0,0.0,0.0,0.0,0.0,0.0,0.0,0.0,0.0,0.0,0.0,0.0,0.0,0.0,0.0,0.0,0.0,0.0,0.0,0.0,0.0,0.0,0.0,0.0,0.0,0.0,0.0,0.0,0.0,0.0,0.0,1.0,0.0,0.0,0.0,0.0,0.0,0.0,0.0,0.0,0.0,0.0,0.0,0.0,0.0,0.0,0.0,0.0,0.0,0.0,0.0,0.0,0.0,0.0,0.0,0.0,0.0,0.0,0.0,0.0,0.0
101299,0,0.0,0.0,1.0,0.0,0.0,202500.0,1350000.0,41904.0,1350000.0,0.04622,34.92876712328767,-3188.0,-1195.0,-3821.0,8.0,2.0,1.0,1.0,13.0,0.7999292493190486,0.3819353549742606,0.175605979469379,0.2113,0.1023,0.9945,0.9252,0.0003,0.24,0.2069,0.3333,0.375,,0.1723,0.2401,0.0,0.4168,0.2153,0.1061,0.9945,0.9281,0.0003,0.2417,0.2069,0.3333,0.375,,0.1882,0.2502,0.0,0.4412,0.2134,0.1023,0.9945,0.9262,0.0003,0.24,0.2069,0.3333,0.375,,0.1753,0.2445,0.0,0.4255,0.2795,1.0,0.0,0.0,0.0,0.0,-778.0,0.0,0.0,0.0,0.0,1.0,1.0,1.0,1.0,0.0,1.0,0.0,0.0,0.0,0.0,0.0,0.0,1.0,1.0,0.0,1.0,0.0,0.0,0.0,0.0,0.0,0.0,0.0,0.0,0.0,0.0,0.0,0.0,0.0,0.0,0.0,0.0,0.0,0.0,2.0,107017.92,33620.13,5562812.25,4114298.4975,0.0,0.0,0.0,0.0,-2046.0,891.5,-462.5,-2573.0,135.0,-33.0,1.0,21509.055,134433.0,120987.0,13446.0,134433.0,6.0,-778.0,365243.0,-747.0,-597.0,-597.0,-595.0,16.0,0.0,0.1089309645967609,20.0,7.0,6.0,3.0,-22.0,0.0,0.0,6.0,21509.055,21509.055,-686.5,-672.0,3.5,1.0,0.0,,,,,,,,,,,,,,,,,,,,,8340754437.0,184292771607.0,165489836197.5,51935889610.935,1863.0,1704.0,71124.0,70716.0,9140.0,505714.0,17795.51660000229,17857.601799999105,17309.430599998082,11288.121200000083,11225.95160000009,11173.526200000057,128316.0,662349.0,4135.636700000124,4133.277700000017,3944.051100000095,13518636.35068453,-601475028.0,-921282017.0,-296287122.0,-1534118113.0416667,43977.0,30676.0,11342.473199999176,11218.37999999897,10702.9688999973,22872.35360000964,22794.185500009597,22180.20890000815,67398.351038654,157932.10023494088,126020.67686252172,34975.324200027884,34915.78240002833,34362.174700028736,22937.495099995933,22910.942599995506,22558.331699995742,3711708.0,,,,9811.34680000072,9926.22900000216,10285.668199999647,16457.73929999975,16642.8619999997,16239.795299999698,828.2110000001759,813.3906000000459,759.3781000000133,3911.091400000124,3894.34010000016,3727.165800000158,436186.0,430985.0,1262246.0,6420.530346002895,631523.0,625082.0,,16321.4668999998,154069.81449999055,154072.56249999005,153964.34189998714,77556.31799999627,77893.86310000657,78294.98230000648,67.5,20668492.08,6166038.6,1969329672.810001,686840860.3275001,25485834.105,586861.47,44.0,5168.0,-6763281.5,3240806.5,-3500442.0,-3778669.0,-33.25,107017.92,33620.13,33124.5,0.0,0.0,0.0,0.0,0.0,-2849.0,-2514.0,-905.0,-2573.0,77153446.53000002,1098194879.7449996,1237141736.46,18090237.285000008,1098194879.7449996,79537.0,-5553027.0,1275546623.0,55908709.0,279398622.0,128825056.0,291556923.0,79367.0,1262.0,222.76442104362928,2168342.0,665863.0,405660.0,-1325829.0,359870.0,2509.0,885192456.9374771,891034352.8874781,-54722227.0,-54278614.5,988368.5,44608.5,,,,,,,,,,,,,,,,,,,,,1466346.0,14740989.0,3229853.0,8548894.0,11599258.0,1414626.0,1057488064.857001,801480417.007495,72057812275.1696,21665536639.24512,582091046.036999,5792665.7475,689.5,94245.0,-276745591.5,21910450.0,-123711697.0,-218561648.0,-2015251.5,,,,,,,,,,,,,,,,,,,,,4269883.5,2477503.0,-8997384.5,921269.0,37582.5,3730865106.3074656,3655451268.8324633,-260453466.0,-257144743.0,2524776.5,269010.5,3923573577.862456,33233883483.15092,36661200952.65764,1728342571.1175494,48053590072.78571,3985297.0,-247416054.5,103013529854.5,1053088663.0,17263396811.5,3501602910.5,18876683385.5,3669536.0,71868.0,20857.54643457052,89749056.5,-91.27147227233507,6.666666666666668,4.8324742268041225,168.79236689733088,32.21649484536083,1125.282445982206,101250.0,0.6234898018587334,-0.7818314824680299,0.0,0.0,0.0,0.0,0.0,0.0,1.0,0.0,0.0,0.0,0.0,0.0,0.0,1.0,0.0,1.0,0.0,0.0,0.0,0.0,1.0,0.0,0.0,0.0,0.0,1.0,0.0,0.0,0.0,0.0,0.0,0.0,0.0,0.0,0.0,0.0,1.0,0.0,0.0,0.0,0.0,0.0,0.0,0.0,0.0,0.0,0.0,0.0,0.0,0.0,0.0,0.0,0.0,0.0,0.0,0.0,0.0,0.0,0.0,0.0,0.0,0.0,0.0,0.0,0.0,0.0,0.0,0.0,0.0,0.0,0.0,0.0,0.0,0.0,0.0,0.0,0.0,0.0,0.0,0.0,0.0,0.0,0.0,0.0,0.0,0.0,0.0,0.0,0.0,1.0,0.0,0.0,0.0,0.0,0.0,0.0,0.0,0.0,0.0,0.0,0.0,0.0,0.0,0.0,0.0,0.0,0.0,0.0,1.0,0.0,1.0,0.0,0.0,0.0,0.0,0.0,0.0,0.0,1.0,0.0
101301,0,0.0,1.0,0.0,1.0,1.0,202500.0,407520.0,26041.5,360000.0,0.0072739999999999,50.38356164383562,-219.0,-5190.0,-1945.0,,3.0,2.0,2.0,11.0,0.4493587031907877,0.7218096747873972,0.5316861425197883,,,,,,,,,,,,,,,,,,,,,,,,,,,,,,,,,,,,,,,,,,,,1.0,0.0,0.0,0.0,0.0,-496.0,0.0,0.0,0.0,0.0,1.0,2.0,1.0,1.0,0.0,1.0,1.0,1.0,1.0,1.0,0.0,1.0,1.0,0.0,0.0,1.0,0.0,0.0,0.0,0.0,0.0,0.0,0.0,0.0,0.0,0.0,0.0,0.0,0.0,0.0,0.0,0.0,0.0,0.0,1.0,33552.0,,1350000.0,702337.5,0.0,0.0,0.0,0.0,-1105.0,721.0,-35.0,,37.0,-18.0,3.0,8467.785,45000.0,45000.0,0.0,88400.25,6.0,-472.0,365243.0,-457.0,-127.0,-127.0,-120.0,11.0,0.0,0.0,190.0,14.0,12.0,6.0,-10.5,0.0,0.0,12.0,14685.57,14685.57,-320.0,-292.0,6.5,1.0,0.0,,,,,,,,,,,,,,,,,,,,,8340780478.5,184293179127.0,165490196197.5,51936092110.935,1863.0,1704.0,71124.0,70717.0,9140.0,505716.0,,,,,,,128317.0,662352.0,,,,13518686.734246176,-601475247.0,-921283962.0,-296287618.0,-1534123303.0416667,43977.0,30676.0,,,,,,,67398.80039735719,157932.82204461563,126021.20854866426,,,,,,,3711719.0,,,,,,,,,,,,,,,,436186.0,430985.0,,6420.537620002896,631525.0,625084.0,,,,,,,,,37.0,20702044.08,,1978291073.3400009,692761364.3250003,25485834.105,618685.47,44.0,5196.0,-6779656.0,3239874.0,-3508830.0,,-18.0,33552.0,,1350000.0,702337.5,0.0,0.0,0.0,0.0,-1105.0,721.0,-35.0,,77176539.31500001,1098641680.2449996,1237602455.46,18090237.285000008,1098575779.9949996,79543.0,-5554591.0,1275911595.0,55908030.0,279763738.0,129190172.0,291922046.0,79426.0,1262.0,222.76442104362928,2168879.0,665965.0,405706.0,-1325962.0,359870.0,2509.0,885397935.7799773,891239831.7299783,-54728272.0,-54284441.5,988543.5,44617.5,,,,,,,,,,,,,,,,,,,,,1466347.0,14741026.0,3229853.0,8548908.0,11599270.0,1414629.0,1057521616.857001,,72059162275.1696,21666238976.74512,582091046.036999,5792665.7475,689.5,94245.0,-276746696.5,21911171.0,-123711732.0,,-2015269.5,,,,,,,,,,,,,,,,,,,,,4269895.5,2477509.0,-8997395.0,921269.0,37582.5,3730879791.8774657,3655465954.402464,-260453786.0,-257145035.0,2524783.0,269011.5,3923582045.647456,33233928483.15092,36661245952.65764,1728342571.1175494,48053678473.03571,3985303.0,-247416526.5,103013895097.5,1053088206.0,17263396684.5,3501602783.5,18876683265.5,3669547.0,71868.0,20857.54643457052,89749246.5,-4.346655791190864,2.0124444444444443,7.776049766718508,391.78508276699546,15.648868152756178,788.4457132306468,67500.0,1.0,0.0,0.0,0.0,0.0,0.0,0.0,0.0,1.0,0.0,1.0,0.0,0.0,0.0,0.0,0.0,0.0,1.0,0.0,0.0,0.0,0.0,1.0,0.0,0.0,0.0,0.0,1.0,0.0,0.0,0.0,0.0,0.0,0.0,0.0,0.0,0.0,0.0,0.0,0.0,0.0,0.0,0.0,0.0,0.0,0.0,0.0,0.0,0.0,0.0,0.0,0.0,0.0,0.0,0.0,0.0,0.0,0.0,0.0,0.0,0.0,0.0,0.0,0.0,0.0,0.0,0.0,0.0,0.0,0.0,0.0,0.0,0.0,0.0,0.0,0.0,0.0,0.0,0.0,0.0,0.0,0.0,0.0,1.0,0.0,0.0,0.0,0.0,0.0,0.0,0.0,0.0,0.0,0.0,0.0,0.0,0.0,0.0,0.0,0.0,0.0,0.0,0.0,0.0,0.0,0.0,0.0,0.0,0.0,0.0,0.0,0.0,0.0,0.0,0.0,0.0,0.0,0.0,0.0,0.0,0.0,0.0
101305,0,0.0,0.0,0.0,1.0,0.0,81000.0,378706.5,16173.0,306000.0,0.030755,61.17808219178082,,-4551.0,-4429.0,,2.0,2.0,2.0,10.0,0.2930079799660247,0.7321344451640427,0.2471909382666521,,,,,,,,,,,,,,,,,,,,,,,,,,,,,,,,,,,,,,,,,,,,,0.0,0.0,0.0,0.0,-570.0,0.0,0.0,0.0,0.0,1.0,4.0,1.0,0.0,0.0,1.0,0.0,0.0,0.0,0.0,0.0,0.0,0.0,0.0,0.0,1.0,0.0,0.0,0.0,0.0,0.0,0.0,0.0,0.0,0.0,0.0,0.0,0.0,0.0,0.0,0.0,0.0,0.0,0.0,9.0,0.0,108.4275,22500.0,0.0,0.0,0.0,0.0,0.0,-257.0,-152.0,-128.0,-162.0,94.0,-5.0,9.0,7014.8925,0.0,0.0,,96750.0,24.0,-361.0,365243.0,-357.0,182445.0,693.0,182451.5,12.0,1.0,,-1.0,23.0,24.0,24.0,-12.0,0.0,0.0,21.0,16080.12,16080.12,-348.0,-331.0,4.0,1.0,11.0,0.0,225000.0,,0.0,,,0.0,,0.0,0.0,0.0,0.0,,0.0,,,0.0,-7.0,0.0,0.0,8340796651.5,184293557833.5,165490502197.5,51936173110.935,1863.0,1704.0,71124.0,70718.0,9140.0,505720.0,,,,,,,128317.0,662354.0,,,,13518747.912328364,,-921288391.0,-296288188.0,-1534127854.0416667,43977.0,30676.0,,,,,,,67399.09340533716,157933.55417906083,126021.4557396025,,,,,,,3711729.0,,,,,,,,,,,,,,,,436186.0,430985.0,,6420.568375002896,631527.0,625086.0,,,,,,,,,9.0,20702044.08,6173680.455,1978711710.8400009,693030053.4750001,25485966.629999995,618685.47,44.0,5196.0,-6782369.0,3267367.0,-3510611.0,-3788696.0,-4.0,0.0,216.855,26671.185,0.0,0.0,0.0,0.0,0.0,-316.0,-287.0,-227.0,-287.0,77406452.4825,1100467303.2449996,1239591455.46,,1100426803.2449996,79741.0,-5569604.0,1280111889.5,56265112.5,280853187.0,129551184.0,292645999.0,79749.0,1267.5,,2169132.0,667327.0,406569.0,-1328601.0,359870.0,2509.0,886586694.3899779,892486415.3399793,-54801293.0,-54356176.0,989068.0,44711.0,873068636.6099992,2238826500.0,,116124986.02500002,,,49242867.97499996,,113647675.99499972,837834905.2949991,869661465.4349978,869695217.3699979,,9453.0,,,282940.0,-495916.0,210789.0,426.0,1466356.0,14741120.0,3229864.0,8548931.0,11599291.0,1414638.0,1057521616.857001,801480525.434995,72059184775.1696,21666238976.74512,582091046.036999,5792665.7475,689.5,94245.0,-276746953.5,21911019.0,-123711860.0,-218561810.0,-2015274.5,5917605100.402461,18705858750.0,,447614441.63999766,,,308855711.3849987,,458768124.9449992,5702940738.090032,5880923268.9749975,5881166451.719999,,80783.5,,,970790.0,-1697027.5,177364.0,6755.0,4269919.5,2477533.0,-8997407.0,921269.0,37582.5,3730895871.9974656,3655482034.5224633,-260454134.0,-257145366.0,2524787.0,269012.5,3923589060.539956,33233928483.15092,36661245952.65764,,48053775223.03571,3985327.0,-247416887.5,103014260340.5,1053087849.0,17263579129.5,3501603476.5,18876865717.0,3669559.0,71869.0,,89749245.5,,4.675388888888889,5.008347245409015,306.4010794246118,23.415971062882587,1432.5442022853922,40500.0,-0.9009688679024191,0.4338837391175582,0.0,0.0,0.0,0.0,0.0,0.0,1.0,0.0,0.0,1.0,0.0,0.0,0.0,0.0,0.0,0.0,0.0,0.0,1.0,0.0,1.0,0.0,0.0,0.0,0.0,1.0,0.0,0.0,0.0,0.0,0.0,0.0,0.0,0.0,0.0,0.0,0.0,0.0,0.0,0.0,0.0,0.0,0.0,0.0,0.0,0.0,0.0,0.0,0.0,0.0,0.0,0.0,0.0,0.0,0.0,0.0,0.0,0.0,0.0,0.0,0.0,0.0,0.0,0.0,0.0,0.0,0.0,0.0,0.0,0.0,0.0,0.0,0.0,0.0,0.0,0.0,0.0,0.0,0.0,0.0,0.0,0.0,0.0,0.0,0.0,0.0,0.0,0.0,0.0,0.0,0.0,0.0,0.0,0.0,0.0,0.0,0.0,0.0,0.0,0.0,0.0,0.0,0.0,0.0,0.0,1.0,0.0,0.0,0.0,0.0,0.0,0.0,0.0,0.0,0.0,0.0,0.0,0.0,0.0,0.0
101308,0,0.0,0.0,0.0,1.0,1.0,540000.0,500490.0,59526.0,450000.0,0.032561,33.07671232876712,-360.0,-6119.0,-4374.0,,2.0,1.0,1.0,10.0,0.1397948965351341,0.7045064166006577,0.3328505641648731,0.133,0.1151,0.9747,0.6532,0.0244,0.0,0.3103,0.1667,0.2083,0.0644,0.1072,0.1197,0.0058,0.0048,0.1334,0.1075,0.9747,0.6668,0.023,0.0,0.3103,0.1667,0.2083,0.0611,0.1166,0.1246,0.0,0.0037,0.1343,0.1151,0.9747,0.6578,0.0245,0.0,0.3103,0.1667,0.2083,0.0655,0.109,0.1218,0.0058,0.0049,0.0949,1.0,1.0,0.0,1.0,0.0,0.0,0.0,0.0,0.0,0.0,1.0,0.0,1.0,1.0,0.0,1.0,1.0,0.0,0.0,0.0,0.0,0.0,0.0,0.0,0.0,1.0,0.0,0.0,0.0,0.0,0.0,0.0,0.0,0.0,0.0,0.0,0.0,0.0,0.0,0.0,0.0,0.0,0.0,0.0,9.0,0.0,16713.0,147898.35,0.0,0.0,0.0,0.0,0.0,-967.0,-485.0,-481.0,-757.0,267.0,-18.0,2.0,7725.4425,51187.5,47043.0,5123.25,51187.5,8.0,-2212.5,365243.0,-2174.0,-1964.0,-1964.0,-1955.5,15.0,0.5,0.1066718078521832,39.5,18.0,10.0,4.0,-57.5,0.0,0.0,24.0,7116.615,4206.78,-1710.0,-1701.0,5.0,1.0,0.0,,,,,,,,,,,,,,,,,,,,,8340856177.5,184294058323.5,165490952197.5,51936713110.935,1863.0,1704.0,71124.0,70719.0,9140.0,505720.0,17795.649600002293,17857.73609999911,17309.56399999808,11288.236300000086,11226.06670000009,11173.633700000057,128318.0,662356.0,4135.661100000123,4133.302200000017,3944.0741000000953,13518780.989040695,-601475607.0,-921292765.0,-296288188.0,-1534133973.0416667,43977.0,30676.0,11342.473199999176,11218.37999999897,10702.9688999973,22872.663900009637,22794.495800009598,22180.519200008148,67399.23320023369,157934.25868547743,126021.78859016667,34975.490900027886,34915.94910002833,34362.34140002874,22937.703399995928,22911.150899995504,22558.539999995737,3711739.0,8290.279300000167,8394.724600000081,8118.464400000227,9811.45400000072,9926.33800000216,10285.784799999648,16457.85899999975,16642.9837999997,16239.919899999695,828.2168000001759,813.3964000000459,759.3781000000133,3911.096200000124,3894.34500000016,3727.169500000158,436187.0,430986.0,,6420.600936002896,631528.0,625087.0,,16321.5617999998,154070.78919999054,154073.53719999007,153965.31659998713,77556.97119999627,77894.52090000657,78295.64910000649,32.0,20843809.02,6211815.9750000015,1981794964.5900004,693737232.9750001,25664371.875,618685.47,44.0,5196.0,-6794971.0,3265381.0,-3516930.0,-3795831.0,-15.5,0.0,24318.0,147898.35,0.0,0.0,0.0,0.0,0.0,-1268.0,-964.0,-937.0,-940.0,77515511.4,1101971005.2449996,1241472473.91,18200021.08500001,1101971005.2449996,79898.0,-5581780.5,1282666397.5,56620942.0,281576922.0,130276666.0,293736184.0,79952.0,1269.5,224.4052280699176,2176324.5,668089.0,407093.5,-1330302.0,359889.0,2528.0,887553158.3774793,893402468.4374803,-54969356.0,-54522967.0,993943.5,44766.5,,,,,,,,,,,,,,,,,,,,,1466365.0,14741387.0,3229864.0,8548949.0,11599315.0,1414640.0,1057521616.857001,801497238.434995,72059332673.5196,21666238976.74512,582091046.036999,5792665.7475,689.5,94245.0,-276747920.5,21910534.0,-123712341.0,-218562567.0,-2015292.5,,,,,,,,,,,,,,,,,,,,,4269929.5,2477537.0,-8997464.5,921269.0,37582.5,3730902988.612466,3655486241.302464,-260455844.0,-257147067.0,2524792.0,269013.5,3923596785.982456,33233979670.65092,36661292995.65764,1728347694.3675494,48053826410.53571,3985335.0,-247419100.0,103014625583.5,1053085675.0,17263577165.5,3501601512.5,18876863761.5,3669574.0,71869.5,20857.65310637837,89749285.0,-10.883790275822085,0.9268333333333332,9.071666162685212,300.0608920057495,8.407922588448745,278.10643674066216,270000.0,-0.2225209339563143,0.9749279121818236,0.0,0.0,0.0,0.0,0.0,0.0,1.0,0.0,1.0,0.0,0.0,0.0,0.0,0.0,0.0,1.0,0.0,0.0,0.0,0.0,0.0,1.0,0.0,0.0,0.0,1.0,0.0,0.0,0.0,0.0,0.0,0.0,0.0,0.0,0.0,0.0,0.0,0.0,0.0,0.0,0.0,0.0,0.0,0.0,0.0,0.0,0.0,0.0,0.0,0.0,0.0,0.0,0.0,1.0,0.0,0.0,0.0,0.0,0.0,0.0,0.0,0.0,0.0,0.0,0.0,0.0,0.0,0.0,0.0,0.0,0.0,0.0,0.0,0.0,0.0,0.0,0.0,0.0,0.0,0.0,0.0,0.0,0.0,0.0,0.0,0.0,0.0,0.0,0.0,0.0,0.0,0.0,0.0,0.0,0.0,0.0,0.0,0.0,0.0,0.0,0.0,0.0,0.0,0.0,0.0,0.0,0.0,0.0,1.0,0.0,1.0,0.0,0.0,0.0,0.0,0.0,0.0,1.0,0.0,0.0
101318,0,0.0,0.0,0.0,0.0,0.0,90000.0,225000.0,13896.0,225000.0,0.028663,57.13424657534247,,-9581.0,-4361.0,,2.0,2.0,2.0,11.0,,0.6933393275493207,0.6195277080511546,0.1113,0.0809,0.9866,0.8164,0.0247,0.12,0.1034,0.3333,0.0417,0.0929,0.0908,0.0678,0.0,0.0,0.1134,0.084,0.9866,0.8236,0.0249,0.1208,0.1034,0.3333,0.0417,0.095,0.0992,0.0707,0.0,0.0,0.1124,0.0809,0.9866,0.8189,0.0249,0.12,0.1034,0.3333,0.0417,0.0945,0.0923,0.0691,0.0,0.0,0.0921,1.0,0.0,0.0,0.0,0.0,-824.0,0.0,0.0,0.0,0.0,0.0,5.0,1.0,0.0,0.0,1.0,0.0,0.0,0.0,0.0,0.0,0.0,0.0,0.0,0.0,1.0,0.0,0.0,0.0,0.0,0.0,0.0,0.0,0.0,0.0,0.0,0.0,0.0,0.0,0.0,0.0,0.0,0.0,0.0,4.0,11448.0,,122620.5,0.0,0.0,0.0,0.0,0.0,-488.5,-186.0,-199.0,-186.0,132.0,-22.5,5.0,16274.79,90000.0,143910.0,0.0,112500.0,12.0,-2091.0,365243.0,-2061.0,-1791.0,-1731.0,-1786.0,12.0,1.0,0.0,4.0,47.0,12.0,6.0,-65.0,0.0,0.0,45.0,16274.79,16274.79,-2002.0,-2001.0,6.0,1.0,25.0,0.0,675000.0,,0.0,,,0.0,,0.0,0.0,0.0,0.0,,0.0,,,0.0,-15.0,0.0,0.0,8340870073.5,184294283323.5,165491177197.5,51936803110.935,1863.0,1704.0,71124.0,70719.0,9140.0,505725.0,17795.760900002293,17857.84849999911,17309.67739999808,11288.317200000089,11226.147600000091,11173.717700000056,128318.0,662358.0,4135.685800000123,4133.327100000018,3944.099000000095,13518838.12328727,,-921297126.0,-296289012.0,-1534143554.0416667,43977.0,30676.0,11342.593199999175,11218.49999999897,10703.0896999973,22872.767300009637,22794.599200009598,22180.622600008148,,157934.95202480498,126022.40811787471,34975.824200027884,34916.28240002833,34362.674700028736,22937.745099995933,22911.192599995506,22558.581699995742,3711750.0,8290.372200000167,8394.819100000079,8118.5594000002275,9811.54480000072,9926.43030000216,10285.883999999647,16457.92679999975,16643.0528999997,16239.990599999695,828.2168000001759,813.3964000000459,759.3781000000133,3911.096200000124,3894.34500000016,3727.169500000158,436187.0,430986.0,,6420.629599002896,631530.0,625089.0,,16321.6538999998,154071.77579999054,154074.52379999007,153966.30319998713,77557.78759999629,77895.33980000658,78296.47270000649,17.0,21117500.01,,1993792304.6100004,698367298.4550003,25721099.414999995,618685.47,44.0,5196.0,-6863369.5,3263776.0,-3552803.5,-3835772.0,-8.0,0.0,,180000.0,0.0,0.0,0.0,0.0,0.0,-2692.0,-2326.0,-2373.0,-2373.0,78249697.42500001,1111954385.7449996,1253216699.91,18331337.83500001,1112033135.7449996,80686.0,-5644650.0,1295996277.0,56935014.0,284462285.0,131341273.0,296622480.0,80528.0,1288.0,226.2074788295793,2180047.0,678815.0,413055.0,-1352036.0,359890.0,2529.0,896581743.7499752,901855945.3949764,-55619224.0,-55168521.0,1000799.0,45334.0,881028332.6849995,2275726500.0,,116922565.98,,,49666761.94499996,,114256462.27499972,845520243.1199987,877599352.3499978,877633104.2849977,,9508.0,,,285281.0,-499540.0,210793.0,430.0,1466369.0,14741519.0,3229889.0,8548996.0,11599360.0,1414645.0,1057533064.857001,,72059455294.0196,21666238976.74512,582091046.036999,5792665.7475,689.5,94245.0,-276748409.0,21910348.0,-123712540.0,-218562753.0,-2015315.0,5917605100.402461,18706533750.0,,447614441.63999766,,,308855711.3849987,,458768124.9449992,5702940738.090032,5880923268.9749975,5881166451.719999,,80783.5,,,970790.0,-1697042.5,177364.0,6755.0,4269941.5,2477543.0,-8997529.5,921269.0,37582.5,3730919263.402465,3655502516.092464,-260457846.0,-257149068.0,2524798.0,269014.5,3923613060.772456,33234069670.65092,36661436905.65764,1728347694.3675494,48053938910.53571,3985347.0,-247421191.0,103014990826.5,1053083614.0,17263575374.5,3501599781.5,18876861975.5,3669586.0,71870.5,20857.65310637837,89749289.0,,2.5,6.476683937823834,370.0404570941869,16.191709844559586,925.1011427354674,45000.0,1.0,0.0,0.0,0.0,0.0,0.0,0.0,0.0,1.0,0.0,0.0,1.0,0.0,0.0,0.0,0.0,0.0,0.0,0.0,0.0,1.0,0.0,1.0,0.0,0.0,0.0,0.0,1.0,0.0,0.0,0.0,0.0,0.0,0.0,0.0,0.0,0.0,0.0,0.0,0.0,0.0,0.0,0.0,0.0,0.0,0.0,0.0,0.0,0.0,0.0,0.0,0.0,0.0,0.0,0.0,0.0,0.0,0.0,0.0,0.0,0.0,0.0,0.0,0.0,0.0,0.0,0.0,0.0,0.0,0.0,0.0,0.0,0.0,0.0,0.0,0.0,0.0,0.0,0.0,0.0,0.0,0.0,0.0,0.0,0.0,0.0,0.0,0.0,0.0,0.0,0.0,0.0,0.0,0.0,0.0,0.0,0.0,0.0,0.0,0.0,0.0,0.0,0.0,0.0,0.0,0.0,0.0,1.0,0.0,0.0,1.0,0.0,1.0,0.0,0.0,0.0,0.0,0.0,0.0,1.0,0.0,0.0
101327,0,0.0,1.0,1.0,1.0,2.0,225000.0,848745.0,43465.5,675000.0,0.031329,34.18904109589041,-2582.0,-2584.0,-4264.0,8.0,4.0,2.0,2.0,12.0,,0.1426701643643623,0.2314393514998941,0.0619,0.0511,0.9747,0.6532,0.0053,0.0,0.1034,0.1667,0.2083,0.0602,0.0504,0.0511,0.0,0.0,0.063,0.053,0.9747,0.6668,0.0053,0.0,0.1034,0.1667,0.2083,0.0616,0.0551,0.0533,0.0,0.0,0.0625,0.0511,0.9747,0.6578,0.0053,0.0,0.1034,0.1667,0.2083,0.0612,0.0513,0.052,0.0,0.0,0.0402,1.0,3.0,0.0,3.0,0.0,-58.0,0.0,0.0,0.0,0.0,2.0,2.0,1.0,1.0,0.0,1.0,0.0,0.0,0.0,0.0,0.0,0.0,0.0,0.0,0.0,1.0,0.0,0.0,0.0,0.0,0.0,0.0,0.0,0.0,0.0,0.0,0.0,0.0,0.0,0.0,0.0,0.0,0.0,0.0,7.0,19444.5,0.0,319545.0,102597.9975,0.0,0.0,0.0,0.0,-1031.0,304.0,-22.0,-1577.0,248.0,-20.0,6.0,10280.4975,80838.0,91327.5,1260.0,80838.0,15.0,-1197.0,365243.0,-1167.0,-659.0,-657.0,-654.0,12.5,0.0,0.0467506799894894,507.5,72.0,18.0,8.0,-44.5,0.0,0.0,73.0,11457.0,11457.0,-1346.0,-1343.0,7.0,1.0,15.0,0.0,225000.0,,0.0,,,0.0,,0.0,0.0,0.0,0.0,,0.0,,,0.0,-10.0,0.0,0.0,8340913539.0,184295132068.5,165491852197.5,51937028110.935,1863.0,1704.0,71124.0,70721.0,9140.0,505727.0,17795.822800002294,17857.91099999911,17309.740399998078,11288.368300000087,11226.198700000094,11173.770700000056,128320.0,662362.0,4135.691100000124,4133.3324000000175,3944.104300000095,13518872.312328368,-601478189.0,-921301390.0,-296289070.0,-1534146138.0416667,43977.0,30676.0,11342.593199999175,11218.49999999897,10703.0896999973,22872.870700009636,22794.702600009598,22180.726000008148,,157935.0946949693,126022.63955722626,34975.990900027886,34916.44910002833,34362.84140002874,22937.953399995928,22911.400899995504,22558.789999995737,3711762.0,8290.432400000167,8394.880300000079,8118.6210000002275,9811.59520000072,9926.481600002158,10285.939099999649,16457.97789999975,16643.1048999997,16240.043899999697,828.2168000001759,813.3964000000459,759.3781000000133,3911.096200000124,3894.34500000016,3727.169500000158,436190.0,430989.0,1262254.0,6420.660928002895,631532.0,625091.0,,16321.6940999998,154072.75049999054,154075.49849999006,153967.27789998712,77558.44079999629,77895.99760000657,78297.13950000651,34.0,21275337.51,6269286.1275,2000466748.35,700050866.0175003,25919673.075,618685.47,44.0,5196.0,-6912502.0,3247083.0,-3587368.0,-3869904.5,-16.5,25389.0,0.0,319545.0,0.0,0.0,0.0,0.0,0.0,-1437.0,-706.0,-1025.0,-2123.0,79070672.83500002,1124579568.1949997,1266947960.265,18475400.430000007,1124579568.1949997,81411.0,-5701328.5,1308227261.5,57264973.5,286263734.5,132421398.5,298424873.5,81225.0,1307.0,227.87716256917295,2185251.0,685054.0,417402.0,-1362774.5,359927.0,2546.0,910678983.5249752,916979943.7349764,-56426806.0,-55968532.0,1026933.0,45763.0,899258896.9349996,2317410000.0,,118867760.91,,,51016249.03499997,,117096267.86999968,862940134.0799987,895818516.7499976,895854788.6849977,,9673.0,,,294919.0,-510388.0,210815.0,452.0,1466376.0,14741767.0,3229904.0,8549068.0,11599433.0,1414651.0,1057552509.357001,801497238.434995,72059774839.0196,21666341574.742622,582091046.036999,5792665.7475,689.5,94245.0,-276749440.0,21910652.0,-123712562.0,-218564330.0,-2015335.0,5917605100.402461,18706758750.0,,447614441.63999766,,,308855711.3849987,,458768124.9449992,5702940738.090032,5880923268.9749975,5881166451.719999,,80783.5,,,970790.0,-1697052.5,177364.0,6755.0,4269959.5,2477551.0,-8997574.0,921269.0,37582.5,3730930720.402465,3655513973.092464,-260459192.0,-257150411.0,2524805.0,269015.5,3923623341.269956,33234150508.65092,36661528233.15764,1728348954.3675494,48054019748.53571,3985362.0,-247422388.0,103015356069.5,1053082447.0,17263574715.5,3501599124.5,18876861321.5,3669598.5,71870.5,20857.69985705836,89749796.5,-75.52127574324867,3.7722,5.176519308417022,176.98023136913972,19.52686613521068,667.6048287706689,56250.0,-0.2225209339563143,0.9749279121818236,0.0,1.0,0.0,0.0,0.0,0.0,0.0,0.0,0.0,0.0,0.0,0.0,0.0,1.0,0.0,0.0,0.0,0.0,1.0,0.0,1.0,0.0,0.0,0.0,0.0,1.0,0.0,0.0,0.0,0.0,0.0,0.0,0.0,0.0,0.0,0.0,0.0,0.0,0.0,0.0,0.0,0.0,0.0,0.0,0.0,0.0,0.0,0.0,0.0,0.0,0.0,0.0,0.0,0.0,0.0,0.0,0.0,0.0,0.0,0.0,0.0,0.0,0.0,0.0,0.0,0.0,0.0,0.0,0.0,0.0,0.0,0.0,1.0,0.0,0.0,0.0,0.0,0.0,0.0,0.0,0.0,0.0,0.0,0.0,0.0,0.0,0.0,0.0,0.0,0.0,0.0,0.0,0.0,0.0,0.0,0.0,0.0,0.0,0.0,0.0,0.0,0.0,0.0,0.0,0.0,0.0,0.0,0.0,1.0,0.0,1.0,0.0,0.0,1.0,0.0,0.0,0.0,0.0,0.0,0.0
101329,0,0.0,0.0,0.0,1.0,1.0,112500.0,93829.5,9981.0,81000.0,0.010966,35.273972602739725,-1904.0,-1610.0,-3354.0,,2.0,2.0,2.0,14.0,0.5779129593821749,0.5718446463635923,0.5867400085415683,,,,,,,,,,,,,,,,,,,,,,,,,,,,,,,,,,,,,,,,,,,,,0.0,0.0,0.0,0.0,-1636.0,0.0,0.0,0.0,0.0,1.0,3.0,1.0,1.0,0.0,1.0,1.0,0.0,0.0,0.0,0.0,0.0,1.0,1.0,0.0,1.0,0.0,0.0,0.0,0.0,0.0,0.0,0.0,0.0,0.0,0.0,0.0,0.0,0.0,0.0,0.0,0.0,0.0,0.0,7.0,0.0,0.0,49050.0,0.0,0.0,0.0,0.0,0.0,-1185.0,-427.0,-649.0,-843.0,297.0,-21.0,7.0,6947.2125,31455.0,33322.5,1935.0,41850.0,6.0,-448.0,365243.0,-319.5,182541.0,100.5,182542.5,13.0,0.5,0.047241913740451,-1.0,23.0,24.0,13.0,-10.0,0.0,0.0,21.0,27449.82,27449.82,-273.0,-268.0,4.0,1.0,13.0,0.0,180000.0,,0.0,,,0.0,,0.0,0.0,0.0,0.0,,0.0,,,0.0,-9.0,0.0,0.0,8340923520.0,184295225898.0,165491933197.5,51937140610.935,1863.0,1704.0,71124.0,70722.0,9140.0,505730.0,,,,,,,128321.0,662364.0,,,,13518907.58630097,-601480093.0,-921304744.0,-296290706.0,-1534147748.0416667,43977.0,30676.0,,,,,,,67399.81111319308,157935.6665396157,126023.22629723477,,,,,,,3711776.0,,,,,,,,,,,,,,,,436190.0,430989.0,,6420.671894002896,631534.0,625093.0,,,,,,,,,39.0,21423157.965,6277760.819999998,2002850213.85,700842765.7800003,25919673.075,618685.47,44.0,5196.0,-6923317.0,3299945.0,-3592491.0,-3874569.5,-19.0,0.0,0.0,49050.0,0.0,0.0,0.0,0.0,0.0,-1185.0,-427.0,-649.0,-1021.0,79140793.50000001,1125755649.9449997,1268185305.015,18480530.430000007,1125530649.9449997,81471.0,-5707066.0,1310418719.5,57990195.5,287538570.0,133149004.5,299699724.5,81368.0,1307.5,228.021400916893,2187824.0,685992.0,417960.0,-1365075.0,359927.0,2546.0,911659648.9949764,918140609.2049776,-56493784.0,-56034411.0,1027358.0,45839.0,899258896.9349996,2319430500.0,,118867760.91,,,51016249.03499997,,117096267.86999968,862940134.0799987,895818516.7499976,895854788.6849977,,9673.0,,,294919.0,-510513.0,210815.0,452.0,1466383.0,14742064.0,3229917.0,8549091.0,11599454.0,1414658.0,1057552509.357001,801497238.434995,72059823889.0196,21666341574.742622,582091046.036999,5792665.7475,689.5,94245.0,-276750625.0,21910225.0,-123713211.0,-218565173.0,-2015356.0,5917605100.402461,18706938750.0,,447614441.63999766,,,308855711.3849987,,458768124.9449992,5702940738.090032,5880923268.9749975,5881166451.719999,,80783.5,,,970790.0,-1697061.5,177364.0,6755.0,4269983.5,2477564.0,-8997584.0,921269.0,37582.5,3730958170.2224655,3655541422.912464,-260459465.0,-257150679.0,2524809.0,269016.5,3923630288.482456,33234181963.65092,36661561555.65764,1728350889.3675494,48054061598.53571,3985368.0,-247422836.0,103015721312.5,1053082127.5,17263757256.5,3501599225.0,18877043864.0,3669611.5,71871.0,20857.7470989721,89749795.5,-53.97747572815535,0.83404,11.271415689810642,397.5876082364712,9.400811541929668,331.6039687735465,56250.0,-0.9009688679024191,0.4338837391175582,0.0,0.0,0.0,0.0,0.0,0.0,1.0,0.0,0.0,0.0,0.0,0.0,0.0,1.0,0.0,0.0,0.0,0.0,1.0,0.0,0.0,0.0,1.0,0.0,0.0,1.0,0.0,0.0,0.0,0.0,0.0,0.0,0.0,0.0,0.0,0.0,0.0,0.0,1.0,0.0,0.0,0.0,0.0,0.0,0.0,0.0,0.0,0.0,0.0,0.0,0.0,0.0,0.0,1.0,0.0,0.0,0.0,0.0,0.0,0.0,0.0,0.0,0.0,0.0,0.0,0.0,0.0,0.0,0.0,0.0,0.0,0.0,0.0,0.0,0.0,0.0,0.0,0.0,0.0,0.0,0.0,0.0,0.0,0.0,0.0,0.0,0.0,0.0,0.0,0.0,0.0,0.0,0.0,0.0,0.0,0.0,0.0,0.0,0.0,0.0,0.0,0.0,0.0,0.0,0.0,0.0,0.0,0.0,0.0,0.0,0.0,0.0,0.0,0.0,0.0,0.0,0.0,0.0,0.0,0.0
101332,0,0.0,0.0,1.0,1.0,0.0,90000.0,248760.0,26919.0,225000.0,0.030755,58.942465753424656,,-4793.0,-5070.0,7.0,2.0,2.0,2.0,12.0,,0.5269057957577571,,,,,,,,,,,,,,,,,,,,,,,,,,,,,,,,,,,,,,,,,,,,,,0.0,0.0,0.0,0.0,0.0,,,,,,,1.0,0.0,0.0,1.0,0.0,1.0,0.0,0.0,0.0,0.0,0.0,0.0,0.0,0.0,0.0,0.0,1.0,0.0,0.0,0.0,0.0,0.0,0.0,0.0,0.0,0.0,0.0,0.0,0.0,0.0,0.0,0.0,0.0,,,,,,,,,,,,,0.0,,0.0,,,,,,,,,,,,,,,,,5.0,10.0,1.0,-94.0,0.0,0.0,4.0,3357.495,3357.495,-2861.0,-2861.0,8.5,1.0,0.0,,,,,,,,,,,,,,,,,,,,,8340950439.0,184295474658.0,165492158197.5,51937230610.935,,,,,,,,,,,,,128321.0,662366.0,,,,13518966.528766723,,-921309814.0,-296290706.0,-1534152541.0416667,43977.0,30676.0,,,,,,,,157936.19344541145,,,,,,,,3711788.0,,,,,,,,,,,,,,,,436190.0,430989.0,1262261.0,6420.702649002896,631536.0,625095.0,,,,,,,,,,,,,,,,,,,,,,,,,,,,,,,,,,,,,,,,,,,,,,,,,,,686338.0,418175.0,-1366141.0,359927.0,2546.0,912086960.3774765,918549068.152478,-56523992.0,-56064308.0,1027503.5,45878.5,,,,,,,,,,,,,,,,,,,,,1466383.0,14742064.0,3229917.0,8549096.0,11599458.0,1414658.0,,,,,,,,,,,,,,,,,,,,,,,,,,,,,,,,,,4269993.5,2477565.0,-8997678.0,921269.0,37582.5,3730961527.7174654,3655544780.407464,-260462326.0,-257153540.0,2524817.5,269017.5,,,,,,,,,,,,,,,,,,2.764,3.3433634236041456,197.06608409704,9.24105650284186,544.6906564442186,45000.0,-0.9009688679024191,0.4338837391175582,0.0,1.0,0.0,0.0,0.0,0.0,0.0,0.0,0.0,1.0,0.0,0.0,0.0,0.0,0.0,0.0,0.0,0.0,1.0,0.0,1.0,0.0,0.0,0.0,0.0,1.0,0.0,0.0,0.0,0.0,0.0,0.0,0.0,0.0,0.0,0.0,0.0,0.0,0.0,0.0,0.0,0.0,0.0,0.0,0.0,0.0,0.0,0.0,0.0,0.0,0.0,0.0,0.0,0.0,0.0,0.0,0.0,0.0,0.0,0.0,0.0,0.0,0.0,0.0,0.0,0.0,0.0,0.0,0.0,0.0,0.0,0.0,0.0,0.0,0.0,0.0,0.0,0.0,0.0,0.0,0.0,0.0,0.0,0.0,0.0,0.0,0.0,0.0,0.0,0.0,0.0,0.0,0.0,0.0,0.0,0.0,0.0,0.0,0.0,0.0,0.0,0.0,0.0,0.0,0.0,1.0,0.0,0.0,0.0,0.0,0.0,0.0,0.0,0.0,0.0,0.0,0.0,0.0,0.0,0.0
101337,0,0.0,0.0,0.0,1.0,0.0,157500.0,1024740.0,55719.0,900000.0,0.0228,47.84109589041096,-922.0,-1292.0,-896.0,,2.0,2.0,2.0,13.0,0.5508480923673861,0.4233633858452441,0.6212263380626669,,,,,,,,,,,,,,,,,,,,,,,,,,,,,,,,,,,,,,,,,,,,,1.0,1.0,1.0,1.0,-409.0,0.0,0.0,0.0,0.0,1.0,3.0,1.0,1.0,0.0,1.0,0.0,0.0,0.0,0.0,0.0,0.0,0.0,0.0,0.0,1.0,0.0,0.0,0.0,0.0,0.0,0.0,0.0,0.0,0.0,0.0,0.0,0.0,0.0,0.0,0.0,0.0,0.0,0.0,2.0,7715.25,,123711.75,14706.0,0.0,0.0,0.0,0.0,-382.0,-124.0,-167.5,-344.0,26.0,-6.5,5.0,12913.245,92061.0,88870.5,4603.5,92061.0,6.0,-415.0,365243.0,-356.0,-281.0,-116.0,-275.0,16.0,0.5,0.0511190640055058,71.0,17.0,6.0,3.0,-13.0,0.0,0.0,22.0,12913.245,12913.245,-359.5,-358.5,3.5,1.0,13.0,0.0,0.0,0.0,0.0,0.0,0.0,0.0,591.75,591.75,0.0,0.0,0.0,0.0,0.0,0.0,0.0,0.0,-8.0,0.0,0.0,8341006158.0,184296499398.0,165493058197.5,51937388110.935,1863.0,1704.0,71124.0,70723.0,9140.0,505733.0,,,,,,,128321.0,662368.0,,,,13519014.369862614,-601481015.0,-921310710.0,-296291115.0,-1534153833.0416667,43978.0,30677.0,,,,,,,67400.36196128545,157936.6168087973,126023.84752357284,,,,,,,3711801.0,,,,,,,,,,,,,,,,436191.0,430990.0,,6420.725449002895,631538.0,625097.0,,,,,,,,,13.0,21438588.465,,2013771674.3400004,701691253.5600003,26019987.84,618685.47,45.0,5196.0,-6983601.0,3313392.0,-3628908.5,-3914823.0,-6.0,0.0,,151470.0,0.0,0.0,0.0,0.0,0.0,-590.0,-284.0,-331.0,-344.0,79373843.77499999,1128352222.3949995,1270944961.515,18567862.380000006,1128352222.3949995,81665.0,-5725194.0,1315531914.0,58338885.0,288803980.0,133502750.0,300600238.5,81609.0,1315.5,229.52162528582656,2190643.0,689490.0,420119.0,-1370967.0,359973.0,2549.0,915380090.3699791,921534248.6999804,-56661129.5,-56200621.5,1028910.0,46006.0,899258896.9349996,2320389000.0,74686452.75,118896223.41,4928432.4,39206223.36000002,51016249.03499997,126921272.76000066,117126505.61999968,862940134.0799987,895818516.7499976,895854788.6849977,3836.0,9675.0,74.0,5765.0,294919.0,-510630.0,210815.0,452.0,1466385.0,14742090.0,3229930.0,8549113.0,11599480.0,1414663.0,1057560224.607001,,72059947600.7696,21666356280.742622,582091046.036999,5792665.7475,689.5,94245.0,-276751007.0,21910101.0,-123713378.5,-218565517.0,-2015362.5,5917605100.402461,18706938750.0,198653345.325,447614441.63999766,1948107.735,256577150.4750008,308855711.3849987,636026554.1924982,458768716.6949992,5702940738.090032,5880923268.9749975,5881166451.719999,13371.0,80783.5,44.0,70304.0,970790.0,-1697069.5,177364.0,6755.0,4269999.5,2477568.0,-8997691.0,921269.0,37582.5,3730974440.962465,3655557693.652464,-260462685.5,-257153898.5,2524821.0,269018.5,3923643201.727456,33234274024.65092,36661650426.15764,1728355492.8675494,48054153659.53571,3985374.0,-247423251.0,103016086555.5,1053081771.5,17263756975.5,3501599109.0,18877043589.0,3669627.5,71871.5,20857.798218036107,89749866.5,-19.272133776199745,6.506285714285713,2.8266838959780327,135.2316553193655,18.39121305120336,879.8557871235976,78750.0,0.6234898018587336,0.7818314824680298,0.0,0.0,0.0,0.0,0.0,0.0,1.0,0.0,0.0,0.0,0.0,0.0,0.0,1.0,0.0,1.0,0.0,0.0,0.0,0.0,1.0,0.0,0.0,0.0,0.0,0.0,0.0,0.0,1.0,0.0,0.0,0.0,0.0,0.0,0.0,0.0,0.0,0.0,0.0,0.0,0.0,0.0,0.0,0.0,1.0,0.0,0.0,0.0,0.0,0.0,0.0,0.0,0.0,0.0,0.0,0.0,0.0,0.0,0.0,0.0,0.0,0.0,0.0,0.0,0.0,0.0,0.0,0.0,0.0,0.0,0.0,0.0,0.0,0.0,0.0,0.0,0.0,0.0,0.0,0.0,0.0,0.0,0.0,0.0,0.0,0.0,0.0,0.0,0.0,0.0,1.0,0.0,0.0,0.0,0.0,0.0,0.0,0.0,0.0,0.0,0.0,0.0,0.0,0.0,0.0,0.0,0.0,0.0,0.0,0.0,0.0,0.0,0.0,0.0,0.0,0.0,0.0,0.0,0.0,0.0
101343,0,0.0,0.0,0.0,1.0,1.0,180000.0,505233.0,21537.0,378000.0,0.018801,44.38082191780822,-7741.0,-1592.0,-4828.0,,3.0,2.0,2.0,8.0,0.6002092616642773,0.5256518837269177,0.6109913280868294,0.1598,0.0904,0.9965,0.9524,0.1017,0.24,0.1034,0.375,0.4167,0.071,0.1294,0.1637,0.0039,0.0117,0.1628,0.0938,0.9965,0.9543,0.1026,0.2417,0.1034,0.375,0.4167,0.0726,0.1414,0.1706,0.0039,0.0124,0.1613,0.0904,0.9965,0.953,0.1023,0.24,0.1034,0.375,0.4167,0.0722,0.1317,0.1666,0.0039,0.012,0.1985,1.0,1.0,0.0,1.0,0.0,-1799.0,0.0,0.0,0.0,0.0,0.0,2.0,1.0,1.0,0.0,1.0,0.0,0.0,0.0,0.0,0.0,0.0,0.0,0.0,0.0,0.0,0.0,0.0,0.0,0.0,0.0,1.0,0.0,0.0,0.0,0.0,0.0,0.0,0.0,0.0,0.0,0.0,0.0,0.0,12.0,3375.0,0.0,346500.0,0.0,0.0,0.0,0.0,0.0,-734.0,980.0,-416.0,-559.0,379.0,-18.0,4.0,13944.5325,206966.565,250411.815,0.0,289490.13,24.0,-1415.0,365243.0,-1309.5,-925.5,-468.0,-913.5,11.0,0.5,0.0,-1.0,35.0,24.0,12.0,-45.0,0.0,0.0,84.0,5612.4,5612.4,-1075.5,-1070.0,12.0,0.0,44.0,0.0,180000.0,0.0,0.0,0.0,0.0,0.0,89.415,89.415,0.0,0.0,0.0,0.0,0.0,0.0,0.0,17.0,-25.5,0.0,0.0,8341027695.0,184297004631.0,165493436197.5,51937568110.935,1863.0,1704.0,71124.0,70723.0,9140.0,505735.0,17795.982600002295,17858.07229999911,17309.903199998076,11288.458700000088,11226.289100000093,11173.864500000058,128322.0,662371.0,4135.792800000123,4133.434700000017,3944.206900000095,13519058.750684531,-601488756.0,-921315538.0,-296292914.0,-1534155425.0416667,43978.0,30677.0,11342.833199999175,11218.73999999897,10703.3313999973,22872.974100009636,22794.806000009597,22180.829400008148,67400.96217054712,157937.14246068106,126024.45851490088,34976.365900027886,34916.82410002833,34363.21640002874,22938.370099995933,22911.817599995506,22559.206699995742,3711809.0,8290.503400000167,8394.952500000081,8118.693600000228,9811.72460000072,9926.613300002158,10286.080499999647,16458.14159999975,16643.2714999997,16240.214499999694,828.220700000176,813.400300000046,759.3820000000132,3911.107900000124,3894.357000000161,3727.181900000159,436192.0,430991.0,,6420.744250002896,631540.0,625099.0,,16321.8925999998,154073.74699999054,154076.49499999007,153968.27439998713,77559.39319999628,77896.95060000657,78298.09380000648,24.5,21449055.465,6399395.369999999,2026540196.6400003,705588152.4000003,26156133.0,618685.47,45.0,5196.0,-7008490.5,3315789.5,-3639968.5,-3925260.0,-11.75,3375.0,288.0,270000.0,0.0,0.0,0.0,0.0,0.0,-1081.0,921.0,-547.0,-672.0,79721584.28999999,1134099932.6699998,1277260502.265,18671245.155000005,1134257432.6699998,82096.0,-5747904.5,1320644465.5,58321052.5,289520666.5,133855816.5,301316943.0,81874.0,1320.5,230.16564448852344,2202585.5,691440.0,421178.0,-1377162.0,359973.0,2549.0,917674925.4674784,923868960.2324792,-56860283.5,-56397856.5,1030473.5,46171.0,900877707.0449996,2322324000.0,74686452.75,119085223.41,4928432.4,39206223.36000002,51087843.58499996,127154278.6650007,117381246.52499974,864509801.4449987,897441873.5699974,897478145.5049975,3836.0,9678.0,74.0,5765.0,295168.5,-511208.5,210815.0,452.0,1466397.0,14742469.0,3229974.0,8549148.0,11599564.0,1414667.0,1057563599.607001,801497238.434995,72060294100.7696,21666356280.742622,582091046.036999,5792665.7475,689.5,94245.0,-276751741.0,21911081.0,-123713794.5,-218566076.0,-2015380.5,5917605100.402461,18707118750.0,198653345.325,447614441.63999766,1948107.735,256577150.4750008,308855711.3849987,636026643.6074983,458768806.1099992,5702940738.090032,5880923268.9749975,5881166451.719999,13371.0,80783.5,44.0,70304.0,970807.0,-1697095.0,177364.0,6755.0,4270023.5,2477580.0,-8997736.0,921269.0,37582.5,3730980053.362466,3655563306.052464,-260463761.0,-257154968.5,2524833.0,269018.5,3923657146.2599545,33234480991.21591,36661900837.97264,1728355492.8675494,48054443149.66571,3985398.0,-247424666.0,103016451798.5,1053080462.0,17263756050.0,3501598641.0,18877042675.5,3669638.5,71872.0,20857.798218036107,89749865.5,-174.4221865547256,2.80685,8.357709987463435,370.9220385943019,23.458838278311735,1041.122524028416,60000.0,-0.9009688679024191,0.4338837391175582,0.0,0.0,0.0,0.0,0.0,0.0,1.0,0.0,0.0,0.0,1.0,0.0,0.0,0.0,0.0,0.0,0.0,0.0,1.0,0.0,1.0,0.0,0.0,0.0,0.0,1.0,0.0,0.0,0.0,0.0,0.0,0.0,0.0,0.0,0.0,0.0,0.0,0.0,1.0,0.0,0.0,0.0,0.0,0.0,0.0,0.0,0.0,0.0,0.0,0.0,0.0,0.0,0.0,0.0,0.0,0.0,0.0,0.0,0.0,0.0,0.0,0.0,0.0,0.0,0.0,0.0,0.0,0.0,0.0,0.0,0.0,0.0,0.0,0.0,0.0,0.0,0.0,0.0,0.0,1.0,0.0,0.0,0.0,0.0,0.0,0.0,0.0,0.0,0.0,0.0,0.0,0.0,0.0,0.0,0.0,0.0,0.0,0.0,0.0,0.0,0.0,0.0,0.0,0.0,0.0,0.0,0.0,0.0,0.0,1.0,1.0,0.0,0.0,0.0,0.0,0.0,0.0,0.0,1.0,0.0
101345,0,0.0,0.0,0.0,0.0,0.0,63000.0,83538.0,6592.5,67500.0,0.018634,37.92054794520548,-778.0,-7913.0,-4767.0,,1.0,2.0,2.0,12.0,0.6893473854922831,0.7308459284605278,,,,,,,,,,,,,,,,,,,,,,,,,,,,,,,,,,,,,,,,,,,,,,0.0,0.0,0.0,0.0,-879.0,,,,,,,1.0,1.0,0.0,1.0,0.0,0.0,0.0,0.0,0.0,0.0,0.0,0.0,0.0,1.0,0.0,0.0,0.0,0.0,0.0,0.0,0.0,0.0,0.0,0.0,0.0,0.0,0.0,0.0,0.0,0.0,0.0,0.0,0.0,,,,,,,,,,,,,0.0,,2.0,7083.855,59530.5,63409.5,2976.75,59530.5,12.0,-879.0,365243.0,-848.0,-788.0,-518.0,-781.0,13.0,0.0,0.0484194930011181,40.0,4.0,12.0,10.5,-27.5,0.0,0.0,4.0,9000.0,18000.0,-850.5,-833.0,1.5,2.5,0.0,,,,,,,,,,,,,,,,,,,,,8341034287.5,184297088169.0,165493503697.5,51937631110.935,,,,,,,,,,,,,128322.0,662372.0,,,,13519096.671232477,-601489534.0,-921320305.0,-296293793.0,-1534163338.0416667,43978.0,30677.0,,,,,,,67401.65151793262,157937.8733066095,,,,,,,,3711821.0,,,,,,,,,,,,,,,,436192.0,430991.0,,6420.762884002896,631542.0,625101.0,,,,,,,,,,,,,,,,,,,,,,,,,,,,,,,,,,,80013260.02499998,1139358820.05,1284021048.6450002,18692966.655000005,1139358820.05,82450.0,-5759909.5,1323017481.0,58314011.0,289515879.0,134219709.0,301677550.0,82098.5,1324.0,230.3672428504304,2204478.0,693686.0,422855.5,-1379426.0,359973.0,2549.0,922017902.7149785,928154381.2199788,-56952333.0,-56488889.0,1031889.5,46302.0,,,,,,,,,,,,,,,,,,,,,1466397.0,14742469.0,3229974.0,8549152.0,11599568.0,1414669.0,,,,,,,,,,,,,,,,,,,,,,,,,,,,,,,,,,4270035.5,2477590.5,-8997763.5,921269.0,37582.5,3730989053.362466,3655581306.052464,-260464611.5,-257155801.5,2524834.5,269021.0,3923664230.1149545,33234540521.71591,36661964247.47264,1728358469.6175494,48054502680.16571,3985410.0,-247425545.0,103016817041.5,1053079614.0,17263755262.0,3501598123.0,18877041894.5,3669651.5,71872.0,20857.846637529103,89749905.5,-20.51658117188064,1.3259999999999998,9.55631399317406,362.380662957595,12.671672354948804,480.516759081771,63000.0,-0.9009688679024191,0.4338837391175582,0.0,0.0,0.0,0.0,0.0,0.0,1.0,0.0,1.0,0.0,0.0,0.0,0.0,0.0,0.0,1.0,0.0,0.0,0.0,0.0,0.0,0.0,1.0,0.0,0.0,1.0,0.0,0.0,0.0,0.0,0.0,0.0,0.0,0.0,0.0,0.0,0.0,0.0,0.0,0.0,0.0,0.0,0.0,0.0,0.0,0.0,0.0,0.0,0.0,0.0,0.0,0.0,0.0,0.0,0.0,0.0,0.0,0.0,0.0,0.0,0.0,0.0,0.0,0.0,0.0,0.0,0.0,0.0,0.0,0.0,0.0,0.0,0.0,0.0,0.0,0.0,0.0,0.0,0.0,0.0,0.0,1.0,0.0,0.0,0.0,0.0,0.0,0.0,0.0,0.0,0.0,0.0,0.0,0.0,0.0,0.0,0.0,0.0,0.0,0.0,0.0,0.0,0.0,0.0,0.0,0.0,0.0,0.0,0.0,0.0,0.0,0.0,0.0,0.0,0.0,0.0,0.0,0.0,0.0,0.0
101346,0,0.0,1.0,1.0,1.0,1.0,180000.0,675000.0,21906.0,675000.0,0.019101,51.98904109589043,-6834.0,-2848.0,-2516.0,8.0,3.0,2.0,2.0,9.0,0.45073921819059,0.6847750229869103,0.7662336700704004,,,,,,,,,,,,,,,,,,,,,,,,,,,,,,,,,,,,,,,,,,,,,0.0,0.0,0.0,0.0,-2670.0,0.0,0.0,0.0,0.0,0.0,2.0,1.0,1.0,1.0,1.0,0.0,0.0,0.0,0.0,0.0,0.0,1.0,1.0,0.0,1.0,0.0,0.0,0.0,0.0,0.0,0.0,0.0,0.0,0.0,0.0,0.0,0.0,0.0,0.0,0.0,0.0,0.0,0.0,3.0,0.0,,78484.5,0.0,0.0,0.0,0.0,0.0,-1310.0,-1005.0,-1002.0,-1002.0,121.0,-21.0,4.0,17039.34,159928.2,148929.75,16690.5,159928.2,10.0,-1206.5,365243.0,-1170.0,-900.0,-900.0,-894.5,17.5,0.0,0.1089355244415787,82.0,33.0,10.0,5.0,-42.0,0.0,0.0,30.0,16004.565,16004.565,-1282.5,-1271.0,5.5,1.0,0.0,,,,,,,,,,,,,,,,,,,,,8341056193.5,184297763169.0,165494178697.5,51937811110.935,1863.0,1704.0,71124.0,70723.0,9140.0,505737.0,,,,,,,128323.0,662375.0,,,,13519148.660273572,-601496368.0,-921322821.0,-296296463.0,-1534166186.0416667,43978.0,30677.0,,,,,,,67402.10225715081,157938.55808163248,126025.22474857098,,,,,,,3711830.0,,,,,,,,,,,,,,,,436192.0,430991.0,1262269.0,6420.781985002895,631544.0,625103.0,,,,,,,,,44.0,21544041.465,,2039140349.6400003,710985567.0150003,26156133.0,618685.47,45.0,5196.0,-7024544.0,3327973.0,-3648293.0,-3932953.0,-21.5,0.0,,78484.5,0.0,0.0,0.0,0.0,0.0,-1310.0,-1005.0,-1002.0,-1002.0,80058203.6625,1139744666.7,1284395475.6450002,18732200.805000003,1139744666.7,82481.0,-5764097.0,1323565345.5,58312374.0,289514647.0,134218477.0,301676325.5,82146.0,1324.0,230.65217083063183,2205100.5,693874.0,422968.0,-1380028.0,359973.0,2549.0,922296739.7924788,928433218.2974796,-56968716.5,-56504909.0,1031984.0,46322.5,,,,,,,,,,,,,,,,,,,,,1466400.0,14742590.0,3229974.0,8549185.0,11599598.0,1414673.0,1057563599.607001,,72060372585.2696,21666356280.742622,582091046.036999,5792665.7475,689.5,94245.0,-276753051.0,21910076.0,-123714796.5,-218567078.0,-2015401.5,,,,,,,,,,,,,,,,,,,,,4270045.5,2477595.5,-8997805.5,921269.0,37582.5,3731005057.9274654,3655597310.617464,-260465894.0,-257157072.5,2524840.0,269022.0,3923681269.454956,33234700449.91592,36662113177.22264,1728375160.1175494,48054662608.36572,3985420.0,-247426751.5,103017182284.5,1053078444.0,17263754362.0,3501597223.0,18877041000.0,3669669.0,71872.0,20857.955573053547,89749987.5,-131.45077993254637,3.75,8.216926869350862,427.1901486926082,30.81347576006573,1601.9630575972806,60000.0,0.6234898018587336,0.7818314824680298,0.0,0.0,0.0,0.0,0.0,0.0,1.0,0.0,0.0,0.0,0.0,0.0,0.0,1.0,0.0,1.0,0.0,0.0,0.0,0.0,1.0,0.0,0.0,0.0,0.0,1.0,0.0,0.0,0.0,0.0,0.0,0.0,0.0,0.0,0.0,0.0,0.0,0.0,1.0,0.0,0.0,0.0,0.0,0.0,0.0,0.0,0.0,0.0,0.0,0.0,0.0,0.0,0.0,1.0,0.0,0.0,0.0,0.0,0.0,0.0,0.0,0.0,0.0,0.0,0.0,0.0,0.0,0.0,0.0,0.0,0.0,0.0,0.0,0.0,0.0,0.0,0.0,0.0,0.0,0.0,0.0,0.0,0.0,0.0,0.0,0.0,0.0,0.0,0.0,0.0,0.0,0.0,0.0,0.0,0.0,0.0,0.0,0.0,0.0,0.0,0.0,0.0,0.0,0.0,0.0,0.0,0.0,0.0,0.0,0.0,0.0,0.0,0.0,0.0,0.0,0.0,0.0,0.0,0.0,0.0
101353,0,0.0,1.0,1.0,0.0,0.0,360000.0,900000.0,45954.0,900000.0,0.04622,50.386301369863006,,-7510.0,-1915.0,3.0,2.0,1.0,1.0,13.0,0.3701754147804709,0.7222046940883718,0.7713615919194317,0.1608,0.1047,0.9891,,,0.16,0.1379,0.375,,,,,,,0.1639,0.1086,0.9891,,,0.1611,0.1379,0.375,,,,,,,0.1624,0.1047,0.9891,,,0.16,0.1379,0.375,,,,,,,0.1297,1.0,0.0,0.0,0.0,0.0,-2053.0,0.0,0.0,0.0,0.0,0.0,2.0,1.0,0.0,0.0,1.0,1.0,0.0,0.0,0.0,0.0,0.0,0.0,0.0,0.0,0.0,0.0,0.0,0.0,0.0,1.0,0.0,0.0,0.0,0.0,0.0,0.0,0.0,0.0,0.0,0.0,0.0,0.0,0.0,5.0,0.0,5449.5,675000.0,0.0,0.0,0.0,0.0,0.0,-1751.0,-791.0,-832.0,-1450.5,259.0,-25.0,4.0,13854.285,111235.5,107039.25,4837.5,111235.5,9.0,-1832.0,365243.0,-1800.0,-1680.0,-1560.0,-1675.5,11.0,0.5,0.1057936147844851,1567.0,27.0,12.0,4.0,-50.0,0.0,0.0,24.0,18199.62,18199.62,-1525.0,-1503.0,3.5,1.0,0.0,,,,,,,,,,,,,,,,,,,,,8341102147.5,184298663169.0,165495078697.5,51938171110.935,1863.0,1704.0,71124.0,70723.0,9140.0,505739.0,17796.143400002296,17858.23469999911,17310.067099998076,11288.563400000085,11226.39380000009,11173.973100000056,128323.0,662377.0,,,,13519199.046574945,,-921324736.0,-296298516.0,-1534173696.0416667,43978.0,30677.0,11342.993199999177,11218.89999999897,10703.4924999973,22873.112000009634,22794.943900009595,22180.96730000815,67402.47243256557,157939.28028632654,126025.99611016289,34976.740900027886,34917.19910002833,34363.59140002874,,,,3711843.0,,,,,,,,,,,,,,,,436192.0,430991.0,1262272.0,6420.828205002896,631545.0,625104.0,,16322.0222999998,154074.73609999055,154077.48409999005,153969.26349998714,,,,58.0,21544041.465,6430755.014999999,2044369949.4900005,711943014.0150003,26156133.0,618685.47,45.0,5196.0,-7051992.0,3313752.0,-3662827.0,-3945666.0,-28.5,0.0,5449.5,675000.0,0.0,0.0,0.0,0.0,0.0,-1751.0,-791.0,-832.0,-1502.0,80903681.93249997,1155815109.45,1301619772.3950002,18796577.805000003,1155815109.45,83436.0,-5817296.5,1334157392.5,58639653.0,290945766.0,134560426.0,303107635.0,82870.5,1341.0,231.6253435045364,2215778.0,700271.0,426945.0,-1394032.0,359973.0,2549.0,930277308.7124794,937332689.9624796,-57368931.5,-56900569.5,1034429.0,46661.5,,,,,,,,,,,,,,,,,,,,,1466405.0,14742849.0,3229974.0,8549212.0,11599622.0,1414677.0,1057563599.607001,801502687.934995,72061047585.2696,21666356280.742622,582091046.036999,5792665.7475,689.5,94245.0,-276754802.0,21909285.0,-123715628.5,-218568528.5,-2015426.5,,,,,,,,,,,,,,,,,,,,,4270057.5,2477599.5,-8997855.5,921269.0,37582.5,3731023257.547465,3655615510.237464,-260467419.0,-257158575.5,2524843.5,269023.0,3923695123.7399545,33234811685.41592,36662220216.47264,1728379997.6175494,48054773843.86572,3985429.0,-247428583.5,103017547527.5,1053076644.0,17263752682.0,3501595663.0,18877039324.5,3669680.0,71872.5,20858.06136666833,89751554.5,,2.5,7.833920877399138,394.72229823629465,19.584802193497847,986.8057455907368,180000.0,0.6234898018587336,0.7818314824680298,0.0,0.0,0.0,0.0,0.0,0.0,1.0,0.0,0.0,1.0,0.0,0.0,0.0,0.0,0.0,0.0,0.0,0.0,1.0,0.0,1.0,0.0,0.0,0.0,0.0,1.0,0.0,0.0,0.0,0.0,0.0,0.0,0.0,0.0,0.0,0.0,0.0,0.0,0.0,0.0,0.0,0.0,0.0,0.0,0.0,0.0,0.0,0.0,0.0,0.0,0.0,0.0,0.0,0.0,0.0,0.0,0.0,0.0,0.0,0.0,0.0,0.0,0.0,0.0,0.0,0.0,0.0,0.0,0.0,0.0,0.0,0.0,0.0,0.0,0.0,0.0,0.0,0.0,0.0,0.0,0.0,0.0,0.0,0.0,0.0,0.0,0.0,0.0,0.0,0.0,0.0,0.0,0.0,0.0,0.0,0.0,0.0,0.0,0.0,0.0,0.0,0.0,0.0,0.0,0.0,1.0,0.0,0.0,0.0,0.0,1.0,0.0,0.0,0.0,0.0,0.0,0.0,1.0,0.0,0.0
101354,0,0.0,0.0,0.0,1.0,2.0,67500.0,256185.0,23625.0,207000.0,0.035792,30.271232876712325,-868.0,-5191.0,-1407.0,,4.0,2.0,2.0,12.0,0.2044471573793336,0.4250458833934941,0.511891801533151,,,,,,,,,,,,,,,,,,,,,,,,,,,,,,,,,,,,,,,,,,,,,2.0,0.0,2.0,0.0,-242.0,0.0,0.0,0.0,0.0,1.0,1.0,1.0,1.0,0.0,1.0,0.0,1.0,0.0,0.0,0.0,1.0,1.0,0.0,0.0,1.0,0.0,0.0,0.0,0.0,0.0,0.0,0.0,0.0,0.0,0.0,0.0,0.0,0.0,0.0,0.0,0.0,0.0,0.0,6.0,450.0,0.0,122557.5,0.0,0.0,0.0,0.0,0.0,-923.5,-548.0,-372.5,-760.0,182.0,-15.0,1.0,5190.975,40375.35,45703.35,0.0,40375.35,10.0,-242.0,365243.0,-204.0,365243.0,66.0,365243.0,14.0,0.0,0.0,141.0,7.0,10.0,7.0,-5.0,0.0,0.0,7.0,5190.975,5190.975,-121.0,-114.0,4.0,1.0,0.0,,,,,,,,,,,,,,,,,,,,,8341125772.5,184298919354.0,165495285697.5,51938238610.935,1863.0,1704.0,71124.0,70724.0,9140.0,505740.0,,,,,,,128325.0,662381.0,,,,13519229.31780782,-601497236.0,-921326143.0,-296298758.0,-1534178887.0416667,43978.0,30677.0,,,,,,,67402.67687972295,157939.70533220994,126026.50800196444,,,,,,,3711855.0,,,,,,,,,,,,,,,,436194.0,430993.0,,6420.863997002895,631547.0,625106.0,,,,,,,,,31.0,21591502.965,6438429.922499999,2046547850.4900005,712814617.8900003,26287952.625,618685.47,45.0,5196.0,-7058194.0,3338233.0,-3665907.0,-3949569.0,-15.0,450.0,0.0,121365.0,0.0,0.0,0.0,0.0,0.0,-934.0,-548.0,-695.0,-760.0,80931236.48999996,1156053781.8,1301857798.995,18813992.805000003,1156053781.8,83461.0,-5820176.0,1335070500.0,58636860.0,291308600.0,134558308.0,303470477.0,82901.0,1341.0,231.72623836301727,2218269.0,700418.0,427012.0,-1394770.0,359973.0,2549.0,930596007.7799792,937651389.0299796,-57387870.0,-56919288.0,1034484.0,46679.0,,,,,,,,,,,,,,,,,,,,,1466411.0,14743031.0,3229974.0,8549219.0,11599629.0,1414678.0,1057564049.607001,801502687.934995,72061170142.7696,21666356280.742622,582091046.036999,5792665.7475,689.5,94245.0,-276755725.5,21908737.0,-123716001.0,-218569288.5,-2015441.5,,,,,,,,,,,,,,,,,,,,,4270067.5,2477606.5,-8997860.5,921269.0,37582.5,3731028448.5224648,3655620701.212464,-260467540.0,-257158689.5,2524847.5,269024.0,3923700314.714955,33234852060.76591,36662265919.82264,1728379997.6175494,48054814219.215706,3985439.0,-247428825.5,103017912770.5,1053076440.0,17264117925.0,3501595729.0,18877404567.5,3669694.0,71872.5,20858.06136666833,89751695.5,-28.67408815277401,3.795333333333333,2.8571428571428568,86.48923679060665,10.843809523809524,328.25548336594915,16875.0,-0.9009688679024191,-0.433883739117558,1.0,0.0,0.0,0.0,0.0,0.0,0.0,0.0,0.0,0.0,0.0,0.0,0.0,1.0,0.0,0.0,0.0,0.0,1.0,0.0,1.0,0.0,0.0,0.0,0.0,1.0,0.0,0.0,0.0,0.0,0.0,0.0,0.0,1.0,0.0,0.0,0.0,0.0,0.0,0.0,0.0,0.0,0.0,0.0,0.0,0.0,0.0,0.0,0.0,0.0,0.0,0.0,0.0,0.0,0.0,0.0,0.0,0.0,0.0,0.0,0.0,0.0,0.0,0.0,0.0,0.0,0.0,0.0,0.0,0.0,0.0,0.0,0.0,0.0,0.0,0.0,0.0,0.0,0.0,0.0,0.0,0.0,0.0,0.0,0.0,0.0,0.0,0.0,0.0,0.0,0.0,0.0,0.0,0.0,0.0,0.0,0.0,0.0,0.0,1.0,0.0,0.0,0.0,0.0,0.0,0.0,0.0,0.0,0.0,0.0,0.0,0.0,0.0,0.0,0.0,0.0,0.0,0.0,0.0,0.0
101355,0,0.0,1.0,1.0,1.0,0.0,225000.0,1157958.0,49189.5,1035000.0,0.016612,51.21643835616438,-1737.0,-10795.0,-2243.0,5.0,2.0,2.0,2.0,15.0,0.6581624862688094,0.1147600730519566,0.2009260877159708,0.0825,0.0641,0.9752,0.66,0.029,0.0,0.1379,0.1667,0.2083,0.0,0.0672,0.0699,0.0,0.0,0.084,0.0666,0.9752,0.6733,0.0292,0.0,0.1379,0.1667,0.2083,0.0,0.0735,0.0728,0.0,0.0,0.0833,0.0641,0.9752,0.6645,0.0291,0.0,0.1379,0.1667,0.2083,0.0,0.0684,0.0711,0.0,0.0,0.0708,1.0,0.0,0.0,0.0,0.0,-296.0,0.0,0.0,0.0,0.0,0.0,2.0,1.0,1.0,0.0,1.0,0.0,1.0,0.0,0.0,0.0,0.0,0.0,0.0,0.0,1.0,0.0,0.0,0.0,0.0,0.0,0.0,0.0,0.0,0.0,0.0,0.0,0.0,0.0,0.0,0.0,0.0,0.0,0.0,19.0,0.0,0.0,70434.0,0.0,0.0,0.0,0.0,0.0,-1381.0,-659.0,-584.0,-1265.0,927.0,-29.0,6.0,9965.925,43688.25,138237.75,0.0,145651.5,24.0,-623.0,365243.0,-592.0,-589.0,98.0,-585.0,13.0,0.0,0.0,500.0,14.0,24.0,18.5,-24.5,0.0,0.0,12.0,12244.32,12244.32,-742.5,-724.0,5.5,1.0,25.0,0.0,765000.0,,0.0,,,0.0,,0.0,0.0,0.0,0.0,,0.0,,,0.0,-13.0,0.0,0.0,8341174962.0,184300077312.0,165496320697.5,51938463610.935,1863.0,1704.0,71124.0,70724.0,9140.0,505742.0,17796.225900002293,17858.317999999108,17310.151099998075,11288.627500000086,11226.45790000009,11174.03970000006,128325.0,662383.0,4135.821800000123,4133.463800000017,3944.236100000095,13519280.534246176,-601498973.0,-921328386.0,-296299054.0,-1534189682.0416667,43978.0,30677.0,11342.993199999177,11218.89999999897,10703.4924999973,22873.24990000964,22795.0818000096,22181.10520000815,67403.33504220923,157939.820092283,126026.70892805216,34976.90760002789,34917.36580002833,34363.75810002873,22938.578399995928,22912.025899995504,22559.414999995737,3711870.0,8290.503400000167,8394.952500000081,8118.693600000228,9811.79180000072,9926.681700002158,10286.15399999965,16458.21149999975,16643.342599999698,16240.287299999694,828.220700000176,813.400300000046,759.3820000000132,3911.107900000124,3894.357000000161,3727.181900000159,436194.0,430993.0,1262277.0,6420.880609002896,631549.0,625108.0,,16322.093099999798,154075.71129999054,154078.45929999006,153970.23869998712,77560.05319999628,77897.61510000657,78298.76710000649,46.0,21607338.105,6447110.94,2048959470.2400005,713507806.8900003,26287952.625,618685.47,45.0,5196.0,-7076810.0,3331491.5,-3674335.0,-3958684.5,-22.5,0.0,0.0,52515.0,0.0,0.0,0.0,0.0,0.0,-2192.0,-1737.0,-917.0,-1674.0,80952092.27999996,1156331915.55,1302145159.995,18813992.805000003,1156375603.8,83521.0,-5821992.5,1335800986.0,58635971.0,291308011.0,134558207.0,303469892.0,82943.5,1341.0,231.72623836301727,2219768.5,700615.0,427160.5,-1394978.0,359973.0,2549.0,930830442.5249796,937885823.77498,-57393193.5,-56924493.5,1034533.0,46689.5,907980770.3399996,2349774000.0,,120007812.82500002,,,51425200.25999997,,118382820.83999978,871434050.8949988,904536882.1349976,904573154.0699975,,9693.0,,,295494.0,-512198.0,210815.0,452.0,1466430.0,14743958.0,3229999.0,8549233.0,11599641.0,1414684.0,1057564049.607001,801502687.934995,72061240576.7696,21666356280.742622,582091046.036999,5792665.7475,689.5,94245.0,-276757106.5,21908078.0,-123716585.0,-218570553.5,-2015470.5,5917605100.402461,18707883750.0,,447614441.63999766,,,308855711.3849987,,458768806.1099992,5702940738.090032,5880923268.9749975,5881166451.719999,,80783.5,,,970807.0,-1697108.0,177364.0,6755.0,4270091.5,2477625.0,-8997885.0,921269.0,37582.5,3731040692.8424654,3655632945.532464,-260468282.5,-257159413.5,2524853.0,269025.0,3923710280.639957,33234895749.01591,36662404157.57264,1728379997.6175494,48054959870.715706,3985463.0,-247429448.5,103018278013.5,1053075848.0,17264117336.0,3501595827.0,18877403982.5,3669707.0,71872.5,20858.06136666833,89752195.5,-33.91489247887023,5.14648,4.574146921599122,234.27151384212053,23.54075564907145,1205.6736605581966,112500.0,-0.9009688679024191,0.4338837391175582,0.0,0.0,0.0,0.0,0.0,0.0,1.0,0.0,1.0,0.0,0.0,0.0,0.0,0.0,0.0,0.0,0.0,0.0,1.0,0.0,1.0,0.0,0.0,0.0,0.0,1.0,0.0,0.0,0.0,0.0,0.0,0.0,0.0,0.0,0.0,0.0,0.0,0.0,0.0,0.0,0.0,0.0,0.0,0.0,0.0,0.0,0.0,0.0,0.0,0.0,0.0,0.0,0.0,1.0,0.0,0.0,0.0,0.0,0.0,0.0,0.0,0.0,0.0,0.0,0.0,0.0,0.0,0.0,0.0,0.0,0.0,0.0,0.0,0.0,0.0,0.0,0.0,0.0,0.0,0.0,0.0,0.0,0.0,0.0,0.0,0.0,0.0,0.0,0.0,0.0,0.0,0.0,0.0,0.0,0.0,0.0,0.0,0.0,0.0,0.0,0.0,0.0,0.0,0.0,0.0,0.0,0.0,0.0,1.0,0.0,1.0,0.0,0.0,0.0,0.0,0.0,0.0,1.0,0.0,0.0
101356,0,0.0,0.0,0.0,1.0,0.0,112500.0,552555.0,24466.5,477000.0,0.010006,64.90136986301371,,-9734.0,-4498.0,,2.0,2.0,1.0,8.0,,0.4906381856158077,0.6397075677637197,0.1113,0.1372,0.9861,0.8096,0.0286,0.0,0.2759,0.1667,0.2083,0.1035,0.0891,0.1272,0.0077,0.0236,0.1134,0.1424,0.9861,0.8171,0.0289,0.0,0.2759,0.1667,0.2083,0.1059,0.0973,0.1325,0.0078,0.0249,0.1124,0.1372,0.9861,0.8121,0.0288,0.0,0.2759,0.1667,0.2083,0.1053,0.0906,0.1295,0.0078,0.0241,0.1225,1.0,4.0,0.0,4.0,0.0,-2121.0,0.0,0.0,0.0,0.0,1.0,1.0,1.0,0.0,0.0,1.0,0.0,0.0,0.0,0.0,0.0,0.0,0.0,0.0,0.0,1.0,0.0,0.0,0.0,0.0,0.0,0.0,0.0,0.0,0.0,0.0,0.0,0.0,0.0,0.0,0.0,0.0,0.0,0.0,2.0,24543.0,,450000.0,308936.25,0.0,0.0,0.0,0.0,-1478.0,180.0,-127.0,,98.0,-27.5,4.0,10468.6875,93352.5,114959.25,0.0,93352.5,15.0,-2167.5,365243.0,-2184.0,-1704.0,-1674.0,-1700.0,9.0,1.0,0.0,42.0,37.0,12.0,6.0,-67.0,0.0,0.0,35.0,6483.825,6483.825,-2070.0,-2034.0,6.0,1.0,0.0,,,,,,,,,,,,,,,,,,,,,8341199428.5,184300629867.0,165496797697.5,51938576110.935,1863.0,1704.0,71124.0,70725.0,9140.0,505743.0,17796.337200002294,17858.43039999911,17310.264499998073,11288.764700000083,11226.59510000009,11174.182100000058,128325.0,662385.0,4135.850400000123,4133.492600000017,3944.265000000096,13519345.43561604,,-921332884.0,-296301175.0,-1534199416.0416667,43978.0,30677.0,11342.993199999177,11218.89999999897,10703.4924999973,22873.52580000964,22795.3577000096,22181.381100008148,,157940.31073046866,126027.34863561991,34977.074300027896,34917.53250002833,34363.92480002873,22938.78669999593,22912.234199995502,22559.623299995736,3711878.0,8290.606900000166,8395.057800000079,8118.799500000227,9811.88090000072,9926.772300002158,10286.251299999649,16458.33869999975,16643.4720999997,16240.419799999694,828.228400000176,813.4081000000459,759.3898000000132,3911.131500000124,3894.381100000161,3727.206800000158,436198.0,430997.0,,6420.890615002895,631551.0,625109.0,,16322.215599999798,154076.69739999055,154079.44539999007,153971.22479998713,77560.86279999626,77898.42720000657,78299.58420000649,49.0,21670568.235,,2050825647.1500008,714728679.2100003,26349249.555,618685.47,45.0,5196.0,-7089891.5,3354111.0,-3680481.0,,-24.0,31500.0,,630000.0,518476.5,0.0,0.0,0.0,0.0,-2319.0,452.0,-2.0,,81026738.03249997,1156839607.8,1303518181.995,18813992.805000003,1156839607.8,83581.0,-5829265.0,1336896715.0,58995977.0,291668827.0,134919645.0,303830723.0,83001.5,1343.0,231.72623836301727,2222046.5,701066.0,427424.0,-1396368.0,359973.0,2549.0,931330449.8999796,938385831.14998,-57432999.0,-56963680.0,1034723.0,46715.0,,,,,,,,,,,,,,,,,,,,,1466432.0,14744056.0,3229999.0,8549270.0,11599676.0,1414688.0,1057588592.607001,,72061690576.7696,21666665216.992622,582091046.036999,5792665.7475,689.5,94245.0,-276758584.5,21908258.0,-123716712.0,,-2015498.0,,,,,,,,,,,,,,,,,,,,,4270103.5,2477631.0,-8997952.0,921269.0,37582.5,3731047176.6674647,3655639429.357464,-260470352.5,-257161447.5,2524859.0,269026.0,3923720749.327457,33234989101.51591,36662519116.82264,1728379997.6175494,48055053223.215706,3985478.0,-247431616.0,103018643256.5,1053073664.0,17264115632.0,3501594153.0,18877402282.5,3669716.0,71873.5,20858.06136666833,89752237.5,,4.9116,4.598123965422108,298.42454415584734,22.584145668567228,1465.74199107586,56250.0,-0.2225209339563146,-0.9749279121818236,0.0,0.0,0.0,0.0,0.0,0.0,1.0,0.0,0.0,1.0,0.0,0.0,0.0,0.0,0.0,0.0,0.0,0.0,1.0,0.0,1.0,0.0,0.0,0.0,0.0,1.0,0.0,0.0,0.0,0.0,0.0,0.0,0.0,0.0,0.0,0.0,0.0,0.0,0.0,0.0,0.0,0.0,0.0,0.0,0.0,0.0,0.0,0.0,0.0,0.0,0.0,0.0,0.0,0.0,0.0,0.0,0.0,0.0,0.0,0.0,0.0,0.0,0.0,0.0,0.0,0.0,0.0,0.0,0.0,0.0,0.0,0.0,0.0,0.0,0.0,0.0,0.0,0.0,0.0,0.0,0.0,0.0,0.0,0.0,0.0,0.0,0.0,0.0,0.0,0.0,0.0,0.0,0.0,0.0,0.0,0.0,0.0,0.0,0.0,0.0,0.0,0.0,0.0,0.0,0.0,1.0,0.0,0.0,1.0,0.0,1.0,0.0,0.0,0.0,0.0,0.0,0.0,1.0,0.0,0.0
101362,0,0.0,0.0,0.0,1.0,0.0,90000.0,450000.0,14517.0,450000.0,0.0066709999999999,28.265753424657536,-2481.0,-3407.0,-2978.0,,2.0,2.0,2.0,14.0,0.6090207550775935,0.5511942707630505,0.3474182272002641,,,,,,,,,,,,,,,,,,,,,,,,,,,,,,,,,,,,,,,,,,,,,0.0,0.0,0.0,0.0,-905.0,0.0,0.0,0.0,0.0,0.0,2.0,1.0,1.0,1.0,1.0,1.0,0.0,0.0,0.0,0.0,0.0,0.0,0.0,0.0,1.0,0.0,0.0,0.0,0.0,0.0,0.0,0.0,0.0,0.0,0.0,0.0,0.0,0.0,0.0,0.0,0.0,0.0,0.0,11.0,0.0,85.5,108000.0,10298.25,0.0,0.0,0.0,0.0,-711.0,360.5,-413.0,-1479.0,373.0,-18.0,4.0,6105.127500000001,112500.0,112500.0,0.0,112500.0,5.0,-790.5,365243.0,-874.0,-664.0,-604.0,-659.0,17.5,0.0,0.0,2.0,9.0,10.0,6.0,-26.0,0.0,0.0,8.0,5460.255,5460.255,-776.5,-769.0,4.5,1.0,0.0,,,,,,,,,,,,,,,,,,,,,8341213945.5,184301079867.0,165497247697.5,51938666110.935,1863.0,1704.0,71124.0,70725.0,9140.0,505745.0,,,,,,,128325.0,662387.0,,,,13519373.701369464,-601501454.0,-921335862.0,-296302080.0,-1534202823.0416667,43978.0,30677.0,,,,,,,67403.94406296429,157940.86192473938,126027.69605384712,,,,,,,3711892.0,,,,,,,,,,,,,,,,436198.0,430997.0,,6420.897286002895,631553.0,625111.0,,,,,,,,,24.0,21691605.735,6468286.184999999,2055584324.2500005,717490251.2250003,26356642.29,618685.47,45.0,5196.0,-7109138.0,3352895.0,-3689966.0,-3974510.0,-11.5,0.0,85.5,36130.5,0.0,0.0,0.0,0.0,0.0,-1280.0,-1476.0,-729.0,-1630.0,81123714.78749998,1158187855.05,1304962963.245,18831619.305000003,1158187855.05,83726.0,-5842468.5,1339818659.0,58986960.0,292026764.0,134912908.0,304188713.0,83191.5,1344.0,232.0392842071704,2226312.5,701955.0,427925.0,-1399806.0,359973.0,2549.0,931864440.12748,938937847.0274808,-57531706.5,-57061426.0,1035130.5,46791.5,,,,,,,,,,,,,,,,,,,,,1466443.0,14744429.0,3229999.0,8549279.0,11599684.0,1414692.0,1057588592.607001,801502773.434995,72061798576.7696,21666675515.242622,582091046.036999,5792665.7475,689.5,94245.0,-276759295.5,21908618.5,-123717125.0,-218572032.5,-2015516.0,,,,,,,,,,,,,,,,,,,,,4270113.5,2477637.0,-8997978.0,921269.0,37582.5,3731052636.922465,3655644889.612464,-260471129.0,-257162216.5,2524863.5,269027.0,3923726854.454956,33235101601.51591,36662631616.82264,1728379997.6175494,48055165723.215706,3985483.0,-247432406.5,103019008499.5,1053072790.0,17264114968.0,3501593549.0,18877401623.5,3669733.5,71873.5,20858.06136666833,89752239.5,-87.77406222739168,5.0,6.199628022318661,175.23715700345653,30.998140111593305,876.1857850172826,45000.0,1.0,0.0,0.0,0.0,0.0,0.0,0.0,0.0,1.0,0.0,0.0,0.0,0.0,0.0,0.0,1.0,0.0,0.0,0.0,0.0,1.0,0.0,1.0,0.0,0.0,0.0,0.0,0.0,0.0,0.0,0.0,1.0,0.0,0.0,0.0,0.0,0.0,0.0,0.0,0.0,0.0,0.0,0.0,0.0,0.0,0.0,1.0,0.0,0.0,0.0,0.0,0.0,0.0,0.0,0.0,0.0,0.0,0.0,0.0,0.0,0.0,0.0,0.0,0.0,0.0,0.0,0.0,0.0,0.0,0.0,0.0,0.0,0.0,0.0,0.0,0.0,0.0,0.0,0.0,0.0,0.0,0.0,0.0,0.0,0.0,0.0,0.0,0.0,0.0,0.0,0.0,0.0,1.0,0.0,0.0,0.0,0.0,0.0,0.0,0.0,0.0,0.0,0.0,0.0,0.0,0.0,0.0,0.0,0.0,0.0,0.0,0.0,0.0,0.0,0.0,0.0,0.0,0.0,0.0,0.0,0.0,0.0
101363,1,0.0,1.0,0.0,1.0,1.0,315000.0,781920.0,42547.5,675000.0,0.007114,30.476712328767125,-1907.0,-5155.0,-3688.0,,3.0,2.0,2.0,17.0,,0.0548672795104247,,0.0361,,0.9692,,,0.0,0.1379,0.0833,,0.0481,,0.023,,,0.0368,,0.9692,,,0.0,0.1379,0.0833,,0.0492,,0.024,,,0.0364,,0.9692,,,0.0,0.1379,0.0833,,0.049,,0.0234,,,0.0323,1.0,0.0,0.0,0.0,0.0,0.0,0.0,0.0,0.0,0.0,2.0,0.0,1.0,1.0,0.0,1.0,0.0,0.0,0.0,0.0,0.0,0.0,1.0,1.0,0.0,1.0,0.0,0.0,0.0,0.0,0.0,0.0,0.0,0.0,0.0,0.0,0.0,0.0,0.0,0.0,0.0,0.0,0.0,0.0,0.0,,,,,,,,,,,,,0.0,,1.0,5159.16,45423.0,45423.0,0.0,45423.0,10.0,-366.0,365243.0,-333.0,-63.0,-63.0,-60.0,11.0,0.0,0.0,82.0,10.0,10.0,5.5,-7.5,0.0,0.0,10.0,5159.16,5159.16,-205.5,-198.0,5.5,1.0,0.0,,,,,,,,,,,,,,,,,,,,,8341256493.0,184301861787.0,165497922697.5,51938981110.935,1863.0,1704.0,71124.0,70727.0,9140.0,505745.0,17796.3733000023,17858.46679999911,17310.301299998075,,,,128326.0,662390.0,,,,13519404.178081792,-601503361.0,-921339550.0,-296302080.0,-1534207978.0416667,43978.0,30677.0,11342.993199999177,11218.89999999897,10703.4924999973,22873.66370000964,22795.4956000096,22181.519000008157,,157940.9167920189,,34977.15760002789,34917.61580002833,34364.00810002873,,,,3711909.0,8290.655000000166,8395.106800000081,8118.848700000228,,,,16458.36169999975,16643.4954999997,16240.443799999695,,,,,,,436198.0,430997.0,,6420.904400002895,631555.0,625113.0,,16322.247899999797,154077.66659999054,154080.41459999006,153972.19399998712,,,,,,,,,,,,,,,,,,,,,,,,,,,,,,81138354.07499997,1158391450.8,1305166558.995,18831619.305000003,1158391450.8,83741.0,-5844157.0,1340183902.0,58986627.0,292026701.0,134912845.0,304188653.0,83229.0,1344.0,232.0392842071704,2226449.0,702050.0,427985.5,-1399957.5,359973.0,2549.0,931922169.34498,938995576.2449808,-57535624.5,-57065251.5,1035175.0,46801.5,,,,,,,,,,,,,,,,,,,,,1466443.0,14744429.0,3229999.0,8549289.0,11599694.0,1414693.0,,,,,,,,,,,,,,,,,,,,,,,,,,,,,,,,,,4270123.5,2477642.5,-8997985.5,921269.0,37582.5,3731057796.0824647,3655650048.7724633,-260471334.5,-257162414.5,2524869.0,269028.0,3923732013.6149545,33235147024.51591,36662677039.82264,1728379997.6175494,48055211146.215706,3985493.0,-247432772.5,103019373742.5,1053072457.0,17264114905.0,3501593486.0,18877401563.5,3669744.5,71873.5,20858.06136666833,89752321.5,-62.57236605537576,2.4822857142857138,7.4034902168164995,225.63404156675816,18.377578001057643,560.0881580377129,105000.0,-0.9009688679024191,0.4338837391175582,0.0,0.0,0.0,0.0,0.0,0.0,1.0,0.0,0.0,0.0,0.0,0.0,0.0,1.0,0.0,0.0,0.0,0.0,1.0,0.0,1.0,0.0,0.0,0.0,0.0,1.0,0.0,0.0,0.0,0.0,0.0,0.0,0.0,0.0,0.0,0.0,0.0,0.0,1.0,0.0,0.0,0.0,0.0,0.0,0.0,0.0,0.0,0.0,0.0,0.0,0.0,0.0,0.0,0.0,0.0,0.0,0.0,0.0,0.0,0.0,0.0,0.0,0.0,0.0,0.0,0.0,0.0,0.0,0.0,0.0,0.0,0.0,0.0,0.0,0.0,0.0,0.0,0.0,0.0,0.0,0.0,0.0,0.0,0.0,0.0,0.0,0.0,0.0,0.0,0.0,1.0,0.0,0.0,0.0,0.0,0.0,0.0,0.0,0.0,0.0,0.0,0.0,0.0,0.0,0.0,0.0,0.0,0.0,0.0,0.0,1.0,0.0,0.0,0.0,0.0,0.0,0.0,0.0,1.0,0.0
101365,0,0.0,0.0,0.0,1.0,0.0,225000.0,525735.0,36720.0,450000.0,0.04622,53.81917808219178,-5639.0,-8156.0,-3198.0,,2.0,1.0,1.0,14.0,0.7104509684204358,0.698811989203456,,,,,,,,,,,,,,,,,,,,,,,,,,,,,,,,,,,,,,,,,,,,,,0.0,0.0,0.0,0.0,-2114.0,0.0,0.0,0.0,0.0,1.0,2.0,1.0,1.0,0.0,1.0,1.0,0.0,0.0,0.0,0.0,0.0,1.0,1.0,0.0,0.0,0.0,0.0,1.0,0.0,0.0,0.0,0.0,0.0,0.0,0.0,0.0,0.0,0.0,0.0,0.0,0.0,0.0,0.0,1.0,0.0,,67500.0,0.0,,0.0,0.0,0.0,-371.0,30886.0,-352.0,,13.0,-6.0,3.0,17465.805,147150.0,143361.0,7357.5,147150.0,10.0,-741.0,365243.0,-710.0,-560.0,-560.0,-556.0,15.0,0.0,0.0506907206890126,148.0,36.0,10.0,6.0,-20.5,0.0,0.0,36.0,37630.98,32491.1925,-607.0,-581.0,6.0,1.5,0.0,,,,,,,,,,,,,,,,,,,,,8341293213.0,184302387522.0,165498372697.5,51939206110.935,1863.0,1704.0,71124.0,70728.0,9140.0,505747.0,,,,,,,128326.0,662392.0,,,,13519457.997259876,-601509000.0,-921342748.0,-296304194.0,-1534216134.0416667,43978.0,30677.0,,,,,,,67404.65451393269,157941.61560400805,,,,,,,,3711923.0,,,,,,,,,,,,,,,,436198.0,430997.0,,6420.950620002895,631556.0,625114.0,,,,,,,,,13.0,21717903.735,,2058201110.2500005,718401235.7250003,,618685.47,45.0,5196.0,-7116255.0,3415517.0,-3692642.0,,-6.0,0.0,,67500.0,0.0,,0.0,0.0,0.0,-371.0,30886.0,-352.0,,81240660.80999997,1159551100.8,1306431823.995,18846334.305000003,1159551100.8,83781.0,-5847574.0,1341279631.0,58983317.0,292024213.0,134910645.0,304186174.0,83273.0,1345.0,232.14066564854843,2226714.0,702482.0,428227.0,-1400436.0,359973.0,2549.0,933327857.56498,940566595.9949808,-57546994.5,-57076379.0,1035387.0,46887.0,,,,,,,,,,,,,,,,,,,,,1466444.0,14744442.0,3229999.0,8549325.0,11599730.0,1414696.0,1057588592.607001,,72061866076.7696,21666675515.242622,,5792665.7475,689.5,94245.0,-276759666.5,21939504.5,-123717477.0,,-2015522.0,,,,,,,,,,,,,,,,,,,,,4270133.5,2477648.5,-8998006.0,921269.0,37582.5,3731095427.0624647,3655682539.9649634,-260471941.5,-257162995.5,2524875.0,269029.5,3923749479.419955,33235294174.51591,36662820400.82264,1728387355.1175494,48055358296.215706,3985503.0,-247433513.5,103019738985.5,1053071747.0,17264114345.0,3501592926.0,18877401007.5,3669759.5,71873.5,20858.11205738902,89752469.5,-104.7767766239055,2.3366,6.127450980392156,329.7743755036261,14.317401960784313,770.5508058017729,112500.0,-0.2225209339563143,0.9749279121818236,0.0,0.0,0.0,0.0,0.0,0.0,1.0,0.0,1.0,0.0,0.0,0.0,0.0,0.0,0.0,0.0,0.0,0.0,1.0,1.0,0.0,0.0,0.0,0.0,0.0,1.0,0.0,0.0,0.0,0.0,0.0,1.0,0.0,0.0,0.0,0.0,0.0,0.0,0.0,0.0,0.0,0.0,0.0,0.0,0.0,0.0,0.0,0.0,0.0,0.0,0.0,0.0,0.0,1.0,0.0,0.0,0.0,0.0,0.0,0.0,0.0,0.0,0.0,0.0,0.0,0.0,0.0,0.0,0.0,0.0,0.0,0.0,0.0,0.0,0.0,0.0,0.0,0.0,0.0,0.0,0.0,0.0,0.0,0.0,0.0,0.0,0.0,0.0,0.0,0.0,0.0,0.0,0.0,0.0,0.0,0.0,0.0,0.0,0.0,0.0,0.0,0.0,0.0,0.0,0.0,0.0,0.0,0.0,0.0,0.0,0.0,0.0,0.0,0.0,0.0,0.0,0.0,0.0,0.0,0.0
101366,0,0.0,0.0,0.0,0.0,0.0,112500.0,598500.0,19435.5,450000.0,0.006852,51.6054794520548,-1714.0,-630.0,-2357.0,,1.0,3.0,3.0,15.0,0.6485997623492777,0.3716301173096265,,,,,,,,,,,,,,,,,,,,,,,,,,,,,,,,,,,,,,,,,,,,,,1.0,1.0,1.0,1.0,-390.0,,,,,,,1.0,1.0,1.0,1.0,1.0,0.0,0.0,0.0,0.0,0.0,0.0,0.0,0.0,1.0,0.0,0.0,0.0,0.0,0.0,0.0,0.0,0.0,0.0,0.0,0.0,0.0,0.0,0.0,0.0,0.0,0.0,0.0,0.0,,,,,,,,,,,,,0.0,,1.0,23262.705,221265.0,238788.0,0.0,221265.0,12.0,-390.0,365243.0,-357.0,-177.0,-27.0,-172.0,9.0,0.0,0.0,40.0,8.0,12.0,8.5,-9.5,0.0,0.0,7.0,23262.705,23262.705,-276.0,-267.0,4.0,1.0,0.0,,,,,,,,,,,,,,,,,,,,,8341312648.5,184302986022.0,165498822697.5,51939318610.935,,,,,,,,,,,,,128326.0,662393.0,,,,13519509.602739329,-601510714.0,-921345105.0,-296304584.0,-1534216764.0416667,43979.0,30678.0,,,,,,,67405.30311369506,157941.98723412538,,,,,,,,3711938.0,,,,,,,,,,,,,,,,436199.0,430998.0,,6420.957472002897,631559.0,625117.0,,,,,,,,,,,,,,,,,,,,,,,,,,,,,,,,,,,81281389.31999998,1159851957.3,1306764166.995,18846334.305000003,1159851957.3,83799.0,-5848705.0,1342010117.0,58982250.0,292023476.0,134910058.0,304185446.0,83297.0,1345.0,232.14066564854843,2227560.0,702679.0,428334.0,-1401268.5,359980.0,2556.0,933775170.47998,941013908.9099804,-57572707.0,-57101627.0,1035483.0,46911.0,,,,,,,,,,,,,,,,,,,,,1466444.0,14744442.0,3229999.0,8549333.0,11599737.0,1414697.0,,,,,,,,,,,,,,,,,,,,,,,,,,,,,,,,,,4270145.5,2477657.0,-8998015.5,921269.0,37582.5,3731118689.7674646,3655705802.6699634,-260472217.5,-257163262.5,2524879.0,269030.5,3923772742.124954,33235515439.51591,36663059188.82264,1728387355.1175494,48055579561.215706,3985515.0,-247433903.5,103020104228.5,1053071390.0,17264114168.0,3501592899.0,18877400835.5,3669768.5,71873.5,20858.11205738902,89752509.5,-33.213527288171576,5.32,5.788376939106275,298.7119671917967,30.79416531604538,1589.1476654603582,112500.0,1.0,0.0,0.0,0.0,0.0,0.0,0.0,0.0,1.0,0.0,0.0,0.0,1.0,0.0,0.0,0.0,0.0,0.0,0.0,0.0,1.0,0.0,0.0,0.0,1.0,0.0,0.0,1.0,0.0,0.0,0.0,0.0,0.0,0.0,0.0,0.0,0.0,0.0,0.0,0.0,0.0,0.0,0.0,0.0,0.0,0.0,0.0,0.0,0.0,0.0,0.0,0.0,0.0,0.0,0.0,0.0,0.0,0.0,0.0,0.0,0.0,0.0,0.0,0.0,0.0,0.0,0.0,0.0,0.0,0.0,0.0,0.0,0.0,0.0,0.0,0.0,0.0,0.0,0.0,0.0,0.0,0.0,0.0,1.0,0.0,0.0,0.0,0.0,0.0,0.0,0.0,0.0,0.0,0.0,0.0,0.0,0.0,0.0,0.0,0.0,0.0,0.0,0.0,0.0,0.0,0.0,0.0,0.0,0.0,0.0,0.0,0.0,0.0,0.0,0.0,0.0,0.0,0.0,0.0,0.0,0.0,0.0
101367,0,0.0,0.0,0.0,1.0,1.0,112500.0,296280.0,23539.5,225000.0,0.030755,24.35342465753425,-166.0,-3640.0,-557.0,,2.0,2.0,2.0,12.0,0.6532935050817775,0.1463384162285791,,,,,,,,,,,,,,,,,,,,,,,,,,,,,,,,,,,,,,,,,,,,,,0.0,0.0,0.0,0.0,0.0,,,,,,,1.0,1.0,0.0,1.0,0.0,0.0,0.0,0.0,0.0,1.0,1.0,0.0,0.0,1.0,0.0,0.0,0.0,0.0,0.0,0.0,0.0,0.0,0.0,0.0,0.0,0.0,0.0,0.0,0.0,0.0,0.0,0.0,0.0,,,,,,,,,,,,,0.0,,1.0,3326.895,24300.0,24300.0,0.0,24300.0,8.0,-378.0,365243.0,-336.0,-156.0,-126.0,-149.0,12.0,0.0,0.0,168.0,8.0,8.0,4.5,-8.5,0.0,0.0,7.0,3326.895,3326.895,-284.0,-246.0,4.0,1.0,0.0,,,,,,,,,,,,,,,,,,,,,8341336188.0,184303282302.0,165499047697.5,51939431110.935,,,,,,,,,,,,,128327.0,662395.0,,,,13519533.956163986,-601510880.0,-921345662.0,-296304584.0,-1534220404.0416667,43979.0,30678.0,,,,,,,67405.95640720014,157942.1335725416,,,,,,,,3711950.0,,,,,,,,,,,,,,,,436199.0,430998.0,,6420.988227002897,631561.0,625119.0,,,,,,,,,,,,,,,,,,,,,,,,,,,,,,,,,,,81284716.21499997,1159876257.3,1306788466.995,18846334.305000003,1159876257.3,83807.0,-5849083.0,1342375360.0,58981914.0,292023320.0,134909932.0,304185297.0,83309.0,1345.0,232.14066564854843,2227728.0,702752.0,428376.0,-1401337.0,359980.0,2556.0,933966352.7549796,941205091.1849804,-57574461.0,-57103202.0,1035518.0,46919.0,,,,,,,,,,,,,,,,,,,,,1466444.0,14744442.0,3229999.0,8549341.0,11599744.0,1414698.0,,,,,,,,,,,,,,,,,,,,,,,,,,,,,,,,,,4270153.5,2477661.5,-8998024.0,921269.0,37582.5,3731122016.6624646,3655709129.5649633,-260472501.5,-257163508.5,2524883.0,269031.5,3923776069.019954,33235539739.51591,36663083488.82264,1728387355.1175494,48055603861.215706,3985523.0,-247434281.5,103020469471.5,1053071054.0,17264114012.0,3501592773.0,18877400686.5,3669780.5,71873.5,20858.11205738902,89752677.5,-6.816289796377545,2.6336,4.779200917606576,116.38990947015029,12.58650353660868,306.5244655805878,56250.0,0.6234898018587336,0.7818314824680298,0.0,0.0,0.0,0.0,0.0,0.0,1.0,0.0,1.0,0.0,0.0,0.0,0.0,0.0,0.0,0.0,0.0,0.0,1.0,0.0,0.0,0.0,1.0,0.0,0.0,1.0,0.0,0.0,0.0,0.0,0.0,0.0,0.0,0.0,0.0,0.0,0.0,0.0,0.0,0.0,0.0,0.0,0.0,0.0,1.0,0.0,0.0,0.0,0.0,0.0,0.0,0.0,0.0,1.0,0.0,0.0,0.0,0.0,0.0,0.0,0.0,0.0,0.0,0.0,0.0,0.0,0.0,0.0,0.0,0.0,0.0,0.0,0.0,0.0,0.0,0.0,0.0,0.0,0.0,0.0,0.0,0.0,0.0,0.0,0.0,0.0,0.0,0.0,0.0,0.0,0.0,0.0,0.0,0.0,0.0,0.0,0.0,0.0,0.0,0.0,0.0,0.0,0.0,0.0,0.0,0.0,0.0,0.0,0.0,0.0,0.0,0.0,0.0,0.0,0.0,0.0,0.0,0.0,0.0,0.0
101368,0,0.0,1.0,1.0,1.0,2.0,450000.0,675000.0,53460.0,675000.0,0.072508,39.638356164383566,-3525.0,-4438.0,-3473.0,8.0,4.0,1.0,1.0,9.0,0.676367796906397,0.7094306306926429,0.622922000268356,0.0619,0.0618,0.9737,0.6396,0.0,0.0,0.1034,0.1667,0.2083,0.0,0.0504,0.0506,0.0,0.0,0.063,0.0641,0.9737,0.6537,0.0,0.0,0.1034,0.1667,0.2083,0.0,0.0551,0.0527,0.0,0.0,0.0625,0.0618,0.9737,0.6444,0.0,0.0,0.1034,0.1667,0.2083,0.0,0.0513,0.0515,0.0,0.0,0.0398,1.0,0.0,0.0,0.0,0.0,-1719.0,0.0,0.0,0.0,0.0,1.0,1.0,1.0,1.0,0.0,1.0,1.0,0.0,0.0,0.0,0.0,0.0,0.0,0.0,0.0,1.0,0.0,0.0,0.0,0.0,0.0,0.0,0.0,0.0,0.0,0.0,0.0,0.0,0.0,0.0,0.0,0.0,0.0,0.0,6.0,0.0,0.0,1246695.75,0.0,0.0,0.0,0.0,0.0,-1458.5,82.0,-230.5,-1246.0,282.0,-27.0,1.0,3469.68,26955.0,21685.5,9000.0,26955.0,8.0,-1719.0,365243.0,-1688.0,-1568.0,-1478.0,-1564.0,15.0,0.0,0.3194283352664347,20.0,10.0,8.0,2.0,-55.5,0.0,0.0,10.0,8801.91,3469.68,-2283.5,-2268.5,7.5,1.0,0.0,,,,,,,,,,,,,,,,,,,,,8341389648.0,184303957302.0,165499722697.5,51939881110.935,1863.0,1704.0,71124.0,70729.0,9140.0,505748.0,17796.4352000023,17858.52929999911,17310.364299998073,11288.826500000085,11226.656900000087,11174.246200000058,128329.0,662399.0,4135.850400000123,4133.492600000017,3944.265000000096,13519573.594520148,-601514405.0,-921349135.0,-296306303.0,-1534224842.0416667,43979.0,30678.0,11342.993199999177,11218.89999999897,10703.4924999973,22873.76710000964,22795.5990000096,22181.622400008157,67406.63277499704,157942.8430031723,126028.3189758474,34977.324300027896,34917.78250002833,34364.17480002873,22938.994999995924,22912.442499995497,22559.83159999573,3711959.0,8290.655000000166,8395.106800000081,8118.848700000228,9811.93130000072,9926.823600002155,10286.306399999648,16458.412299999753,16643.5469999997,16240.496499999696,828.228400000176,813.4081000000459,759.3898000000132,3911.131500000124,3894.381100000161,3727.206800000158,436199.0,430998.0,1262285.0,6421.060735002897,631562.0,625120.0,,16322.2876999998,154078.64029999054,154081.38829999007,153973.16769998713,77561.50239999626,77899.07160000657,78300.23790000647,48.5,21740718.735,6468286.184999999,2063795001.7500005,718533045.2250003,26356642.29,618685.47,45.0,5196.0,-7121739.0,3414459.0,-3693748.5,-3979300.0,-23.75,0.0,0.0,1800000.0,0.0,0.0,0.0,0.0,0.0,-1932.0,-1246.0,-376.0,-1246.0,81288185.89499998,1159903212.3,1306810152.495,18855334.305000003,1159903212.3,83815.0,-5850802.0,1342740603.0,58980226.0,292021752.0,134908454.0,304183733.0,83324.0,1345.0,232.4600939838149,2227748.0,702812.5,428405.5,-1401662.0,359980.0,2556.0,934010657.8199795,941249353.0499804,-57585144.0,-57113594.5,1035548.0,46930.5,,,,,,,,,,,,,,,,,,,,,1466450.0,14744724.0,3229999.0,8549351.0,11599754.0,1414699.0,1057588592.607001,801502773.434995,72063112772.5196,21666675515.242622,582091046.036999,5792665.7475,689.5,94245.0,-276761125.0,21939586.5,-123717707.5,-218573278.5,-2015549.0,,,,,,,,,,,,,,,,,,,,,4270161.5,2477663.5,-8998079.5,921269.0,37582.5,3731130818.572465,3655712599.244963,-260474785.0,-257165777.0,2524890.5,269032.5,3923779538.6999545,33235566694.51591,36663105174.32264,1728396355.1175494,48055630816.215706,3985531.0,-247436000.5,103020834714.5,1053069366.0,17264112444.0,3501591295.0,18877399122.5,3669795.5,71873.5,20858.43148572429,89752697.5,-88.92901575891622,1.5,8.417508417508419,333.65619666989534,12.626262626262625,500.4842950048429,112500.0,-0.2225209339563143,0.9749279121818236,0.0,0.0,0.0,0.0,0.0,0.0,1.0,0.0,1.0,0.0,0.0,0.0,0.0,0.0,0.0,1.0,0.0,0.0,0.0,0.0,1.0,0.0,0.0,0.0,0.0,1.0,0.0,0.0,0.0,0.0,0.0,0.0,0.0,0.0,0.0,0.0,0.0,0.0,0.0,0.0,1.0,0.0,0.0,0.0,0.0,0.0,0.0,0.0,0.0,0.0,0.0,0.0,0.0,0.0,0.0,0.0,0.0,0.0,0.0,0.0,0.0,0.0,0.0,0.0,0.0,0.0,0.0,0.0,0.0,0.0,0.0,0.0,0.0,0.0,0.0,0.0,0.0,0.0,0.0,0.0,0.0,0.0,0.0,0.0,0.0,0.0,0.0,0.0,0.0,0.0,0.0,0.0,0.0,0.0,0.0,0.0,0.0,0.0,0.0,0.0,0.0,0.0,0.0,1.0,0.0,0.0,0.0,0.0,1.0,0.0,1.0,0.0,0.0,0.0,0.0,0.0,0.0,0.0,1.0,0.0
101374,0,0.0,1.0,0.0,0.0,0.0,180000.0,790830.0,52978.5,675000.0,0.04622,23.728767123287675,-1509.0,-1652.0,-1274.0,,1.0,1.0,1.0,17.0,,0.3631934949076992,0.434733248750173,0.0495,0.0,0.9737,0.6396,0.0242,0.0,0.1034,0.125,0.0417,0.0189,0.0403,0.0401,0.0,0.0,0.0504,0.0,0.9737,0.6537,0.0244,0.0,0.1034,0.125,0.0417,0.0193,0.0441,0.0418,0.0,0.0,0.05,0.0,0.9737,0.6444,0.0243,0.0,0.1034,0.125,0.0417,0.0192,0.041,0.0408,0.0,0.0,0.0447,1.0,0.0,0.0,0.0,0.0,-716.0,0.0,0.0,0.0,0.0,1.0,2.0,1.0,1.0,1.0,1.0,0.0,0.0,0.0,0.0,0.0,0.0,1.0,1.0,0.0,1.0,0.0,0.0,0.0,0.0,0.0,0.0,0.0,0.0,0.0,0.0,0.0,0.0,0.0,0.0,0.0,0.0,0.0,0.0,1.0,,,225000.0,193720.5,0.0,0.0,0.0,0.0,-288.0,-170.0,-217.0,,10.0,-4.5,2.0,15010.3575,124758.0,130542.75,5845.5,124758.0,11.0,-523.0,365243.0,-492.5,-192.5,-192.5,-187.5,16.5,0.5,0.0504647603235033,50.0,23.0,12.0,5.0,-12.0,0.0,0.0,25.0,14207.805,14207.805,-362.0,-355.0,6.0,1.0,0.0,,,,,,,,,,,,,,,,,,,,,8341442626.5,184304748132.0,165500397697.5,51940061110.935,1863.0,1704.0,71124.0,70730.0,9140.0,505750.0,17796.4847000023,17858.57929999911,17310.414699998073,11288.826500000085,11226.656900000087,11174.246200000058,128329.0,662400.0,4135.874600000123,4133.516900000017,3944.289400000095,13519597.323287273,-601515914.0,-921350409.0,-296307019.0,-1534226494.0416667,43979.0,30678.0,11342.993199999177,11218.89999999897,10703.4924999973,22873.87050000964,22795.7024000096,22181.725800008157,,157943.20619666722,126028.75370909616,34977.449300027896,34917.90750002833,34364.29980002873,22939.03669999593,22912.484199995502,22559.873299995736,3711976.0,8290.673900000165,8395.126000000082,8118.868000000229,9811.97160000072,9926.864600002156,10286.350499999648,16458.452399999747,16643.5877999997,16240.538299999696,828.228400000176,813.4081000000459,759.3898000000132,3911.131500000124,3894.381100000161,3727.206800000158,436199.0,430998.0,,6421.106955002897,631563.0,625121.0,,16322.3323999998,154079.61399999054,154082.36199999007,153974.14139998713,77562.14199999625,77899.71600000658,78300.89160000648,10.0,,,2073551090.8050003,723038868.1800003,26519937.975,618685.47,45.0,5196.0,-7147452.0,3419199.0,-3708317.0,,-4.5,,,225000.0,193720.5,0.0,0.0,0.0,0.0,-288.0,-170.0,-217.0,,81606789.54000002,1163597086.8,1312381746.495,18947213.055000003,1163597086.8,84149.0,-5879003.0,1348765567.5,58957413.0,292734353.0,135625318.0,304897572.5,83637.5,1348.5,234.0033045348896,2230210.0,706114.0,430488.0,-1409980.0,359980.0,2556.0,937612230.0299768,944708692.004978,-57864297.0,-57390960.0,1037669.0,47127.0,,,,,,,,,,,,,,,,,,,,,1466451.0,14744734.0,3229999.0,8549374.0,11599779.0,1414701.0,,,72063337772.5196,21666869235.742622,582091046.036999,5792665.7475,689.5,94245.0,-276761413.0,21939416.5,-123717924.5,,-2015553.5,,,,,,,,,,,,,,,,,,,,,4270173.5,2477668.5,-8998091.5,921269.0,37582.5,3731145026.377465,3655726807.049964,-260475147.0,-257166132.0,2524896.5,269033.5,3923794549.057455,33235691452.51591,36663235717.07264,1728402200.6175494,48055755574.215706,3985542.0,-247436523.5,103021199957.5,1053068873.5,17264112251.5,3501591102.5,18877398935.0,3669812.0,71874.0,20858.48195048461,89752747.5,-63.59369587807412,4.3935,3.3976046886944697,80.62097043502139,14.927376199779156,354.2082336062665,180000.0,0.6234898018587334,-0.7818314824680299,0.0,0.0,0.0,0.0,0.0,0.0,1.0,0.0,0.0,0.0,1.0,0.0,0.0,0.0,0.0,0.0,0.0,0.0,1.0,0.0,0.0,0.0,1.0,0.0,0.0,1.0,0.0,0.0,0.0,0.0,0.0,0.0,1.0,0.0,0.0,0.0,0.0,0.0,0.0,0.0,0.0,0.0,0.0,0.0,0.0,0.0,0.0,0.0,0.0,0.0,0.0,1.0,0.0,0.0,0.0,0.0,0.0,0.0,0.0,0.0,0.0,0.0,0.0,0.0,0.0,0.0,0.0,0.0,0.0,0.0,0.0,0.0,0.0,0.0,0.0,0.0,0.0,0.0,0.0,0.0,0.0,0.0,0.0,0.0,0.0,0.0,0.0,0.0,0.0,0.0,0.0,0.0,0.0,0.0,0.0,0.0,0.0,0.0,0.0,0.0,0.0,0.0,0.0,0.0,0.0,0.0,0.0,1.0,0.0,0.0,1.0,0.0,0.0,0.0,0.0,0.0,0.0,0.0,1.0,0.0
101380,0,0.0,0.0,1.0,1.0,0.0,162000.0,495000.0,27769.5,495000.0,0.003069,49.96986301369864,-3527.0,-6069.0,-1749.0,8.0,2.0,3.0,3.0,11.0,,0.4795779954058346,0.8038850611746273,0.0825,0.0572,0.9776,,,0.0,0.1379,0.1667,,0.0324,,0.0406,,0.0225,0.084,0.0593,0.9777,,,0.0,0.1379,0.1667,,0.0331,,0.0423,,0.0238,0.0833,0.0572,0.9776,,,0.0,0.1379,0.1667,,0.0329,,0.0413,,0.0229,0.0516,1.0,4.0,0.0,4.0,0.0,-928.0,0.0,0.0,0.0,0.0,0.0,2.0,1.0,1.0,0.0,1.0,0.0,0.0,0.0,0.0,0.0,0.0,0.0,0.0,0.0,1.0,0.0,0.0,0.0,0.0,0.0,0.0,0.0,0.0,0.0,0.0,0.0,0.0,0.0,0.0,0.0,0.0,0.0,0.0,7.0,0.0,11942.01,63000.0,0.0,0.0,0.0,0.0,0.0,-1827.0,-1642.0,-1422.0,-1429.0,427.0,-32.0,1.0,10810.26,82800.0,90085.5,0.0,82800.0,10.0,-928.0,365243.0,-892.0,-652.0,-622.0,-635.0,12.0,0.0,0.0,3466.0,11.0,10.0,5.0,-25.0,0.0,0.0,9.0,10810.26,10810.26,-804.0,-772.0,5.0,1.0,0.0,,,,,,,,,,,,,,,,,,,,,8341470396.0,184305243132.0,165500892697.5,51940223110.935,1863.0,1704.0,71124.0,70730.0,9140.0,505752.0,17796.5672000023,17858.66259999911,17310.498699998072,11288.883700000082,11226.714100000088,11174.30550000006,128329.0,662402.0,,,,13519647.293150283,-601519441.0,-921352158.0,-296307947.0,-1534232563.0416667,43979.0,30678.0,11342.993199999177,11218.89999999897,10703.4924999973,22874.00840000964,22795.8403000096,22181.863700008154,,157943.68577466262,126029.55759415732,34977.6160000279,34918.07420002833,34364.466500028735,,,,3711987.0,8290.706300000165,8395.158900000082,8118.901100000227,,,,16458.492999999748,16643.6290999997,16240.580599999696,,,,3911.154000000124,3894.404000000161,3727.230600000158,436203.0,431002.0,1262293.0,6421.110024002896,631566.0,625124.0,,16322.3839999998,154080.59159999056,154083.33959999005,153975.11909998712,,,,61.0,21828491.235,6538596.434999999,2076202658.1150005,723417174.1800003,26519937.975,618685.47,45.0,5196.0,-7171935.0,3435279.0,-3724261.0,-4009724.0,-30.0,0.0,0.0,63000.0,0.0,0.0,0.0,0.0,0.0,-2033.0,-1863.0,-1422.0,-1429.0,81848806.15500002,1168011170.55,1317112848.495,19070688.555000003,1168011170.55,84430.0,-5897674.0,1353328274.0,58940682.0,293453769.0,135980711.0,305617078.0,83864.0,1351.0,235.0218921695686,2242773.0,708189.0,431637.0,-1415568.0,360126.0,2614.0,940631053.7699796,947847795.47998,-58220399.0,-57745419.0,1047945.0,47374.0,,,,,,,,,,,,,,,,,,,,,1466458.0,14745161.0,3229999.0,8549385.0,11599788.0,1414702.0,1057588592.607001,801514715.444995,72063400772.5196,21666869235.742622,582091046.036999,5792665.7475,689.5,94245.0,-276763240.0,21937774.5,-123719346.5,-218574707.5,-2015585.5,,,,,,,,,,,,,,,,,,,,,4270183.5,2477673.5,-8998116.5,921269.0,37582.5,3731155836.637465,3655737617.309963,-260475951.0,-257166904.0,2524901.5,269034.5,3923805359.317455,33235774252.51591,36663325802.57264,1728402200.6175494,48055838374.215706,3985552.0,-247437451.5,103021565200.5,1053067981.5,17264111599.5,3501590480.5,18877398300.0,3669824.0,71874.0,20858.48195048461,89756213.5,-70.58254290257142,3.055555555555556,5.83373845405931,291.5111114070897,17.825311942959,890.7283959661073,81000.0,-0.9009688679024191,-0.433883739117558,0.0,0.0,0.0,0.0,0.0,0.0,1.0,0.0,0.0,0.0,0.0,0.0,0.0,1.0,0.0,1.0,0.0,0.0,0.0,0.0,1.0,0.0,0.0,0.0,0.0,1.0,0.0,0.0,0.0,0.0,0.0,0.0,0.0,0.0,0.0,0.0,1.0,0.0,0.0,0.0,0.0,0.0,0.0,0.0,0.0,0.0,0.0,0.0,0.0,0.0,0.0,0.0,0.0,1.0,0.0,0.0,0.0,0.0,0.0,0.0,0.0,0.0,0.0,0.0,0.0,0.0,0.0,0.0,0.0,0.0,0.0,0.0,0.0,0.0,0.0,0.0,0.0,0.0,0.0,0.0,0.0,0.0,0.0,0.0,0.0,0.0,0.0,0.0,0.0,0.0,0.0,0.0,0.0,0.0,0.0,0.0,0.0,0.0,0.0,0.0,0.0,0.0,0.0,0.0,0.0,0.0,0.0,0.0,0.0,0.0,1.0,0.0,0.0,0.0,0.0,0.0,0.0,0.0,0.0,0.0
101383,0,0.0,1.0,1.0,0.0,0.0,135000.0,272520.0,16803.0,225000.0,0.020713,65.67945205479452,,-12199.0,-5163.0,10.0,2.0,3.0,2.0,8.0,,0.6087030719394882,0.6446794549585961,0.2216,0.1708,0.9836,0.7756,0.1287,0.24,0.2069,0.3333,0.375,0.0953,0.1774,0.238,0.0154,0.0243,0.2258,0.1772,0.9836,0.7844,0.1299,0.2417,0.2069,0.3333,0.375,0.0975,0.1938,0.2479,0.0156,0.0257,0.2238,0.1708,0.9836,0.7786,0.1295,0.24,0.2069,0.3333,0.375,0.097,0.1804,0.2422,0.0155,0.0248,0.2628,1.0,1.0,1.0,1.0,1.0,-2412.0,0.0,0.0,0.0,0.0,0.0,4.0,1.0,0.0,0.0,1.0,0.0,1.0,0.0,0.0,0.0,0.0,0.0,0.0,0.0,0.0,0.0,0.0,1.0,0.0,0.0,0.0,0.0,0.0,0.0,0.0,0.0,0.0,0.0,0.0,0.0,0.0,0.0,0.0,4.0,18162.0,0.0,491539.5,435960.0,0.0,0.0,0.0,0.0,-558.0,1268.0,-63.0,-144.0,86.0,-10.0,15.0,13297.365,198891.0,215640.0,0.0,211945.5,24.0,-1134.0,365243.0,-1439.0,-920.0,-659.0,-916.0,8.0,1.0,0.0,-1.0,224.0,24.0,12.0,-36.0,0.0,0.0,217.0,13297.365,13297.365,-1084.0,-1074.0,9.0,1.0,0.0,,,,,,,,,,,,,,,,,,,,,8341487199.0,184305515652.0,165501117697.5,51940358110.935,1863.0,1704.0,71124.0,70730.0,9140.0,505756.0,17796.7888000023,17858.886399999108,17310.724499998072,11289.054500000084,11226.884900000088,11174.48270000006,128329.0,662404.0,4136.003300000123,4133.646400000017,3944.419300000095,13519712.97260234,,-921357321.0,-296310359.0,-1534244762.0416667,43980.0,30679.0,11343.233199999177,11219.13999999897,10703.7341999973,22874.21530000964,22796.0472000096,22182.070600008155,,157944.29447773454,126030.20227361226,34977.949300027896,34918.40750002833,34364.79980002873,22939.41169999593,22912.859199995502,22560.248299995736,3711995.0,8290.801600000166,8395.255900000082,8118.998600000227,9812.14900000072,9927.045000002156,10286.544299999649,16458.730999999752,16643.8712999997,16240.828499999694,828.243800000176,813.4236000000459,759.4054000000133,3911.178300000124,3894.428800000161,3727.256300000159,436204.0,431003.0,1262303.0,6421.130737002897,631569.0,625126.0,,16322.6467999998,154081.57519999053,154084.32319999006,153976.10269998712,77562.91759999625,77900.49460000657,78301.67600000647,19.0,21846653.235,6543736.1549999975,2079789279.6150005,725405364.9900001,26519937.975,618685.47,45.0,5196.0,-7185059.0,3430132.0,-3732095.5,-4017427.0,-9.0,18162.0,0.0,474606.0,435960.0,0.0,0.0,0.0,0.0,-558.0,1268.0,-95.0,-144.0,82036206.96750003,1170448649.46,1319822883.4050002,19090236.555000003,1170504899.46,84688.0,-5914018.0,1357527905.5,58927173.5,294534040.0,136339143.0,306697422.5,84052.0,1355.5,235.2832660744416,2243220.0,711646.0,433627.0,-1421892.5,360144.0,2622.0,943491263.6249808,950709429.6299812,-58424927.0,-57948342.0,1050391.0,47548.0,,,,,,,,,,,,,,,,,,,,,1466462.0,14745247.0,3229999.0,8549609.0,11600005.0,1414717.0,1057606754.607001,801514715.444995,72063892312.0196,21667305195.742622,582091046.036999,5792665.7475,689.5,94245.0,-276763798.0,21939042.5,-123719409.5,-218574851.5,-2015595.5,,,,,,,,,,,,,,,,,,,,,4270207.5,2477685.5,-8998152.5,921269.0,37582.5,3731169134.002465,3655750914.674964,-260477035.0,-257167978.0,2524910.5,269035.5,3923818656.682455,33235973143.51591,36663541442.57264,1728402200.6175494,48056050319.715706,3985576.0,-247438585.5,103021930443.5,1053066542.5,17264110679.5,3501589821.5,18877397384.0,3669832.0,71875.0,20858.48195048461,89756212.5,,2.018666666666667,8.034279592929835,527.6870813186491,16.218532404927693,1065.2243214885798,67500.0,-0.2225209339563143,0.9749279121818236,0.0,0.0,0.0,0.0,0.0,0.0,1.0,0.0,0.0,1.0,0.0,0.0,0.0,0.0,0.0,0.0,0.0,0.0,1.0,0.0,1.0,0.0,0.0,0.0,0.0,0.0,1.0,0.0,0.0,0.0,0.0,0.0,0.0,0.0,0.0,0.0,0.0,0.0,0.0,0.0,0.0,0.0,0.0,0.0,0.0,0.0,0.0,0.0,0.0,0.0,0.0,0.0,0.0,0.0,0.0,0.0,0.0,0.0,0.0,0.0,0.0,0.0,0.0,0.0,0.0,0.0,0.0,0.0,0.0,0.0,0.0,0.0,0.0,0.0,0.0,0.0,0.0,0.0,0.0,0.0,0.0,0.0,0.0,0.0,0.0,0.0,0.0,0.0,0.0,0.0,0.0,0.0,0.0,0.0,0.0,0.0,0.0,0.0,0.0,0.0,0.0,0.0,0.0,0.0,0.0,1.0,0.0,0.0,1.0,0.0,1.0,0.0,0.0,0.0,0.0,0.0,0.0,1.0,0.0,0.0
101398,0,0.0,0.0,0.0,1.0,0.0,112500.0,675000.0,38880.0,675000.0,0.028663,61.4,,-10264.0,-4814.0,,2.0,2.0,2.0,12.0,0.8013683389023125,0.6673896919446497,,0.0866,0.1008,0.9851,,,0.1064,0.0917,0.3333,,,,0.0585,,0.0875,0.0294,0.022,0.9856,,,0.0403,0.0345,0.3333,,,,0.0262,,0.0,0.0999,0.1014,0.9856,,,0.12,0.1034,0.3333,,,,0.0657,,0.0823,0.237,1.0,0.0,0.0,0.0,0.0,-1144.0,0.0,0.0,0.0,0.0,0.0,3.0,1.0,0.0,0.0,1.0,0.0,0.0,0.0,0.0,0.0,0.0,0.0,0.0,0.0,0.0,0.0,0.0,1.0,0.0,0.0,0.0,0.0,0.0,0.0,0.0,0.0,0.0,0.0,0.0,0.0,0.0,0.0,0.0,1.0,0.0,,45000.0,0.0,,0.0,0.0,0.0,-261.0,3392.0,-261.0,,9.0,-4.0,3.0,10815.345,90463.5,98424.0,0.0,90463.5,10.0,-610.0,365243.0,-575.0,-485.0,-485.0,-482.0,13.0,0.0,0.0,10.0,30.0,10.0,4.0,-17.0,0.0,0.0,27.0,10815.345,10815.345,-541.0,-515.0,5.0,1.0,0.0,,,,,,,,,,,,,,,,,,,,,8341526079.0,184306190652.0,165501792697.5,51940470610.935,1863.0,1704.0,71124.0,70730.0,9140.0,505759.0,17796.8754000023,17858.98629999911,17310.753899998068,11289.155300000082,11226.986300000088,11174.504700000058,128329.0,662406.0,,,,13519774.37260234,,-921362135.0,-296311503.0,-1534255026.0416667,43980.0,30679.0,11343.339599999175,11219.259999998969,10703.7744999973,22874.30700000964,22796.1506000096,22182.10510000816,67407.43414333594,157944.96186742652,,34978.28260002789,34918.74080002833,34365.13310002873,,,,3712007.0,,,,,,,16458.789499999748,16643.9369999997,16240.854699999694,,,,3911.265800000124,3894.511100000161,3727.256300000159,436204.0,431003.0,,6421.159400002896,631571.0,625128.0,,16322.8837999998,154082.56029999055,154085.30879999007,153977.08829998714,,,,9.0,22198301.91,,2097934564.5450008,731475323.6400001,,619468.47,45.0,5228.0,-7243287.0,3502598.0,-3761701.0,,-4.0,0.0,,45000.0,0.0,,0.0,0.0,0.0,-261.0,3392.0,-261.0,,83104242.07500002,1184446268.01,1335387370.9050002,19305948.105000004,1184446268.01,85972.0,-6019517.0,1379987426.0,59570754.0,297394344.0,138105790.0,310289809.0,85077.0,1383.0,238.3100009890574,2256481.0,722346.0,439924.0,-1450413.5,360219.0,2697.0,956195106.6149856,963314373.9599842,-59374677.0,-58889405.0,1059016.0,48388.0,,,,,,,,,,,,,,,,,,,,,1466463.0,14745256.0,3229999.0,8549639.0,11600032.0,1414720.0,1057606754.607001,,72063937312.0196,21667305195.742622,,5792665.7475,689.5,94245.0,-276764059.0,21942434.5,-123719670.5,,-2015599.5,,,,,,,,,,,,,,,,,,,,,4270217.5,2477689.5,-8998169.5,921269.0,37582.5,3731179949.347465,3655761730.0199633,-260477576.0,-257168493.0,2524915.5,269036.5,3923829472.027455,33236063607.01591,36663639866.57264,1728402200.6175494,48056140783.215706,3985586.0,-247439195.5,103022295686.5,1053065967.5,17264110194.5,3501589336.5,18877396902.0,3669845.0,71875.0,20858.48195048461,89756222.5,,6.0,2.8935185185185186,177.66203703703704,17.36111111111111,1065.9722222222224,56250.0,-0.2225209339563146,-0.9749279121818236,0.0,0.0,0.0,0.0,0.0,0.0,1.0,0.0,0.0,1.0,0.0,0.0,0.0,0.0,0.0,0.0,0.0,0.0,1.0,0.0,1.0,0.0,0.0,0.0,0.0,1.0,0.0,0.0,0.0,0.0,0.0,0.0,0.0,0.0,0.0,0.0,0.0,0.0,0.0,0.0,0.0,0.0,0.0,0.0,0.0,0.0,0.0,0.0,0.0,0.0,0.0,0.0,0.0,0.0,0.0,0.0,0.0,0.0,0.0,0.0,0.0,0.0,0.0,0.0,0.0,0.0,0.0,0.0,0.0,0.0,0.0,0.0,0.0,0.0,0.0,0.0,0.0,0.0,0.0,0.0,0.0,0.0,0.0,0.0,0.0,0.0,0.0,0.0,0.0,0.0,0.0,0.0,0.0,0.0,0.0,0.0,0.0,0.0,0.0,0.0,0.0,0.0,0.0,0.0,0.0,1.0,0.0,0.0,0.0,0.0,1.0,0.0,0.0,0.0,0.0,0.0,0.0,0.0,1.0,0.0
101399,0,0.0,0.0,0.0,0.0,0.0,90000.0,360000.0,25731.0,360000.0,0.015221,41.96986301369864,-3082.0,-6467.0,-4709.0,,2.0,2.0,2.0,18.0,0.339795133559665,0.122859505202134,0.326475210066026,,,,,,,,,,,,,,,,,,,,,,,,,,,,,,,,,,,,,,,,,,,,,0.0,0.0,0.0,0.0,-1264.0,0.0,0.0,0.0,0.0,0.0,3.0,1.0,1.0,1.0,1.0,0.0,0.0,0.0,0.0,0.0,1.0,1.0,0.0,0.0,1.0,0.0,0.0,0.0,0.0,0.0,0.0,0.0,0.0,0.0,0.0,0.0,0.0,0.0,0.0,0.0,0.0,0.0,0.0,4.0,0.0,0.0,186750.0,32028.2325,0.0,0.0,0.0,0.0,-543.5,369.5,-22.5,-592.0,93.0,-11.0,14.0,8362.755,69412.5,73797.75,6750.0,91310.4,12.0,-1255.5,365243.0,-1325.0,-1229.0,-904.0,-1221.0,11.5,1.0,0.1045099511066928,-1.0,109.0,24.0,9.0,-39.0,0.0,0.0,210.0,8681.377499999999,8362.755,-867.0,-867.0,15.0,1.0,45.0,327201.255,450000.0,0.0,9201.69,0.0,0.0,15819.66,22500.0,22500.0,308699.685,317395.89,317395.89,0.0,2.0,0.0,0.0,22.5,-23.0,0.0,0.0,8341551810.0,184306550652.0,165502152697.5,51940560610.935,1863.0,1704.0,71124.0,70730.0,9140.0,505762.0,,,,,,,128329.0,662408.0,,,,13519816.342465354,-601522523.0,-921366844.0,-296312767.0,-1534261493.0416667,43980.0,30679.0,,,,,,,67407.7739384695,157945.08472693173,126030.52874882234,,,,,,,3712025.0,,,,,,,,,,,,,,,,436204.0,431003.0,,6421.174621002897,631573.0,625130.0,,,,,,,,,18.5,22198301.91,6743804.939999999,2098589472.2250009,731852104.1400001,26519937.975,619468.47,45.0,5228.0,-7245351.5,3502207.5,-3762662.5,-4046251.0,-8.75,0.0,0.0,58500.0,0.0,0.0,0.0,0.0,0.0,-747.0,-17.0,-34.0,-1168.0,83190316.725,1185965720.01,1336994320.9050002,19339981.605000004,1186151795.01,86090.0,-6027357.5,1381812281.0,59563131.0,297752097.0,138464083.0,310647613.0,85179.5,1385.0,238.88912515415143,2256869.5,723571.0,440582.0,-1452654.0,360219.0,2697.0,958072524.4124868,965169197.8424852,-59470258.5,-58984484.5,1063189.5,48427.0,936089705.7899998,2420955000.0,77755452.75,123095942.595,5423234.4,39841987.81500002,52942619.36249994,131233760.66250032,121132748.9699997,898485990.7499985,932487478.5599972,932523750.494997,3955.0,9872.0,76.0,5841.0,300084.5,-523698.0,210826.0,463.0,1466467.0,14745349.0,3230044.0,8549748.0,11600242.0,1414734.0,1057606754.607001,801514715.444995,72064124062.0196,21667337223.97512,582091046.036999,5792665.7475,689.5,94245.0,-276764602.5,21942804.0,-123719693.0,-218575443.5,-2015610.5,5917932301.657461,18708333750.0,198653345.325,447623643.32999766,1948107.735,256577150.4750008,308871531.0449987,636049143.6074983,458791306.1099992,5703249437.775031,5881240664.864999,5881483847.61,13371.0,80785.5,44.0,70304.0,970829.5,-1697131.0,177364.0,6755.0,4270241.5,2477698.5,-8998208.5,921269.0,37582.5,3731188630.7249646,3655770092.7749634,-260478443.0,-257169360.0,2524930.5,269037.5,3923837834.782455,33236133019.51591,36663713664.32264,1728408950.6175494,48056232093.61572,3985598.0,-247440451.0,103022660929.5,1053064642.5,17264108965.5,3501588432.5,18877395681.0,3669856.5,71876.0,20858.58646043572,89756221.5,-73.43364449376591,4.0,3.497726477789437,146.79910113220927,13.990905911157748,587.1964045288371,45000.0,0.6234898018587336,0.7818314824680298,0.0,0.0,0.0,0.0,0.0,0.0,1.0,0.0,0.0,0.0,0.0,0.0,0.0,1.0,0.0,0.0,0.0,0.0,1.0,0.0,1.0,0.0,0.0,0.0,0.0,1.0,0.0,0.0,0.0,0.0,0.0,0.0,0.0,0.0,0.0,0.0,0.0,0.0,0.0,0.0,0.0,0.0,0.0,0.0,1.0,0.0,0.0,0.0,0.0,0.0,0.0,0.0,0.0,0.0,0.0,0.0,0.0,0.0,0.0,0.0,0.0,0.0,0.0,0.0,0.0,0.0,0.0,0.0,0.0,0.0,0.0,0.0,0.0,0.0,0.0,0.0,0.0,0.0,0.0,0.0,0.0,0.0,0.0,0.0,0.0,0.0,0.0,0.0,0.0,0.0,0.0,0.0,0.0,0.0,0.0,0.0,0.0,0.0,0.0,1.0,0.0,0.0,0.0,0.0,0.0,0.0,0.0,0.0,0.0,0.0,0.0,0.0,0.0,0.0,0.0,0.0,0.0,0.0,0.0,0.0
101401,0,0.0,1.0,1.0,1.0,0.0,157500.0,1024740.0,55719.0,900000.0,0.018029,46.31506849315068,-651.0,-8212.0,-420.0,26.0,2.0,3.0,3.0,12.0,,0.2540009381836865,,0.0814,,0.9836,,,0.0,0.2069,0.1667,,,,0.0825,,0.0091,0.083,,0.9836,,,0.0,0.2069,0.1667,,,,0.086,,0.0096,0.0822,,0.9836,,,0.0,0.2069,0.1667,,,,0.084,,0.0093,0.0669,1.0,0.0,0.0,0.0,0.0,-627.0,,,,,,,1.0,1.0,0.0,1.0,0.0,0.0,0.0,0.0,0.0,0.0,0.0,0.0,0.0,1.0,0.0,0.0,0.0,0.0,0.0,0.0,0.0,0.0,0.0,0.0,0.0,0.0,0.0,0.0,0.0,0.0,0.0,0.0,0.0,,,,,,,,,,,,,0.0,,1.0,13810.725,121594.5,121594.5,0.0,121594.5,10.0,-627.0,365243.0,-585.0,-315.0,-315.0,-312.0,6.0,0.0,0.0,18.0,12.0,10.0,5.0,-15.5,0.0,0.0,10.0,13810.725,13810.725,-465.0,-450.0,5.5,1.0,0.0,,,,,,,,,,,,,,,,,,,,,8341607529.0,184307575392.0,165503052697.5,51940718110.935,,,,,,,17796.9568000023,17859.06849999911,17310.83689999807,,,,128329.0,662410.0,,,,13519862.657533849,-601523174.0,-921367264.0,-296313394.0,-1534269705.0416667,43980.0,30679.0,11343.339599999175,11219.259999998969,10703.7744999973,22874.51390000964,22796.35750000961,22182.31200000816,,157945.3387278699,,34978.449300027896,34918.90750002833,34365.29980002873,,,,3712037.0,,,,,,,16458.871999999752,16644.0209999997,16240.940699999695,,,,3911.274900000125,3894.520400000161,3727.265900000158,436204.0,431003.0,1262329.0,6421.192650002897,631576.0,625133.0,,16322.9506999998,154083.54389999056,154086.29239999008,153978.07189998715,,,,,,,,,,,,,,,,,,,,,,,,,,,,,,83350120.81499997,1188994769.91,1340184546.4050002,19375861.005000006,1188994769.91,86314.0,-6040110.0,1384734225.0,59553151.0,298112553.0,138461385.0,311008091.0,85312.0,1391.0,239.31381292259715,2257941.0,725546.0,441894.0,-1456022.0,360366.0,2730.0,960764401.2824856,967725642.4874845,-59621472.0,-59134884.5,1065146.5,48554.5,,,,,,,,,,,,,,,,,,,,,1466467.0,14745349.0,3230044.0,8549760.0,11600252.0,1414735.0,,,,,,,,,,,,,,,,,,,,,,,,,,,,,,,,,,4270251.5,2477703.5,-8998224.0,921269.0,37582.5,3731202441.449965,3655783903.4999633,-260478908.0,-257169810.0,2524936.0,269038.5,3923851645.507455,33236254614.01591,36663835258.82264,1728408950.6175494,48056353688.11572,3985608.0,-247441078.0,103023026172.5,1053064057.5,17264108650.5,3501588117.5,18877395369.0,3669862.5,71876.0,20858.58646043572,89756239.5,-14.055900621118012,6.506285714285713,2.8266838959780327,130.9180582507086,18.39121305120336,851.7902921386102,78750.0,-0.9009688679024191,0.4338837391175582,0.0,0.0,0.0,0.0,0.0,0.0,1.0,0.0,0.0,0.0,0.0,0.0,0.0,1.0,0.0,0.0,0.0,0.0,1.0,0.0,1.0,0.0,0.0,0.0,0.0,1.0,0.0,0.0,0.0,0.0,0.0,0.0,0.0,0.0,1.0,0.0,0.0,0.0,0.0,0.0,0.0,0.0,0.0,0.0,0.0,0.0,0.0,0.0,0.0,0.0,0.0,0.0,0.0,0.0,0.0,0.0,0.0,0.0,0.0,0.0,0.0,0.0,0.0,0.0,0.0,0.0,0.0,0.0,0.0,0.0,0.0,0.0,0.0,0.0,0.0,0.0,0.0,0.0,0.0,0.0,0.0,0.0,0.0,0.0,0.0,0.0,0.0,0.0,0.0,0.0,1.0,0.0,0.0,0.0,0.0,0.0,0.0,0.0,0.0,0.0,0.0,0.0,0.0,0.0,0.0,0.0,0.0,0.0,0.0,0.0,1.0,0.0,0.0,0.0,0.0,0.0,0.0,1.0,0.0,0.0
101412,0,0.0,0.0,0.0,0.0,0.0,81000.0,199008.0,19683.0,180000.0,0.020246,31.624657534246573,-1934.0,-4580.0,-2450.0,,2.0,3.0,3.0,10.0,0.555624083606204,0.1843775209352848,0.6127042441012546,,,,,,,,,,,,,,,,,,,,,,,,,,,,,,,,,,,,,,,,,,,,,4.0,2.0,4.0,2.0,-1334.0,0.0,0.0,0.0,0.0,1.0,1.0,1.0,1.0,1.0,1.0,0.0,1.0,0.0,0.0,0.0,1.0,1.0,0.0,0.0,1.0,0.0,0.0,0.0,0.0,0.0,0.0,0.0,0.0,0.0,0.0,0.0,0.0,0.0,0.0,0.0,0.0,0.0,0.0,3.0,0.0,,46530.0,0.0,0.0,0.0,0.0,0.0,-1166.0,-1105.0,-983.0,-1082.0,110.0,-18.0,5.0,15139.2375,67590.0,67590.0,0.0,67590.0,9.0,-1038.0,365243.0,-1064.5,-764.5,-734.5,-759.0,14.0,0.0,0.0,51.0,36.0,18.0,5.5,-28.5,0.0,0.0,42.0,21928.5,17051.13,-793.0,-783.0,7.0,1.0,0.0,,,,,,,,,,,,,,,,,,,,,8341627212.0,184307774400.0,165503232697.5,51940799110.935,1863.0,1704.0,71124.0,70731.0,9140.0,505763.0,,,,,,,128329.0,662412.0,,,,13519894.28219138,-601525108.0,-921369714.0,-296314728.0,-1534274285.0416667,43982.0,30681.0,,,,,,,67408.3295625531,157945.52310539086,126031.14145306643,,,,,,,3712047.0,,,,,,,,,,,,,,,,436208.0,431007.0,,6421.212896002897,631579.0,625136.0,,,,,,,,,39.0,22245313.41,,2116771165.800001,737743731.9750001,26730523.17,619468.47,45.0,5228.0,-7341864.0,3501571.0,-3814590.0,-4099269.0,-19.0,0.0,,46530.0,0.0,0.0,0.0,0.0,0.0,-1166.0,-1105.0,-983.0,-1082.0,84059626.725,1200161411.6850002,1352703825.4050002,19529054.28,1200161411.6850002,87221.0,-6112055.0,1397333972.5,60598191.0,299898350.0,139518891.0,312428750.5,86080.0,1400.5,241.8557971652113,2278003.0,730903.0,444669.0,-1475833.0,360809.0,2752.0,968717471.4899826,975346701.817483,-60598193.5,-60105748.0,1080245.5,49066.5,,,,,,,,,,,,,,,,,,,,,1466470.0,14745459.0,3230044.0,8549796.0,11600294.0,1414740.0,1057606754.607001,,72064170592.0196,21667337223.97512,582091046.036999,5792665.7475,689.5,94245.0,-276765768.5,21941699.0,-123720676.0,-218576525.5,-2015628.5,,,,,,,,,,,,,,,,,,,,,4270269.5,2477709.0,-8998252.5,921269.0,37582.5,3731224369.949965,3655800954.6299634,-260479701.0,-257170593.0,2524943.0,269039.5,3923866784.7449546,33236322204.01591,36663902848.82264,1728408950.6175494,48056421278.11572,3985617.0,-247442116.0,103023391415.5,1053062993.0,17264107886.0,3501587383.0,18877394610.0,3669876.5,71876.0,20858.58646043572,89756290.5,-61.15481244044009,2.4568888888888893,4.11522633744856,130.14262359772258,10.110653863740284,319.74596588809345,40500.0,0.6234898018587334,-0.7818314824680299,0.0,0.0,0.0,0.0,0.0,0.0,1.0,0.0,0.0,0.0,0.0,0.0,0.0,1.0,0.0,1.0,0.0,0.0,0.0,0.0,1.0,0.0,0.0,0.0,0.0,1.0,0.0,0.0,0.0,0.0,0.0,0.0,0.0,1.0,0.0,0.0,0.0,0.0,0.0,0.0,0.0,0.0,0.0,0.0,0.0,0.0,0.0,0.0,0.0,0.0,0.0,0.0,0.0,0.0,0.0,0.0,0.0,0.0,0.0,0.0,0.0,0.0,0.0,0.0,0.0,0.0,0.0,0.0,0.0,0.0,0.0,0.0,0.0,0.0,0.0,0.0,0.0,0.0,0.0,0.0,0.0,0.0,0.0,0.0,0.0,0.0,0.0,1.0,0.0,0.0,0.0,0.0,0.0,0.0,0.0,0.0,0.0,0.0,0.0,0.0,0.0,0.0,0.0,0.0,0.0,0.0,0.0,0.0,0.0,0.0,0.0,0.0,0.0,0.0,0.0,0.0,0.0,0.0,0.0,0.0
101426,0,0.0,1.0,1.0,1.0,0.0,157500.0,360000.0,28440.0,360000.0,0.00733,53.11232876712329,-3595.0,-3169.0,-2814.0,25.0,2.0,2.0,2.0,10.0,,0.660681937825239,0.6263042766749393,,,,,,,,,,,,,,,,,,,,,,,,,,,,,,,,,,,,,,,,,,,,,0.0,0.0,0.0,0.0,-654.0,0.0,0.0,0.0,0.0,0.0,1.0,1.0,1.0,0.0,1.0,1.0,0.0,0.0,0.0,0.0,0.0,1.0,0.0,0.0,1.0,0.0,0.0,0.0,0.0,0.0,0.0,0.0,0.0,0.0,0.0,0.0,0.0,0.0,0.0,0.0,0.0,0.0,0.0,3.0,6725.1825,0.0,135000.0,75910.5,29542.995,0.0,0.0,0.0,-595.0,206.0,-14.0,-832.0,72.0,-11.5,7.0,10125.0,70785.0,77013.0,0.0,202500.0,5.0,-410.0,365243.0,-622.0,-382.0,-352.0,-380.0,12.0,0.0,0.0,-1.0,10.0,10.0,5.5,-17.5,0.0,0.0,9.0,8601.93,8601.93,-511.0,-502.0,5.0,1.0,0.0,,,,,,,,,,,,,,,,,,,,,8341655652.0,184308134400.0,165503592697.5,51940956610.935,1863.0,1704.0,71124.0,70731.0,9140.0,505764.0,,,,,,,128329.0,662414.0,,,,13519947.394520149,-601528703.0,-921372528.0,-296315382.0,-1534277454.0416667,43982.0,30681.0,,,,,,,,157946.18378732866,126031.76775734311,,,,,,,3712057.0,,,,,,,,,,,,,,,,436208.0,431007.0,1262354.0,6421.220226002897,631581.0,625138.0,,,,,,,,,20.0,22259468.092499997,6791484.1949999975,2128539156.165001,741074588.7300001,26834609.16,619468.47,46.0,5228.0,-7369995.0,3535154.0,-3826888.0,-4113095.0,-9.5,6725.1825,0.0,135000.0,75910.5,0.0,0.0,0.0,0.0,-595.0,-832.0,-14.0,-832.0,84595589.68499997,1205936285.0850005,1358796406.9050002,19761295.68,1206228785.0850005,87724.0,-6163243.0,1408837488.0,60926799.0,301332141.0,139860125.0,313863167.0,86650.0,1411.0,244.57846345772515,2288885.0,735381.0,447169.5,-1489161.5,360811.0,2754.0,974967551.5499812,981561575.474982,-61202419.0,-60706459.0,1090284.0,49502.0,,,,,,,,,,,,,,,,,,,,,1466473.0,14745531.0,3230044.0,8549806.0,11600303.0,1414747.0,1057613479.789501,801514715.444995,72064305592.0196,21667413134.47512,582120589.031999,5792665.7475,689.5,94245.0,-276766363.5,21941905.0,-123720690.0,-218577357.5,-2015640.0,,,,,,,,,,,,,,,,,,,,,4270279.5,2477714.5,-8998270.0,921269.0,37582.5,3731232971.879965,3655809556.559962,-260480212.0,-257171095.0,2524948.0,269040.5,3923876909.7449546,33236392989.01591,36663979861.82264,1728408950.6175494,48056623778.11572,3985622.0,-247442526.0,103023756658.5,1053062371.0,17264107504.0,3501587031.0,18877394230.0,3669888.5,71876.0,20858.58646043572,89756289.5,-67.68673269369648,2.2857142857142856,5.537974683544303,294.13473209641063,12.658227848101266,672.30795907751,78750.0,0.6234898018587336,0.7818314824680298,0.0,0.0,0.0,0.0,0.0,0.0,1.0,0.0,0.0,0.0,0.0,0.0,0.0,1.0,0.0,0.0,0.0,0.0,1.0,1.0,0.0,0.0,0.0,0.0,0.0,1.0,0.0,0.0,0.0,0.0,0.0,0.0,0.0,0.0,0.0,0.0,0.0,0.0,1.0,0.0,0.0,0.0,0.0,0.0,0.0,0.0,0.0,0.0,0.0,1.0,0.0,0.0,0.0,0.0,0.0,0.0,0.0,0.0,0.0,0.0,0.0,0.0,0.0,0.0,0.0,0.0,0.0,0.0,0.0,0.0,0.0,0.0,0.0,0.0,0.0,0.0,0.0,0.0,0.0,0.0,0.0,0.0,0.0,0.0,0.0,0.0,0.0,0.0,0.0,0.0,0.0,0.0,0.0,0.0,0.0,0.0,0.0,0.0,0.0,0.0,0.0,0.0,0.0,0.0,0.0,0.0,0.0,0.0,0.0,0.0,0.0,0.0,0.0,0.0,0.0,0.0,0.0,0.0,0.0,0.0
101427,0,0.0,0.0,0.0,1.0,0.0,225000.0,472500.0,37462.5,472500.0,0.0072739999999999,23.049315068493147,-1060.0,-8396.0,-1056.0,,1.0,2.0,2.0,13.0,,0.0209316062417423,0.1342654235549427,,,,,,,,,,,,,,,,,,,,,,,,,,,,,,,,,,,,,,,,,,,,,1.0,1.0,1.0,1.0,-237.0,0.0,0.0,0.0,0.0,1.0,2.0,1.0,1.0,0.0,1.0,0.0,0.0,0.0,0.0,0.0,0.0,1.0,1.0,0.0,1.0,0.0,0.0,0.0,0.0,0.0,0.0,0.0,0.0,0.0,0.0,0.0,0.0,0.0,0.0,0.0,0.0,0.0,0.0,5.0,8749.26,0.0,90963.405,43916.85,0.0,0.0,0.0,0.0,-178.0,75.0,-27.0,-202.0,37.0,-5.0,8.0,5484.195,39942.0,34764.75,0.0,54909.0,6.0,-285.5,365243.0,-354.0,-219.0,-114.0,-213.0,9.0,0.0,0.0,-1.0,20.0,7.0,5.0,-11.0,0.0,0.0,30.0,5484.195,5484.195,-228.0,-218.5,4.0,1.0,7.0,89031.87,90000.0,0.0,0.0,0.0,0.0,4856.715,4950.0,276.93,86453.64,89031.87,89031.87,0.0,0.0,0.0,0.0,2.0,-4.0,0.0,0.0,8341693114.5,184308606900.0,165504065197.5,51941181610.935,1863.0,1704.0,71124.0,70732.0,9140.0,505766.0,,,,,,,128329.0,662415.0,,,,13519970.443835218,-601529763.0,-921373584.0,-296315619.0,-1534285850.0416667,43983.0,30682.0,,,,,,,,157946.2047189349,126031.90202276668,,,,,,,3712070.0,,,,,,,,,,,,,,,,436209.0,431008.0,,6421.227500002897,631583.0,625140.0,,,,,,,,,6.0,22286123.774999995,6791484.1949999975,2128925535.165001,741236423.5800003,26970692.309999995,619468.47,46.0,5228.0,-7371186.0,3534815.5,-3827798.0,-4113297.0,-2.5,3638.52,3125.97,87628.5,16204.5,0.0,0.0,0.0,0.0,-386.0,5.0,-27.0,-202.0,84626037.35999997,1206570314.8350005,1359436664.6550002,19761295.68,1206583650.5850005,87750.0,-6166454.0,1409385245.5,60925919.5,301696531.0,140224710.0,314227573.0,86731.5,1411.0,244.57846345772515,2289090.5,735508.0,447248.0,-1489380.0,360811.0,2754.0,975094019.1674812,981688043.0924816,-61207168.5,-60711009.5,1090411.0,49514.0,967119621.4349996,2490273000.0,79507977.75,125604879.75,5454914.4,40566242.79,54941649.74999996,134900284.6349999,124665485.4899998,928308191.3099984,963438480.3149972,963474752.2499973,4091.0,10129.0,78.0,5960.0,315644.0,-541443.0,210855.0,463.0,1466478.0,14745568.0,3230051.0,8549826.0,11600333.0,1414755.0,1057622229.049501,801514715.444995,72064396555.4246,21667457051.32512,582120589.031999,5792665.7475,689.5,94245.0,-276766541.5,21941980.0,-123720717.0,-218577559.5,-2015645.0,5918021333.527461,18708423750.0,198653345.325,447623643.32999766,1948107.735,256577150.4750008,308876387.7599987,636054093.6074983,458791583.0399993,5703335891.415031,5881329696.735,5881572879.48,13371.0,80785.5,44.0,70304.0,970831.5,-1697135.0,177364.0,6755.0,4270286.5,2477719.5,-8998281.0,921269.0,37582.5,3731238456.074965,3655815040.7549634,-260480440.0,-257171313.5,2524952.0,269041.5,3923882393.9399543,33236432931.01591,36664014626.57264,1728408950.6175494,48056678687.11572,3985628.0,-247442811.5,103024121901.5,1053062017.0,17264107285.0,3501586917.0,18877394017.0,3669897.5,71876.0,20858.58646043572,89756288.5,-45.98835136098894,2.1,6.006006006006006,138.4343247356946,12.612612612612612,290.7120819449587,225000.0,-0.2225209339563143,0.9749279121818236,0.0,0.0,0.0,0.0,0.0,0.0,1.0,0.0,1.0,0.0,0.0,0.0,0.0,0.0,0.0,0.0,0.0,0.0,1.0,0.0,0.0,0.0,1.0,0.0,0.0,1.0,0.0,0.0,0.0,0.0,0.0,0.0,1.0,0.0,0.0,0.0,0.0,0.0,0.0,0.0,0.0,0.0,0.0,0.0,0.0,0.0,0.0,0.0,0.0,0.0,0.0,0.0,0.0,1.0,0.0,0.0,0.0,0.0,0.0,0.0,0.0,0.0,0.0,0.0,0.0,0.0,0.0,0.0,0.0,0.0,0.0,0.0,0.0,0.0,0.0,0.0,0.0,0.0,0.0,0.0,0.0,0.0,0.0,0.0,0.0,0.0,0.0,0.0,0.0,0.0,0.0,0.0,0.0,0.0,0.0,0.0,0.0,0.0,0.0,0.0,0.0,0.0,0.0,0.0,0.0,0.0,0.0,0.0,0.0,0.0,0.0,0.0,0.0,0.0,0.0,0.0,0.0,0.0,0.0,0.0
101428,0,0.0,1.0,1.0,1.0,0.0,202500.0,254700.0,20119.5,225000.0,0.022625,32.38356164383562,-490.0,-2168.0,-3962.0,15.0,2.0,2.0,2.0,7.0,,0.5603289418185118,0.2580842039460289,0.3062,0.0778,0.9806,0.7348,0.0283,0.0,0.0345,0.3333,0.0417,0.0675,0.2068,0.0704,0.1969,0.0037,0.312,0.0807,0.9806,0.7452,0.0285,0.0,0.0345,0.3333,0.0417,0.069,0.2259,0.0733,0.1984,0.0039,0.3092,0.0778,0.9806,0.7383,0.0285,0.0,0.0345,0.3333,0.0417,0.0687,0.2104,0.0717,0.198,0.0038,0.0716,1.0,0.0,0.0,0.0,0.0,-3098.0,0.0,0.0,0.0,0.0,0.0,0.0,1.0,1.0,0.0,1.0,0.0,0.0,0.0,0.0,0.0,0.0,0.0,0.0,0.0,1.0,0.0,0.0,0.0,0.0,0.0,0.0,0.0,0.0,0.0,0.0,0.0,0.0,0.0,0.0,0.0,0.0,0.0,0.0,11.0,0.0,,141750.0,0.0,0.0,0.0,0.0,0.0,-2259.0,-1300.0,-609.0,-2077.5,729.0,-33.0,0.0,,,,,,,,,,,,,,,,,4.0,4.0,0.0,-94.5,0.0,0.0,0.0,,,,,,,0.0,,,,,,,,,,,,,,,,,,,,,8341713234.0,184308861600.0,165504290197.5,51941384110.935,1863.0,1704.0,71124.0,70732.0,9140.0,505766.0,17797.2630000023,17859.37769999911,17311.148899998072,11289.233100000083,11227.064100000089,11174.585400000058,128329.0,662417.0,4136.031600000123,4133.674900000017,3944.447800000096,13520002.827396862,-601530253.0,-921377546.0,-296318717.0,-1534288018.0416667,43983.0,30682.0,11343.339599999175,11219.259999998969,10703.7744999973,22874.548400009644,22796.392000009604,22182.34650000816,,157946.76504787672,126032.16010697062,34978.78260002789,34919.24080002833,34365.63310002873,22939.453399995928,22912.900899995504,22560.289999995737,3712077.0,8290.869100000165,8395.324600000082,8119.067600000229,9812.35580000072,9927.255400002156,10286.770199999646,16458.942399999753,16644.0926999997,16241.013999999695,828.440700000176,813.6216000000459,759.6038000000133,3911.278600000125,3894.524200000161,3727.269800000159,436209.0,431008.0,1262369.0,6421.250125002895,631585.0,625142.0,,16323.0222999998,154084.52449999054,154087.2729999901,153979.05249998716,77563.65239999625,77901.23290000657,78302.42120000649,75.0,22298762.294999994,,2130374482.0650003,741283853.5800003,26970692.309999995,619468.47,46.0,5228.0,-7386959.0,3525829.0,-3832884.0,-4123300.0,-37.0,0.0,,75672.0,0.0,0.0,0.0,0.0,0.0,-2373.0,-1989.0,-712.0,-2166.0,,,,,,,,,,,,,,,,,735583.0,447289.0,-1489734.5,360811.0,2754.0,,,,,,,,,,,,,,,,,,,,,,,,,,,1466489.0,14746297.0,3230051.0,8549830.0,11600333.0,1414755.0,1057622229.049501,,72064538305.4246,21667457051.32512,582120589.031999,5792665.7475,689.5,94245.0,-276768800.5,21940680.0,-123721326.0,-218579637.0,-2015678.0,,,,,,,,,,,,,,,,,,,,,4270290.5,2477719.5,-8998375.5,921269.0,37582.5,,,,,,,,,,,,,,,,,,,,,,,-15.131133671742806,1.257777777777778,10.064862446879893,325.9360934852612,12.659360322075598,409.9551753614617,101250.0,-0.2225209339563143,0.9749279121818236,0.0,0.0,0.0,0.0,0.0,0.0,1.0,0.0,1.0,0.0,0.0,0.0,0.0,0.0,0.0,0.0,0.0,0.0,1.0,1.0,0.0,0.0,0.0,0.0,0.0,1.0,0.0,0.0,0.0,0.0,0.0,0.0,0.0,0.0,0.0,0.0,0.0,0.0,1.0,0.0,0.0,0.0,0.0,0.0,0.0,0.0,0.0,0.0,0.0,0.0,0.0,0.0,0.0,0.0,0.0,0.0,0.0,0.0,0.0,0.0,0.0,0.0,0.0,0.0,0.0,0.0,0.0,0.0,0.0,0.0,0.0,0.0,0.0,0.0,0.0,0.0,0.0,0.0,0.0,0.0,0.0,0.0,0.0,0.0,0.0,0.0,0.0,0.0,0.0,0.0,0.0,0.0,0.0,0.0,0.0,0.0,0.0,0.0,0.0,0.0,0.0,0.0,0.0,1.0,0.0,0.0,0.0,0.0,1.0,0.0,1.0,0.0,0.0,0.0,0.0,0.0,0.0,0.0,1.0,0.0
101429,0,0.0,1.0,0.0,1.0,0.0,67500.0,225000.0,17905.5,225000.0,0.0145199999999999,55.96986301369864,,-7787.0,-3990.0,,1.0,2.0,2.0,7.0,,0.2190446308236475,,0.0124,0.0318,0.9821,,,0.0,0.069,0.0417,,0.0419,,0.0118,,0.0028,0.0126,0.03,0.9821,,,0.0,0.069,0.0417,,0.0429,,0.0123,,0.0,0.0125,0.0318,0.9821,,,0.0,0.069,0.0417,,0.0426,,0.012,,0.0028,0.0093,1.0,0.0,0.0,0.0,0.0,-137.0,,,,,,,1.0,0.0,0.0,1.0,0.0,0.0,0.0,0.0,0.0,0.0,0.0,0.0,0.0,1.0,0.0,0.0,0.0,0.0,0.0,0.0,0.0,0.0,0.0,0.0,0.0,0.0,0.0,0.0,0.0,0.0,0.0,0.0,0.0,,,,,,,,,,,,,0.0,,4.0,5901.03,73788.75,73788.75,0.0,89955.0,18.0,-333.0,365243.0,-859.5,-439.5,-349.5,-435.5,8.0,0.0,0.0,21.5,32.0,18.0,10.5,-25.5,0.0,0.0,31.0,5901.03,5901.03,-779.0,-774.0,8.0,1.0,0.0,,,,,,,,,,,,,,,,,,,,,8341731139.5,184309086600.0,165504515197.5,51941451610.935,,,,,,,17797.275400002298,17859.39019999911,17311.16149999807,11289.264900000084,11227.095900000088,11174.61540000006,128329.0,662418.0,,,,13520058.797259877,,-921381536.0,-296318854.0,-1534295805.0416667,43983.0,30682.0,11343.339599999175,11219.259999998969,10703.7744999973,22874.617400009643,22796.461000009604,22182.41550000816,,157946.98409250757,,34978.824300027896,34919.28250002833,34365.67480002873,,,,3712084.0,8290.911000000166,8395.367200000082,8119.110500000228,,,,16458.954199999753,16644.104699999698,16241.026299999694,,,,3911.281400000125,3894.527000000161,3727.269800000159,436209.0,431008.0,,6421.264645002895,631587.0,625144.0,,16323.031599999797,154085.5065999905,154088.25509999009,153980.03459998715,,,,,,,,,,,,,,,,,,,,,,,,,,,,,,84654627.29999997,1206929318.0850005,1359785313.4050002,19774795.68,1207041818.0850005,87776.0,-6169060.5,1410480867.5,60923810.5,301695619.5,140223948.5,314226671.5,86791.0,1412.0,244.83934438452744,2289636.5,735885.0,447449.0,-1490416.5,360811.0,2754.0,975298724.1449808,981892748.0699816,-61227787.0,-60731200.0,1090622.0,49543.0,,,,,,,,,,,,,,,,,,,,,1466489.0,14746297.0,3230051.0,8549862.0,11600364.0,1414759.0,,,,,,,,,,,,,,,,,,,,,,,,,,,,,,,,,,4270308.5,2477730.0,-8998401.0,921269.0,37582.5,3731244357.1049647,3655820941.784963,-260481219.0,-257172087.5,2524960.0,269042.5,3923888294.9699545,33236506719.76591,36664088415.32264,1728408950.6175494,48056768642.11572,3985646.0,-247443144.5,103024487144.5,1053061157.5,17264106845.5,3501586567.5,18877393581.5,3669905.5,71876.0,20858.58646043572,89756310.0,,3.333333333333333,3.7697914048755967,210.9947085211056,12.565971349585324,703.3156950703524,67500.0,-0.9009688679024191,-0.433883739117558,0.0,0.0,0.0,0.0,0.0,0.0,1.0,0.0,0.0,1.0,0.0,0.0,0.0,0.0,0.0,0.0,0.0,0.0,1.0,0.0,0.0,1.0,0.0,0.0,0.0,1.0,0.0,0.0,0.0,0.0,0.0,0.0,0.0,0.0,0.0,0.0,0.0,0.0,0.0,0.0,0.0,0.0,0.0,0.0,0.0,0.0,0.0,0.0,0.0,0.0,0.0,0.0,0.0,0.0,0.0,0.0,0.0,0.0,0.0,0.0,0.0,0.0,0.0,0.0,0.0,0.0,0.0,0.0,0.0,0.0,0.0,0.0,0.0,0.0,0.0,0.0,0.0,0.0,0.0,0.0,0.0,0.0,0.0,0.0,0.0,0.0,0.0,0.0,0.0,0.0,0.0,0.0,0.0,0.0,0.0,0.0,0.0,0.0,0.0,0.0,0.0,0.0,0.0,0.0,0.0,1.0,0.0,0.0,0.0,0.0,1.0,0.0,0.0,0.0,0.0,0.0,0.0,1.0,0.0,0.0
101434,0,0.0,0.0,0.0,1.0,0.0,90000.0,550980.0,30897.0,450000.0,0.018634,50.91506849315069,-2127.0,-10485.0,-2052.0,,2.0,2.0,2.0,14.0,,0.7189642067363002,0.5513812618027899,0.0928,0.0,0.9891,0.8504,0.0138,0.0,0.2069,0.1667,0.2083,,0.0756,0.0906,0.0039,0.0391,0.0945,0.0,0.9891,0.8563,0.0139,0.0,0.2069,0.1667,0.2083,,0.0826,0.0944,0.0039,0.0414,0.0937,0.0,0.9891,0.8524,0.0138,0.0,0.2069,0.1667,0.2083,,0.077,0.0923,0.0039,0.0399,0.0798,1.0,2.0,1.0,2.0,1.0,-540.0,0.0,0.0,0.0,0.0,1.0,0.0,1.0,1.0,0.0,1.0,0.0,0.0,0.0,0.0,0.0,0.0,0.0,0.0,0.0,1.0,0.0,0.0,0.0,0.0,0.0,0.0,0.0,0.0,0.0,0.0,0.0,0.0,0.0,0.0,0.0,0.0,0.0,0.0,1.0,,0.0,161196.75,0.0,0.0,0.0,0.0,0.0,-358.0,-113.0,-110.0,-113.0,12.0,-5.5,1.0,18643.185,158175.0,169483.5,0.0,158175.0,10.0,-540.0,365243.0,-509.0,-299.0,-239.0,-292.0,18.0,0.0,0.0,20.0,9.0,10.0,6.0,-13.0,0.0,0.0,8.0,18643.185,18643.185,-448.0,-404.0,4.5,1.0,0.0,,,,,,,,,,,,,,,,,,,,,8341762036.5,184309637580.0,165504965197.5,51941541610.935,1863.0,1704.0,71124.0,70733.0,9140.0,505766.0,17797.368200002296,17859.483899999108,17311.25599999807,11289.264900000084,11227.095900000088,11174.61540000006,128329.0,662420.0,4136.045400000124,4133.688700000017,3944.4617000000944,13520109.712328369,-601532380.0,-921383588.0,-296319394.0,-1534306290.0416667,43984.0,30683.0,11343.339599999175,11219.259999998969,10703.7744999973,22874.824300009645,22796.667900009605,22182.62240000816,,157947.70305671426,126032.71148823242,34978.9910000279,34919.44920002833,34365.841500028735,22939.66169999593,22913.109199995502,22560.498299995736,3712098.0,,,,9812.43140000072,9927.332400002157,10286.852799999646,16459.044799999752,16644.196999999698,16241.120699999696,828.4446000001759,813.6255000000459,759.6077000000133,3911.320500000125,3894.566900000161,3727.311200000159,436211.0,431010.0,,6421.283279002895,631589.0,625146.0,,16323.111399999798,154086.49569999054,154089.2441999901,153981.02369998716,77564.50279999625,77902.08530000657,78303.27750000649,12.0,,6804426.1949999975,2140414963.4250004,745060118.6250002,27100927.485,619468.47,48.0,5228.0,-7424542.0,3550346.0,-3846138.0,-4143522.0,-5.5,,0.0,161196.75,0.0,0.0,0.0,0.0,0.0,-358.0,-113.0,-110.0,-113.0,84852318.41999997,1209982568.0850005,1363471924.9050002,19854589.68,1209982568.0850005,88012.0,-6188433.0,1414679549.0,61277228.0,303514381.0,141315505.0,316045586.0,87128.0,1415.0,245.6105909863629,2291581.0,738477.0,449264.0,-1493813.0,360811.0,2754.0,979817932.4624794,987114466.2374804,-61350010.0,-60851585.5,1093917.5,49779.5,,,,,,,,,,,,,,,,,,,,,1466490.0,14746309.0,3230051.0,8549871.0,11600372.0,1414760.0,,801514715.444995,72064699502.1746,21667457051.32512,582120589.031999,5792665.7475,689.5,94245.0,-276769158.5,21940567.0,-123721436.0,-218579750.0,-2015683.5,,,,,,,,,,,,,,,,,,,,,4270318.5,2477736.0,-8998414.0,921269.0,37582.5,3731263000.2899647,3655839584.969963,-260481667.0,-257172491.5,2524964.5,269043.5,3923906938.154955,33236664894.76591,36664257898.82264,1728408950.6175494,48056926817.11572,3985656.0,-247443684.5,103024852387.5,1053060648.5,17264106546.5,3501586328.5,18877393289.5,3669923.5,71876.0,20858.58646043572,89756330.0,-41.77545200172191,6.122000000000001,2.9129041654529564,148.31071509802118,17.832799300903,907.958197830086,45000.0,-0.9009688679024191,-0.433883739117558,0.0,0.0,0.0,0.0,0.0,0.0,1.0,0.0,0.0,0.0,0.0,0.0,0.0,1.0,0.0,0.0,0.0,0.0,1.0,0.0,1.0,0.0,0.0,0.0,0.0,1.0,0.0,0.0,0.0,0.0,0.0,0.0,0.0,0.0,0.0,0.0,0.0,0.0,0.0,0.0,0.0,0.0,1.0,0.0,0.0,0.0,0.0,0.0,0.0,0.0,0.0,0.0,0.0,0.0,0.0,0.0,0.0,0.0,0.0,0.0,0.0,0.0,0.0,0.0,0.0,0.0,0.0,0.0,0.0,0.0,0.0,0.0,0.0,0.0,0.0,0.0,0.0,0.0,0.0,0.0,0.0,0.0,0.0,0.0,0.0,0.0,0.0,0.0,0.0,0.0,1.0,0.0,0.0,0.0,0.0,0.0,0.0,0.0,0.0,0.0,0.0,0.0,0.0,0.0,0.0,0.0,0.0,0.0,0.0,1.0,1.0,0.0,0.0,0.0,0.0,0.0,0.0,1.0,0.0,0.0
101440,0,0.0,0.0,0.0,1.0,0.0,90000.0,550980.0,43659.0,450000.0,0.030755,33.86301369863013,-688.0,-1350.0,-2372.0,,2.0,2.0,2.0,11.0,0.7602553989745393,0.5913549929618737,,,,,,,,,,,,,,,,,,,,,,,,,,,,,,,,,,,,,,,,,,,,,,5.0,2.0,5.0,0.0,0.0,0.0,0.0,0.0,0.0,1.0,0.0,1.0,1.0,0.0,1.0,0.0,1.0,0.0,0.0,0.0,0.0,0.0,0.0,0.0,1.0,0.0,0.0,0.0,0.0,0.0,0.0,0.0,0.0,0.0,0.0,0.0,0.0,0.0,0.0,0.0,0.0,0.0,0.0,1.0,24853.5,,449865.0,460246.5,,0.0,0.0,0.0,-904.0,,-25.0,,30.0,-14.5,3.0,7833.8925,88155.0,98064.0,0.0,156577.5,12.0,-575.0,182334.5,-701.0,182276.5,182531.5,182280.5,12.0,0.0,0.0,-1.0,9.0,24.0,20.0,-26.0,0.0,0.0,43.0,4417.785,4417.785,-320.0,-320.0,15.0,0.0,19.0,239362.335,225000.0,0.0,1800.0,0.0,1800.0,11707.335,12037.5,11925.0,224584.47,237395.205,237395.205,0.0,2.0,0.0,2.0,8.0,-10.0,0.0,0.0,8341805695.5,184310188560.0,165505415197.5,51941631610.935,1863.0,1704.0,71124.0,70734.0,9140.0,505766.0,,,,,,,128329.0,662422.0,,,,13520143.575342068,-601533068.0,-921385960.0,-296319394.0,-1534307640.0416667,43986.0,30683.0,,,,,,,67409.08981795207,157948.29441170723,,,,,,,,3712109.0,,,,,,,,,,,,,,,,436216.0,431015.0,,6421.314034002896,631591.0,625148.0,,,,,,,,,30.0,22615666.46999999,,2151170795.4750004,748289615.6250002,,619468.47,48.0,5228.0,-7461066.0,,-3862045.0,,-14.5,24853.5,,449865.0,460246.5,,0.0,0.0,0.0,-904.0,,-25.0,,85158805.99499995,1213724036.7450006,1368240025.9050002,19873874.34,1213836536.7450006,88408.0,-6221021.0,1420520331.0,61257635.0,305143759.5,141854255.5,318042564.5,87472.0,1421.0,245.9271397567643,2294961.0,741970.0,451333.0,-1499607.0,360823.0,2766.0,982612466.2799754,989759104.8299756,-61673169.0,-61172677.0,1100206.0,49979.0,975655507.0949998,2511895500.0,80601477.75,127842282.63,5568539.4,41596520.66999999,55334269.52999994,136776085.91999897,126494334.80999972,936520919.6849984,971921646.4949976,971957918.4299976,4126.0,10231.0,79.0,6026.0,317676.0,-550354.0,210863.0,471.0,1466491.0,14746339.0,3230070.0,8549880.0,11600415.0,1414763.0,1057647082.549501,,72065149367.1746,21667917297.82512,,5792665.7475,689.5,94245.0,-276770062.5,,-123721461.0,,-2015698.0,5918260695.862461,18708648750.0,198653345.325,447625443.32999766,1948107.735,256578950.4750008,308888095.09499866,636066131.1074983,458803508.0399993,5703560475.885032,5881567091.94,5881810274.684999,13371.0,80787.5,44.0,70306.0,970839.5,-1697145.0,177364.0,6755.0,4270342.5,2477756.0,-8998440.0,921269.0,37582.5,3731267418.074965,3655844002.7549634,-260481987.0,-257172811.5,2524979.5,269043.5,3923914772.047455,33236753049.76591,36664355962.82264,1728408950.6175494,48057083394.61572,3985668.0,-247444259.5,103025034722.0,1053059947.5,17264288823.0,3501768860.0,18877575570.0,3669935.5,71876.0,20858.58646043572,89756329.0,-20.31715210355988,6.122000000000001,2.061430632859204,69.80625375928702,12.620078334364049,427.3538855143552,45000.0,-0.2225209339563143,0.9749279121818236,0.0,1.0,0.0,0.0,0.0,0.0,0.0,0.0,0.0,0.0,0.0,0.0,0.0,1.0,0.0,0.0,0.0,0.0,1.0,0.0,1.0,0.0,0.0,0.0,0.0,1.0,0.0,0.0,0.0,0.0,0.0,1.0,0.0,0.0,0.0,0.0,0.0,0.0,0.0,0.0,0.0,0.0,0.0,0.0,0.0,0.0,0.0,0.0,0.0,0.0,0.0,0.0,0.0,0.0,0.0,0.0,0.0,0.0,0.0,0.0,0.0,0.0,0.0,0.0,0.0,0.0,0.0,0.0,0.0,0.0,0.0,0.0,0.0,0.0,0.0,0.0,0.0,0.0,0.0,0.0,0.0,0.0,0.0,0.0,0.0,0.0,0.0,0.0,0.0,0.0,1.0,0.0,0.0,0.0,0.0,0.0,0.0,0.0,0.0,0.0,0.0,0.0,0.0,0.0,0.0,0.0,0.0,0.0,0.0,0.0,0.0,0.0,0.0,0.0,0.0,0.0,0.0,0.0,0.0,0.0
101448,0,0.0,0.0,0.0,1.0,0.0,112500.0,206059.5,17815.5,166500.0,0.035792,45.60821917808219,-3646.0,-75.0,-165.0,,2.0,2.0,2.0,13.0,,0.5936886166221982,,,,,,,,,,,,,,,,,,,,,,,,,,,,,,,,,,,,,,,,,,,,,,0.0,0.0,0.0,0.0,-1279.0,,,,,,,1.0,1.0,0.0,1.0,0.0,0.0,0.0,0.0,0.0,0.0,0.0,0.0,0.0,1.0,0.0,0.0,0.0,0.0,0.0,0.0,0.0,0.0,0.0,0.0,0.0,0.0,0.0,0.0,0.0,0.0,0.0,0.0,0.0,,,,,,,,,,,,,0.0,,12.0,9655.515,18135.0,15885.0,0.0,87457.5,11.0,-381.5,365243.0,-520.0,-362.0,-242.0,-359.0,15.0,0.0,0.0,-1.0,40.0,12.0,8.0,-14.5,0.0,0.0,65.0,9150.075,9150.075,-249.0,-236.0,7.0,1.0,18.0,2707.2000000000007,225000.0,0.0,7341.030000000002,0.0,24952.095,0.0,22850.3025,5411.475,2563.65,2563.65,2563.65,0.0,2.5,0.0,7.5,0.0,-9.5,0.0,0.0,8341823511.0,184310394619.5,165505581697.5,51941744110.935,,,,,,,,,,,,,128329.0,662424.0,,,,13520189.183561243,-601536714.0,-921386125.0,-296320673.0,-1534307715.0416667,43986.0,30683.0,,,,,,,,157948.88810032385,,,,,,,,3712122.0,,,,,,,,,,,,,,,,436216.0,431015.0,,6421.349826002896,631593.0,625150.0,,,,,,,,,,,,,,,,,,,,,,,,,,,,,,,,,,,85625708.46749994,1218716012.7450006,1374284317.9050002,19916795.34,1218943262.7450006,88894.0,-6261678.5,1429650231.0,61594329.0,307132009.0,143116357.0,320031338.0,88015.0,1432.0,246.7826677043692,2297945.5,747934.0,454602.0,-1513718.5,455435.0,96643.0,990757088.7299732,997086802.409975,-62019086.0,-61515738.0,1105657.0,50298.0,978687897.3,2517858000.0,81432177.75,128925585.315,5568539.4,41831950.94999999,55498997.74499995,138014517.037499,127695506.57999976,939370515.614998,974899553.8049976,974935825.739998,4163.0,10341.0,79.0,6094.0,318104.0,-551083.5,210863.0,471.0,1466491.0,14746339.0,3230088.0,8549920.0,11600480.0,1414775.0,,,,,,,,,,,,,,5918263403.062461,18708873750.0,198653345.325,447632784.3599976,1948107.735,256603902.5700008,308888095.09499866,636088981.4099983,458808919.5149993,5703563039.535031,5881569655.589997,5881812838.334999,13371.0,80790.0,44.0,70313.5,970839.5,-1697154.5,177364.0,6755.0,4270354.5,2477764.0,-8998454.5,921269.0,37582.5,3731276568.149964,3655853152.8299623,-260482236.0,-257173047.5,2524986.5,269044.5,3923924427.562455,33236771184.76591,36664371847.82264,1728408950.6175494,48057170852.11572,3985679.0,-247444641.0,103025399965.0,1053059427.5,17264288461.0,3501768618.0,18877575211.0,3669950.5,71876.0,20858.58646043572,89756328.0,-79.94173124286658,1.83164,6.314725940894165,288.0034047618224,11.566304622379391,527.5185562979444,56250.0,0.6234898018587336,0.7818314824680298,0.0,1.0,0.0,0.0,0.0,0.0,0.0,0.0,0.0,0.0,0.0,0.0,0.0,1.0,0.0,0.0,0.0,0.0,1.0,0.0,1.0,0.0,0.0,0.0,0.0,1.0,0.0,0.0,0.0,0.0,0.0,0.0,0.0,0.0,0.0,0.0,0.0,0.0,1.0,0.0,0.0,0.0,0.0,0.0,0.0,0.0,0.0,0.0,0.0,0.0,0.0,0.0,0.0,1.0,0.0,0.0,0.0,0.0,0.0,0.0,0.0,0.0,0.0,0.0,0.0,0.0,0.0,0.0,0.0,0.0,0.0,0.0,0.0,0.0,0.0,0.0,0.0,0.0,0.0,0.0,0.0,0.0,0.0,0.0,0.0,0.0,0.0,0.0,0.0,0.0,0.0,0.0,0.0,0.0,0.0,0.0,0.0,0.0,0.0,0.0,0.0,0.0,0.0,0.0,0.0,0.0,0.0,0.0,0.0,0.0,0.0,0.0,0.0,0.0,0.0,0.0,0.0,0.0,0.0,0.0
101449,0,0.0,0.0,0.0,1.0,0.0,157500.0,225000.0,17775.0,225000.0,0.028663,53.39452054794521,-2606.0,-2605.0,-3025.0,,1.0,2.0,2.0,14.0,0.5856254645708554,0.6597596968763494,0.2764406945454034,0.0361,0.0,0.9727,0.66,0.0052,0.0,0.1379,0.1042,0.2083,0.032,0.0504,0.0315,0.0,0.0101,0.0105,0.0,0.9702,0.6733,0.0052,0.0,0.1034,0.0417,0.2083,0.0146,0.0551,0.014,0.0,0.0076,0.0364,0.0,0.9727,0.6645,0.0052,0.0,0.1379,0.1042,0.2083,0.0326,0.0513,0.0321,0.0,0.0103,0.0419,1.0,0.0,0.0,0.0,0.0,0.0,0.0,0.0,0.0,0.0,1.0,1.0,1.0,1.0,0.0,1.0,1.0,0.0,0.0,0.0,0.0,0.0,0.0,0.0,0.0,1.0,0.0,0.0,0.0,0.0,0.0,0.0,0.0,0.0,0.0,0.0,0.0,0.0,0.0,0.0,0.0,0.0,0.0,0.0,11.0,0.0,0.0,108000.0,0.0,0.0,0.0,0.0,0.0,-899.0,-595.0,-562.0,-1085.0,406.0,-19.0,3.0,9108.945,128295.0,128295.0,4500.0,128295.0,24.0,-1935.0,365243.0,-1904.0,-1214.0,-1214.0,-1208.0,12.0,0.0,0.0938332201973786,364.0,59.0,24.0,9.0,-45.0,0.0,0.0,167.0,552.15,395.28,-1366.0,-1364.0,24.0,0.0,96.0,0.0,135000.0,0.0,0.0,0.0,0.0,0.0,52.785,0.0,0.0,0.0,0.0,0.0,0.0,0.0,0.0,26.0,-48.5,0.0,0.0,8341841286.0,184310619619.5,165505806697.5,51941901610.935,1863.0,1704.0,71124.0,70735.0,9140.0,505767.0,17797.404300002298,17859.520299999112,17311.26649999807,11289.264900000084,11227.095900000088,11174.61540000006,128329.0,662425.0,4136.050600000122,4133.6939000000175,3944.466900000096,13520242.578081792,-601539320.0,-921389150.0,-296320673.0,-1534310320.0416667,43986.0,30683.0,11343.339599999175,11219.259999998969,10703.7744999973,22874.96220000965,22796.80580000961,22182.72580000816,67409.67544341665,157949.5478600207,126032.98792892696,34979.0952000279,34919.55340002834,34365.883200028744,22939.869999995924,22913.317499995497,22560.70659999573,3712136.0,8290.943000000165,8395.399800000083,8119.125100000227,9812.48180000072,9927.383700002154,10286.907899999644,16459.07629999975,16644.2290999997,16241.134699999697,828.4446000001759,813.6255000000459,759.6077000000133,3911.330600000125,3894.577200000161,3727.318800000159,436216.0,431015.0,,6421.378489002896,631595.0,625152.0,,16323.153299999798,154087.46839999055,154090.2168999901,153981.99389998714,77565.16279999625,77902.74980000657,78303.95080000648,30.0,22712407.46999999,6866724.644999998,2155240765.98,749517629.6250002,27387227.789999995,619468.47,48.0,5228.0,-7494702.0,3588109.0,-3878551.0,-4186195.0,-14.5,0.0,0.0,80325.0,0.0,0.0,0.0,0.0,0.0,-1187.0,-1095.0,-989.0,-1482.0,85674532.90499993,1219708618.2450006,1375470648.4050002,19921295.34,1219708618.2450006,89000.0,-6267758.0,1431110902.0,61589217.0,307494021.0,143113827.0,320393367.0,88123.0,1432.0,246.90118886108812,2298505.0,749082.0,455323.0,-1515245.0,455438.0,96646.0,991627914.5549744,997888871.1149752,-62155877.0,-61651752.0,1108644.0,50361.0,979575382.35,2524574250.0,81472677.75,129035960.91,5568539.4,41918998.94999998,55558629.53999995,138286974.93749887,127947850.46999976,940228867.079998,975786098.1749976,975822370.1099976,4165.0,10361.0,79.0,6117.0,319276.0,-553385.5,211046.0,471.0,1466502.0,14746745.0,3230184.0,8549979.0,11600647.0,1414778.0,1057647082.549501,801514715.444995,72065257367.1746,21667917297.82512,582120589.031999,5792665.7475,689.5,94245.0,-276770961.5,21939972.0,-123722023.0,-218580835.0,-2015717.0,5918263403.062461,18709008750.0,198653345.325,447632784.3599976,1948107.735,256603902.5700008,308888095.09499866,636089034.1949981,458808919.5149993,5703563039.535031,5881569655.589997,5881812838.334999,13371.0,80790.0,44.0,70313.5,970865.5,-1697203.0,177364.0,6755.0,4270378.5,2477773.0,-8998499.5,921269.0,37582.5,3731277120.299965,3655853548.1099634,-260483602.0,-257174411.5,2525010.5,269044.5,3923933536.507455,33236899479.76591,36664500142.82264,1728413450.6175494,48057299147.11572,3985703.0,-247446576.0,103025765208.0,1053057523.5,17264287247.0,3501767404.0,18877574003.0,3669962.5,71876.0,20858.680293655914,89756692.0,-48.806506234286005,1.4285714285714286,8.860759493670884,473.1160048552106,12.658227848101266,675.8800069360152,157500.0,-0.9009688679024191,0.4338837391175582,0.0,0.0,0.0,0.0,0.0,0.0,1.0,0.0,0.0,0.0,0.0,0.0,0.0,1.0,0.0,0.0,0.0,0.0,1.0,0.0,0.0,0.0,0.0,1.0,0.0,1.0,0.0,0.0,0.0,0.0,0.0,0.0,0.0,0.0,0.0,0.0,0.0,0.0,0.0,0.0,0.0,1.0,0.0,0.0,0.0,0.0,0.0,0.0,0.0,0.0,0.0,0.0,0.0,0.0,0.0,0.0,0.0,0.0,0.0,0.0,0.0,0.0,0.0,0.0,0.0,0.0,0.0,0.0,0.0,0.0,0.0,0.0,0.0,0.0,0.0,0.0,0.0,0.0,0.0,0.0,0.0,0.0,0.0,0.0,0.0,0.0,0.0,1.0,0.0,0.0,0.0,0.0,0.0,0.0,0.0,0.0,0.0,0.0,0.0,0.0,0.0,0.0,0.0,0.0,0.0,0.0,0.0,1.0,0.0,0.0,1.0,0.0,0.0,0.0,0.0,0.0,0.0,0.0,0.0,1.0
101465,0,0.0,0.0,0.0,0.0,0.0,202500.0,135000.0,14175.0,135000.0,0.028663,27.189041095890413,-1270.0,-2563.0,-2564.0,,1.0,2.0,2.0,10.0,0.3670380909445617,0.6713870508068898,0.3876253444214701,0.1021,0.1901,0.9891,0.8164,0.0296,0.02,0.0517,0.25,0.375,0.0643,0.1202,0.0997,0.0,0.0451,0.0578,0.0637,0.9866,0.8236,0.0299,0.0,0.0345,0.1667,0.375,0.0658,0.1313,0.0961,0.0,0.0,0.1031,0.1901,0.9891,0.8189,0.0298,0.02,0.0517,0.25,0.375,0.0654,0.1223,0.1014,0.0,0.046,0.091,1.0,6.0,4.0,6.0,4.0,-2293.0,0.0,0.0,0.0,0.0,0.0,1.0,1.0,1.0,0.0,1.0,1.0,0.0,0.0,0.0,0.0,0.0,1.0,1.0,0.0,1.0,0.0,0.0,0.0,0.0,0.0,0.0,0.0,0.0,0.0,0.0,0.0,0.0,0.0,0.0,0.0,0.0,0.0,0.0,8.0,0.0,0.0,85236.75,0.0,0.0,0.0,0.0,0.0,-1563.5,-1106.0,-1040.5,-1227.0,406.0,-25.0,8.0,12837.33,48388.5,58941.0,3487.5,62427.6,11.0,-775.5,365243.0,-1214.0,-1003.0,-1003.0,-981.0,13.5,0.0,0.1089921194382153,3.5,49.0,12.0,5.0,-40.0,0.0,0.0,91.0,5489.235,5489.235,-552.0,-547.0,9.0,0.0,19.0,568358.595,765000.0,9000.0,22500.0,0.0,0.0,28742.49,31586.1525,31567.005,554599.53,567013.095,567013.095,1.0,1.0,0.0,0.0,9.0,-10.0,0.0,0.0,8341855461.0,184310754619.5,165505941697.5,51942104110.935,1863.0,1704.0,71124.0,70735.0,9140.0,505768.0,17797.506400002298,17859.623399999113,17311.32429999807,11289.455000000084,11227.286000000087,11174.67910000006,128329.0,662426.0,4136.080200000122,4133.723700000017,3944.496800000096,13520269.767122887,-601540590.0,-921391714.0,-296322966.0,-1534312883.0416667,43990.0,30687.0,11343.359599999178,11219.279999998971,10703.7744999973,22875.01390000965,22796.85750000961,22182.76030000816,67410.0424815076,157950.2192470715,126033.3755542714,34979.3452000279,34919.80340002834,34366.049900028745,22940.244999995924,22913.692499995497,22561.08159999573,3712146.0,8291.007300000165,8395.465200000082,8119.19090000023,9812.60200000072,9927.506000002157,10287.039199999645,16459.175999999752,16644.330499999698,16241.230799999696,828.4446000001759,813.6255000000459,759.6077000000133,3911.375700000125,3894.623200000161,3727.318800000159,436222.0,431021.0,,6421.407152002896,631597.0,625154.0,,16323.244299999797,154088.45749999062,154091.2059999901,153982.98049998714,77565.97919999625,77903.56870000657,78304.77440000647,52.0,23015387.24999999,6970166.009999998,2177297064.405,757102510.9800003,27530708.04,619468.47,48.0,5228.0,-7570253.5,3568375.5,-3917042.5,-4232570.5,-25.5,0.0,0.0,82723.5,0.0,0.0,0.0,0.0,0.0,-1601.0,-1349.0,-1224.0,-1227.0,86655648.66749993,1234374254.2350006,1392298909.1550002,20095745.58,1234422642.7350006,89890.0,-6321252.0,1446084277.0,61907656.0,309651939.0,144181593.0,323647863.0,88996.0,1447.0,249.1512681723273,2313312.5,759021.0,461166.0,-1532699.0,455469.0,96670.0,1011051275.3099712,1016590237.739972,-63332236.0,-62820587.0,1173150.0,50924.0,1012250606.850001,2576403000.0,85046577.75,133721140.04999998,5625126.9,42973690.58999999,57747544.28999995,143993215.93499887,133383591.76499964,971549402.8049988,1008396291.5099984,1008432563.4449984,4361.0,10609.0,82.0,6166.0,333231.0,-566007.0,211507.0,473.0,1466510.0,14747151.0,3230203.0,8550028.0,11600738.0,1414786.0,1057647082.549501,801514715.444995,72065342603.9246,21667917297.82512,582120589.031999,5792665.7475,689.5,94245.0,-276772525.0,21938866.0,-123723063.5,-218582062.0,-2015742.0,5918831761.657461,18709773750.0,198662345.325,447655284.3599976,1948107.735,256603902.5700008,308916837.58499867,636120620.3474983,458840486.51999927,5704117639.065031,5882136668.684999,5882379851.429999,13372.0,80791.0,44.0,70313.5,970874.5,-1697213.0,177364.0,6755.0,4270390.5,2477778.0,-8998539.5,921269.0,37582.5,3731282609.534965,3655859037.344963,-260484154.0,-257174958.5,2525019.5,269044.5,3923946373.837455,33236947868.26591,36664559083.82264,1728416938.1175494,48057361574.715706,3985714.0,-247447351.5,103026130451.0,1053056309.5,17264286244.0,3501766401.0,18877573022.0,3669976.0,71876.0,20858.78928577536,89756695.5,-46.70999596936719,0.6666666666666666,14.285714285714285,388.4148727984344,9.523809523809524,258.9432485322896,202500.0,0.6234898018587336,0.7818314824680298,0.0,0.0,0.0,0.0,0.0,0.0,1.0,0.0,0.0,0.0,0.0,0.0,0.0,1.0,0.0,1.0,0.0,0.0,0.0,0.0,0.0,0.0,1.0,0.0,0.0,1.0,0.0,0.0,0.0,0.0,0.0,0.0,0.0,1.0,0.0,0.0,0.0,0.0,0.0,0.0,0.0,0.0,0.0,0.0,0.0,0.0,0.0,0.0,0.0,0.0,1.0,0.0,0.0,0.0,0.0,0.0,0.0,0.0,0.0,0.0,0.0,0.0,0.0,0.0,0.0,0.0,0.0,0.0,0.0,0.0,0.0,0.0,0.0,0.0,0.0,0.0,0.0,0.0,0.0,0.0,0.0,0.0,0.0,0.0,0.0,0.0,0.0,0.0,0.0,0.0,0.0,0.0,0.0,0.0,0.0,0.0,0.0,0.0,0.0,0.0,0.0,0.0,0.0,0.0,0.0,0.0,0.0,0.0,1.0,0.0,1.0,0.0,0.0,0.0,0.0,0.0,0.0,0.0,1.0,0.0
101467,0,0.0,1.0,1.0,1.0,2.0,103500.0,218938.5,22563.0,189000.0,0.01885,46.11506849315069,-882.0,-9289.0,-385.0,16.0,4.0,2.0,2.0,15.0,,0.6548734590431866,0.8406665596573005,0.1278,0.058,0.9816,0.7484,,0.08,0.0345,0.625,0.0417,,,0.0741,,0.0178,0.1303,0.0601,0.9816,0.7583,,0.0806,0.0345,0.625,0.0417,,,0.0772,,0.0189,0.1291,0.058,0.9816,0.7518,,0.08,0.0345,0.625,0.0417,,,0.0754,,0.0182,0.0953,1.0,0.0,0.0,0.0,0.0,-360.0,0.0,0.0,0.0,0.0,0.0,0.0,1.0,1.0,0.0,1.0,1.0,0.0,0.0,0.0,0.0,0.0,0.0,0.0,0.0,1.0,0.0,0.0,0.0,0.0,0.0,0.0,0.0,0.0,0.0,0.0,0.0,0.0,0.0,0.0,0.0,0.0,0.0,0.0,1.0,,,270000.0,,,0.0,0.0,0.0,-2593.0,-1863.0,-2226.0,-2229.0,86.0,-42.5,3.0,6800.3325,45000.0,45000.0,4500.0,76835.25,6.0,-360.0,365243.0,182456.5,365243.0,182621.5,365243.0,16.0,0.5,0.0409525046661242,1326.0,11.0,12.0,7.0,-7.0,0.0,0.0,11.0,11350.665,11350.665,-189.0,-180.0,6.0,1.0,11.0,0.0,225000.0,,0.0,,,0.0,,0.0,0.0,0.0,0.0,,0.0,,,0.0,-7.0,0.0,0.0,8341878024.0,184310973558.0,165506130697.5,51942207610.935,1863.0,1704.0,71124.0,70735.0,9140.0,505768.0,17797.634200002296,17859.752499999107,17311.45459999807,11289.513000000085,11227.344000000088,11174.739200000062,128331.0,662430.0,,,,13520315.882191382,-601541472.0,-921392099.0,-296323326.0,-1534322172.0416667,43990.0,30687.0,11343.439599999178,11219.359999998973,10703.8550999973,22875.048400009648,22796.892000009608,22182.794800008163,,157950.87412053056,126034.21622083106,34979.9702000279,34920.42840002834,34366.674900028745,22940.28669999593,22913.734199995502,22561.123299995736,3712161.0,,,,,,,16459.25009999975,16644.4058999997,16241.307999999695,,,,3911.393500000125,3894.641400000161,3727.337700000159,436222.0,431021.0,1262385.0,6421.426002002895,631599.0,625156.0,,16323.3395999998,154089.43909999062,154092.1875999901,153983.96209998714,77566.72759999624,77904.32050000658,78305.53270000649,86.0,,,2178587655.405,,,619468.47,48.0,5228.0,-7581675.0,3597866.0,-3923511.0,-4240044.0,-42.5,,,270000.0,,,0.0,0.0,0.0,-2593.0,-1863.0,-2226.0,-2229.0,86693337.38249993,1234791868.185001,1392707439.4050002,20108456.28,1234846203.435001,89939.0,-6327589.0,1448093113.5,62270108.0,310564264.5,144546294.0,324560203.5,89105.0,1447.5,249.355651181808,2314884.0,759439.0,461413.0,-1533693.0,455509.0,96675.0,1011668031.584972,1017179275.1849724,-63383936.0,-62871827.0,1173842.0,50979.0,1017392391.810001,2584638000.0,,134049917.025,,,58009200.74999996,,133676834.66999964,976560306.2549988,1013521930.4699984,1013558202.4049984,,10631.0,,,333316.0,-566138.0,211507.0,473.0,1466511.0,14747237.0,3230214.0,8550039.0,11600749.0,1414789.0,,,72065612603.9246,,,5792665.7475,689.5,94245.0,-276775118.0,21937003.0,-123725289.5,-218584291.0,-2015784.5,5918831761.657461,18709998750.0,,447655284.3599976,,,308916837.58499867,,458840486.51999927,5704117639.065031,5882136668.684999,5882379851.429999,,80791.0,,,970874.5,-1697220.0,177364.0,6755.0,4270402.5,2477785.0,-8998546.5,921269.0,37582.5,3731293960.199965,3655870388.009964,-260484343.0,-257175138.5,2525025.5,269045.5,3923953174.169955,33236992868.26591,36664604083.82264,1728421438.1175494,48057438409.965706,3985720.0,-247447711.5,103026495694.0,1053238766.0,17264651487.0,3501949022.5,18877938265.0,3669992.0,71876.5,20858.83023828002,89758021.5,-19.12606939163498,2.1153478260869565,4.587155963302751,211.53701143647103,9.703430394894298,447.4743572790706,25875.0,0.6234898018587336,0.7818314824680298,0.0,0.0,0.0,0.0,0.0,0.0,1.0,0.0,0.0,0.0,0.0,0.0,0.0,1.0,0.0,0.0,0.0,0.0,1.0,0.0,1.0,0.0,0.0,0.0,0.0,1.0,0.0,0.0,0.0,0.0,0.0,0.0,0.0,0.0,1.0,0.0,0.0,0.0,0.0,0.0,0.0,0.0,0.0,0.0,0.0,0.0,0.0,0.0,0.0,0.0,0.0,0.0,0.0,0.0,0.0,0.0,0.0,0.0,0.0,1.0,0.0,0.0,0.0,0.0,0.0,0.0,0.0,0.0,0.0,0.0,0.0,0.0,0.0,0.0,0.0,0.0,0.0,0.0,0.0,0.0,0.0,0.0,0.0,0.0,0.0,0.0,0.0,0.0,0.0,0.0,0.0,0.0,0.0,0.0,0.0,0.0,0.0,0.0,0.0,0.0,0.0,0.0,0.0,0.0,0.0,0.0,0.0,0.0,0.0,1.0,1.0,0.0,0.0,0.0,0.0,0.0,0.0,1.0,0.0,0.0
101472,0,0.0,1.0,0.0,0.0,0.0,135000.0,119893.5,13041.0,103500.0,0.00733,25.0054794520548,-612.0,-8448.0,-1703.0,,2.0,2.0,2.0,13.0,,0.5969233193130189,0.4400578303966329,,,,,,,,,,,,,,,,,,,,,,,,,,,,,,,,,,,,,,,,,,,,,6.0,0.0,5.0,0.0,0.0,0.0,0.0,0.0,1.0,0.0,4.0,1.0,1.0,0.0,1.0,0.0,0.0,0.0,0.0,0.0,0.0,0.0,0.0,0.0,1.0,0.0,0.0,0.0,0.0,0.0,0.0,0.0,0.0,0.0,0.0,0.0,0.0,0.0,0.0,0.0,0.0,0.0,0.0,3.0,,0.0,53012.61,0.0,0.0,0.0,0.0,0.0,-761.0,-547.0,-325.0,-328.0,90.0,-18.0,6.0,8070.165,24747.75,27362.25,4432.5,63000.0,12.0,-372.0,365243.0,-729.0,-399.0,-399.0,-395.0,13.0,0.0,0.0449792262245092,-1.0,33.0,12.0,7.0,-22.0,0.0,0.0,30.0,8070.165,8070.165,-664.0,-654.0,5.0,1.0,0.0,,,,,,,,,,,,,,,,,,,,,8341891065.0,184311093451.5,165506234197.5,51942342610.935,1863.0,1704.0,71125.0,70735.0,9140.0,505772.0,,,,,,,128331.0,662432.0,,,,13520340.887670835,-601542084.0,-921393802.0,-296323326.0,-1534330620.0416667,43990.0,30687.0,,,,,,,,157951.47104384983,126034.65627866144,,,,,,,3712174.0,,,,,,,,,,,,,,,,436228.0,431026.0,,6421.433332002895,631601.0,625158.0,,,,,,,,,25.0,,6970166.009999998,2183217021.675,757631471.3550003,27530708.04,619468.47,48.0,5228.0,-7611877.0,3582410.0,-3940725.0,-4258022.0,-13.0,,0.0,0.0,0.0,0.0,0.0,0.0,0.0,-1698.0,-1070.0,-325.0,-328.0,87019735.22999994,1240785008.685001,1399553482.9050002,20126321.28,1240834504.185001,90391.0,-6345329.0,1453021106.0,62255241.0,312199619.0,145275423.0,326195634.0,89509.5,1455.0,249.860264463532,2319889.5,764027.0,464992.0,-1537240.0,455509.0,96675.0,1018902947.91747,1024834041.8774704,-63695063.0,-63181471.5,1187904.5,51193.5,,,,,,,,,,,,,,,,,,,,,1466514.0,14747327.0,3230214.0,8550072.0,11600779.0,1414795.0,,801514715.444995,72065665616.5346,21667917297.82512,582120589.031999,5792665.7475,689.5,94245.0,-276775879.0,21936456.0,-123725614.5,-218584619.0,-2015802.5,,,,,,,,,,,,,,,,,,,,,4270414.5,2477792.0,-8998568.5,921269.0,37582.5,3731302030.364965,3655878458.174964,-260485007.0,-257175792.5,2525030.5,269046.5,3923961244.3349543,33237017616.01591,36664631446.07264,1728425870.6175494,48057501409.965706,3985732.0,-247448083.5,103026860937.0,1053238037.0,17264651088.0,3501948623.5,18877937870.0,3670005.0,71876.5,20858.875217506247,89758020.5,-24.47463569628575,0.8881,10.351966873706004,258.85589494880736,9.193581780538302,229.88992030403583,67500.0,-0.2225209339563143,0.9749279121818236,0.0,0.0,0.0,0.0,0.0,0.0,1.0,0.0,0.0,0.0,0.0,0.0,0.0,1.0,0.0,0.0,0.0,0.0,1.0,1.0,0.0,0.0,0.0,0.0,0.0,1.0,0.0,0.0,0.0,0.0,0.0,0.0,0.0,0.0,0.0,0.0,0.0,0.0,1.0,0.0,0.0,0.0,0.0,0.0,0.0,0.0,0.0,0.0,0.0,0.0,0.0,0.0,0.0,0.0,0.0,0.0,0.0,0.0,0.0,0.0,0.0,0.0,0.0,0.0,0.0,0.0,0.0,0.0,0.0,0.0,0.0,0.0,0.0,0.0,0.0,0.0,0.0,0.0,0.0,0.0,0.0,0.0,0.0,0.0,0.0,0.0,0.0,0.0,0.0,0.0,1.0,0.0,0.0,0.0,0.0,0.0,0.0,0.0,0.0,0.0,0.0,0.0,0.0,0.0,0.0,0.0,0.0,0.0,0.0,0.0,0.0,0.0,0.0,0.0,0.0,0.0,0.0,0.0,0.0,0.0
101478,0,0.0,1.0,0.0,1.0,0.0,206100.0,237024.0,12231.0,180000.0,0.025164,63.3013698630137,,-1174.0,-5320.0,,2.0,2.0,2.0,12.0,,0.2491999129638328,0.2735646775174348,0.1392,0.044,0.9995,,,0.04,0.0345,0.625,,0.0126,,0.1305,,0.032,0.1418,0.0457,0.9995,,,0.0403,0.0345,0.625,,0.0129,,0.136,,0.0339,0.1405,0.044,0.9995,,,0.04,0.0345,0.625,,0.0128,,0.1329,,0.0327,0.1096,1.0,0.0,0.0,0.0,0.0,-343.0,0.0,0.0,0.0,0.0,0.0,7.0,1.0,0.0,0.0,1.0,0.0,1.0,0.0,0.0,0.0,0.0,0.0,0.0,0.0,0.0,0.0,0.0,1.0,0.0,0.0,0.0,0.0,0.0,0.0,0.0,0.0,0.0,0.0,0.0,0.0,0.0,0.0,0.0,8.0,6921.0,4140.0,450000.0,0.0,0.0,0.0,0.0,0.0,-2091.0,-548.0,-905.0,-1121.5,463.0,-30.0,21.0,19125.0,135000.0,160879.5,0.0,382500.0,36.0,-343.0,365243.0,-1324.5,-964.5,-45.0,-954.5,10.0,0.5,0.0,-1.0,95.0,36.0,25.0,-45.0,0.0,0.0,132.0,17151.975,17151.975,-935.0,-922.0,9.0,1.0,12.0,286501.2075,382500.0,83250.0,101706.0075,0.0,5578.2,14515.8975,121500.0,92650.8375,279482.8725,281724.4575,281724.4575,4.0,5.0,0.0,1.0,4.5,-6.5,0.0,0.0,8341903296.0,184311330475.5,165506414197.5,51942548710.935,1863.0,1704.0,71125.0,70735.0,9140.0,505779.0,17797.773400002294,17859.892999999112,17311.59639999807,11289.557000000084,11227.388000000088,11174.78490000006,128331.0,662434.0,,,,13520404.189040694,,-921399122.0,-296323669.0,-1534331794.0416667,43990.0,30687.0,11343.479599999177,11219.399999998972,10703.8953999973,22875.08290000965,22796.92650000961,22182.829300008165,,157951.72024376286,126034.92984333896,34980.5952000279,34921.05340002834,34367.299900028745,,,,3712186.0,8291.019900000165,8395.478000000083,8119.203800000227,,,,16459.38059999975,16644.5387999997,16241.443999999694,,,,3911.425500000125,3894.674100000161,3727.371600000158,436228.0,431026.0,,6421.458496002895,631603.0,625160.0,,16323.4491999998,154090.4385999906,154093.18709999011,153984.96159998715,,,,69.0,23092638.74999999,6974306.009999998,2188481553.2250004,758952032.3550003,27530708.04,619468.47,48.0,5228.0,-7634964.5,3576003.5,-3949261.5,-4271170.0,-34.0,13842.0,8280.0,450000.0,0.0,0.0,0.0,0.0,0.0,-2091.0,-548.0,-905.0,-1338.0,87675760.34999995,1249952642.685001,1409687068.9050002,20277377.28,1249952642.685001,90859.0,-6367750.0,1458316627.5,62241130.5,313648841.5,145997342.5,327645090.5,89973.0,1460.5,250.82761579020573,2327393.0,767689.0,466979.0,-1547255.0,658284.0,96684.0,1026183687.1199694,1031784805.9349698,-63815982.0,-63301200.5,1189635.5,51335.5,1028433942.7650012,2603436750.0,87473427.75,136453278.55499998,5625126.9,43425229.09499999,58663733.57999993,146470134.28499886,135684293.3099996,987087518.0549992,1024512069.0374992,1024548340.972499,4460.0,10820.5,82.0,6281.0,336977.0,-570084.5,211520.0,486.0,1466522.0,14747790.0,3230226.0,8550167.0,11600911.0,1414816.0,1057654003.549501,801518855.444995,72066115616.5346,21667917297.82512,582120589.031999,5792665.7475,689.5,94245.0,-276777970.0,21935908.0,-123726519.5,-218585740.5,-2015832.5,5919118262.864962,18710381250.0,198745595.325,447756990.3674977,1948107.735,256609480.7700008,308931353.48249865,636242120.3474983,458933137.3574992,5704397121.937531,5882418393.142499,5882661575.8875,13376.0,80796.0,44.0,70314.5,970879.0,-1697226.5,177364.0,6755.0,4270450.5,2477817.0,-8998613.5,921269.0,37582.5,3731319182.339965,3655895610.1499634,-260485942.0,-257176714.5,2525039.5,269047.5,3923980369.3349543,33237152616.01591,36664792325.57264,1728425870.6175494,48057883909.965706,3985768.0,-247448426.5,103027226180.0,1053236712.5,17264650123.5,3501948578.5,18877936915.5,3670015.0,71877.0,20858.875217506247,89758019.5,,1.1500436681222708,16.850625459896982,1066.6676746600542,19.37895511405445,1226.7144052335018,103050.0,-0.2225209339563143,0.9749279121818236,0.0,0.0,0.0,0.0,0.0,0.0,1.0,0.0,0.0,1.0,0.0,0.0,0.0,0.0,0.0,0.0,0.0,0.0,1.0,0.0,1.0,0.0,0.0,0.0,0.0,1.0,0.0,0.0,0.0,0.0,0.0,0.0,0.0,0.0,0.0,0.0,0.0,0.0,0.0,0.0,0.0,0.0,0.0,0.0,0.0,0.0,0.0,0.0,0.0,0.0,0.0,0.0,0.0,0.0,0.0,0.0,0.0,0.0,0.0,0.0,0.0,0.0,0.0,0.0,0.0,0.0,0.0,0.0,0.0,0.0,0.0,0.0,0.0,0.0,0.0,0.0,0.0,0.0,0.0,0.0,0.0,0.0,0.0,0.0,0.0,0.0,0.0,0.0,0.0,0.0,0.0,0.0,0.0,0.0,0.0,0.0,0.0,0.0,0.0,0.0,0.0,0.0,0.0,0.0,0.0,1.0,1.0,0.0,0.0,0.0,1.0,0.0,0.0,0.0,1.0,0.0,0.0,0.0,0.0,0.0
101497,0,0.0,0.0,1.0,0.0,0.0,247500.0,929088.0,37431.0,720000.0,0.020713,52.11780821917807,-3203.0,-2079.0,-2551.0,10.0,1.0,3.0,1.0,10.0,,0.4736867130526337,0.4812493411434029,0.0588,0.0,0.9717,0.6124,0.0101,0.0,0.1379,0.2083,0.0,0.0436,0.0471,0.0651,0.0039,0.1908,0.0599,0.0,0.9717,0.6276,0.0102,0.0,0.1379,0.2083,0.0,0.0446,0.0514,0.0679,0.0039,0.202,0.0593,0.0,0.9717,0.6176,0.0101,0.0,0.1379,0.2083,0.0,0.0444,0.0479,0.0663,0.0039,0.1948,0.0982,1.0,2.0,1.0,2.0,0.0,-1821.0,0.0,0.0,0.0,0.0,2.0,2.0,1.0,1.0,0.0,1.0,0.0,0.0,0.0,0.0,0.0,0.0,0.0,0.0,0.0,1.0,0.0,0.0,0.0,0.0,0.0,0.0,0.0,0.0,0.0,0.0,0.0,0.0,0.0,0.0,0.0,0.0,0.0,0.0,5.0,16929.0,0.0,526491.0,324585.0,0.0,0.0,0.0,0.0,-693.0,544.0,-162.0,-838.5,171.0,-18.0,4.0,12081.285,157916.25,170529.75,17847.0,196857.0,24.0,-1078.0,365243.0,-1326.0,-756.0,-636.0,-751.0,11.0,0.0,0.1334982087916719,57.5,46.0,24.0,16.5,-31.5,0.0,0.0,43.0,12081.285,12081.285,-970.0,-936.0,8.0,1.0,0.0,,,,,,,,,,,,,,,,,,,,,8341940727.0,184312259563.5,165507134197.5,51942796210.935,1863.0,1704.0,71125.0,70737.0,9140.0,505781.0,17797.832200002296,17859.95229999911,17311.65629999807,11289.557000000084,11227.388000000088,11174.78490000006,128331.0,662435.0,4136.090300000124,4133.733800000017,3944.507000000095,13520456.306848915,-601545287.0,-921401673.0,-296325490.0,-1534333873.0416667,43991.0,30687.0,11343.479599999177,11219.399999998972,10703.8953999973,22875.220800009647,22797.06440000961,22182.96720000817,,157952.19393047589,126035.4110926801,34980.8035000279,34921.26170002833,34367.508200028744,22940.28669999593,22913.734199995502,22561.123299995736,3712196.0,8291.063500000166,8395.522400000084,8119.24840000023,9812.64910000072,9927.553900002154,10287.090599999645,16459.44569999975,16644.6050999997,16241.511899999694,828.4485000001761,813.629400000046,759.6116000000133,3911.616300000125,3894.868900000162,3727.573600000159,436230.0,431028.0,1262395.0,6421.479209002896,631606.0,625161.0,,16323.5473999998,154091.41029999062,154094.1587999901,153985.93329998714,77567.33999999624,77904.93810000658,78306.16030000651,23.0,23543556.34499999,7114347.449999997,2223470520.8100004,774489050.1900003,27827966.475,619468.47,48.0,5228.0,-7748507.0,3543599.0,-4008351.0,-4340106.5,-11.0,16929.0,0.0,450000.0,0.0,0.0,0.0,0.0,0.0,-1519.0,-423.0,-560.0,-1509.0,88822565.63999996,1265055299.9550006,1425976362.4050002,20591333.55,1265153728.4550006,92067.0,-6447981.0,1474567620.0,62192663.0,318729752.0,147803934.0,333091691.0,91103.5,1480.0,254.010381145395,2354117.0,777422.0,473687.5,-1562016.0,658289.0,96689.0,1040816817.7649696,1046655308.9699712,-64465594.0,-63943594.0,1202064.0,51902.0,,,,,,,,,,,,,,,,,,,,,1466527.0,14747961.0,3230226.0,8550213.0,11600954.0,1414820.0,1057670932.549501,801518855.444995,72066642107.5346,21668241882.82512,582120589.031999,5792665.7475,689.5,94245.0,-276778663.0,21936452.0,-123726681.5,-218586579.0,-2015850.5,,,,,,,,,,,,,,,,,,,,,4270474.5,2477833.5,-8998645.0,921269.0,37582.5,3731331263.624964,3655907691.434962,-260486912.0,-257177650.5,2525047.5,269048.5,3923992450.6199546,33237310532.26591,36664962855.32264,1728443717.6175494,48058080766.965706,3985792.0,-247449504.5,103027591423.0,1053235386.5,17264649367.5,3501947942.5,18877936164.5,3670026.0,71877.0,20859.00871571504,89758077.0,-61.45692056983652,3.753890909090909,6.612166386150517,344.6116196266884,24.82135128636692,1293.63442608372,247500.0,0.6234898018587336,0.7818314824680298,0.0,0.0,0.0,0.0,0.0,0.0,1.0,0.0,0.0,0.0,0.0,0.0,0.0,1.0,0.0,0.0,0.0,0.0,1.0,0.0,0.0,1.0,0.0,0.0,0.0,1.0,0.0,0.0,0.0,0.0,0.0,0.0,0.0,0.0,0.0,0.0,0.0,0.0,0.0,0.0,0.0,0.0,0.0,0.0,0.0,0.0,0.0,0.0,0.0,0.0,0.0,0.0,0.0,0.0,0.0,0.0,0.0,0.0,0.0,0.0,0.0,0.0,0.0,0.0,0.0,0.0,0.0,0.0,0.0,0.0,0.0,0.0,0.0,0.0,0.0,0.0,0.0,0.0,1.0,0.0,0.0,0.0,0.0,0.0,0.0,0.0,0.0,0.0,0.0,0.0,0.0,0.0,0.0,0.0,0.0,0.0,0.0,0.0,0.0,0.0,0.0,0.0,0.0,0.0,0.0,0.0,0.0,0.0,1.0,0.0,1.0,0.0,0.0,0.0,0.0,0.0,0.0,0.0,1.0,0.0
101504,0,0.0,0.0,0.0,1.0,0.0,270000.0,2013840.0,62640.0,1800000.0,0.0228,53.89863013698629,-349.0,-569.0,-3208.0,,2.0,2.0,2.0,8.0,0.7460798771251209,0.4872394538314295,0.1419915427739129,0.1536,0.052,0.9985,0.9796,,0.1332,0.0572,0.625,0.6667,0.0436,0.1208,0.081,0.0206,0.0383,0.0987,0.0361,0.9985,0.9804,,0.1611,0.069,0.625,0.6667,0.0268,0.0826,0.0508,0.0233,0.0228,0.1624,0.0574,0.9985,0.9799,,0.16,0.069,0.625,0.6667,0.0528,0.1283,0.0938,0.0233,0.044,0.2066,1.0,2.0,2.0,2.0,2.0,-2154.0,0.0,0.0,0.0,0.0,1.0,3.0,1.0,1.0,0.0,1.0,1.0,0.0,0.0,0.0,0.0,0.0,0.0,0.0,0.0,1.0,0.0,0.0,0.0,0.0,0.0,0.0,0.0,0.0,0.0,0.0,0.0,0.0,0.0,0.0,0.0,0.0,0.0,0.0,13.0,0.0,0.0,183240.0,0.0,0.0,0.0,0.0,0.0,-1701.0,-59.0,-599.0,-1418.0,708.0,-31.0,13.0,39066.84,90805.5,96358.5,10201.5,452250.0,12.0,-298.0,365243.0,-945.0,-615.0,-615.0,-610.0,11.0,1.0,0.1042638974201473,-1.0,54.0,12.0,6.0,-24.5,0.0,0.0,53.0,19647.495,19647.495,-768.0,-765.0,6.0,1.0,0.0,,,,,,,,,,,,,,,,,,,,,8342003367.0,184314273403.5,165508934197.5,51943066210.935,1863.0,1704.0,71125.0,70738.0,9140.0,505784.0,17797.985800002298,17860.114699999114,17311.75499999807,11289.609000000082,11227.445400000088,11174.821000000062,128331.0,662437.0,,,,13520510.205479052,-601545636.0,-921404881.0,-296327644.0,-1534334442.0416667,43993.0,30689.0,11343.61279999918,11219.559999998972,10704.0564999973,22875.27800000965,22797.13340000961,22183.03620000817,67410.78856138473,157952.6811699297,126035.55308422285,34981.4285000279,34921.88670002833,34368.133200028744,22940.953399995928,22914.400899995504,22561.789999995737,3712204.0,8291.107100000167,8395.575200000083,8119.275200000228,9812.76990000072,9927.682200002157,10287.173199999645,16459.526699999748,16644.698899999694,16241.562699999697,828.4691000001759,813.6527000000459,759.6349000000133,3911.654600000125,3894.912900000161,3727.59640000016,436232.0,431030.0,,6421.502009002896,631608.0,625163.0,,16323.7539999998,154092.40879999058,154095.1572999901,153986.93179998716,77568.31959999625,77905.91800000657,78307.14070000651,56.0,24629845.09499999,7127489.474999998,2232475578.0900006,778006565.1900003,27827966.475,619468.47,48.0,5228.0,-7785774.0,3538039.5,-4025629.0,-4362173.0,-27.5,0.0,0.0,183240.0,0.0,0.0,0.0,0.0,0.0,-2250.0,-59.0,-1164.0,-1701.0,89714298.41999999,1273894189.6950006,1435819342.9050002,20670415.29,1274366689.6950006,92692.0,-6506467.0,1485887802.0,62878060.0,320519663.0,148867628.0,335247934.0,91768.0,1498.0,255.18592509020596,2358974.0,782108.0,476570.5,-1575546.5,658347.0,96747.0,1049914272.50997,1056326698.889972,-65032123.0,-64506321.0,1210970.0,52300.0,,,,,,,,,,,,,,,,,,,,,1466540.0,14748669.0,3230226.0,8550267.0,11601007.0,1414833.0,1057670932.549501,801518855.444995,72066825347.5346,21668241882.82512,582120589.031999,5792665.7475,689.5,94245.0,-276780364.0,21936393.0,-123727280.5,-218587997.0,-2015881.5,,,,,,,,,,,,,,,,,,,,,4270486.5,2477839.5,-8998669.5,921269.0,37582.5,3731350911.119964,3655927338.9299626,-260487680.0,-257178415.5,2525053.5,269049.5,3924031517.4599543,33237401337.76591,36665059213.82264,1728453919.1175494,48058533016.965706,3985804.0,-247449802.5,103027956666.0,1053234441.5,17264648752.5,3501947327.5,18877935554.5,3670037.0,71878.0,20859.11297961246,89758076.0,-6.475118182280282,7.458666666666668,4.310344827586206,232.321681624941,32.14942528735632,1732.809982679893,135000.0,1.0,0.0,0.0,0.0,0.0,0.0,0.0,0.0,0.0,0.0,1.0,0.0,0.0,0.0,0.0,0.0,0.0,0.0,0.0,0.0,1.0,0.0,1.0,0.0,0.0,0.0,0.0,1.0,0.0,0.0,0.0,0.0,0.0,0.0,0.0,0.0,0.0,1.0,0.0,0.0,0.0,0.0,0.0,0.0,0.0,0.0,0.0,0.0,0.0,0.0,0.0,0.0,0.0,0.0,0.0,0.0,0.0,0.0,0.0,0.0,0.0,0.0,0.0,1.0,0.0,0.0,0.0,0.0,0.0,0.0,0.0,0.0,0.0,0.0,0.0,0.0,0.0,0.0,0.0,0.0,0.0,0.0,0.0,0.0,0.0,0.0,0.0,0.0,0.0,0.0,0.0,0.0,0.0,0.0,0.0,0.0,0.0,0.0,0.0,0.0,0.0,0.0,0.0,0.0,0.0,0.0,0.0,0.0,1.0,0.0,0.0,0.0,1.0,0.0,0.0,0.0,0.0,1.0,0.0,0.0,0.0,0.0
101547,0,0.0,0.0,0.0,0.0,0.0,112500.0,537471.0,58014.0,495000.0,0.00496,28.98356164383561,-3536.0,-6055.0,-2507.0,,2.0,2.0,2.0,12.0,0.4757882492890989,0.7651411548580364,,,,,,,,,,,,,,,,,,,,,,,,,,,,,,,,,,,,,,,,,,,,,,0.0,0.0,0.0,0.0,-646.0,,,,,,,1.0,1.0,0.0,1.0,0.0,0.0,0.0,0.0,0.0,0.0,0.0,0.0,0.0,1.0,0.0,0.0,0.0,0.0,0.0,0.0,0.0,0.0,0.0,0.0,0.0,0.0,0.0,0.0,0.0,0.0,0.0,0.0,0.0,,,,,,,,,,,,,0.0,,4.0,16881.48,80145.0,85032.0,0.0,86040.0,8.0,-378.0,365243.0,-351.0,-134.0,-134.0,-131.0,13.0,0.0,0.0,155.0,37.0,20.0,5.5,-10.0,0.0,0.0,34.0,18980.64,18980.64,-293.0,-282.5,6.0,1.0,0.0,,,,,,,,,,,,,,,,,,,,,8342061381.0,184314810874.5,165509429197.5,51943178710.935,,,,,,,,,,,,,128331.0,662439.0,,,,13520539.189040694,-601549172.0,-921407388.0,-296328290.0,-1534340497.0416667,43993.0,30689.0,,,,,,,67411.264349634,157953.44631108458,,,,,,,,3712216.0,,,,,,,,,,,,,,,,436232.0,431030.0,,6421.506969002896,631610.0,625165.0,,,,,,,,,,,,,,,,,,,,,,,,,,,,,,,,,,,92855463.02999993,1327021090.7400007,1496034945.4050002,21311791.335,1327021090.7400007,96362.0,-6664682.0,1527155810.0,64960000.0,331400354.0,152840387.0,346495673.0,94517.5,1541.0,261.3264492466521,2403576.5,807910.0,493930.5,-1612892.0,658548.0,96824.0,1087181856.8099818,1095522814.5299866,-66892000.0,-66348983.5,1260174.5,53729.5,,,,,,,,,,,,,,,,,,,,,1466540.0,14748669.0,3230226.0,8550304.0,11601041.0,1414837.0,,,,,,,,,,,,,,,,,,,,,,,,,,,,,,,,,,4270506.5,2477845.0,-8998679.5,921269.0,37582.5,3731369891.759964,3655946319.5699625,-260487973.0,-257178698.0,2525059.5,269050.5,3924048398.9399543,33237481482.76591,36665144245.82264,1728453919.1175494,48058619056.965706,3985812.0,-247450180.5,103028321909.0,1053234090.5,17264648618.5,3501947193.5,18877935423.5,3670050.0,71878.0,20859.11297961246,89758231.0,-122.0001890537858,4.77752,1.9391870927707104,56.20454864225026,9.264505119453926,268.5183552293235,56250.0,-0.9009688679024191,-0.433883739117558,0.0,0.0,0.0,0.0,0.0,0.0,1.0,0.0,0.0,0.0,0.0,0.0,0.0,1.0,0.0,1.0,0.0,0.0,0.0,0.0,1.0,0.0,0.0,0.0,0.0,1.0,0.0,0.0,0.0,0.0,0.0,0.0,0.0,0.0,0.0,0.0,0.0,0.0,0.0,0.0,0.0,0.0,0.0,0.0,1.0,0.0,0.0,0.0,0.0,0.0,0.0,0.0,0.0,1.0,0.0,0.0,0.0,0.0,0.0,0.0,0.0,0.0,0.0,0.0,0.0,0.0,0.0,0.0,0.0,0.0,0.0,0.0,0.0,0.0,0.0,0.0,0.0,0.0,0.0,0.0,0.0,0.0,0.0,0.0,0.0,0.0,0.0,0.0,0.0,0.0,0.0,0.0,0.0,0.0,0.0,0.0,0.0,0.0,0.0,0.0,0.0,0.0,0.0,0.0,0.0,0.0,0.0,0.0,0.0,0.0,0.0,0.0,0.0,0.0,0.0,0.0,0.0,0.0,0.0,0.0
101548,0,0.0,0.0,0.0,1.0,2.0,103500.0,407520.0,29655.0,360000.0,0.035792,31.78904109589041,-2929.0,-5917.0,-197.0,,4.0,2.0,2.0,11.0,0.21597693036539,0.7310566535195546,0.3723336657058204,,,,,,,,,,,,,,,,,,,,,,,,,,,,,,,,,,,,,,,,,,,,,0.0,0.0,0.0,0.0,-1453.0,0.0,0.0,0.0,0.0,1.0,1.0,1.0,1.0,1.0,1.0,1.0,0.0,0.0,0.0,0.0,0.0,1.0,1.0,0.0,1.0,0.0,0.0,0.0,0.0,0.0,0.0,0.0,0.0,0.0,0.0,0.0,0.0,0.0,0.0,0.0,0.0,0.0,0.0,1.0,13050.0,0.0,229500.0,203422.14,26077.86,0.0,0.0,0.0,-225.0,1590.0,-5.0,,8.0,-3.5,11.0,10292.535,59130.0,53055.0,0.0,96700.5,12.0,-500.0,365243.0,-758.5,-443.5,-428.5,-435.5,13.0,0.0,0.0,40.0,68.0,12.0,7.0,-23.5,0.0,0.0,68.0,9946.665,9482.94,-653.0,-653.5,6.0,1.0,0.0,,,,,,,,,,,,,,,,,,,,,8342091036.0,184315218394.5,165509789197.5,51943282210.935,1863.0,1704.0,71125.0,70739.0,9140.0,505785.0,,,,,,,128333.0,662443.0,,,,13520570.978081793,-601552101.0,-921407585.0,-296329743.0,-1534346414.0416667,43993.0,30689.0,,,,,,,67411.48032656437,157954.1773677381,126035.92541788856,,,,,,,3712227.0,,,,,,,,,,,,,,,,436232.0,431030.0,,6421.542761002896,631612.0,625167.0,,,,,,,,,8.0,25120820.744999982,7254506.744999997,2288805949.575001,801192805.9200004,28798655.535000004,619544.9249999999,50.0,8516.0,-7965216.0,3621372.0,-4119501.0,,-3.5,13050.0,0.0,229500.0,203422.14,26077.86,0.0,0.0,0.0,-225.0,1590.0,-5.0,,92937585.05999994,1327788322.7400007,1496870248.9050002,21317866.335,1327729192.7400007,96412.0,-6669820.0,1528799403.5,64956806.5,331399237.5,152838558.5,346494571.0,94621.0,1542.0,261.4383421482711,2404696.0,808531.0,494224.0,-1614095.5,658548.0,96824.0,1088237555.0999827,1096706597.7599876,-66919713.0,-66376323.5,1260588.5,53787.5,,,,,,,,,,,,,,,,,,,,,1466541.0,14748677.0,3230226.0,8550372.0,11601109.0,1414848.0,1057683982.549501,801518855.444995,72067054847.5346,21668445304.96512,582146666.891999,5792665.7475,689.5,94245.0,-276780589.0,21937983.0,-123727285.5,,-2015885.0,,,,,,,,,,,,,,,,,,,,,4270518.5,2477852.0,-8998703.0,921269.0,37582.5,3731379838.424964,3655955802.5099626,-260488626.0,-257179351.5,2525065.5,269051.5,3924058691.4749546,33237540612.76591,36665197300.82264,1728453919.1175494,48058715757.465706,3985824.0,-247450680.5,103028687152.0,1053233332.0,17264648175.0,3501946765.0,18877934988.0,3670063.0,71878.0,20859.11297961246,89758271.0,-92.13867103335345,3.9373913043478255,3.4901365705614573,110.94809487184816,13.742033383915029,436.8460639823726,25875.0,-0.9009688679024191,-0.433883739117558,0.0,0.0,0.0,0.0,0.0,0.0,1.0,0.0,0.0,0.0,0.0,0.0,0.0,1.0,0.0,1.0,0.0,0.0,0.0,0.0,1.0,0.0,0.0,0.0,0.0,0.0,0.0,0.0,0.0,1.0,0.0,0.0,0.0,0.0,0.0,0.0,0.0,0.0,1.0,0.0,0.0,0.0,0.0,0.0,0.0,0.0,0.0,0.0,0.0,0.0,0.0,0.0,0.0,1.0,0.0,0.0,0.0,0.0,0.0,0.0,0.0,0.0,0.0,0.0,0.0,0.0,0.0,0.0,0.0,0.0,0.0,0.0,0.0,0.0,0.0,0.0,0.0,0.0,0.0,0.0,0.0,0.0,0.0,0.0,0.0,0.0,0.0,0.0,0.0,0.0,0.0,0.0,0.0,0.0,0.0,0.0,0.0,0.0,0.0,0.0,0.0,0.0,0.0,0.0,0.0,0.0,0.0,0.0,0.0,0.0,0.0,0.0,0.0,0.0,0.0,0.0,0.0,0.0,0.0,0.0
101555,0,0.0,0.0,1.0,1.0,0.0,135000.0,103500.0,10998.0,103500.0,0.018801,55.54520547945207,-1874.0,-4281.0,-2371.0,13.0,2.0,2.0,2.0,13.0,0.5787321071751633,0.5254719476957936,0.059629657546692,0.1536,0.0,0.9762,,,0.0,0.069,0.1667,,0.0,,0.0771,,0.0145,0.1565,0.0,0.9762,,,0.0,0.069,0.1667,,0.0,,0.0803,,0.0153,0.1551,0.0,0.9762,,,0.0,0.069,0.1667,,0.0,,0.0784,,0.0148,0.0637,1.0,0.0,0.0,0.0,0.0,-276.0,0.0,0.0,0.0,0.0,1.0,0.0,1.0,1.0,0.0,1.0,0.0,0.0,0.0,0.0,0.0,0.0,1.0,1.0,0.0,0.0,0.0,0.0,1.0,0.0,0.0,0.0,0.0,0.0,0.0,0.0,0.0,0.0,0.0,0.0,0.0,0.0,0.0,0.0,16.0,5566.14,0.0,118656.0,12836.25,0.0,0.0,0.0,0.0,-963.5,-195.5,-393.5,-546.0,571.0,-21.0,1.0,2819.115,27933.75,27931.5,2.25,27933.75,12.0,-201.0,365243.0,-163.0,-73.0,167.0,365243.0,7.0,0.0,8.77237945300772e-05,120.0,5.0,12.0,10.5,-5.0,0.0,0.0,4.0,2819.115,2819.115,-168.5,-118.0,2.5,1.0,0.0,,,,,,,,,,,,,,,,,,,,,8342102034.0,184315321894.5,165509892697.5,51943417210.935,1863.0,1704.0,71125.0,70740.0,9140.0,505785.0,17798.1394000023,17860.269799999114,17311.91149999807,11289.609000000082,11227.445400000088,11174.821000000062,128333.0,662445.0,,,,13520626.523287272,-601553975.0,-921409956.0,-296330019.0,-1534350695.0416667,43993.0,30689.0,11343.61279999918,11219.559999998972,10704.0564999973,22875.34700000965,22797.20240000961,22183.105200008165,67412.05905867153,157954.7028396858,126035.98504754611,34981.5952000279,34922.05340002834,34368.299900028745,,,,3712240.0,8291.107100000167,8395.575200000083,8119.275200000228,,,,16459.603799999746,16644.777299999696,16241.642999999694,,,,3911.669100000125,3894.927700000161,3727.611700000159,436232.0,431030.0,1262408.0,6421.561562002896,631614.0,625169.0,,16323.8176999998,154093.38499999058,154096.1334999901,153987.90799998716,,,,32.5,25217935.244999982,7279411.139999998,2301080983.200001,805237913.1375005,28907703.135000005,619544.9249999999,50.0,8516.0,-8012490.0,3693756.0,-4136839.5,-4479345.0,-15.75,59314.5,0.0,114444.0,0.0,0.0,0.0,0.0,0.0,-1671.0,-575.0,-527.0,-553.0,93123436.72499992,1329510191.4900007,1499242126.9050002,21337479.585,1329510191.4900007,96718.0,-6689038.0,1534459404.0,64940192.0,332482333.0,153196949.0,347943089.0,94914.0,1547.0,262.0466303950484,2408580.0,811368.0,496218.5,-1619510.0,658591.0,96852.0,1091330958.352486,1099512421.2674894,-67146874.0,-66602461.5,1265171.5,53966.5,,,,,,,,,,,,,,,,,,,,,1466557.0,14749248.0,3230226.0,8550377.0,11601113.0,1414849.0,1057689548.6895008,801518855.444995,72067173503.5346,21668458141.21512,582146666.891999,5792665.7475,689.5,94245.0,-276781552.5,21937787.5,-123727679.0,-218588543.0,-2015906.0,,,,,,,,,,,,,,,,,,,,,4270530.5,2477862.5,-8998708.0,921269.0,37582.5,3731382657.539964,3655958621.624962,-260488794.5,-257179469.5,2525068.0,269052.5,3924061510.589955,33237568546.51591,36665225232.32264,1728453921.3675494,48058743691.215706,3985836.0,-247450881.5,103029052395.0,1053233169.0,17264648102.0,3501946932.0,18878300231.0,3670070.0,71878.0,20859.113067336253,89758391.0,-33.73828548880339,0.7666666666666667,12.274959083469724,681.8151245431923,9.410801963993451,522.7249288164473,67500.0,0.6234898018587336,0.7818314824680298,0.0,0.0,0.0,0.0,0.0,0.0,1.0,0.0,0.0,0.0,0.0,0.0,0.0,1.0,0.0,1.0,0.0,0.0,0.0,0.0,1.0,0.0,0.0,0.0,0.0,1.0,0.0,0.0,0.0,0.0,0.0,0.0,0.0,0.0,0.0,0.0,0.0,0.0,1.0,0.0,0.0,0.0,0.0,0.0,0.0,0.0,0.0,0.0,0.0,0.0,0.0,1.0,0.0,0.0,0.0,0.0,0.0,0.0,0.0,0.0,0.0,0.0,0.0,0.0,0.0,0.0,0.0,0.0,0.0,0.0,0.0,0.0,0.0,0.0,0.0,0.0,0.0,0.0,0.0,0.0,0.0,0.0,0.0,0.0,0.0,0.0,0.0,0.0,0.0,0.0,0.0,0.0,0.0,0.0,0.0,0.0,0.0,0.0,0.0,0.0,0.0,0.0,0.0,0.0,0.0,0.0,0.0,0.0,0.0,0.0,0.0,1.0,0.0,0.0,0.0,0.0,0.0,0.0,1.0,0.0
101570,0,0.0,0.0,0.0,0.0,1.0,112500.0,900000.0,29034.0,900000.0,0.00963,41.44109589041096,-354.0,-8284.0,-4924.0,,3.0,2.0,2.0,7.0,0.6608461773238364,0.5032929070729277,0.7662336700704004,,,,,,,,,,,,,,,,,,,,,,,,,,,,,,,,,,,,,,,,,,,,,0.0,0.0,0.0,0.0,-758.0,0.0,0.0,0.0,0.0,0.0,2.0,1.0,1.0,0.0,1.0,0.0,0.0,0.0,0.0,0.0,0.0,1.0,1.0,0.0,1.0,0.0,0.0,0.0,0.0,0.0,0.0,0.0,0.0,0.0,0.0,0.0,0.0,0.0,0.0,0.0,0.0,0.0,0.0,3.0,6176.25,,90000.0,0.0,0.0,0.0,0.0,0.0,-1111.0,102.0,-93.0,-1829.0,170.0,-28.0,1.0,17705.025,101925.0,96574.5,10192.5,101925.0,6.0,-758.0,365243.0,-727.0,-607.0,-577.0,-594.0,10.0,0.0,0.1039699447479941,288.0,7.0,6.0,3.0,-22.0,0.0,0.0,6.0,17705.025,17709.975,-661.0,-652.0,3.5,1.0,0.0,,,,,,,,,,,,,,,,,,,,,8342131068.0,184316221894.5,165510792697.5,51943529710.935,1863.0,1704.0,71125.0,70740.0,9140.0,505787.0,,,,,,,128334.0,662448.0,,,,13520667.964383164,-601554329.0,-921414880.0,-296330777.0,-1534358979.0416667,43993.0,30689.0,,,,,,,67412.71990484888,157955.20613259287,126036.7512812162,,,,,,,3712247.0,,,,,,,,,,,,,,,,436232.0,431030.0,,6421.571192002895,631616.0,625171.0,,,,,,,,,37.0,25290357.119999982,,2319697673.145001,813267680.9400005,29187092.02500001,619544.9249999999,50.0,8516.0,-8108410.0,3684567.0,-4191262.0,-4535814.0,-18.0,49.5,,90000.0,0.0,0.0,0.0,0.0,0.0,-2919.0,-1092.0,-1086.0,-1829.0,93882759.47999991,1338965097.1200008,1509856326.4050002,21601247.715,1338965097.1200008,97324.0,-6728033.0,1545779117.0,66010566.0,335752630.0,155010324.0,351580109.0,95872.0,1557.0,264.16495701709016,2434229.0,815497.0,498653.0,-1626249.0,658591.0,96852.0,1097678282.6249874,1105820543.9474893,-67523173.5,-66974562.5,1275697.0,54388.0,,,,,,,,,,,,,,,,,,,,,1466560.0,14749418.0,3230226.0,8550384.0,11601119.0,1414850.0,1057695724.9395008,,72067263503.5346,21668458141.21512,582146666.891999,5792665.7475,689.5,94245.0,-276782663.5,21937889.5,-123727772.0,-218590372.0,-2015934.0,,,,,,,,,,,,,,,,,,,,,4270536.5,2477865.5,-8998730.0,921269.0,37582.5,3731400362.564964,3655976331.5999618,-260489455.5,-257180121.5,2525071.5,269053.5,3924079215.6149545,33237670471.51591,36665321806.82264,1728464113.8675494,48058845616.215706,3985842.0,-247451639.5,103029417638.0,1053232442.0,17264647495.0,3501946355.0,18878299637.0,3670080.0,71878.0,20859.217037281,89758679.0,-8.542245140817139,8.0,3.874767513949163,160.5746120986165,30.998140111593305,1284.5968967889326,37500.0,0.6234898018587336,0.7818314824680298,0.0,0.0,0.0,0.0,0.0,0.0,1.0,0.0,0.0,0.0,0.0,0.0,0.0,1.0,0.0,0.0,0.0,0.0,1.0,0.0,1.0,0.0,0.0,0.0,0.0,1.0,0.0,0.0,0.0,0.0,0.0,0.0,0.0,0.0,0.0,0.0,0.0,0.0,0.0,0.0,1.0,0.0,0.0,0.0,0.0,0.0,0.0,0.0,0.0,0.0,0.0,0.0,0.0,0.0,0.0,0.0,0.0,0.0,0.0,0.0,0.0,0.0,0.0,0.0,0.0,0.0,0.0,0.0,0.0,0.0,0.0,0.0,0.0,0.0,0.0,0.0,0.0,0.0,0.0,0.0,0.0,0.0,0.0,1.0,0.0,0.0,0.0,0.0,0.0,0.0,0.0,0.0,0.0,0.0,0.0,0.0,0.0,0.0,0.0,0.0,0.0,0.0,0.0,0.0,0.0,0.0,0.0,0.0,0.0,0.0,0.0,0.0,0.0,0.0,0.0,0.0,0.0,0.0,0.0,0.0
101572,0,0.0,0.0,0.0,1.0,0.0,189000.0,276277.5,16902.0,238500.0,0.02461,47.55616438356165,-3347.0,-5373.0,-887.0,,2.0,2.0,2.0,11.0,,0.4159926105676352,,0.0742,0.0449,0.9861,0.8096,0.0,0.08,0.069,0.3333,0.375,0.01,0.0605,0.0443,0.0,0.1131,0.0756,0.0466,0.9861,0.8171,0.0,0.0806,0.069,0.3333,0.375,0.0102,0.0661,0.0462,0.0,0.1197,0.0749,0.0449,0.9861,0.8121,0.0,0.08,0.069,0.3333,0.375,0.0102,0.0616,0.0451,0.0,0.1155,0.0595,1.0,0.0,0.0,0.0,0.0,-559.0,,,,,,,1.0,1.0,0.0,1.0,1.0,0.0,0.0,0.0,0.0,0.0,0.0,0.0,0.0,1.0,0.0,0.0,0.0,0.0,0.0,0.0,0.0,0.0,0.0,0.0,0.0,0.0,0.0,0.0,0.0,0.0,0.0,0.0,0.0,,,,,,,,,,,,,0.0,,2.0,12778.6275,198319.5,198319.5,0.0,198319.5,18.0,-904.5,365243.0,-872.5,182177.0,-362.5,182180.0,15.5,0.0,0.0,2025.0,31.0,24.0,11.0,-16.0,0.0,0.0,31.0,9751.095,9751.095,-449.0,-436.0,8.0,1.0,0.0,,,,,,,,,,,,,,,,,,,,,8342147970.0,184316498172.0,165511031197.5,51943718710.935,,,,,,,17798.2136000023,17860.344699999114,17311.98709999807,11289.653900000085,11227.490300000089,11174.86760000006,128334.0,662450.0,4136.090300000124,4133.733800000017,3944.507000000095,13520715.520547545,-601557676.0,-921415767.0,-296331336.0,-1534364352.0416667,43993.0,30689.0,11343.69279999918,11219.639999998972,10704.1370999973,22875.41600000965,22797.27140000961,22183.174200008165,,157955.62212520346,,34981.9285000279,34922.38670002833,34368.633200028744,22941.328399995928,22914.775899995504,22562.164999995737,3712258.0,8291.117100000167,8395.585400000084,8119.285400000228,9812.83040000072,9927.743800002156,10287.239299999645,16459.648099999748,16644.822399999695,16241.689199999695,828.4691000001759,813.6527000000459,759.6349000000133,3911.782200000125,3895.043200000161,3727.7314000001593,436232.0,431030.0,,6421.595802002896,631618.0,625173.0,,16323.8771999998,154094.37109999062,154097.1195999901,153988.89409998714,77569.12919999624,77906.73010000658,78307.95780000651,,,,,,,,,,,,,,,,,,,,,,,,,,,93944074.63499992,1339614915.1200008,1510633390.9050002,21697277.715,1339614915.1200008,97396.0,-6737281.0,1548153196.5,66368079.5,336476977.5,155369832.5,352304486.5,95961.0,1559.0,265.20049676356547,2436406.0,816297.0,499143.0,-1628458.0,658591.0,96852.0,1098215670.1499903,1106407036.304992,-67587335.0,-67038181.0,1276057.0,54453.0,,,,,,,,,,,,,,,,,,,,,1466560.0,14749418.0,3230226.0,8550415.0,11601150.0,1414852.0,,,,,,,,,,,,,,,,,,,,,,,,,,,,,,,,,,4270560.5,2477876.5,-8998746.0,921269.0,37582.5,3731410113.659964,3655986082.6949615,-260489904.5,-257180557.5,2525079.5,269054.5,3924091994.242455,33237868791.01591,36665520126.32264,1728464113.8675494,48059043935.715706,3985860.0,-247452544.0,103029782881.0,1053231569.5,17264829672.0,3501945992.5,18878481817.0,3670095.5,71878.0,20859.217037281,89760704.0,-70.3799400852633,1.4617857142857142,11.182108626198085,531.7781959823187,16.345846645367413,777.3457700555823,94500.0,0.6234898018587336,0.7818314824680298,0.0,0.0,0.0,0.0,0.0,0.0,1.0,0.0,1.0,0.0,0.0,0.0,0.0,0.0,0.0,0.0,0.0,0.0,1.0,0.0,1.0,0.0,0.0,0.0,0.0,0.0,0.0,1.0,0.0,0.0,0.0,0.0,0.0,0.0,0.0,0.0,1.0,0.0,0.0,0.0,0.0,0.0,0.0,0.0,0.0,0.0,0.0,0.0,0.0,0.0,0.0,0.0,0.0,0.0,0.0,0.0,0.0,0.0,0.0,1.0,0.0,0.0,0.0,0.0,0.0,0.0,0.0,0.0,0.0,0.0,0.0,0.0,0.0,0.0,0.0,0.0,0.0,0.0,0.0,0.0,0.0,0.0,0.0,0.0,0.0,0.0,0.0,0.0,0.0,0.0,0.0,0.0,0.0,0.0,0.0,0.0,0.0,0.0,0.0,0.0,0.0,0.0,0.0,0.0,0.0,0.0,0.0,1.0,0.0,0.0,1.0,0.0,0.0,0.0,0.0,0.0,0.0,1.0,0.0,0.0
101578,0,1.0,0.0,0.0,1.0,0.0,153747.0,135000.0,6750.0,135000.0,0.0084739999999999,39.0027397260274,-102.0,-308.0,-840.0,,2.0,2.0,2.0,11.0,0.4966283870388136,0.6823390268310672,0.41534714488434,,,,,,,,,,,,,,,,,,,,,,,,,,,,,,,,,,,,,,,,,,,,,0.0,0.0,0.0,0.0,0.0,0.0,0.0,0.0,0.0,0.0,0.0,1.0,1.0,1.0,1.0,0.0,0.0,1.0,1.0,0.0,1.0,1.0,0.0,0.0,0.0,0.0,0.0,0.0,0.0,0.0,0.0,0.0,1.0,0.0,0.0,0.0,0.0,0.0,0.0,0.0,0.0,0.0,0.0,3.0,0.0,587.07,158175.0,0.0,0.0,0.0,0.0,0.0,-276.0,-93.0,-88.0,-242.0,40.0,-7.5,0.0,,,,,,,,,,,,,,,,,0.0,,,,,,0.0,,,,,,,0.0,,,,,,,,,,,,,,,,,,,,,8342154720.0,184316633172.0,165511166197.5,51943872457.935,1863.0,1704.0,71125.0,70740.0,9140.0,505787.0,,,,,,,128334.0,662452.0,,,,13520754.523287272,-601557778.0,-921416607.0,-296331336.0,-1534364660.0416667,43993.0,30689.0,,,,,,,67413.21653323591,157956.30446423026,126037.16662836108,,,,,,,3712269.0,,,,,,,,,,,,,,,,436232.0,431030.0,,6421.604276002896,631620.0,625175.0,,,,,,,,,10.0,25310008.619999982,7452237.869999997,2325459033.4950013,814976893.1250005,29328438.42000001,619544.9249999999,50.0,8516.0,-8139483.0,3707380.0,-4206846.0,-4549764.0,-4.5,0.0,0.0,158175.0,0.0,0.0,0.0,0.0,0.0,-762.0,-396.0,-394.0,-396.0,,,,,,,,,,,,,,,,,,,,,,,,,,,,,,,,,,,,,,,,,,,,,,,,1466563.0,14749458.0,3230226.0,8550415.0,11601150.0,1414852.0,1057695724.9395008,801519442.5149951,72067421678.5346,21668458141.21512,582146666.891999,5792665.7475,689.5,94245.0,-276782939.5,21937796.5,-123727860.0,-218590614.0,-2015941.5,,,,,,,,,,,,,,,,,,,,,,,,,,,,,,,,,,,,,,,,,,,,,,,,-2.615200899128969,0.8780659134812386,22.77733333333333,888.3784036529681,20.0,780.0547945205481,76873.5,-0.9009688679024191,0.4338837391175582,0.0,0.0,0.0,0.0,0.0,0.0,1.0,0.0,1.0,0.0,0.0,0.0,0.0,0.0,0.0,1.0,0.0,0.0,0.0,0.0,1.0,0.0,0.0,0.0,0.0,1.0,0.0,0.0,0.0,0.0,0.0,0.0,0.0,0.0,0.0,0.0,0.0,0.0,0.0,0.0,0.0,0.0,0.0,0.0,1.0,0.0,0.0,0.0,0.0,0.0,0.0,0.0,0.0,0.0,0.0,0.0,0.0,0.0,0.0,0.0,0.0,0.0,0.0,0.0,0.0,0.0,0.0,0.0,0.0,0.0,0.0,0.0,0.0,0.0,0.0,0.0,0.0,0.0,0.0,0.0,0.0,0.0,0.0,0.0,0.0,0.0,0.0,0.0,0.0,0.0,1.0,0.0,0.0,0.0,0.0,0.0,0.0,0.0,0.0,0.0,0.0,0.0,0.0,0.0,0.0,0.0,0.0,0.0,0.0,0.0,0.0,0.0,0.0,0.0,0.0,0.0,0.0,0.0,0.0,0.0
101580,0,0.0,0.0,0.0,1.0,0.0,117000.0,330804.0,14035.5,202500.0,0.031329,54.76438356164383,-205.0,-1714.0,-3036.0,,2.0,2.0,2.0,11.0,0.1895251840498086,0.1793154655583073,0.5082869913916046,0.0186,0.0417,0.9861,0.8096,0.0025,0.0,0.1034,0.0417,0.0833,0.0162,0.0151,0.0173,0.0,0.033,0.0189,0.0433,0.9861,0.8171,0.0025,0.0,0.1034,0.0417,0.0833,0.0165,0.0165,0.018,0.0,0.0349,0.0187,0.0417,0.9861,0.8121,0.0025,0.0,0.1034,0.0417,0.0833,0.0164,0.0154,0.0176,0.0,0.0337,0.015,1.0,0.0,0.0,0.0,0.0,-373.0,0.0,0.0,0.0,0.0,1.0,0.0,1.0,1.0,0.0,1.0,0.0,1.0,0.0,0.0,0.0,0.0,1.0,1.0,0.0,1.0,0.0,0.0,0.0,0.0,0.0,0.0,0.0,0.0,0.0,0.0,0.0,0.0,0.0,0.0,0.0,0.0,0.0,0.0,4.0,0.0,,25704.0,224511.75,0.0,0.0,0.0,0.0,-1349.5,-1259.0,-1194.0,-1197.0,174.0,-21.5,3.0,14027.31,129015.0,142641.0,0.0,129015.0,12.0,-373.0,365243.0,-334.0,-64.0,-64.0,-57.0,14.0,0.0,0.0,200.0,28.0,12.0,6.5,-8.5,0.0,0.0,27.0,14027.31,14027.31,-250.0,-244.0,5.0,1.0,0.0,,,,,,,,,,,,,,,,,,,,,8342168755.5,184316963976.0,165511368697.5,51943989457.935,1863.0,1704.0,71125.0,70741.0,9140.0,505787.0,17798.232200002298,17860.363399999114,17312.00599999807,11289.695600000085,11227.532000000088,11174.91090000006,128334.0,662454.0,4136.092800000122,4133.736300000017,3944.509500000095,13520809.287670836,-601557983.0,-921419643.0,-296331709.0,-1534366374.0416667,43993.0,30689.0,11343.69279999918,11219.639999998972,10704.1370999973,22875.51940000965,22797.37480000961,22183.277600008165,67413.40605841996,157956.48377969582,126037.67491535249,34981.9702000279,34922.42840002834,34368.674900028745,22941.41169999593,22914.859199995502,22562.248299995736,3712280.0,8291.133300000167,8395.601800000084,8119.301900000229,9812.84550000072,9927.759200002156,10287.255799999644,16459.665399999747,16644.839999999695,16241.707199999695,828.4691000001759,813.6527000000459,759.6349000000133,3911.815200000125,3895.076900000161,3727.76630000016,436232.0,431030.0,,6421.635605002895,631622.0,625177.0,,16323.892199999797,154095.3571999906,154098.10569999012,153989.88019998718,77569.93879999622,77907.54220000657,78308.77490000651,45.0,25326082.619999982,,2326539138.885001,815312370.1950005,29328438.42000001,619544.9249999999,50.0,8516.0,-8145051.0,3704358.0,-4210814.0,-4554147.0,-22.0,0.0,,18409.5,0.0,0.0,0.0,0.0,0.0,-1350.0,-1259.0,-1194.0,-1197.0,94268226.46499991,1344715728.2550008,1516154553.5400002,21750301.215,1344715728.2550008,97876.0,-6767736.0,1554910017.0,67081519.0,339385424.0,156454879.0,354847571.0,96588.0,1563.0,266.029702928524,2448830.0,818362.0,500460.5,-1632904.5,658591.0,96852.0,1100598401.8799934,1109056974.2099955,-67710827.0,-67159600.0,1276957.0,54620.0,,,,,,,,,,,,,,,,,,,,,1466567.0,14749632.0,3230226.0,8550443.0,11601177.0,1414855.0,1057695724.9395008,,72067447382.5346,21668682652.96512,582146666.891999,5792665.7475,689.5,94245.0,-276784289.0,21936537.5,-123729054.0,-218591811.0,-2015963.0,,,,,,,,,,,,,,,,,,,,,4270572.5,2477883.0,-8998754.5,921269.0,37582.5,3731424140.969964,3656000110.0049615,-260490154.5,-257180801.5,2525084.5,269055.5,3924106021.5524554,33237997806.01591,36665662767.32264,1728464113.8675494,48059172950.715706,3985872.0,-247452917.0,103030148124.0,1053231235.5,17264829608.0,3501945928.5,18878481760.0,3670109.5,71878.0,20859.217037281,89760904.0,-3.743308819850918,2.827384615384615,8.33600512984931,456.51618230289824,23.56909265790317,1290.7468305173331,58500.0,1.0,0.0,0.0,1.0,0.0,0.0,0.0,0.0,0.0,0.0,1.0,0.0,0.0,0.0,0.0,0.0,0.0,0.0,0.0,0.0,1.0,1.0,0.0,0.0,0.0,0.0,0.0,1.0,0.0,0.0,0.0,0.0,0.0,0.0,0.0,0.0,0.0,0.0,0.0,0.0,1.0,0.0,0.0,0.0,0.0,0.0,0.0,0.0,0.0,0.0,0.0,0.0,0.0,0.0,0.0,0.0,0.0,0.0,0.0,0.0,0.0,0.0,0.0,0.0,0.0,0.0,0.0,0.0,0.0,0.0,0.0,0.0,0.0,0.0,0.0,0.0,0.0,0.0,0.0,0.0,0.0,0.0,0.0,0.0,0.0,0.0,0.0,0.0,0.0,0.0,0.0,0.0,1.0,0.0,0.0,0.0,0.0,0.0,0.0,0.0,0.0,0.0,0.0,0.0,0.0,0.0,0.0,0.0,0.0,0.0,0.0,1.0,1.0,0.0,0.0,0.0,0.0,0.0,0.0,0.0,1.0,0.0
101588,0,0.0,0.0,1.0,1.0,3.0,90000.0,769527.0,32733.0,612000.0,0.020246,35.69041095890411,-443.0,-3735.0,-4914.0,15.0,5.0,3.0,3.0,6.0,0.3422086159458189,0.5189083209607123,0.2650494299443805,,,,,,,,,,,,,,,,,,,,,,,,,,,,,,,,,,,,,,,,,,,,,0.0,0.0,0.0,0.0,-1765.0,0.0,0.0,0.0,0.0,0.0,1.0,1.0,1.0,0.0,1.0,0.0,1.0,0.0,0.0,0.0,0.0,0.0,0.0,0.0,1.0,0.0,0.0,0.0,0.0,0.0,0.0,0.0,0.0,0.0,0.0,0.0,0.0,0.0,0.0,0.0,0.0,0.0,0.0,5.0,10071.0,4423.6575,105583.5,0.0,0.0,0.0,0.0,0.0,-360.0,-114.0,-114.0,-732.5,135.0,-23.0,2.0,6339.825,56828.025,53480.25,7424.775,56828.025,10.0,-1975.5,365243.0,-1939.5,-1699.5,-1669.5,-1694.5,11.5,0.0,0.1562069190565783,735.0,20.0,10.0,5.0,-57.5,0.0,0.0,25.0,8892.63,3787.02,-1673.0,-1674.0,5.0,1.0,0.0,,,,,,,,,,,,,,,,,,,,,8342201488.5,184317733503.0,165511980697.5,51944079457.935,1863.0,1704.0,71125.0,70741.0,9140.0,505788.0,,,,,,,128337.0,662459.0,,,,13520844.978081793,-601558426.0,-921424557.0,-296333474.0,-1534370109.0416667,43993.0,30689.0,,,,,,,67413.7482670359,157957.00268801677,126037.93996478242,,,,,,,3712286.0,,,,,,,,,,,,,,,,436232.0,431030.0,1262423.0,6421.655851002895,631625.0,625180.0,,,,,,,,,12.0,25336153.619999982,7493336.527499997,2331982899.585001,816798517.3800005,29428276.905000005,619544.9249999999,50.0,8516.0,-8160169.0,3701369.0,-4219737.0,-4562678.5,-5.5,0.0,8847.315,42547.5,0.0,0.0,0.0,0.0,0.0,-1430.0,-1351.0,-1351.0,-1940.0,94565143.43999992,1347302913.0300007,1518883794.5400002,21980201.489999995,1347302913.0300007,98107.0,-6784076.5,1560204754.5,67067103.0,341200768.0,156811833.0,356662970.0,96914.5,1568.0,267.5834097694437,2456215.0,819610.0,501333.5,-1636104.5,658591.0,96852.0,1102644963.1799989,1111084022.9250016,-68025820.0,-67472962.0,1288660.0,54732.0,,,,,,,,,,,,,,,,,,,,,1466572.0,14749767.0,3230226.0,8550463.0,11601202.0,1414857.0,1057705795.9395008,801523866.1724951,72067552966.0346,21668682652.96512,582146666.891999,5792665.7475,689.5,94245.0,-276784649.0,21936423.5,-123729168.0,-218592543.5,-2015986.0,,,,,,,,,,,,,,,,,,,,,4270582.5,2477888.0,-8998812.0,921269.0,37582.5,3731433033.599964,3656003897.024962,-260491827.5,-257182475.5,2525089.5,269056.5,3924112361.377455,33238054634.04092,36665716247.57264,1728471538.6425498,48059229778.74072,3985882.0,-247454892.5,103030513367.0,1053229296.0,17264827908.5,3501944259.0,18878480065.5,3670121.0,71878.0,20859.37324420005,89761639.0,-12.412297535887005,8.5503,2.7495188342040144,98.1314571319882,23.509210888094582,839.0533979156387,18000.0,1.0,0.0,0.0,0.0,0.0,0.0,0.0,1.0,0.0,0.0,0.0,0.0,0.0,0.0,0.0,1.0,0.0,0.0,0.0,0.0,1.0,0.0,1.0,0.0,0.0,0.0,0.0,1.0,0.0,0.0,0.0,0.0,0.0,0.0,0.0,0.0,0.0,0.0,0.0,0.0,0.0,0.0,0.0,0.0,0.0,0.0,0.0,0.0,0.0,0.0,0.0,0.0,0.0,0.0,0.0,0.0,0.0,0.0,0.0,0.0,0.0,0.0,0.0,0.0,0.0,0.0,0.0,0.0,0.0,0.0,0.0,0.0,0.0,0.0,0.0,0.0,0.0,0.0,1.0,0.0,0.0,0.0,0.0,0.0,0.0,0.0,0.0,0.0,0.0,0.0,0.0,0.0,0.0,0.0,0.0,0.0,0.0,0.0,0.0,0.0,0.0,0.0,0.0,0.0,0.0,0.0,0.0,0.0,0.0,0.0,0.0,0.0,0.0,0.0,0.0,0.0,0.0,0.0,0.0,0.0,0.0,0.0
101602,0,0.0,0.0,1.0,0.0,0.0,103500.0,453366.0,29101.5,400500.0,0.007305,33.72054794520548,-846.0,-6421.0,-4322.0,3.0,1.0,3.0,3.0,13.0,0.5425459085738482,0.6501333652273584,0.8128226070575616,0.0124,0.0,0.9722,0.6192,0.0016,0.0,0.069,0.0417,0.0833,0.0122,0.0101,0.0131,0.0,0.0,0.0126,0.0,0.9722,0.6341,0.0017,0.0,0.069,0.0417,0.0833,0.0124,0.011,0.0137,0.0,0.0,0.0125,0.0,0.9722,0.6243,0.0017,0.0,0.069,0.0417,0.0833,0.0124,0.0103,0.0133,0.0,0.0,0.0112,1.0,0.0,0.0,0.0,0.0,-239.0,0.0,0.0,0.0,0.0,0.0,3.0,1.0,1.0,0.0,1.0,0.0,1.0,0.0,0.0,0.0,0.0,0.0,0.0,0.0,1.0,0.0,0.0,0.0,0.0,0.0,0.0,0.0,0.0,0.0,0.0,0.0,0.0,0.0,0.0,0.0,0.0,0.0,0.0,2.0,0.0,0.0,18432.0,0.0,0.0,0.0,0.0,0.0,-1869.5,-1778.0,-1395.5,-1770.0,124.0,-30.5,4.0,8136.495,49990.5,46615.5,3375.0,65646.0,10.0,-205.0,365243.0,-197.0,-167.0,133.0,-165.0,12.0,0.0,0.0559924720193433,16.0,18.0,10.0,3.5,-13.5,0.0,0.0,26.0,8136.495,8136.495,-129.0,-126.5,6.0,0.0,5.0,182198.565,180000.0,0.0,7703.55,0.0,7703.55,9279.315,11062.552500000002,11042.28,178200.495,182198.565,182198.565,0.0,8.0,0.0,8.0,2.0,-3.0,0.0,0.0,8342230590.0,184318186869.0,165512381197.5,51944182957.935,1863.0,1704.0,71125.0,70741.0,9140.0,505791.0,17798.244600002294,17860.375899999115,17312.018599998068,11289.695600000085,11227.532000000088,11174.91090000006,128337.0,662460.0,4136.094400000122,4133.738000000017,3944.511200000096,13520878.698629737,-601559272.0,-921428879.0,-296333713.0,-1534376530.0416667,43993.0,30689.0,11343.69279999918,11219.639999998972,10704.1370999973,22875.58840000965,22797.44380000961,22183.346600008164,67414.29081294447,157957.65282138198,126038.75278738949,34982.0119000279,34922.47010002834,34368.71660002875,22941.494999995924,22914.942499995497,22562.33159999573,3712299.0,8291.145500000166,8395.614200000084,8119.314300000227,9812.85560000072,9927.769500002156,10287.266799999645,16459.678499999747,16644.853299999693,16241.720899999696,828.4691000001759,813.6527000000459,759.6349000000133,3911.815200000125,3895.076900000161,3727.76630000016,436232.0,431030.0,1262426.0,6421.663156002895,631628.0,625183.0,,16323.9033999998,154096.32939999062,154099.0778999901,153990.85239998714,77570.55799999624,77908.16650000657,78309.40900000649,62.0,25591232.51999999,7669494.494999997,2358463279.770001,823890717.5850005,29912374.89000001,619544.9249999999,50.0,8516.0,-8232357.5,3703663.0,-4251405.0,-4598769.0,-30.5,0.0,0.0,18432.0,0.0,0.0,0.0,0.0,0.0,-1869.5,-1778.0,-1395.5,-1770.0,95524018.24499992,1360711043.3250008,1534477755.5100002,22244256.315,1360711043.3250008,99066.0,-6852685.5,1576457318.0,68483264.0,344454792.0,158611916.0,359551862.0,97923.5,1582.0,270.26006077349166,2520097.5,827279.0,506095.0,-1651199.0,658591.0,96852.0,1112717465.122497,1121896592.0325,-68474247.5,-67913566.5,1292376.5,55360.0,1096588875.4650006,2819439000.0,94532352.75,147881504.87999997,6015501.9,47257736.39999996,62545023.76499996,157958723.47499982,146419040.4749997,1052890881.6599998,1092362986.934998,1092401148.8699982,4805.0,12443.0,84.0,7554.0,358486.0,-616734.0,211667.0,520.0,1466574.0,14749891.0,3230231.0,8550481.0,11601228.0,1414861.0,1057705795.9395008,801523866.1724951,72067571398.0346,21668682652.96512,582146666.891999,5792665.7475,689.5,94245.0,-276786518.5,21934645.5,-123730563.5,-218594313.5,-2016016.5,5919300461.429961,18710561250.0,198745595.325,447764693.9174976,1948107.735,256617184.3200008,308940632.79749864,636253182.8999982,458944179.6374992,5704575322.432531,5882600591.7075,5882843774.452499,13376.0,80804.0,44.0,70322.5,970881.0,-1697229.5,177364.0,6755.0,4270592.5,2477891.5,-8998825.5,921269.0,37582.5,3731441170.094964,3656012033.519962,-260491956.5,-257182602.0,2525095.5,269056.5,3924120497.872455,33238104624.54092,36665762863.07264,1728474913.6425498,48059295424.74072,3985892.0,-247455097.5,103030878610.0,1053229099.0,17264827741.5,3501944392.0,18878479900.5,3670133.0,71878.0,20859.42923667208,89761655.0,-25.08856028599285,4.380347826086957,3.5565177052729235,119.92772579862782,15.578784598732026,525.325152989572,103500.0,-0.9009688679024191,0.4338837391175582,0.0,0.0,0.0,0.0,0.0,0.0,1.0,0.0,1.0,0.0,0.0,0.0,0.0,0.0,0.0,0.0,0.0,0.0,1.0,0.0,0.0,0.0,1.0,0.0,0.0,1.0,0.0,0.0,0.0,0.0,0.0,0.0,0.0,0.0,0.0,0.0,0.0,0.0,0.0,0.0,0.0,0.0,0.0,0.0,1.0,0.0,0.0,0.0,0.0,0.0,0.0,0.0,0.0,1.0,0.0,0.0,0.0,0.0,0.0,0.0,0.0,0.0,0.0,0.0,0.0,0.0,0.0,0.0,0.0,0.0,0.0,0.0,0.0,0.0,0.0,0.0,0.0,0.0,0.0,0.0,0.0,0.0,0.0,0.0,0.0,0.0,0.0,0.0,0.0,0.0,0.0,0.0,0.0,0.0,0.0,0.0,0.0,0.0,0.0,0.0,0.0,0.0,0.0,0.0,0.0,0.0,0.0,0.0,1.0,0.0,1.0,0.0,0.0,0.0,0.0,0.0,0.0,0.0,1.0,0.0
101610,0,0.0,0.0,1.0,0.0,0.0,180000.0,315000.0,33205.5,315000.0,0.0038179999999999,29.693150684931503,-1343.0,-5166.0,-1697.0,21.0,2.0,2.0,2.0,14.0,0.2585214920705433,0.4871247244736477,0.3774042489507649,0.0041,,0.9672,,,,,0.0,,0.0162,,0.0014,,,0.0042,,0.9672,,,,,0.0,,0.0166,,0.0014,,,0.0042,,0.9672,,,,,0.0,,0.0165,,0.0014,,,0.0016,2.0,3.0,0.0,3.0,0.0,-1269.0,0.0,0.0,0.0,0.0,0.0,3.0,1.0,1.0,1.0,1.0,1.0,0.0,0.0,0.0,0.0,0.0,0.0,0.0,0.0,1.0,0.0,0.0,0.0,0.0,0.0,0.0,0.0,0.0,0.0,0.0,0.0,0.0,0.0,0.0,0.0,0.0,0.0,0.0,13.0,0.0,0.0,337500.0,119997.0,0.0,0.0,0.0,0.0,-852.0,-161.0,-735.0,-790.0,405.0,-16.0,7.0,6472.9125,30640.5,30640.5,0.0,39532.5,11.0,-230.0,365243.0,-274.0,-214.0,51.0,-208.0,6.0,0.0,0.0,-1.0,16.0,7.0,4.5,-9.5,0.0,0.0,16.0,4586.22,4769.325000000002,-1282.0,-1273.5,2.5,1.0,0.0,,,,,,,,,,,,,,,,,,,,,8342263795.5,184318501869.0,165512696197.5,51944362957.935,1863.0,1704.0,71125.0,70741.0,9140.0,505794.0,17798.248700002296,17860.380099999114,17312.022799998067,,,,128337.0,662462.0,,,,13520908.39178042,-601560615.0,-921430576.0,-296334982.0,-1534381696.0416667,43993.0,30689.0,,,,,,,67414.54933443654,157958.13994610647,126039.13019163844,34982.0119000279,34922.47010002834,34368.71660002875,,,,3712313.0,8291.161700000166,8395.630700000083,8119.330900000227,,,,16459.679899999748,16644.854699999694,16241.722299999696,,,,,,,436235.0,431033.0,1262447.0,6421.6669740028965,631630.0,625185.0,,16323.9049999998,154097.2965999906,154100.04509999012,153991.81959998718,,,,28.0,25636217.57999999,7689297.779999997,2369572361.820001,830666934.3150005,29989234.89000001,619544.9249999999,50.0,8516.0,-8304868.0,3754094.0,-4293722.0,-4645117.5,-14.5,0.0,0.0,241191.0,0.0,0.0,0.0,0.0,0.0,-929.0,-166.0,-743.0,-837.0,96125540.17499992,1367806260.8250008,1542503361.5100002,22327501.815,1367824013.3250008,99671.0,-6893441.0,1588145094.0,68815411.0,346620843.0,159321396.0,361718055.0,98502.0,1597.0,271.455605149346,2522097.0,831731.5,508706.0,-1663250.5,658593.0,96852.0,1118336357.1149929,1127863108.7549956,-68806702.5,-68242089.5,1294286.0,55707.5,,,,,,,,,,,,,,,,,,,,,1466587.0,14750296.0,3230231.0,8550497.0,11601244.0,1414868.0,1057705795.9395008,801523866.1724951,72067908898.0346,21668802649.96512,582146666.891999,5792665.7475,689.5,94245.0,-276787370.5,21934484.5,-123731298.5,-218595103.5,-2016032.5,,,,,,,,,,,,,,,,,,,,,4270599.5,2477896.0,-8998835.0,921269.0,37582.5,3731445756.3149633,3656016802.8449616,-260493238.5,-257183875.5,2525098.0,269057.5,3924126970.7849545,33238135265.04092,36665793503.57264,1728474913.6425498,48059334957.24072,3985903.0,-247455327.5,103031243853.0,1053228825.0,17264827527.5,3501944443.0,18878479692.5,3670139.0,71878.0,20859.42923667208,89761654.0,-45.229285846097056,1.75,5.420788724759452,160.96029643546012,9.48638026832904,281.6805187620552,90000.0,-0.9009688679024191,0.4338837391175582,0.0,0.0,0.0,0.0,0.0,1.0,0.0,0.0,0.0,0.0,0.0,0.0,0.0,1.0,0.0,0.0,0.0,0.0,1.0,0.0,1.0,0.0,0.0,0.0,0.0,1.0,0.0,0.0,0.0,0.0,0.0,0.0,0.0,0.0,0.0,0.0,0.0,0.0,0.0,0.0,0.0,0.0,0.0,0.0,1.0,0.0,0.0,0.0,0.0,0.0,0.0,0.0,0.0,0.0,0.0,0.0,0.0,0.0,0.0,0.0,0.0,0.0,0.0,0.0,0.0,0.0,0.0,0.0,0.0,0.0,0.0,0.0,0.0,0.0,0.0,0.0,0.0,0.0,0.0,0.0,0.0,0.0,0.0,0.0,0.0,0.0,0.0,0.0,0.0,0.0,1.0,0.0,0.0,0.0,0.0,0.0,0.0,0.0,0.0,0.0,0.0,0.0,0.0,0.0,0.0,0.0,0.0,0.0,0.0,0.0,1.0,0.0,0.0,0.0,0.0,0.0,0.0,0.0,0.0,1.0
101614,0,0.0,1.0,0.0,0.0,2.0,180000.0,1208304.0,54031.5,1080000.0,0.005002,42.2958904109589,-2344.0,-6256.0,-4615.0,,4.0,3.0,3.0,10.0,,0.6968014803505657,,,,,,,,,,,,,,,,,,,,,,,,,,,,,,,,,,,,,,,,,,,,,,0.0,0.0,0.0,0.0,-3374.0,,,,,,,1.0,1.0,0.0,1.0,0.0,1.0,0.0,0.0,0.0,0.0,1.0,1.0,0.0,1.0,0.0,0.0,0.0,0.0,0.0,0.0,0.0,0.0,0.0,0.0,0.0,0.0,0.0,0.0,0.0,0.0,0.0,0.0,0.0,,,,,,,,,,,,,0.0,,0.0,,,,,,,,,,,,,,,,,0.0,,,,,,99.0,22.5,22.5,-1524.0,-1524.0,51.0,0.0,95.0,0.0,180000.0,0.0,0.0,0.0,0.0,0.0,22.5,0.0,0.0,0.0,0.0,0.0,0.0,0.0,0.0,41.0,-49.0,0.0,0.0,8342317827.0,184319710173.0,165513776197.5,51944542957.935,,,,,,,,,,,,,128339.0,662466.0,,,,13520950.687670832,-601562959.0,-921435191.0,-296338356.0,-1534387952.0416667,43993.0,30689.0,,,,,,,,157958.8367475868,,,,,,,,3712323.0,,,,,,,,,,,,,,,,436235.0,431033.0,,6421.671976002896,631633.0,625188.0,,,,,,,,,,,,,,,,,,,,,,,,,,,,,,,,,,,,,,,,,,,,,,,,,,,,,,,,1120301698.2299852,1129942523.4299874,-69154572.0,-68587920.0,1304307.0,55846.0,1099309043.8350005,2842209000.0,94532352.75,147893019.48,6015501.9,47269250.99999996,62807405.80499996,158276303.055001,146716925.5799997,1055498953.275,1095080504.129999,1095118666.0649989,4805.0,12455.0,84.0,7566.0,361180.0,-624720.0,211667.0,520.0,1466587.0,14750296.0,3230326.0,8550497.0,11601343.0,1414868.0,,,,,,,,,,,,,,5919300461.429961,18710741250.0,198745595.325,447764693.9174976,1948107.735,256617184.3200008,308940632.79749864,636253205.3999982,458944179.6374992,5704575322.432531,5882600591.7075,5882843774.452499,13376.0,80804.0,44.0,70322.5,970922.0,-1697278.5,177364.0,6755.0,,,,,,3731445778.8149633,3656016825.3449616,-260494762.5,-257185399.5,2525149.0,269057.5,,,,,,,,,,,,,,,,,-55.41909573778987,6.7128,3.3313900224868838,140.90410730726708,22.362954942949944,945.8610915322224,45000.0,-0.2225209339563143,0.9749279121818236,0.0,0.0,0.0,0.0,0.0,0.0,1.0,0.0,0.0,0.0,0.0,0.0,0.0,1.0,0.0,0.0,0.0,0.0,1.0,0.0,1.0,0.0,0.0,0.0,0.0,1.0,0.0,0.0,0.0,0.0,0.0,0.0,0.0,0.0,0.0,0.0,0.0,0.0,0.0,0.0,0.0,0.0,0.0,0.0,0.0,0.0,0.0,0.0,0.0,0.0,0.0,0.0,0.0,0.0,0.0,0.0,0.0,0.0,0.0,1.0,0.0,0.0,0.0,0.0,0.0,0.0,0.0,0.0,0.0,0.0,0.0,0.0,0.0,0.0,0.0,0.0,0.0,0.0,0.0,0.0,0.0,0.0,0.0,0.0,0.0,0.0,0.0,0.0,0.0,0.0,0.0,0.0,0.0,0.0,0.0,0.0,0.0,0.0,0.0,0.0,0.0,0.0,0.0,0.0,0.0,0.0,0.0,0.0,0.0,0.0,0.0,0.0,0.0,0.0,0.0,0.0,0.0,0.0,0.0,0.0
101616,0,0.0,0.0,0.0,0.0,0.0,58500.0,58500.0,6939.0,58500.0,0.026392,37.463013698630135,-1223.0,-1369.0,-4424.0,,2.0,2.0,2.0,18.0,0.3571949227061449,0.5274617708090951,0.6075573001388961,,,,,,,,,,,,,,,,,,,,,,,,,,,,,,,,,,,,,,,,,,,,,0.0,0.0,0.0,0.0,-350.0,0.0,0.0,0.0,0.0,1.0,1.0,1.0,1.0,1.0,1.0,0.0,1.0,0.0,0.0,0.0,0.0,0.0,0.0,0.0,1.0,0.0,0.0,0.0,0.0,0.0,0.0,0.0,0.0,0.0,0.0,0.0,0.0,0.0,0.0,0.0,0.0,0.0,0.0,3.0,3974.985,1364.0175,238500.0,0.0,0.0,0.0,0.0,0.0,-895.0,65.0,-67.0,-544.5,75.0,-16.0,4.0,5653.6875,78750.0,81720.0,2250.0,78750.0,9.0,-350.0,365243.0,-232.5,365243.0,457.5,365243.0,10.5,0.5,0.0816165249618487,17.0,23.0,12.0,6.0,-8.0,0.0,0.0,23.0,10180.215,6587.46,-206.0,-200.0,4.0,1.0,11.0,0.0,67500.0,,0.0,,,0.0,,0.0,0.0,0.0,0.0,,0.0,,,0.0,-7.0,0.0,0.0,8342324766.0,184319768673.0,165513834697.5,51944601457.935,1863.0,1704.0,71125.0,70742.0,9140.0,505795.0,,,,,,,128339.0,662468.0,,,,13520988.150684532,-601564182.0,-921439615.0,-296338706.0,-1534389321.0416667,43993.0,30689.0,,,,,,,67414.90652935924,157959.36420935762,126039.73774893855,,,,,,,3712341.0,,,,,,,,,,,,,,,,436235.0,431033.0,,6421.698368002895,631635.0,625190.0,,,,,,,,,30.0,25759070.99999999,7690661.797499998,2382157772.820001,833014158.3450005,29989234.89000001,619544.9249999999,50.0,8516.0,-8337290.0,3739245.0,-4311788.0,-4664745.0,-14.5,3974.985,2728.035,18000.0,0.0,0.0,0.0,0.0,0.0,-1205.0,-1022.0,-1022.0,-1022.0,96444206.8874999,1370935452.105001,1545973289.0100002,22380340.094999995,1370935452.105001,99931.0,-6920559.0,1594902089.5,69160385.5,347700101.0,159671466.0,362797404.5,98822.5,1605.0,272.6723085072495,2530856.0,833259.0,509579.0,-1668145.0,658608.0,96852.0,1121194589.0849843,1130817791.0699868,-69262982.0,-68695797.0,1306581.0,55873.0,1100709136.2600005,2849724000.0,,147893019.48,,,62925789.86999995,,146835332.14499968,1056841784.3700002,1096480349.0549986,1096518510.9899988,,12455.0,,,362770.0,-626945.0,211667.0,520.0,1466590.0,14750371.0,3230337.0,8550520.0,11601366.0,1414872.0,1057709770.924501,801525230.1899952,72068147398.0346,21668802649.96512,582146666.891999,5792665.7475,689.5,94245.0,-276788265.5,21934549.5,-123731365.5,-218595648.0,-2016048.5,5919300461.429961,18710808750.0,,447764693.9174976,,,308940632.79749864,,458944179.6374992,5704575322.432531,5882600591.7075,5882843774.452499,,80804.0,,,970922.0,-1697285.5,177364.0,6755.0,4270611.5,2477902.0,-8998843.0,921269.0,37582.5,3731455959.029964,3656023412.8049617,-260494968.5,-257185599.5,2525153.0,269058.5,3924132624.472455,33238214015.04092,36665875223.57264,1728477163.6425498,48059413707.24072,3985912.0,-247455677.5,103031609096.0,1053228592.5,17265192770.5,3501944900.5,18878844935.5,3670149.5,71878.5,20859.51085319704,89761671.0,-32.64553166593535,1.0,8.430609597924773,315.83604285485853,8.430609597924773,315.83604285485853,29250.0,-0.9009688679024191,-0.433883739117558,0.0,0.0,0.0,0.0,0.0,0.0,1.0,0.0,0.0,0.0,0.0,0.0,0.0,1.0,0.0,0.0,0.0,0.0,1.0,0.0,1.0,0.0,0.0,0.0,0.0,1.0,0.0,0.0,0.0,0.0,0.0,0.0,1.0,0.0,0.0,0.0,0.0,0.0,0.0,0.0,0.0,0.0,0.0,0.0,0.0,0.0,0.0,0.0,0.0,0.0,0.0,0.0,0.0,0.0,0.0,0.0,0.0,0.0,0.0,0.0,0.0,0.0,0.0,0.0,0.0,0.0,0.0,0.0,0.0,0.0,0.0,0.0,0.0,0.0,0.0,0.0,1.0,0.0,0.0,0.0,0.0,0.0,0.0,0.0,0.0,0.0,0.0,0.0,0.0,0.0,0.0,0.0,0.0,0.0,0.0,0.0,0.0,0.0,0.0,0.0,0.0,0.0,0.0,0.0,0.0,0.0,0.0,0.0,0.0,0.0,0.0,0.0,0.0,0.0,0.0,0.0,0.0,0.0,0.0,0.0
101643,0,0.0,0.0,1.0,1.0,1.0,202500.0,272520.0,21658.5,225000.0,0.0228,40.32328767123288,-1763.0,-1205.0,-1901.0,5.0,3.0,2.0,2.0,7.0,,0.5754066355115252,0.3910549766342248,,,,,,,,,,,,,,,,,,,,,,,,,,,,,,,,,,,,,,,,,,,,,0.0,0.0,0.0,0.0,-108.0,0.0,0.0,0.0,0.0,0.0,2.0,1.0,1.0,0.0,1.0,0.0,0.0,0.0,0.0,0.0,0.0,0.0,0.0,0.0,1.0,0.0,0.0,0.0,0.0,0.0,0.0,0.0,0.0,0.0,0.0,0.0,0.0,0.0,0.0,0.0,0.0,0.0,0.0,9.0,10118.25,0.0,180000.0,0.0,0.0,0.0,0.0,0.0,-559.0,99.0,-25.0,-523.5,177.0,-11.0,15.0,14099.985,135000.0,165226.5,0.0,152649.0,12.0,-715.0,365243.0,-660.0,-480.0,-300.0,-474.5,11.0,0.0,0.0,60.0,39.0,12.0,7.0,-19.0,0.0,0.0,38.0,14099.985,14091.345,-522.5,-517.0,3.0,1.0,0.0,,,,,,,,,,,,,,,,,,,,,8342346424.5,184320041193.0,165514059697.5,51944803957.935,1863.0,1704.0,71125.0,70742.0,9140.0,505797.0,,,,,,,128340.0,662471.0,,,,13521028.473972203,-601565945.0,-921441516.0,-296338814.0,-1534390526.0416667,43993.0,30689.0,,,,,,,,157959.93961599312,126040.1288039152,,,,,,,3712348.0,,,,,,,,,,,,,,,,436235.0,431033.0,1262452.0,6421.721168002896,631637.0,625192.0,,,,,,,,,19.0,25870216.49999999,7729810.694999997,2417562746.6850004,840494661.0300006,31621278.42000001,619544.9249999999,50.0,8516.0,-8455863.0,3826114.0,-4374211.0,-4733732.0,-9.0,0.0,0.0,180000.0,0.0,0.0,0.0,0.0,0.0,-1024.0,-221.0,-578.0,-578.0,97946868.55499992,1395026949.825001,1574094234.4650002,22662157.85999999,1395179598.825001,101590.0,-7009785.0,1620467111.5,70922503.5,355870286.0,162921425.0,371700873.5,100504.0,1623.0,277.25272084768034,2564234.0,842750.0,515003.0,-1688831.0,688642.0,96855.0,1131522544.957488,1141245020.0024884,-69862889.5,-69289133.0,1310924.5,56571.5,,,,,,,,,,,,,,,,,,,,,1466599.0,14750548.0,3230337.0,8550559.0,11601404.0,1414887.0,1057719889.174501,801525230.1899952,72068327398.0346,21668802649.96512,582146666.891999,5792665.7475,689.5,94245.0,-276788824.5,21934648.5,-123731390.5,-218596171.5,-2016059.5,,,,,,,,,,,,,,,,,,,,,4270623.5,2477909.0,-8998862.0,921269.0,37582.5,3731470059.014964,3656037504.149962,-260495491.0,-257186116.5,2525156.0,269059.5,3924146724.457455,33238349015.04092,36666040450.07264,1728477163.6425498,48059566356.24072,3985924.0,-247456392.5,103031974339.0,1053227932.5,17265192290.5,3501944600.5,18878844461.0,3670160.5,71878.5,20859.51085319704,89761731.0,-43.72163337409975,1.3457777777777775,9.349677955537087,377.0097538345065,12.582588821940575,507.37134871594907,67500.0,0.6234898018587336,0.7818314824680298,0.0,0.0,0.0,0.0,0.0,0.0,1.0,0.0,0.0,0.0,0.0,0.0,0.0,1.0,0.0,0.0,0.0,0.0,1.0,0.0,1.0,0.0,0.0,0.0,0.0,1.0,0.0,0.0,0.0,0.0,0.0,0.0,0.0,0.0,0.0,0.0,0.0,0.0,1.0,0.0,0.0,0.0,0.0,0.0,0.0,0.0,0.0,0.0,0.0,0.0,0.0,0.0,0.0,0.0,0.0,0.0,0.0,0.0,0.0,0.0,0.0,0.0,0.0,0.0,0.0,0.0,0.0,0.0,0.0,0.0,0.0,0.0,0.0,0.0,0.0,0.0,0.0,0.0,0.0,0.0,0.0,0.0,0.0,0.0,0.0,0.0,0.0,0.0,0.0,0.0,1.0,0.0,0.0,0.0,0.0,0.0,0.0,0.0,0.0,0.0,0.0,0.0,0.0,0.0,0.0,0.0,0.0,0.0,0.0,0.0,0.0,0.0,0.0,0.0,0.0,0.0,0.0,0.0,0.0,0.0
101644,0,0.0,1.0,1.0,0.0,0.0,270000.0,547344.0,28075.5,472500.0,0.018029,51.950684931506856,-10091.0,-5978.0,-2506.0,17.0,2.0,3.0,3.0,7.0,,0.4092142007566335,0.7490217048463391,0.0464,0.0873,0.9901,,,0.0,0.1379,0.1667,,0.0148,,0.0574,,0.0,0.0473,0.0906,0.9901,,,0.0,0.1379,0.1667,,0.0151,,0.0598,,0.0,0.0468,0.0873,0.9901,,,0.0,0.1379,0.1667,,0.0151,,0.0585,,0.0,0.0453,1.0,12.0,0.0,12.0,0.0,-2335.0,0.0,0.0,0.0,0.0,0.0,1.0,1.0,1.0,0.0,1.0,0.0,0.0,0.0,0.0,0.0,0.0,0.0,0.0,0.0,1.0,0.0,0.0,0.0,0.0,0.0,0.0,0.0,0.0,0.0,0.0,0.0,0.0,0.0,0.0,0.0,0.0,0.0,0.0,13.0,24300.0,0.0,2025000.0,0.0,0.0,0.0,0.0,0.0,-1330.0,496.0,-608.0,-960.0,526.0,-20.5,4.0,6099.8625,33052.5,30393.0,3305.25,33052.5,6.0,-2587.5,365243.0,-2298.0,-2148.0,-2148.0,-2146.0,9.0,0.0,0.1065892965576801,40.0,20.0,6.0,3.5,-74.5,0.0,0.0,17.0,5501.97,5491.53,-2278.0,-2268.0,3.0,1.0,0.0,,,,,,,,,,,,,,,,,,,,,8342374500.0,184320588537.0,165514532197.5,51945073957.935,1863.0,1704.0,71125.0,70742.0,9140.0,505798.0,17798.295100002295,17860.426899999115,17312.070099998065,11289.782900000084,11227.619300000088,11175.00150000006,128340.0,662473.0,,,,13521080.424657134,-601576036.0,-921444022.0,-296341149.0,-1534396504.0416667,43993.0,30689.0,11343.69279999918,11219.639999998972,10704.1370999973,22875.72630000965,22797.58170000961,22183.48450000817,,157960.34883019383,126040.87782562006,34982.1786000279,34922.63680002834,34368.88330002875,,,,3712355.0,8291.176500000167,8395.645800000084,8119.346000000227,,,,16459.73729999975,16644.913199999693,16241.782099999697,,,,3911.815200000125,3895.076900000161,3727.76630000016,436247.0,431045.0,1262469.0,6421.739197002896,631640.0,625195.0,,16323.9502999998,154098.2866999906,154101.03519999012,153992.80969998718,,,,44.0,26108783.99999999,7772889.194999997,2426298335.9100003,841097274.3900006,31621278.42000001,619544.9249999999,50.0,8516.0,-8468133.0,3831066.5,-4381373.0,-4740358.0,-21.5,24880.5,0.0,711000.0,0.0,0.0,0.0,0.0,0.0,-1394.0,433.0,-754.0,-960.0,98119499.24249992,1396590362.325001,1575768331.2150002,22696324.10999999,1396590362.325001,101679.0,-7021041.5,1622110705.0,70916501.0,356411775.0,162916411.0,372242385.0,100607.0,1624.0,277.66618367965907,2564724.0,843025.0,515206.0,-1690016.0,688642.0,96855.0,1131988665.6899874,1141678679.3549874,-69894818.0,-69320840.0,1311007.0,56601.0,,,,,,,,,,,,,,,,,,,,,1466612.0,14751074.0,3230337.0,8550579.0,11601421.0,1414891.0,1057744189.174501,801525230.1899952,72070352398.0346,21668802649.96512,582146666.891999,5792665.7475,689.5,94245.0,-276790154.5,21935144.5,-123731998.5,-218597131.5,-2016080.0,,,,,,,,,,,,,,,,,,,,,4270629.5,2477912.5,-8998936.5,921269.0,37582.5,3731475560.9849634,3656042995.6799617,-260497769.0,-257188384.5,2525159.0,269060.5,3924152824.319955,33238382067.54092,36666070843.07264,1728480468.8925498,48059599408.74072,3985930.0,-247458980.0,103032339582.0,1053225634.5,17265190142.5,3501942452.5,18878842315.0,3670169.5,71878.5,20859.6174424936,89761771.0,-194.24190486235625,2.0272,9.616925789389327,499.60588169424767,19.49543196025004,1012.8010433705788,135000.0,-0.9009688679024191,0.4338837391175582,0.0,1.0,0.0,0.0,0.0,0.0,0.0,0.0,0.0,0.0,0.0,0.0,0.0,1.0,0.0,0.0,0.0,0.0,1.0,0.0,1.0,0.0,0.0,0.0,0.0,1.0,0.0,0.0,0.0,0.0,0.0,0.0,0.0,0.0,0.0,0.0,0.0,0.0,1.0,0.0,0.0,0.0,0.0,0.0,0.0,0.0,0.0,0.0,0.0,0.0,0.0,0.0,0.0,0.0,0.0,0.0,0.0,0.0,0.0,0.0,0.0,0.0,0.0,0.0,0.0,0.0,0.0,0.0,0.0,0.0,0.0,0.0,0.0,0.0,0.0,0.0,0.0,0.0,0.0,0.0,0.0,1.0,0.0,0.0,0.0,0.0,0.0,0.0,0.0,0.0,0.0,0.0,0.0,0.0,0.0,0.0,0.0,0.0,0.0,0.0,0.0,0.0,0.0,0.0,0.0,0.0,0.0,0.0,0.0,0.0,1.0,0.0,0.0,0.0,1.0,0.0,0.0,0.0,0.0,0.0
101649,0,0.0,1.0,1.0,0.0,0.0,180000.0,267102.0,27499.5,247500.0,0.010006,42.950684931506856,-5857.0,-3670.0,-827.0,7.0,2.0,2.0,1.0,8.0,0.2126666318815114,0.2303648801563924,0.4489622731076524,1.0,0.0923,0.9935,0.9116,0.036,0.16,0.1379,0.3333,0.375,0.0794,0.1177,0.1589,0.0039,0.0151,1.0,0.0958,0.9935,0.9151,0.0363,0.1611,0.1379,0.3333,0.375,0.0812,0.1286,0.1655,0.0039,0.016,1.0,0.0923,0.9935,0.9128,0.0362,0.16,0.1379,0.3333,0.375,0.0807,0.1197,0.1617,0.0039,0.0154,0.1491,1.0,7.0,0.0,7.0,0.0,0.0,0.0,0.0,0.0,0.0,1.0,2.0,1.0,1.0,0.0,1.0,0.0,0.0,0.0,0.0,0.0,0.0,0.0,0.0,0.0,0.0,0.0,0.0,0.0,0.0,1.0,0.0,0.0,0.0,0.0,0.0,0.0,0.0,0.0,0.0,0.0,0.0,0.0,0.0,6.0,0.0,0.0,216000.0,0.0,0.0,0.0,0.0,0.0,-1628.0,-1195.5,-974.0,-1322.0,336.0,-29.0,6.0,19882.755,99222.75,161658.0,6750.0,213750.0,5.0,-1992.0,365243.0,-1321.0,-1021.0,-285.0,-277.0,10.0,1.0,0.1756598240469207,91.0,46.0,12.0,4.5,-26.5,0.0,0.0,137.0,437.67,437.67,-1198.0,-1198.0,29.0,0.0,89.0,0.0,0.0,0.0,0.0,0.0,0.0,0.0,437.67,0.0,0.0,0.0,0.0,0.0,0.0,0.0,0.0,7.0,-45.0,0.0,0.0,8342401999.5,184320855639.0,165514779697.5,51945253957.935,1863.0,1704.0,71125.0,70743.0,9140.0,505800.0,17799.295100002295,17861.426899999115,17313.070099998065,11289.875200000082,11227.711600000088,11175.09730000006,128340.0,662475.0,4136.130400000122,4133.774200000016,3944.547500000095,13521123.375342064,-601581893.0,-921444849.0,-296341149.0,-1534400174.0416667,43993.0,30689.0,11343.852799999177,11219.799999998972,10704.298199997298,22875.864200009648,22797.71960000961,22183.622400008167,67415.11919599112,157960.579195074,126041.32678789317,34982.5119000279,34922.97010002834,34369.21660002875,22941.869999995924,22915.317499995497,22562.70659999573,3712363.0,8291.255900000167,8395.726500000084,8119.4272000002275,9812.97330000072,9927.889200002155,10287.395399999645,16459.896199999752,16645.074899999694,16241.947599999694,828.4730000001761,813.656600000046,759.6388000000132,3911.830300000125,3895.092300000161,3727.78230000016,436254.0,431052.0,1262476.0,6421.749203002895,631642.0,625196.0,,16324.0993999998,154099.2801999906,154102.02869999013,153993.80319998722,77571.46959999624,77909.07930000658,78310.32410000649,54.0,26299223.99999999,7789784.849999999,2448315531.0000005,845298383.8050008,31630887.00000001,619544.9249999999,50.0,8516.0,-8509696.0,3834696.0,-4397500.5,-4760527.0,-26.5,0.0,0.0,162000.0,0.0,0.0,0.0,0.0,0.0,-1763.0,-1332.0,-974.0,-1322.0,98308687.40999994,1398550242.825001,1578014733.4650002,22738311.35999999,1398550242.825001,101789.0,-7034254.5,1625029907.0,71272095.0,357134216.0,163642608.0,373332584.0,100823.5,1627.0,278.322288950372,2567082.5,844165.0,515988.0,-1692642.5,688645.0,96858.0,1133629215.1649926,1143319228.8299928,-70039581.0,-69464748.0,1314601.0,56656.0,1106987460.3449993,2888356500.0,95318952.75,149409109.21499997,6478821.9,47535406.46999995,63246567.77999995,160095472.11000043,148471703.27999964,1062883404.8550004,1102738657.0499976,1102776818.9849975,4819.0,12496.0,91.0,7586.0,363424.5,-631233.0,220515.0,538.0,1466618.0,14751410.0,3230426.0,8550625.0,11601558.0,1414897.0,1057744189.174501,801525230.1899952,72070568398.0346,21668802649.96512,582146666.891999,5792665.7475,689.5,94245.0,-276791782.5,21933949.0,-123732972.5,-218598453.5,-2016109.0,5919300461.429961,18710808750.0,198745595.325,447764693.9174976,1948107.735,256617184.3200008,308940632.79749864,636253643.0699981,458944179.6374992,5704575322.432531,5882600591.7075,5882843774.452499,13376.0,80804.0,44.0,70322.5,970929.0,-1697330.5,177364.0,6755.0,4270641.5,2477917.0,-8998963.0,921269.0,37582.5,3731475998.654964,3656043433.3499618,-260498967.0,-257189582.5,2525188.0,269060.5,3924172707.0749545,33238481290.29092,36666232501.07264,1728487218.8925498,48059813158.74072,3985935.0,-247460972.0,103032704825.0,1053224313.5,17265189121.5,3501942167.5,18878842038.0,3670179.5,71879.5,20859.79310231764,89761862.0,-136.36569496714932,1.4839,6.545573555882834,281.1368674947266,9.712976599574535,417.1789976754246,90000.0,-0.9009688679024191,0.4338837391175582,0.0,0.0,0.0,0.0,0.0,0.0,1.0,0.0,0.0,0.0,0.0,0.0,0.0,1.0,0.0,0.0,0.0,0.0,1.0,0.0,1.0,0.0,0.0,0.0,0.0,1.0,0.0,0.0,0.0,0.0,0.0,0.0,0.0,0.0,0.0,0.0,0.0,0.0,0.0,1.0,0.0,0.0,0.0,0.0,0.0,0.0,0.0,0.0,0.0,0.0,0.0,0.0,1.0,0.0,0.0,0.0,0.0,0.0,0.0,0.0,0.0,0.0,0.0,0.0,0.0,0.0,0.0,0.0,0.0,0.0,0.0,0.0,0.0,0.0,0.0,0.0,0.0,0.0,0.0,0.0,0.0,0.0,0.0,0.0,0.0,0.0,0.0,0.0,0.0,0.0,0.0,0.0,0.0,0.0,0.0,0.0,0.0,0.0,0.0,0.0,0.0,0.0,0.0,0.0,0.0,0.0,0.0,0.0,1.0,0.0,1.0,0.0,0.0,0.0,0.0,0.0,0.0,1.0,0.0,0.0
101650,0,0.0,0.0,0.0,0.0,0.0,126000.0,245268.0,19507.5,202500.0,0.014464,36.9972602739726,-1310.0,-6967.0,-5267.0,,2.0,2.0,2.0,2.0,,0.6422694277990404,,0.0907,0.028,0.9737,0.6396,0.0172,0.0,0.1379,0.1667,0.2083,0.0772,0.074,0.0714,0.0,0.0,0.0924,0.029,0.9737,0.6537,0.0173,0.0,0.1379,0.1667,0.2083,0.079,0.0808,0.0743,0.0,0.0,0.0916,0.028,0.9737,0.6444,0.0173,0.0,0.1379,0.1667,0.2083,0.0786,0.0752,0.0726,0.0,0.0,0.066,1.0,0.0,0.0,0.0,0.0,-970.0,,,,,,,1.0,1.0,1.0,1.0,0.0,0.0,0.0,0.0,0.0,0.0,0.0,0.0,0.0,1.0,0.0,0.0,0.0,0.0,0.0,0.0,0.0,0.0,0.0,0.0,0.0,0.0,0.0,0.0,0.0,0.0,0.0,0.0,0.0,,,,,,,,,,,,,0.0,,2.0,17722.6875,217451.25,229626.0,11992.5,217451.25,15.0,-590.5,365243.0,-560.0,182317.0,-140.0,182320.5,5.0,0.5,0.099476549087544,19.5,19.0,12.0,9.0,-23.0,0.0,0.0,18.0,11268.27,11268.27,-696.5,-684.0,5.0,1.0,0.0,,,,,,,,,,,,,,,,,,,,,8342421507.0,184321100907.0,165514982197.5,51945379957.935,,,,,,,17799.385800002296,17861.518499999114,17313.16249999807,11289.903200000084,11227.739600000088,11175.126300000058,128340.0,662477.0,4136.147600000122,4133.791500000017,3944.564800000095,13521160.37260234,-601583203.0,-921450116.0,-296342119.0,-1534407141.0416667,43993.0,30689.0,11343.852799999177,11219.799999998972,10704.298199997298,22876.002100009653,22797.857500009613,22183.76030000817,,157961.2214645018,,34982.6786000279,34923.13680002834,34369.38330002875,22942.078299995923,22915.5257999955,22562.91489999573,3712365.0,8291.333100000167,8395.805100000085,8119.506200000226,9813.04730000072,9927.964400002154,10287.476199999644,16459.967599999753,16645.147499999694,16242.021899999694,828.4730000001761,813.656600000046,759.6388000000132,3911.830300000125,3895.092300000161,3727.78230000016,436254.0,431052.0,,6421.763667002895,631644.0,625198.0,,16324.1653999998,154100.2538999906,154103.00239999013,153994.77689998722,77572.10919999624,77909.72370000657,78310.97780000647,,,,,,,,,,,,,,,,,,,,,,,,,,,98417337.99749991,1399662395.325001,1579447753.9650002,22757053.85999999,1399662395.325001,101831.0,-7039810.5,1626308257.5,71268949.5,357314922.5,163640887.5,373513314.5,100858.5,1629.5,278.59742532350646,2568931.5,844616.0,516208.0,-1693553.0,688647.0,96860.0,1135973873.7449956,1146172695.7949953,-70125445.0,-69549904.5,1316356.5,56745.5,,,,,,,,,,,,,,,,,,,,,1466618.0,14751410.0,3230426.0,8550644.0,11601576.0,1414899.0,,,,,,,,,,,,,,,,,,,,,,,,,,,,,,,,,,4270653.5,2477926.0,-8998986.0,921269.0,37582.5,3731487266.924964,3656054701.6199617,-260499663.5,-257190266.5,2525193.0,269061.5,3924190429.762455,33238698741.54092,36666462127.07264,1728499211.3925498,48060030609.99072,3985950.0,-247461562.5,103033070068.0,1053223753.5,17265371438.5,3501942027.5,18879024358.5,3670184.5,71880.0,20859.89257886673,89761881.5,-35.408027251184826,1.9465714285714288,6.459054209919263,238.96730972808132,12.573010380622838,465.16693747926246,63000.0,-0.9009688679024191,0.4338837391175582,0.0,0.0,0.0,0.0,0.0,0.0,1.0,0.0,0.0,0.0,0.0,0.0,0.0,1.0,0.0,0.0,0.0,0.0,1.0,1.0,0.0,0.0,0.0,0.0,0.0,1.0,0.0,0.0,0.0,0.0,0.0,0.0,0.0,0.0,0.0,0.0,0.0,0.0,0.0,0.0,0.0,0.0,0.0,0.0,1.0,0.0,0.0,0.0,0.0,0.0,0.0,0.0,0.0,1.0,0.0,0.0,0.0,0.0,0.0,0.0,0.0,0.0,0.0,0.0,0.0,0.0,0.0,0.0,0.0,0.0,0.0,0.0,0.0,0.0,0.0,0.0,0.0,0.0,0.0,0.0,0.0,0.0,0.0,0.0,0.0,0.0,0.0,0.0,0.0,0.0,0.0,0.0,0.0,0.0,0.0,0.0,0.0,0.0,0.0,0.0,0.0,0.0,0.0,0.0,0.0,0.0,0.0,0.0,1.0,0.0,1.0,0.0,0.0,0.0,0.0,0.0,0.0,0.0,1.0,0.0
101665,0,0.0,0.0,0.0,0.0,0.0,90000.0,360000.0,15264.0,360000.0,0.030755,63.03287671232878,,-14236.0,-4957.0,,1.0,2.0,2.0,13.0,0.7151936044667494,0.7121726618114671,0.7407990879702335,0.1021,0.093,0.9801,0.728,0.0112,0.0,0.2069,0.1667,0.2083,0.078,0.0832,0.0884,0.0,0.0,0.104,0.0965,0.9801,0.7387,0.0113,0.0,0.2069,0.1667,0.2083,0.0797,0.0909,0.0921,0.0,0.0,0.1031,0.093,0.9801,0.7316,0.0113,0.0,0.2069,0.1667,0.2083,0.0793,0.0847,0.09,0.0,0.0,0.0756,1.0,1.0,0.0,1.0,0.0,-2383.0,0.0,0.0,0.0,0.0,0.0,0.0,1.0,0.0,0.0,1.0,0.0,0.0,0.0,0.0,0.0,0.0,0.0,0.0,0.0,1.0,0.0,0.0,0.0,0.0,0.0,0.0,0.0,0.0,0.0,0.0,0.0,0.0,0.0,0.0,0.0,0.0,0.0,0.0,5.0,0.0,0.0,93150.0,0.0,0.0,0.0,0.0,0.0,-1245.0,-910.0,-906.0,-910.0,221.0,-22.0,2.0,5290.965,33705.0,26219.25,7875.0,33705.0,6.0,-2478.0,365243.0,-2439.5,-2289.5,-2289.5,-2278.0,12.0,0.5,0.2672242259691417,24.0,28.0,6.0,4.0,-84.0,0.0,0.0,30.0,4631.805,4631.805,-2533.0,-2537.0,4.5,1.0,0.0,,,,,,,,,,,,,,,,,,,,,8342436771.0,184321460907.0,165515342197.5,51945469957.935,1863.0,1704.0,71125.0,70743.0,9140.0,505800.0,17799.487900002296,17861.621599999115,17313.266499998066,11289.996200000083,11227.832600000089,11175.222800000058,128340.0,662478.0,4136.158800000122,4133.802800000017,3944.5761000000953,13521223.405479051,,-921455073.0,-296344502.0,-1534421377.0416667,43993.0,30689.0,11343.852799999177,11219.799999998972,10704.298199997298,22876.20900000965,22798.06440000961,22183.96720000817,67415.83438959559,157961.93363716366,126042.06758698114,34982.845300027904,34923.30350002834,34369.55000002875,22942.28659999592,22915.734099995498,22563.12319999573,3712378.0,8291.411100000167,8395.884400000084,8119.585900000226,9813.13050000072,9928.049100002154,10287.567099999644,16460.05599999975,16645.237499999694,16242.113999999694,828.4730000001761,813.656600000046,759.6388000000132,3911.830300000125,3895.092300000161,3727.78230000016,436255.0,431053.0,,6421.794422002896,631646.0,625200.0,,16324.2409999998,154101.2339999906,154103.98249999012,153995.75699998718,77572.83719999624,77910.45530000658,78311.71650000649,41.0,26823623.57999999,7865160.839999999,2495620891.7100005,862759631.7900008,31630887.00000001,619544.9249999999,50.0,8516.0,-8622367.0,3862164.0,-4457618.0,-4831814.0,-20.0,0.0,0.0,93150.0,0.0,0.0,0.0,0.0,0.0,-1753.0,-1661.0,-1203.0,-1206.0,99724831.82999992,1420209086.400001,1602315250.2900002,22968958.85999999,1420209086.400001,103171.0,-7110629.5,1643473394.5,71956994.5,359657369.5,165081174.5,375490876.5,102331.5,1645.5,281.10048821599486,2602791.0,851375.0,520714.0,-1706861.5,688663.0,96876.0,1149204120.2999992,1160143297.2224984,-70517459.0,-69937384.5,1320254.0,57203.5,,,,,,,,,,,,,,,,,,,,,1466623.0,14751631.0,3230426.0,8550672.0,11601606.0,1414901.0,1057744189.174501,801525230.1899952,72070661548.0346,21668802649.96512,582146666.891999,5792665.7475,689.5,94245.0,-276793027.5,21933039.0,-123733878.5,-218599363.5,-2016131.0,,,,,,,,,,,,,,,,,,,,,4270659.5,2477930.0,-8999070.0,921269.0,37582.5,3731491898.7299633,3656059333.4249616,-260502196.5,-257192803.5,2525197.5,269062.5,3924195720.727455,33238732446.54092,36666488346.32264,1728507086.3925498,48060064314.99072,3985956.0,-247464040.5,103033435311.0,1053221314.0,17265369149.0,3501939738.0,18879022080.5,3670196.5,71880.5,20860.15980309269,89761905.5,,4.0,5.89622641509434,371.6561126906177,23.58490566037736,1486.6244507624708,90000.0,0.6234898018587336,0.7818314824680298,0.0,0.0,0.0,0.0,0.0,0.0,1.0,0.0,0.0,1.0,0.0,0.0,0.0,0.0,0.0,0.0,0.0,0.0,1.0,0.0,0.0,0.0,0.0,1.0,0.0,1.0,0.0,0.0,0.0,0.0,0.0,0.0,0.0,0.0,0.0,0.0,0.0,0.0,0.0,0.0,0.0,0.0,0.0,0.0,0.0,0.0,0.0,0.0,0.0,0.0,0.0,0.0,0.0,0.0,0.0,0.0,0.0,0.0,0.0,0.0,0.0,0.0,0.0,0.0,0.0,0.0,0.0,0.0,0.0,0.0,0.0,0.0,0.0,0.0,0.0,0.0,0.0,0.0,0.0,0.0,0.0,0.0,0.0,0.0,0.0,0.0,0.0,0.0,0.0,0.0,0.0,0.0,0.0,0.0,0.0,0.0,0.0,0.0,0.0,0.0,0.0,0.0,0.0,0.0,0.0,1.0,0.0,0.0,0.0,1.0,1.0,0.0,0.0,0.0,0.0,0.0,0.0,0.0,1.0,0.0
101667,0,0.0,0.0,0.0,0.0,0.0,135000.0,440784.0,27094.5,360000.0,0.007305,22.78356164383561,-319.0,-3102.0,-995.0,,1.0,3.0,3.0,12.0,0.2434609636035649,0.6810341404494202,0.3740208032583212,,,,,,,,,,,,,,,,,,,,,,,,,,,,,,,,,,,,,,,,,,,,,1.0,0.0,1.0,0.0,-897.0,0.0,0.0,0.0,0.0,1.0,3.0,1.0,1.0,0.0,1.0,0.0,1.0,0.0,0.0,0.0,0.0,0.0,0.0,0.0,1.0,0.0,0.0,0.0,0.0,0.0,0.0,0.0,0.0,0.0,0.0,0.0,0.0,0.0,0.0,0.0,0.0,0.0,0.0,2.0,5550.75,0.0,276113.25,0.0,0.0,0.0,0.0,0.0,-151.5,808.5,-104.0,-185.0,11.0,-4.0,2.0,9518.535,25830.0,24475.5,5166.0,51660.0,6.0,-547.0,365243.0,-866.0,-716.0,-716.0,-713.0,11.5,0.0,0.1039644406815535,39.5,8.0,6.0,3.0,-26.5,0.0,0.0,6.0,9518.535,9518.535,-803.0,-791.0,3.5,1.0,0.0,,,,,,,,,,,,,,,,,,,,,8342463865.5,184321901691.0,165515702197.5,51945604957.935,1863.0,1704.0,71125.0,70744.0,9140.0,505803.0,,,,,,,128340.0,662479.0,,,,13521246.189040694,-601583522.0,-921456068.0,-296345399.0,-1534424479.0416667,43993.0,30689.0,,,,,,,67416.07785055919,157962.6146713041,126042.44160778438,,,,,,,3712390.0,,,,,,,,,,,,,,,,436256.0,431054.0,,6421.801727002896,631649.0,625203.0,,,,,,,,,5.5,26829174.32999999,7865160.839999999,2496338173.7100005,862759631.7900008,31630887.00000001,619544.9249999999,50.0,8516.0,-8626538.5,3860552.0,-4460175.5,-4834370.0,-2.25,0.0,0.0,34726.5,0.0,0.0,0.0,0.0,0.0,-278.0,-185.0,-183.0,-185.0,99746623.3499999,1420316973.900001,1602424809.5400002,22977499.85999999,1420316973.900001,103186.0,-7113504.5,1644386502.0,71954297.0,359655047.0,165078852.0,375488568.0,102366.5,1647.0,281.36265877362746,2602881.5,851603.0,520828.0,-1708313.0,688669.0,96882.0,1149374871.247501,1160297195.1974998,-70562685.0,-69982516.0,1320484.5,57229.5,,,,,,,,,,,,,,,,,,,,,1466625.0,14751642.0,3230426.0,8550680.0,11601612.0,1414903.0,1057749739.924501,801525230.1899952,72070937661.2846,21668802649.96512,582146666.891999,5792665.7475,689.5,94245.0,-276793179.0,21933847.5,-123733982.5,-218599548.5,-2016135.0,,,,,,,,,,,,,,,,,,,,,4270665.5,2477933.0,-8999096.5,921269.0,37582.5,3731501417.264963,3656068851.959962,-260502999.5,-257193594.5,2525201.0,269063.5,3924205239.262455,33238758276.54092,36666512821.82264,1728512252.3925498,48060115974.99072,3985962.0,-247464587.5,103033800554.0,1053220448.0,17265368433.0,3501939022.0,18879021367.5,3670208.0,71880.5,20860.26376753337,89761945.0,-14.001322751322752,3.265066666666667,4.982561036372696,113.52048651637077,16.26839395449261,370.651956508385,135000.0,-0.2225209339563146,-0.9749279121818236,0.0,0.0,0.0,0.0,0.0,0.0,1.0,0.0,0.0,0.0,0.0,0.0,0.0,1.0,0.0,0.0,1.0,0.0,0.0,0.0,0.0,0.0,1.0,0.0,0.0,0.0,0.0,0.0,0.0,1.0,0.0,0.0,0.0,0.0,0.0,0.0,0.0,0.0,0.0,0.0,0.0,0.0,0.0,0.0,0.0,0.0,0.0,0.0,0.0,0.0,0.0,0.0,0.0,0.0,0.0,0.0,0.0,0.0,0.0,0.0,0.0,0.0,0.0,0.0,0.0,0.0,0.0,0.0,0.0,0.0,0.0,0.0,0.0,0.0,0.0,0.0,0.0,0.0,0.0,0.0,0.0,1.0,0.0,0.0,0.0,0.0,0.0,0.0,0.0,0.0,0.0,0.0,0.0,0.0,0.0,0.0,0.0,0.0,0.0,0.0,0.0,0.0,0.0,0.0,0.0,0.0,0.0,0.0,0.0,0.0,0.0,0.0,0.0,0.0,0.0,0.0,0.0,0.0,0.0,0.0
101669,0,0.0,0.0,0.0,1.0,0.0,67500.0,98109.0,7267.5,81000.0,0.009175,60.72876712328768,,-2123.0,-4288.0,,1.0,2.0,2.0,19.0,,0.713595983891026,0.3016248916841194,0.2474,0.1297,0.9806,,,0.0,0.1379,0.1667,,0.0251,,0.1269,,0.0,0.2521,0.1346,0.9806,,,0.0,0.1379,0.1667,,0.0257,,0.1322,,0.0,0.2498,0.1297,0.9806,,,0.0,0.1379,0.1667,,0.0255,,0.1291,,0.0,0.1054,1.0,0.0,0.0,0.0,0.0,-339.0,0.0,0.0,0.0,0.0,2.0,5.0,1.0,0.0,0.0,1.0,0.0,0.0,0.0,0.0,0.0,0.0,0.0,0.0,0.0,1.0,0.0,0.0,0.0,0.0,0.0,0.0,0.0,0.0,0.0,0.0,0.0,0.0,0.0,0.0,0.0,0.0,0.0,0.0,28.0,0.0,0.0,18000.0,0.0,0.0,0.0,0.0,0.0,-511.0,-465.0,-414.0,-464.0,490.0,-12.0,7.0,5184.945,112500.0,119925.0,,112500.0,24.0,-213.0,365243.0,-178.0,365243.0,1232.0,365243.0,18.0,0.0,,-1.0,10.0,48.0,43.5,-6.5,0.0,0.0,10.0,5035.725,5035.725,-173.0,-163.0,2.5,1.0,10.0,0.0,0.0,0.0,0.0,0.0,0.0,0.0,0.0,0.0,0.0,0.0,0.0,0.0,0.0,0.0,0.0,0.0,-6.5,0.0,0.0,8342471133.0,184321999800.0,165515783197.5,51945672457.935,1863.0,1704.0,71125.0,70746.0,9140.0,505808.0,17799.735300002296,17861.871399999116,17313.518599998068,11290.125900000085,11227.962300000088,11175.35740000006,128340.0,662480.0,,,,13521306.91780782,,-921460356.0,-296345738.0,-1534426602.0416667,43993.0,30689.0,11343.852799999177,11219.799999998972,10704.298199997298,22876.34690000966,22798.202300009616,22184.105100008168,,157963.32826728802,126042.74323267606,34983.012000027906,34923.47020002834,34369.71670002875,,,,3712409.0,8291.436200000167,8395.909900000084,8119.611600000227,,,,16460.182899999752,16645.366599999692,16242.246199999694,,,,3911.830300000125,3895.092300000161,3727.78230000016,436256.0,431054.0,,6421.810902002895,631651.0,625205.0,,16324.3463999998,154102.2145999906,154104.96309999013,153996.73759998722,,,,17.5,26841659.57999999,7865160.839999999,2497100725.7100005,862841204.1450008,31630887.00000001,619544.9249999999,50.0,8516.0,-8636446.5,3855248.0,-4468826.0,-4842131.0,-8.5,0.0,0.0,27000.0,0.0,0.0,0.0,0.0,0.0,-959.0,-607.0,-655.0,-700.0,99823907.09249993,1421099973.900001,1603387139.0400002,,1421156223.900001,103354.0,-7117581.0,1645847474.0,72316611.0,360383442.0,165443875.0,376216990.0,102499.0,1650.0,,2602883.0,852187.0,521269.0,-1708978.5,688678.0,96891.0,1150195166.8425057,1160988109.6725032,-70738889.0,-70157917.0,1326130.5,57270.5,1116773290.3049989,2908786500.0,96001602.75,150091759.21499997,6478821.9,47535406.46999995,63808886.92499993,161388576.269999,149730682.76999956,1072254436.8750004,1112474789.4149964,1112512951.3499966,4853.0,12530.0,91.0,7586.0,366340.0,-643338.5,220516.0,539.0,1466653.0,14752132.0,3230436.0,8550690.0,11601622.0,1414910.0,1057749739.924501,801525230.1899952,72070955661.2846,21668802649.96512,582146666.891999,5792665.7475,689.5,94245.0,-276793690.0,21933382.5,-123734396.5,-218600012.5,-2016147.0,5919300461.429961,18710808750.0,198745595.325,447764693.9174976,1948107.735,256617184.3200008,308940632.79749864,636253643.0699981,458944179.6374992,5704575322.432531,5882600591.7075,5882843774.452499,13376.0,80804.0,44.0,70322.5,970929.0,-1697337.0,177364.0,6755.0,4270713.5,2477976.5,-8999103.0,921269.0,37582.5,3731506452.989963,3656073887.684961,-260503172.5,-257193757.5,2525203.5,269064.5,3924210424.207455,33238870776.54092,36666632746.82264,,48060228474.99072,3985986.0,-247464800.5,103034165797.0,1053220270.0,17265733676.0,3501940254.0,18879386610.5,3670226.0,71880.5,,89761944.0,,1.453466666666667,9.287925696594428,564.0442766868824,13.49969040247678,819.819554688494,67500.0,-0.9009688679024191,-0.433883739117558,0.0,0.0,0.0,0.0,0.0,0.0,1.0,0.0,0.0,1.0,0.0,0.0,0.0,0.0,0.0,1.0,0.0,0.0,0.0,0.0,0.0,0.0,0.0,1.0,0.0,1.0,0.0,0.0,0.0,0.0,0.0,0.0,0.0,0.0,0.0,0.0,0.0,0.0,0.0,0.0,0.0,0.0,0.0,0.0,0.0,0.0,0.0,0.0,0.0,0.0,0.0,0.0,0.0,0.0,0.0,0.0,0.0,0.0,0.0,0.0,0.0,0.0,0.0,0.0,0.0,0.0,0.0,0.0,0.0,0.0,0.0,0.0,0.0,0.0,0.0,0.0,0.0,0.0,0.0,0.0,0.0,0.0,0.0,0.0,0.0,0.0,0.0,0.0,0.0,0.0,0.0,0.0,0.0,0.0,0.0,0.0,0.0,0.0,0.0,0.0,0.0,0.0,0.0,0.0,0.0,1.0,0.0,0.0,0.0,0.0,1.0,0.0,0.0,0.0,0.0,0.0,0.0,0.0,1.0,0.0
101674,0,0.0,1.0,1.0,0.0,1.0,234000.0,552555.0,30105.0,477000.0,0.008625,27.39178082191781,-420.0,-4577.0,-2665.0,14.0,2.0,2.0,2.0,15.0,,0.4121091138595088,0.5136937663039473,,,,,,,,,,,,,,,,,,,,,,,,,,,,,,,,,,,,,,,,,,,,,0.0,0.0,0.0,0.0,-638.0,0.0,0.0,0.0,0.0,1.0,1.0,1.0,1.0,0.0,1.0,0.0,0.0,1.0,1.0,0.0,1.0,1.0,0.0,0.0,0.0,0.0,0.0,0.0,0.0,1.0,0.0,0.0,0.0,0.0,0.0,0.0,0.0,0.0,0.0,0.0,0.0,0.0,0.0,5.0,19864.71,0.0,495000.0,204606.0,0.0,0.0,0.0,0.0,-771.0,407.0,-10.0,-603.0,135.0,-13.0,2.0,4585.455,45747.0,50892.75,0.0,91494.0,24.0,-555.5,365243.0,-607.0,-97.0,83.0,-93.0,15.5,0.0,0.0,1073.5,19.0,24.0,15.0,-12.0,0.0,0.0,18.0,4585.455,4585.455,-361.0,-352.0,9.5,1.0,0.0,,,,,,,,,,,,,,,,,,,,,8342501238.0,184322552355.0,165516260197.5,51945906457.935,1863.0,1704.0,71125.0,70747.0,9140.0,505809.0,,,,,,,128341.0,662482.0,,,,13521334.30958864,-601583942.0,-921463021.0,-296346376.0,-1534431179.0416667,43993.0,30689.0,,,,,,,,157963.74037640187,126043.25692644237,,,,,,,3712424.0,,,,,,,,,,,,,,,,436256.0,431054.0,1262490.0,6421.819527002896,631653.0,625207.0,,,,,,,,,26.0,26927607.779999983,7878257.954999999,2508441399.1800003,863933229.6300008,31765237.65000001,619544.9249999999,50.0,8516.0,-8677261.0,3845113.0,-4490404.0,-4867816.0,-12.5,5247.0,0.0,202500.0,80545.5,0.0,0.0,0.0,0.0,-771.0,325.0,-29.0,-603.0,99948560.17499994,1422748086.075001,1605049538.0400002,23018162.535,1422748086.075001,103512.0,-7135136.5,1650229877.0,72303787.0,360738107.0,165799611.0,376571721.0,102784.5,1653.0,282.40195848179934,2621258.5,853218.0,521885.0,-1712952.0,688678.0,96891.0,1151192682.9225073,1161979279.2225046,-70846056.5,-70263330.5,1326638.5,57365.5,,,,,,,,,,,,,,,,,,,,,1466658.0,14752267.0,3230436.0,8550709.0,11601640.0,1414912.0,1057769604.634501,801525230.1899952,72071450661.2846,21669007255.96512,582146666.891999,5792665.7475,689.5,94245.0,-276794461.0,21933789.5,-123734406.5,-218600615.5,-2016160.0,,,,,,,,,,,,,,,,,,,,,4270737.5,2477991.5,-8999115.0,921269.0,37582.5,3731511038.444964,3656078473.139961,-260503533.5,-257194109.5,2525213.0,269065.5,3924215009.662455,33238916523.54092,36666683639.57264,1728512252.3925498,48060319968.99072,3986010.0,-247465356.0,103034531040.0,1053219663.0,17265733579.0,3501940337.0,18879386517.5,3670241.5,71880.5,20860.26376753337,89763017.5,-15.333066613322664,2.3613461538461538,7.772795216741406,212.91070295063167,18.3542600896861,502.7558695251552,117000.0,0.6234898018587336,0.7818314824680298,0.0,0.0,0.0,1.0,0.0,0.0,0.0,0.0,0.0,0.0,0.0,0.0,0.0,1.0,0.0,1.0,0.0,0.0,0.0,0.0,0.0,1.0,0.0,0.0,0.0,0.0,0.0,0.0,0.0,1.0,0.0,0.0,0.0,0.0,0.0,0.0,0.0,0.0,0.0,0.0,1.0,0.0,0.0,0.0,0.0,0.0,0.0,0.0,0.0,0.0,0.0,0.0,0.0,1.0,0.0,0.0,0.0,0.0,0.0,0.0,0.0,0.0,0.0,0.0,0.0,0.0,0.0,0.0,0.0,0.0,0.0,0.0,0.0,0.0,0.0,0.0,0.0,0.0,0.0,0.0,0.0,0.0,0.0,0.0,0.0,0.0,0.0,0.0,0.0,0.0,0.0,0.0,0.0,0.0,0.0,0.0,0.0,0.0,0.0,0.0,0.0,0.0,0.0,0.0,0.0,0.0,0.0,0.0,0.0,0.0,0.0,0.0,0.0,0.0,0.0,0.0,0.0,0.0,0.0,0.0
101675,0,0.0,0.0,0.0,0.0,0.0,180000.0,225000.0,22252.5,225000.0,0.072508,50.16164383561644,-2256.0,-2627.0,-1866.0,,1.0,1.0,1.0,12.0,0.7485319924646802,0.6554218572850649,,,,,,,,,,,,,,,,,,,,,,,,,,,,,,,,,,,,,,,,,,,,,,0.0,0.0,0.0,0.0,-1282.0,,,,,,,1.0,1.0,0.0,1.0,1.0,0.0,0.0,0.0,0.0,0.0,0.0,0.0,0.0,1.0,0.0,0.0,0.0,0.0,0.0,0.0,0.0,0.0,0.0,0.0,0.0,0.0,0.0,0.0,0.0,0.0,0.0,0.0,0.0,,,,,,,,,,,,,0.0,,6.0,19955.97,117306.0,121333.5,5433.75,117306.0,6.0,-619.0,365243.0,-589.0,-349.0,-349.0,-344.5,15.5,0.5,0.0470731871667663,1200.0,39.0,6.0,4.0,-19.0,0.0,0.0,35.0,19661.94,19661.94,-546.0,-542.0,4.0,1.0,5.0,0.0,405000.0,,0.0,,,0.0,,0.0,0.0,0.0,0.0,,0.0,,,0.0,-5.0,0.0,0.0,8342523490.5,184322777355.0,165516485197.5,51946086457.935,,,,,,,,,,,,,128341.0,662483.0,,,,13521384.471232476,-601586198.0,-921464887.0,-296347658.0,-1534433806.0416667,43993.0,30689.0,,,,,,,67416.82638255165,157964.39579825912,,,,,,,,3712436.0,,,,,,,,,,,,,,,,436256.0,431054.0,,6421.892035002897,631654.0,625208.0,,,,,,,,,,,,,,,,,,,,,,,,,,,,,,,,,,,100018842.05249994,1423400300.325001,1605719716.2900002,23030758.035,1423400300.325001,103527.0,-7136807.5,1651508227.5,72665750.0,361100805.0,166162339.0,376570858.0,102845.0,1655.0,282.49610485613283,2625458.0,853548.0,522068.0,-1713435.0,688678.0,96891.0,1151602514.3250058,1162389110.625003,-70858974.0,-70275836.0,1326793.0,57394.0,1117133081.9099991,2911455000.0,,150348259.21499997,,,63833220.98999994,,149995107.13499954,1072600348.5450004,1112828830.6949964,1112866992.6299963,,12537.0,,,366350.0,-643453.0,220516.0,539.0,1466658.0,14752267.0,3230441.0,8550748.0,11601675.0,1414918.0,,,,,,,,,,,,,,5919300461.429961,18711213750.0,,447764693.9174976,,,308940632.79749864,,458944179.6374992,5704575322.432531,5882600591.7075,5882843774.452499,,80804.0,,,970929.0,-1697342.0,177364.0,6755.0,4270743.5,2477995.5,-8999134.0,921269.0,37582.5,3731530700.384964,3656098135.079961,-260504079.5,-257194651.5,2525217.0,269066.5,3924234965.632455,33239033829.54092,36666804973.07264,1728517686.1425498,48060437274.99072,3986016.0,-247465975.0,103034896283.0,1053219074.0,17265733230.0,3501939988.0,18879386173.0,3670257.0,71881.0,20860.310840720544,89764217.5,-44.974602654432246,1.25,8.088978766430737,405.7564718755627,10.111223458038422,507.19558984445337,180000.0,0.6234898018587336,0.7818314824680298,0.0,0.0,0.0,0.0,0.0,0.0,1.0,0.0,1.0,0.0,0.0,0.0,0.0,0.0,0.0,0.0,0.0,0.0,1.0,0.0,0.0,0.0,1.0,0.0,0.0,1.0,0.0,0.0,0.0,0.0,0.0,0.0,0.0,0.0,0.0,0.0,0.0,0.0,0.0,0.0,0.0,0.0,0.0,0.0,1.0,0.0,0.0,0.0,0.0,0.0,0.0,0.0,0.0,0.0,0.0,0.0,0.0,0.0,0.0,0.0,0.0,0.0,0.0,0.0,0.0,0.0,0.0,0.0,0.0,0.0,0.0,0.0,0.0,0.0,0.0,0.0,0.0,0.0,0.0,0.0,0.0,0.0,0.0,0.0,0.0,0.0,0.0,0.0,0.0,0.0,1.0,0.0,0.0,0.0,0.0,0.0,0.0,0.0,0.0,0.0,0.0,0.0,0.0,0.0,0.0,0.0,0.0,0.0,0.0,0.0,0.0,0.0,0.0,0.0,0.0,0.0,0.0,0.0,0.0,0.0
101678,0,0.0,0.0,0.0,1.0,0.0,171000.0,675000.0,25578.0,675000.0,0.028663,48.419178082191785,-3060.0,-220.0,-1204.0,,2.0,2.0,2.0,9.0,0.2924754012532824,0.2629528308516002,0.5954562029091491,,,,,,,,,,,,,,,,,,,,,,,,,,,,,,,,,,,,,,,,,,,,,0.0,0.0,0.0,0.0,-710.0,0.0,0.0,0.0,0.0,0.0,2.0,1.0,1.0,0.0,1.0,0.0,0.0,0.0,0.0,0.0,0.0,0.0,0.0,0.0,1.0,0.0,0.0,0.0,0.0,0.0,0.0,0.0,0.0,0.0,0.0,0.0,0.0,0.0,0.0,0.0,0.0,0.0,0.0,3.0,0.0,,270000.0,0.0,0.0,0.0,0.0,0.0,-756.0,451.0,-438.0,-553.5,72.0,-16.5,3.0,10227.735,180000.0,209700.0,5625.0,180000.0,30.0,-1612.0,365243.0,-1582.0,-712.0,-712.0,-705.0,11.0,1.0,0.182488423105045,-1.0,49.0,30.0,15.0,-37.0,0.0,0.0,150.0,742.905,742.905,-1351.5,-1349.5,41.5,0.0,96.0,0.0,0.0,0.0,0.0,0.0,0.0,0.0,742.905,0.0,0.0,0.0,0.0,0.0,0.0,0.0,0.0,28.0,-48.5,0.0,0.0,8342549068.5,184323452355.0,165517160197.5,51946257457.935,1863.0,1704.0,71125.0,70747.0,9140.0,505811.0,,,,,,,128341.0,662485.0,,,,13521432.890410556,-601589258.0,-921466091.0,-296348368.0,-1534434026.0416667,43993.0,30689.0,,,,,,,67417.1188579529,157964.65875108994,126043.85238264527,,,,,,,3712445.0,,,,,,,,,,,,,,,,436256.0,431054.0,,6421.920698002897,631656.0,625210.0,,,,,,,,,25.0,26969540.48999999,,2510548168.6800003,864791672.1300008,31765237.65000001,619544.9249999999,50.0,8516.0,-8689223.0,3904030.0,-4495847.0,-4874882.5,-12.0,0.0,,270000.0,0.0,0.0,0.0,0.0,0.0,-1353.0,451.0,-438.0,-449.0,100324157.53499994,1426635348.075001,1609356065.0400002,23088317.535,1426635348.075001,103711.0,-7150892.0,1654978036.0,72655813.0,361458040.0,166155275.0,376926426.0,103027.0,1660.0,283.47509970763434,2631564.0,855297.0,523195.0,-1717711.0,688798.0,96907.0,1154326349.2500017,1164925630.7999992,-71038607.0,-70454695.5,1329607.0,57553.0,1117797019.379999,2913952500.0,96330102.75,150420259.21499997,6478821.9,47535406.46999995,63934470.98999994,161862644.60999903,150157332.13499954,1073234779.5600004,1113486997.6574962,1113525159.5924966,4862.0,12539.0,91.0,7586.0,367582.5,-645807.0,220516.0,539.0,1466661.0,14752339.0,3230537.0,8550797.0,11601825.0,1414921.0,1057769604.634501,,72071720661.2846,21669007255.96512,582146666.891999,5792665.7475,689.5,94245.0,-276795217.0,21934240.5,-123734844.5,-218601169.0,-2016176.5,5919300461.429961,18711213750.0,198745595.325,447764693.9174976,1948107.735,256617184.3200008,308940632.79749864,636254385.9749981,458944179.6374992,5704575322.432531,5882600591.7075,5882843774.452499,13376.0,80804.0,44.0,70322.5,970957.0,-1697390.5,177364.0,6755.0,4270773.5,2478010.5,-8999171.0,921269.0,37582.5,3731531443.2899632,3656098877.9849615,-260505431.0,-257196001.0,2525258.5,269066.5,3924245193.367455,33239213829.54092,36667014673.07264,1728523311.1425498,48060617274.99072,3986046.0,-247467587.0,103035261526.0,1053217492.0,17265732518.0,3501939276.0,18879385468.0,3670268.0,71882.0,20860.49332914365,89764216.5,-63.19809879477169,3.947368421052632,6.685432793807178,323.7031609998746,26.389866291344124,1277.7756355258211,85500.0,-0.9009688679024191,-0.433883739117558,0.0,0.0,0.0,0.0,0.0,0.0,1.0,0.0,1.0,0.0,0.0,0.0,0.0,0.0,0.0,0.0,0.0,0.0,1.0,0.0,1.0,0.0,0.0,0.0,0.0,0.0,1.0,0.0,0.0,0.0,0.0,0.0,0.0,0.0,0.0,0.0,0.0,0.0,1.0,0.0,0.0,0.0,0.0,0.0,0.0,0.0,0.0,0.0,0.0,0.0,0.0,0.0,0.0,0.0,0.0,0.0,0.0,0.0,0.0,0.0,0.0,0.0,0.0,0.0,0.0,0.0,0.0,0.0,0.0,0.0,0.0,0.0,0.0,0.0,0.0,0.0,1.0,0.0,0.0,0.0,0.0,0.0,0.0,0.0,0.0,0.0,0.0,0.0,0.0,0.0,0.0,0.0,0.0,0.0,0.0,0.0,0.0,0.0,0.0,0.0,0.0,0.0,0.0,0.0,0.0,0.0,0.0,0.0,0.0,0.0,0.0,0.0,0.0,0.0,0.0,0.0,0.0,0.0,0.0,0.0
101682,0,0.0,0.0,0.0,0.0,0.0,135000.0,135000.0,16020.0,135000.0,0.028663,24.67397260273973,-115.0,-2045.0,-1679.0,,1.0,2.0,2.0,11.0,0.3915699139580133,0.6054743086517351,0.2594676548211199,0.1134,0.0455,0.9955,0.9388,0.0372,0.08,0.0345,0.5833,0.625,,0.0925,0.1067,0.0154,0.0466,0.1155,0.0472,0.9955,0.9412,0.0375,0.0806,0.0345,0.5833,0.625,,0.101,0.1112,0.0156,0.0493,0.1145,0.0455,0.9955,0.9396,0.0374,0.08,0.0345,0.5833,0.625,,0.0941,0.1086,0.0155,0.0476,0.1144,1.0,0.0,0.0,0.0,0.0,-880.0,0.0,0.0,0.0,0.0,0.0,4.0,1.0,1.0,1.0,1.0,0.0,0.0,0.0,0.0,0.0,0.0,0.0,0.0,0.0,1.0,0.0,0.0,0.0,0.0,0.0,0.0,0.0,0.0,0.0,0.0,0.0,0.0,0.0,0.0,0.0,0.0,0.0,0.0,7.0,8820.0,0.0,88200.0,31882.5,0.0,0.0,0.0,0.0,-364.0,182.0,-45.0,-334.5,90.0,-6.0,7.0,7482.5774999999985,69291.0,84384.0,0.0,69291.0,15.0,-533.0,365243.0,-496.0,-468.0,-226.0,-322.0,15.0,0.0,0.0,70.0,23.0,12.0,5.0,-67.0,0.0,0.0,30.0,3767.805,3767.805,-485.0,-467.0,5.5,1.0,16.0,0.0,0.0,0.0,0.0,0.0,0.0,0.0,0.0,0.0,0.0,0.0,0.0,0.0,0.0,0.0,0.0,1.0,-9.5,0.0,0.0,8342565088.5,184323587355.0,165517295197.5,51946392457.935,1863.0,1704.0,71125.0,70747.0,9140.0,505815.0,17799.848700002294,17861.985899999116,17313.634099998068,11290.171400000085,11228.007800000089,11175.404600000058,128341.0,662486.0,4136.196000000122,4133.840200000017,3944.613600000095,13521457.56438316,-601589373.0,-921467770.0,-296349248.0,-1534436071.0416667,43993.0,30689.0,11343.932799999176,11219.879999998971,10704.378799997296,22876.381400009657,22798.23680000961,22184.139600008173,67417.51042786686,157965.26422539866,126044.11185030008,34983.595300027904,34924.05350002834,34370.30000002875,22942.91159999592,22916.359099995498,22563.74819999573,3712456.0,,,,9813.22300000072,9928.143200002154,10287.668099999644,16460.289599999753,16645.47519999969,16242.357399999695,828.4884000001761,813.6721000000459,759.6544000000133,3911.876900000125,3895.139900000161,3727.831600000159,436256.0,431054.0,,6421.949361002897,631658.0,625212.0,,16324.4607999998,154103.2100999906,154105.95859999012,153997.73309998718,77573.77599999624,77911.39490000658,78312.65770000649,12.0,27026377.37999999,7878257.954999999,2528536716.1800003,870481899.6300008,31765237.65000001,637724.9249999999,50.0,8524.0,-8724475.0,3943687.0,-4514071.0,-4894284.0,-5.5,8820.0,0.0,78745.5,0.0,0.0,0.0,0.0,0.0,-455.0,1.0,-48.0,-562.0,100421374.58999991,1427950270.575001,1610722467.5400002,23111996.535,1427950270.575001,103839.0,-7158114.0,1657169494.0,72650549.0,361454763.0,166516977.0,376923338.0,103178.0,1661.0,283.68347168533285,2634411.0,856579.0,523889.0,-1719533.0,688809.0,96907.0,1155316563.495001,1165960845.0449984,-71179502.5,-70594749.5,1334715.5,57619.0,1118288039.287499,2915527500.0,96375102.75,150516707.71499997,6525171.9,47542948.46999995,63982212.61499994,161953493.35499913,150215091.61499956,1073704645.6425004,1113976903.2074966,1114015065.142497,4863.0,12543.0,92.0,7589.0,368817.0,-648197.0,220516.0,539.0,1466668.0,14752429.0,3230553.0,8550820.0,11601855.0,1414928.0,1057778424.634501,801525230.1899952,72071808861.2846,21669039138.46512,582146666.891999,5792665.7475,689.5,94245.0,-276795581.0,21934422.5,-123734889.5,-218601503.5,-2016182.5,5919300461.429961,18711213750.0,198745595.325,447764693.9174976,1948107.735,256617184.3200008,308940632.79749864,636254385.9749981,458944179.6374992,5704575322.432531,5882600591.7075,5882843774.452499,13376.0,80804.0,44.0,70322.5,970958.0,-1697400.0,177364.0,6755.0,4270785.5,2478015.5,-8999238.0,921269.0,37582.5,3731535211.094963,3656102645.789961,-260505916.0,-257196468.0,2525264.0,269067.5,3924252675.944955,33239283120.54092,36667099057.07264,1728523311.1425498,48060686565.99072,3986061.0,-247468120.0,103035626769.0,1053216996.0,17265732050.0,3501939050.0,18879385146.0,3670283.0,71882.0,20860.49332914365,89764286.5,-4.660781701088164,1.0,8.426966292134832,207.926735416346,8.426966292134832,207.926735416346,135000.0,-0.2225209339563143,0.9749279121818236,0.0,0.0,0.0,0.0,0.0,0.0,1.0,0.0,0.0,0.0,0.0,0.0,0.0,1.0,0.0,1.0,0.0,0.0,0.0,0.0,0.0,0.0,1.0,0.0,0.0,1.0,0.0,0.0,0.0,0.0,1.0,0.0,0.0,0.0,0.0,0.0,0.0,0.0,0.0,0.0,0.0,0.0,0.0,0.0,0.0,0.0,0.0,0.0,0.0,0.0,0.0,0.0,0.0,1.0,0.0,0.0,0.0,0.0,0.0,0.0,0.0,0.0,0.0,0.0,0.0,0.0,0.0,0.0,0.0,0.0,0.0,0.0,0.0,0.0,0.0,0.0,0.0,0.0,0.0,0.0,0.0,0.0,0.0,0.0,0.0,0.0,0.0,0.0,0.0,0.0,0.0,0.0,0.0,0.0,0.0,0.0,0.0,0.0,0.0,0.0,0.0,0.0,0.0,0.0,0.0,0.0,0.0,0.0,1.0,0.0,1.0,0.0,0.0,0.0,0.0,0.0,0.0,0.0,0.0,0.0
101686,0,0.0,0.0,0.0,1.0,1.0,90000.0,177768.0,7960.5,135000.0,0.030755,59.30958904109588,-1425.0,-66.0,-4722.0,,2.0,2.0,2.0,12.0,,0.6658394042526368,0.3893387918468769,,,,,,,,,,,,,,,,,,,,,,,,,,,,,,,,,,,,,,,,,,,,,0.0,0.0,0.0,0.0,-1415.0,0.0,0.0,0.0,0.0,1.0,4.0,1.0,1.0,0.0,1.0,0.0,0.0,0.0,0.0,0.0,0.0,0.0,0.0,0.0,1.0,0.0,0.0,0.0,0.0,0.0,0.0,0.0,0.0,0.0,0.0,0.0,0.0,0.0,0.0,0.0,0.0,0.0,0.0,16.0,0.0,0.0,43136.775,0.0,0.0,0.0,0.0,0.0,-1327.5,-1022.0,-922.0,-1086.5,715.0,-22.0,9.0,8254.619999999999,135000.0,135000.0,0.0,135000.0,18.0,-686.0,365243.0,-1008.0,-206.5,-206.5,-201.5,14.0,0.0,0.0,-1.0,93.0,30.0,11.0,-27.0,0.0,0.0,111.0,6844.815,6844.815,-687.0,-678.0,11.0,1.0,11.0,127106.955,135000.0,0.0,0.0,0.0,0.0,6621.795,6862.5,162.315,123856.515,127331.955,127331.955,0.0,0.0,0.0,0.0,4.0,-6.0,0.0,0.0,8342573049.0,184323765123.0,165517430197.5,51946482457.935,1863.0,1704.0,71125.0,70748.0,9140.0,505819.0,,,,,,,128342.0,662488.0,,,,13521516.873972202,-601590798.0,-921472492.0,-296350663.0,-1534436137.0416667,43993.0,30689.0,,,,,,,,157965.93006480287,126044.50118909196,,,,,,,3712468.0,,,,,,,,,,,,,,,,436256.0,431054.0,,6421.9801160028965,631660.0,625214.0,,,,,,,,,44.0,27133263.08999999,7907018.534999998,2536022450.205,872594943.8850008,31853437.65000001,637724.9249999999,50.0,8524.0,-8766025.0,3930487.0,-4531493.5,-4917415.5,-21.5,0.0,0.0,41805.0,0.0,0.0,0.0,0.0,0.0,-1349.0,-1170.0,-922.0,-1159.0,101000432.47499992,1440594010.575001,1624030565.0400002,23456102.535,1440515260.575001,104456.0,-7183898.0,1662464483.5,72635342.5,362906786.0,167241553.5,378375448.0,103635.0,1664.0,285.10183803873304,2641063.0,860552.0,526069.0,-1725245.0,688819.0,96917.0,1158407305.065003,1168633164.4200006,-71348904.0,-70762246.0,1336797.0,57818.0,1119576462.7949994,2916945000.0,96463302.75,150615490.81499997,6525171.9,47551088.06999996,64046043.80999993,162024506.36999914,150254133.02999958,1074907091.925,1115236357.514997,1115274519.4499972,4877.0,12561.0,92.0,7592.0,368873.0,-648315.0,220516.0,539.0,1466684.0,14753144.0,3230564.0,8550913.0,11601966.0,1414937.0,1057778424.634501,801525230.1899952,72071851998.0596,21669039138.46512,582146666.891999,5792665.7475,689.5,94245.0,-276796908.5,21933400.5,-123735811.5,-218602590.0,-2016204.5,5919427568.384961,18711348750.0,198745595.325,447764693.9174976,1948107.735,256617184.3200008,308947254.59249866,636261248.4749981,458944341.9524992,5704699178.947532,5882727923.6624975,5882971106.407499,13376.0,80804.0,44.0,70322.5,970962.0,-1697406.0,177364.0,6755.0,4270815.5,2478026.5,-8999265.0,921269.0,37582.5,3731542055.909963,3656109490.604962,-260506603.0,-257197146.0,2525275.0,269068.5,3924260930.5649543,33239418120.54092,36667234057.07264,1728523311.1425498,48060821565.99072,3986079.0,-247468806.0,103035992012.0,1053215988.0,17265731843.5,3501938843.5,18879384944.5,3670297.0,71882.0,20860.49332914365,89764285.5,-24.0264689578714,1.9752,11.305822498586776,670.5436861627575,22.331260599208598,1324.4578889086783,45000.0,0.6234898018587336,0.7818314824680298,0.0,0.0,0.0,0.0,0.0,0.0,1.0,0.0,0.0,0.0,0.0,0.0,0.0,1.0,0.0,0.0,0.0,0.0,1.0,0.0,0.0,0.0,0.0,1.0,0.0,1.0,0.0,0.0,0.0,0.0,0.0,0.0,0.0,0.0,0.0,0.0,0.0,0.0,0.0,0.0,0.0,0.0,0.0,0.0,0.0,0.0,1.0,0.0,0.0,0.0,0.0,0.0,0.0,0.0,0.0,0.0,0.0,0.0,0.0,0.0,0.0,0.0,0.0,0.0,0.0,0.0,0.0,0.0,0.0,0.0,0.0,0.0,0.0,0.0,0.0,0.0,0.0,0.0,0.0,0.0,0.0,1.0,0.0,0.0,0.0,0.0,0.0,0.0,0.0,0.0,0.0,0.0,0.0,0.0,0.0,0.0,0.0,0.0,0.0,0.0,0.0,0.0,0.0,0.0,0.0,0.0,0.0,0.0,0.0,0.0,0.0,0.0,0.0,0.0,0.0,0.0,0.0,0.0,0.0,0.0
101697,0,0.0,1.0,0.0,1.0,8.0,180000.0,389844.0,18751.5,315000.0,0.018209,35.295890410958904,-1674.0,-199.0,-3370.0,,10.0,3.0,3.0,4.0,0.3323301628705192,0.5024455663626127,,,,,,,,,,,,,,,,,,,,,,,,,,,,,,,,,,,,,,,,,,,,,,0.0,0.0,0.0,0.0,-897.0,,,,,,,1.0,1.0,0.0,1.0,0.0,0.0,0.0,1.0,1.0,0.0,1.0,1.0,0.0,1.0,0.0,0.0,0.0,0.0,0.0,0.0,0.0,0.0,0.0,0.0,0.0,0.0,0.0,0.0,0.0,0.0,0.0,0.0,0.0,,,,,,,,,,,,,0.0,,3.0,16411.545,202500.0,222547.5,,202500.0,18.0,-694.0,365243.0,-867.0,-717.0,-717.0,-709.0,11.0,1.0,,6.0,7.0,6.0,3.0,-27.0,0.0,0.0,6.0,9426.24,9426.24,-801.0,-792.0,3.5,2.0,0.0,,,,,,,,,,,,,,,,,,,,,8342591800.5,184324154967.0,165517745197.5,51946662457.935,,,,,,,,,,,,,128350.0,662498.0,,,,13521552.169862611,-601592472.0,-921475862.0,-296351560.0,-1534436336.0416667,43993.0,30689.0,,,,,,,67417.84275802973,157966.43251036922,,,,,,,,3712472.0,,,,,,,,,,,,,,,,436256.0,431054.0,,6421.998325002895,631663.0,625217.0,,,,,,,,,,,,,,,,,,,,,,,,,,,,,,,,,,,101600915.30999991,1449947362.410001,1636386073.8750002,,1449947362.410001,105197.0,-7219229.0,1669586486.0,72979051.0,364351292.0,167959683.0,379820077.0,104162.0,1673.0,,2651174.0,865120.0,528773.0,-1732055.0,688827.0,96918.0,1163076160.2750072,1173132620.0550034,-71557867.5,-70968418.5,1339002.0,58059.0,,,,,,,,,,,,,,,,,,,,,1466684.0,14753144.0,3230564.0,8550920.0,11601972.0,1414940.0,,,,,,,,,,,,,,,,,,,,,,,,,,,,,,,,,,4270821.5,2478029.5,-8999292.0,921269.0,37582.5,3731551482.1499634,3656118916.844961,-260507404.0,-257197938.0,2525278.5,269070.5,3924277342.109955,33239620620.54092,36667456604.57264,,48061024065.99072,3986097.0,-247469500.0,103036357255.0,1053215121.0,17265731126.5,3501938126.5,18879384235.5,3670308.0,71883.0,,89764291.5,-47.427617790887226,2.1658,9.599232061435083,338.8134428697759,20.790016798656108,733.8021545673607,18000.0,0.6234898018587336,0.7818314824680298,0.0,0.0,0.0,0.0,0.0,0.0,1.0,0.0,0.0,0.0,0.0,0.0,0.0,1.0,0.0,0.0,0.0,0.0,1.0,0.0,1.0,0.0,0.0,0.0,0.0,1.0,0.0,0.0,0.0,0.0,0.0,0.0,0.0,0.0,0.0,0.0,0.0,0.0,1.0,0.0,0.0,0.0,0.0,0.0,0.0,0.0,0.0,0.0,0.0,0.0,0.0,0.0,0.0,0.0,0.0,0.0,0.0,0.0,0.0,0.0,0.0,0.0,0.0,0.0,0.0,0.0,0.0,0.0,0.0,0.0,0.0,0.0,0.0,0.0,0.0,0.0,0.0,0.0,0.0,0.0,0.0,0.0,0.0,0.0,0.0,0.0,0.0,0.0,0.0,0.0,0.0,0.0,0.0,0.0,0.0,0.0,0.0,0.0,0.0,0.0,0.0,0.0,0.0,1.0,0.0,0.0,0.0,0.0,0.0,0.0,0.0,0.0,0.0,0.0,0.0,0.0,0.0,0.0,0.0,0.0
101700,1,0.0,0.0,0.0,0.0,1.0,135000.0,675000.0,36747.0,675000.0,0.018029,31.895890410958906,-2054.0,-1020.0,-1349.0,,3.0,3.0,3.0,5.0,0.0922053366698282,0.3919152942401533,0.1428725230413196,,,0.9747,,,,,,,,,,,,,,0.9747,,,,,,,,,,,,,,0.9747,,,,,,,,,,,,0.0312,1.0,2.0,0.0,2.0,0.0,-662.0,0.0,0.0,0.0,0.0,0.0,2.0,1.0,1.0,1.0,1.0,1.0,0.0,0.0,0.0,0.0,0.0,0.0,0.0,0.0,1.0,0.0,0.0,0.0,0.0,0.0,0.0,0.0,0.0,0.0,0.0,0.0,0.0,0.0,0.0,0.0,0.0,0.0,0.0,3.0,13689.0,,490500.0,466870.5,0.0,0.0,0.0,0.0,-309.0,1517.0,-30.0,,39.0,-6.0,3.0,3907.35,0.0,0.0,18000.0,51898.5,12.0,-300.0,365243.0,-631.0,-301.0,-301.0,-297.0,7.0,0.0,0.3533714825084067,-1.0,13.0,12.0,6.0,-16.0,0.0,0.0,13.0,3907.35,3907.35,-456.0,-451.0,7.0,1.0,0.0,,,,,,,,,,,,,,,,,,,,,8342628547.5,184324829967.0,165518420197.5,51946797457.935,1863.0,1704.0,71125.0,70748.0,9140.0,505821.0,,,,,,,128351.0,662501.0,,,,13521584.065753024,-601594526.0,-921477211.0,-296352222.0,-1534437356.0416667,43993.0,30689.0,,,,,,,67417.9349633664,157966.82442566348,126044.64406161498,,,,,,,3712477.0,,,,,,,,,,,,,,,,436258.0,431056.0,,6422.016354002895,631666.0,625220.0,,16324.4919999998,154104.18479999062,154106.9332999901,153998.70779998714,,,,11.0,27173691.08999999,,2547777405.645,876925779.9750007,32136484.950000007,637724.9249999999,52.0,8524.0,-8810821.0,4043321.0,-4547315.0,,-5.0,2889.0,,103500.0,82071.0,0.0,0.0,0.0,0.0,-610.0,1216.0,-30.0,,102092016.4199999,1460909537.910001,1648301866.8750002,23540140.035,1460961436.410001,105655.0,-7236974.0,1672140818.0,72970219.0,364710075.0,168686894.0,380545684.0,104449.0,1675.0,286.21537458313105,2651630.0,866113.0,529414.0,-1734472.0,688827.0,96918.0,1165959238.7700107,1176014420.5500069,-71726741.0,-71136094.0,1343252.0,58125.0,,,,,,,,,,,,,,,,,,,,,1466687.0,14753183.0,3230564.0,8550933.0,11601985.0,1414943.0,1057792113.634501,,72072342498.0596,21669506008.96512,582146666.891999,5792665.7475,689.5,94245.0,-276797217.5,21934917.5,-123735841.5,,-2016210.5,,,,,,,,,,,,,,,,,,,,,4270833.5,2478035.5,-8999308.0,921269.0,37582.5,3731555389.4999633,3656122824.194961,-260507860.0,-257198389.0,2525285.5,269071.5,3924281249.4599543,33239620620.54092,36667456604.57264,1728541311.1425498,48061075964.49072,3986109.0,-247469800.0,103036722498.0,1053214490.0,17265730825.5,3501937825.5,18879383938.5,3670315.0,71883.0,20860.84670062616,89764290.5,-64.39701082288265,5.0,3.673769287288758,117.17814258250884,18.3688464364438,585.8907129125442,45000.0,-0.9009688679024191,0.4338837391175582,0.0,0.0,0.0,0.0,0.0,0.0,1.0,0.0,0.0,0.0,0.0,0.0,0.0,1.0,0.0,1.0,0.0,0.0,0.0,0.0,1.0,0.0,0.0,0.0,0.0,1.0,0.0,0.0,0.0,0.0,0.0,0.0,0.0,0.0,0.0,0.0,0.0,0.0,0.0,0.0,0.0,0.0,0.0,0.0,0.0,0.0,0.0,0.0,0.0,0.0,0.0,0.0,0.0,1.0,0.0,0.0,0.0,0.0,0.0,0.0,0.0,0.0,0.0,0.0,0.0,0.0,0.0,0.0,0.0,0.0,0.0,0.0,0.0,0.0,0.0,0.0,0.0,0.0,0.0,0.0,0.0,0.0,0.0,0.0,0.0,0.0,0.0,0.0,0.0,0.0,0.0,0.0,0.0,0.0,0.0,0.0,0.0,0.0,0.0,0.0,0.0,0.0,0.0,0.0,0.0,0.0,0.0,0.0,0.0,0.0,1.0,0.0,0.0,0.0,0.0,0.0,0.0,0.0,1.0,0.0
101711,0,0.0,1.0,0.0,1.0,0.0,90000.0,248760.0,25618.5,225000.0,0.030755,66.76986301369864,,-10264.0,-4186.0,,2.0,2.0,2.0,10.0,,0.6835038851999318,,0.1082,0.0756,0.993,0.898,0.1395,0.1,0.0862,0.3646,0.1667,0.0051,0.0829,0.1006,0.0051,0.0089,0.0777,0.0537,0.996,0.9412,0.0401,0.0403,0.0345,0.375,0.0417,0.0,0.0661,0.0685,0.0078,0.0,0.1041,0.0601,0.996,0.9396,0.1573,0.1,0.0862,0.375,0.0417,0.0052,0.0684,0.0827,0.0078,0.0009,0.0854,1.0,3.0,0.0,3.0,0.0,-1242.0,,,,,,,1.0,0.0,0.0,1.0,0.0,0.0,0.0,0.0,0.0,0.0,0.0,0.0,0.0,0.0,0.0,0.0,1.0,0.0,0.0,0.0,0.0,0.0,0.0,0.0,0.0,0.0,0.0,0.0,0.0,0.0,0.0,0.0,0.0,,,,,,,,,,,,,0.0,,5.0,14752.845,53568.0,64881.0,0.0,202500.0,24.0,-398.0,365243.0,-668.0,-338.0,-338.0,-333.0,11.0,1.0,0.0,-1.0,45.0,24.0,13.0,-20.0,0.0,0.0,42.0,14752.845,14752.845,-575.5,-563.0,7.5,1.0,0.0,,,,,,,,,,,,,,,,,,,,,8342654166.0,184325078727.0,165518645197.5,51946887457.935,,,,,,,17799.956900002293,17862.089999999116,17313.71179999807,11290.247000000085,11228.067900000093,11175.458300000058,128351.0,662503.0,4136.335500000122,4133.997500000017,3944.6537000000953,13521650.835616035,,-921481397.0,-296353464.0,-1534447620.0416667,43993.0,30689.0,11344.03279999918,11219.979999998972,10704.419099997298,22876.46760000966,22798.32300000962,22184.17410000817,,157967.50792954868,,34983.959900027905,34924.42850002834,34370.67500002875,22943.078299995923,22916.4007999955,22563.78989999573,3712487.0,8291.441300000168,8395.915100000084,8119.611600000227,9813.30590000072,9928.211600002154,10287.734199999644,16460.39019999975,16645.55789999969,16242.425899999696,828.4935000001759,813.6799000000459,759.6622000000133,3911.885800000125,3895.140800000161,3727.831600000159,436261.0,431059.0,,6422.047109002896,631668.0,625222.0,,16324.5773999998,154105.17779999058,154107.92929999012,153999.70379998715,77574.67399999624,77912.33450000657,78313.59890000649,,,,,,,,,,,,,,,,,,,,,,,,,,,103017716.32499988,1471394974.410001,1659992961.3750002,23724671.535,1471394974.410001,106457.0,-7286767.0,1687113669.0,74030164.0,367970561.0,169399315.0,383808913.0,105216.0,1687.0,288.7020505031649,2661748.0,872607.0,533383.0,-1747876.0,719049.0,96936.0,1174039837.0875106,1184471120.1375065,-72122237.5,-71533264.0,1346492.0,58546.5,,,,,,,,,,,,,,,,,,,,,1466687.0,14753183.0,3230564.0,8550978.0,11602027.0,1414948.0,,,,,,,,,,,,,,,,,,,,,,,,,,,,,,,,,,4270857.5,2478048.5,-8999328.0,921269.0,37582.5,3731570142.3449626,3656137577.039961,-260508435.5,-257198952.0,2525293.0,269072.5,3924296002.3049545,33239674188.54092,36667521485.57264,1728541311.1425498,48061278464.49072,3986133.0,-247470198.0,103037087741.0,1053213822.0,17265730487.5,3501937487.5,18879383605.5,3670326.0,71884.0,20860.84670062616,89764289.5,,2.764,3.513086246267346,234.56828741857944,9.710170384682945,648.3467464249535,45000.0,-0.9009688679024191,0.4338837391175582,0.0,0.0,0.0,0.0,0.0,1.0,0.0,0.0,0.0,1.0,0.0,0.0,0.0,0.0,0.0,0.0,0.0,0.0,1.0,0.0,1.0,0.0,0.0,0.0,0.0,1.0,0.0,0.0,0.0,0.0,0.0,0.0,0.0,0.0,0.0,0.0,0.0,0.0,0.0,0.0,0.0,0.0,0.0,0.0,0.0,0.0,0.0,0.0,0.0,0.0,0.0,0.0,0.0,0.0,0.0,0.0,0.0,0.0,0.0,0.0,0.0,0.0,0.0,0.0,0.0,0.0,0.0,0.0,0.0,0.0,0.0,0.0,0.0,0.0,0.0,0.0,0.0,0.0,0.0,0.0,0.0,0.0,0.0,0.0,0.0,0.0,0.0,0.0,0.0,0.0,0.0,0.0,0.0,0.0,0.0,0.0,0.0,0.0,0.0,0.0,0.0,0.0,0.0,0.0,0.0,1.0,0.0,1.0,0.0,0.0,1.0,0.0,0.0,0.0,0.0,0.0,0.0,0.0,1.0,0.0
101714,0,0.0,0.0,0.0,1.0,0.0,202500.0,906660.0,34308.0,675000.0,0.072508,55.52328767123288,,-7378.0,-3822.0,,2.0,1.0,1.0,16.0,0.6315963320074983,0.6879149429663663,0.4596904504249018,0.0894,0.0802,0.9771,0.6396,0.0067,0.056,0.0828,0.425,0.3438,0.0,0.0706,0.1157,0.0106,0.1004,0.063,0.0414,0.9717,0.6276,0.0,0.0,0.0345,0.1667,0.2083,0.0,0.0551,0.0537,0.0,0.0,0.0911,0.0855,0.9737,0.6377,0.0034,0.08,0.1034,0.3333,0.2917,0.0,0.0701,0.1091,0.0,0.0508,0.2457,1.0,0.0,0.0,0.0,0.0,-389.0,0.0,0.0,0.0,0.0,2.0,3.0,1.0,0.0,0.0,1.0,1.0,0.0,0.0,0.0,0.0,0.0,0.0,0.0,0.0,0.0,0.0,0.0,1.0,0.0,0.0,0.0,0.0,0.0,0.0,0.0,0.0,0.0,0.0,0.0,0.0,0.0,0.0,0.0,5.0,15989.985,0.0,66398.895,0.0,0.0,0.0,0.0,0.0,-363.0,134.0,-18.0,-129.0,59.0,-6.0,5.0,7326.2925,0.0,0.0,4599.0,124245.0,6.0,-157.0,182548.0,-225.5,182611.5,182611.5,182615.5,16.0,0.0,0.0983868919907106,-1.0,13.0,12.0,6.0,-7.0,0.0,0.0,18.0,4527.585,4527.585,-120.5,-114.0,5.0,1.0,5.0,85383.0,202500.0,0.0,37784.7,0.0,37784.7,2250.0,9471.78,0.0,85383.0,85383.0,85383.0,0.0,4.0,0.0,4.0,1.0,-3.0,0.0,0.0,8342688474.0,184325985387.0,165519320197.5,51947089957.935,1863.0,1704.0,71125.0,70750.0,9140.0,505824.0,17800.046300002294,17862.181099999118,17313.774799998067,11290.327200000083,11228.153400000088,11175.49970000006,128351.0,662505.0,4136.342200000122,4134.000900000016,3944.6537000000953,13521706.358903708,,-921485219.0,-296353853.0,-1534454998.0416667,43993.0,30689.0,11344.08879999918,11220.059999998972,10704.419099997298,22876.55040000966,22798.42640000962,22184.208600008173,67418.5665596984,157968.19584449165,126045.1037520654,34984.38490002791,34924.76180002834,34370.84170002875,22943.42209999592,22916.692499995497,22563.99819999573,3712503.0,8291.441300000168,8395.915100000084,8119.611600000227,9813.37650000072,9928.281700002157,10287.789299999644,16460.505899999753,16645.666999999692,16242.479599999697,828.504100000176,813.6799000000459,759.6622000000133,3911.986200000125,3895.191600000161,3727.831600000159,436261.0,431059.0,,6422.119617002895,631669.0,625223.0,,16324.8230999998,154106.15489999054,154108.90299999012,154000.67549998718,77575.31359999624,77912.97220000657,78314.22650000651,12.0,27278427.195,8115157.889999998,2607100574.04,894157568.8650006,33307020.675,637724.9249999999,54.0,8524.0,-8936267.0,4137994.0,-4609457.0,-4994919.0,-5.5,15989.985,0.0,66398.895,0.0,0.0,0.0,0.0,0.0,-540.0,3.0,-124.0,-129.0,103106977.40249988,1472033231.910001,1661272009.8750002,23740250.535,1472056226.910001,106551.0,-7298311.0,1689487601.5,74021417.0,368329393.0,169758537.0,384167786.0,105361.0,1689.0,288.9018254843652,2671401.0,874103.0,534247.0,-1751235.0,719049.0,96936.0,1174855952.6775146,1185220383.187509,-72229822.0,-71638682.0,1347216.5,58642.5,1124685152.1450007,2942820000.0,97199952.75,152122282.24499995,6616971.9,48229429.49999996,64290324.46499993,163154790.22499907,151198875.53999957,1079839936.35,1120313240.0549982,1120351401.989998,4898.0,12706.0,93.0,7715.0,371218.0,-653702.0,248020.0,539.0,1466692.0,14753242.0,3230569.0,8550991.0,11602045.0,1414953.0,1057808103.619501,801525230.1899952,72072408896.9546,21669506008.96512,582146666.891999,5792665.7475,689.5,94245.0,-276797580.5,21935051.5,-123735859.5,-218602719.0,-2016216.5,5919512951.384961,18711551250.0,198745595.325,447802478.6174977,1948107.735,256654969.0200008,308949504.59249866,636270720.2549981,458944341.9524992,5704784561.947532,5882813306.6624975,5883056489.407499,13376.0,80808.0,44.0,70326.5,970963.0,-1697409.0,177364.0,6755.0,4270869.5,2478054.5,-8999335.0,921269.0,37582.5,3731574669.9299626,3656142104.624961,-260508556.0,-257199066.0,2525298.0,269073.5,3924303328.597455,33239674188.54092,36667521485.57264,1728545910.1425498,48061402709.49072,3986139.0,-247470355.0,103037270289.0,1053213596.5,17265913099.0,3502120099.0,18879566221.0,3670342.0,71884.0,20860.94508751815,89764288.5,,4.477333333333333,5.902413431269674,327.72139889893486,26.42707240293809,1467.3179433368314,101250.0,-0.9009688679024191,-0.433883739117558,0.0,0.0,0.0,0.0,0.0,0.0,1.0,0.0,0.0,1.0,0.0,0.0,0.0,0.0,0.0,0.0,0.0,0.0,1.0,0.0,1.0,0.0,0.0,0.0,0.0,1.0,0.0,0.0,0.0,0.0,0.0,0.0,0.0,0.0,0.0,0.0,0.0,0.0,0.0,0.0,0.0,0.0,0.0,0.0,0.0,0.0,0.0,0.0,0.0,0.0,0.0,0.0,0.0,0.0,0.0,0.0,0.0,0.0,0.0,0.0,0.0,0.0,0.0,0.0,0.0,0.0,0.0,0.0,0.0,0.0,0.0,0.0,0.0,0.0,0.0,0.0,0.0,0.0,0.0,0.0,0.0,0.0,0.0,0.0,0.0,0.0,0.0,0.0,0.0,0.0,0.0,0.0,0.0,0.0,0.0,0.0,0.0,0.0,0.0,0.0,0.0,0.0,0.0,0.0,0.0,1.0,1.0,0.0,0.0,0.0,1.0,0.0,0.0,1.0,0.0,0.0,0.0,0.0,0.0,0.0
101715,1,0.0,0.0,0.0,1.0,0.0,112500.0,424255.5,33646.5,346500.0,0.018029,35.794520547945204,-348.0,-2746.0,-956.0,,2.0,3.0,2.0,7.0,,0.4836453014247956,0.2750003523983893,,,,,,,,,,,,,,,,,,,,,,,,,,,,,,,,,,,,,,,,,,,,,3.0,1.0,3.0,1.0,-1045.0,0.0,0.0,0.0,0.0,0.0,1.0,1.0,1.0,0.0,1.0,0.0,0.0,0.0,0.0,0.0,0.0,0.0,0.0,0.0,1.0,0.0,0.0,0.0,0.0,0.0,0.0,0.0,0.0,0.0,0.0,0.0,0.0,0.0,0.0,0.0,0.0,0.0,0.0,5.0,7020.0,0.0,25546.5,33624.0,0.0,0.0,0.0,0.0,-651.0,445.0,-16.0,-119.0,94.0,-9.0,7.0,8290.98,50625.0,63760.5,0.0,84159.0,12.0,-162.0,365243.0,-1004.0,-913.0,-135.0,182168.5,7.0,0.0,0.0,3.0,15.0,6.0,6.0,-60.0,0.0,0.0,54.0,3089.97,3089.97,-755.0,-755.0,12.5,0.0,34.0,0.0,45000.0,0.0,0.0,0.0,0.0,0.0,3089.97,3089.97,0.0,0.0,0.0,0.0,0.0,0.0,0.0,4.0,-17.5,0.0,0.0,8342722120.5,184326409642.5,165519666697.5,51947202457.935,1863.0,1704.0,71125.0,70750.0,9140.0,505825.0,,,,,,,128351.0,662507.0,,,,13521742.153424256,-601594874.0,-921486175.0,-296354898.0,-1534457744.0416667,43994.0,30690.0,,,,,,,,157968.67948979305,126045.3787524178,,,,,,,3712510.0,,,,,,,,,,,,,,,,436264.0,431062.0,,6422.137646002895,631672.0,625225.0,,,,,,,,,22.0,27292197.195,8115157.889999998,2607985526.04,894380953.3650006,33307020.675,637724.9249999999,54.0,8524.0,-8939090.0,4139711.0,-4609508.0,-4995082.0,-10.5,7020.0,0.0,67500.0,67248.0,0.0,0.0,0.0,0.0,-651.0,445.0,-7.0,-206.0,103140371.38499989,1472644250.910001,1662120831.3750002,23744750.535,1472560091.910001,106635.0,-7302238.0,1690582813.0,74018224.0,368509711.5,169757132.0,384348579.5,105425.0,1689.5,289.0103439089458,2672914.0,874245.0,534322.0,-1751614.0,719049.0,96936.0,1175101779.195015,1185446761.6050096,-72256020.0,-71664546.0,1347605.0,58664.0,1125305998.1100008,2944615500.0,97348452.75,152328090.19499993,6616971.9,48286737.44999996,64315328.12999993,163236719.78999907,151269403.9949996,1080415022.13,1120912558.019998,1120950719.9549985,4914.0,12732.0,93.0,7725.0,371285.0,-653992.5,248028.0,539.0,1466697.0,14753336.0,3230603.0,8551006.0,11602099.0,1414960.0,1057815123.619501,801525230.1899952,72072434443.4546,21669539632.96512,582146666.891999,5792665.7475,689.5,94245.0,-276798231.5,21935496.5,-123735875.5,-218602838.0,-2016225.5,5919512951.384961,18711596250.0,198745595.325,447802478.6174977,1948107.735,256654969.0200008,308949504.59249866,636273810.2249981,458947431.9224992,5704784561.947532,5882813306.6624975,5883056489.407499,13376.0,80808.0,44.0,70326.5,970967.0,-1697426.5,177364.0,6755.0,4270875.5,2478060.5,-8999395.0,921269.0,37582.5,3731577759.899962,3656145194.594961,-260509311.0,-257199821.0,2525310.5,269073.5,3924311619.577455,33239724813.54092,36667585246.07264,1728545910.1425498,48061486868.49072,3986151.0,-247470517.0,103037635532.0,1053212592.5,17265912186.0,3502119964.0,18879748389.5,3670349.0,71884.0,20860.94508751815,89764291.5,-9.722158438576349,3.77116,3.3435870001337435,119.68209358012976,12.609201551424368,451.3403240256421,56250.0,-0.9009688679024191,-0.433883739117558,0.0,0.0,0.0,0.0,0.0,0.0,1.0,0.0,0.0,0.0,0.0,0.0,0.0,1.0,0.0,0.0,0.0,0.0,1.0,0.0,1.0,0.0,0.0,0.0,0.0,1.0,0.0,0.0,0.0,0.0,0.0,1.0,0.0,0.0,0.0,0.0,0.0,0.0,0.0,0.0,0.0,0.0,0.0,0.0,0.0,0.0,0.0,0.0,0.0,0.0,0.0,0.0,0.0,1.0,0.0,0.0,0.0,0.0,0.0,0.0,0.0,0.0,0.0,0.0,0.0,0.0,0.0,0.0,0.0,0.0,0.0,0.0,0.0,0.0,0.0,0.0,0.0,0.0,0.0,0.0,0.0,0.0,0.0,0.0,0.0,0.0,0.0,0.0,0.0,0.0,0.0,0.0,0.0,0.0,0.0,0.0,0.0,0.0,0.0,0.0,0.0,0.0,0.0,0.0,0.0,0.0,0.0,0.0,0.0,0.0,0.0,0.0,0.0,0.0,0.0,0.0,0.0,0.0,0.0,0.0
101728,0,0.0,0.0,0.0,1.0,0.0,157500.0,543037.5,30451.5,463500.0,0.0031219999999999,47.85479452054796,-4226.0,-477.0,-1017.0,,1.0,3.0,3.0,13.0,0.7108453974008633,0.5774835438833401,0.4507472818545589,,,,,,,,,,,,,,,,,,,,,,,,,,,,,,,,,,,,,,,,,,,,,5.0,1.0,5.0,1.0,-1617.0,0.0,0.0,0.0,0.0,2.0,2.0,1.0,1.0,0.0,1.0,1.0,0.0,0.0,0.0,0.0,0.0,0.0,0.0,0.0,1.0,0.0,0.0,0.0,0.0,0.0,0.0,0.0,0.0,0.0,0.0,0.0,0.0,0.0,0.0,0.0,0.0,0.0,0.0,5.0,0.0,0.0,94518.0,0.0,0.0,0.0,0.0,0.0,-1399.0,-1155.0,-965.0,-1153.0,209.0,-20.0,8.0,7504.47,58790.25,49860.0,3375.0,69705.0,10.0,-627.0,365243.0,-718.5,-238.5,-238.5,-231.5,12.0,0.0,0.0542736333434007,55.0,57.0,12.0,6.0,-17.0,0.0,0.0,52.0,9629.73,9629.73,-535.5,-523.5,7.0,1.0,0.0,,,,,,,,,,,,,,,,,,,,,8342752572.0,184326952680.0,165520130197.5,51947359957.935,1863.0,1704.0,71125.0,70752.0,9140.0,505827.0,,,,,,,128351.0,662508.0,,,,13521790.008218776,-601599100.0,-921487192.0,-296356515.0,-1534458221.0416667,43995.0,30691.0,,,,,,,67419.27740509581,157969.25697333695,126045.82949969966,,,,,,,3712523.0,,,,,,,,,,,,,,,,436269.0,431067.0,,6422.140768002895,631675.0,625228.0,,,,,,,,,46.0,27365043.195,8155774.124999997,2622915591.885,899458477.2900006,33428520.675,637724.9249999999,54.0,8524.0,-8986867.0,4121364.0,-4632450.0,-5025050.0,-22.5,0.0,0.0,94518.0,0.0,0.0,0.0,0.0,0.0,-1399.0,-1155.0,-965.0,-1153.0,104054465.60999992,1484292892.410001,1675104870.3750002,23937895.035,1484434574.910001,107329.0,-7347307.5,1698249102.5,73993631.0,371598435.0,171571517.0,387803137.0,106277.5,1695.0,290.69474739286125,2699414.0,878997.0,537189.0,-1759135.0,719075.0,96958.0,1187566745.805015,1197442612.7100103,-72600050.0,-72006079.0,1357977.5,58942.0,,,,,,,,,,,,,,,,,,,,,1466702.0,14753545.0,3230603.0,8551063.0,11602151.0,1414968.0,1057815123.619501,801525230.1899952,72072528961.4546,21669539632.96512,582146666.891999,5792665.7475,689.5,94245.0,-276799630.5,21934341.5,-123736840.5,-218603991.0,-2016245.5,,,,,,,,,,,,,,,,,,,,,4270887.5,2478066.5,-8999412.0,921269.0,37582.5,3731587389.6299615,3656154824.3249607,-260509846.5,-257200344.5,2525317.5,269074.5,3924319124.047455,33239783603.79092,36667635106.07264,1728549285.1425498,48061556573.49072,3986161.0,-247471144.0,103038000775.0,1053211874.0,17265911947.5,3502119725.5,18879748158.0,3670361.0,71884.0,20860.99936115149,89764346.5,-88.30881090055533,3.4478571428571434,5.172159006945472,247.5126065049768,17.832865376089853,853.3881082853737,157500.0,-0.9009688679024191,0.4338837391175582,0.0,0.0,0.0,0.0,0.0,0.0,1.0,0.0,1.0,0.0,0.0,0.0,0.0,0.0,0.0,0.0,1.0,0.0,0.0,0.0,0.0,0.0,0.0,1.0,0.0,0.0,0.0,1.0,0.0,0.0,0.0,0.0,0.0,0.0,0.0,0.0,0.0,0.0,0.0,0.0,1.0,0.0,0.0,0.0,0.0,0.0,0.0,0.0,0.0,0.0,0.0,0.0,0.0,0.0,0.0,0.0,0.0,0.0,0.0,0.0,0.0,0.0,0.0,0.0,0.0,0.0,0.0,0.0,0.0,0.0,0.0,0.0,0.0,0.0,0.0,0.0,0.0,0.0,0.0,0.0,0.0,0.0,0.0,0.0,0.0,0.0,0.0,0.0,0.0,0.0,1.0,0.0,0.0,0.0,0.0,0.0,0.0,0.0,0.0,0.0,0.0,0.0,0.0,0.0,0.0,0.0,0.0,0.0,0.0,0.0,0.0,0.0,0.0,0.0,0.0,0.0,0.0,0.0,0.0,0.0
101732,0,0.0,0.0,0.0,1.0,0.0,157500.0,218016.0,17352.0,180000.0,0.035792,53.030136986301365,,-971.0,-2267.0,,2.0,2.0,2.0,14.0,0.4329221768371199,0.6210216540210217,0.5028782772082183,,,,,,,,,,,,,,,,,,,,,,,,,,,,,,,,,,,,,,,,,,,,,0.0,0.0,0.0,0.0,-690.0,0.0,0.0,0.0,0.0,0.0,1.0,1.0,0.0,0.0,1.0,0.0,1.0,0.0,0.0,0.0,0.0,0.0,0.0,0.0,1.0,0.0,0.0,0.0,0.0,0.0,0.0,0.0,0.0,0.0,0.0,0.0,0.0,0.0,0.0,0.0,0.0,0.0,0.0,6.0,13067.4825,0.0,175402.4625,83505.51000000001,0.0,0.0,0.0,0.0,-769.0,108.0,-73.0,-613.5,127.0,-12.0,3.0,4655.6325,45441.0,51439.5,0.0,45441.0,11.0,-690.0,365243.0,-944.0,181816.5,-644.0,181819.0,13.0,0.0,0.0,44.0,16.0,5.0,5.0,-53.5,0.0,0.0,11.0,5842.485,5842.485,-174.0,-158.0,3.0,1.0,0.0,,,,,,,,,,,,,,,,,,,,,8342769924.0,184327170696.0,165520310197.5,51947517457.935,1863.0,1704.0,71125.0,70752.0,9140.0,505828.0,,,,,,,128351.0,662510.0,,,,13521843.038355762,,-921489459.0,-296357205.0,-1534459192.0416667,43995.0,30691.0,,,,,,,67419.71032727265,157969.877994991,126046.33237797688,,,,,,,3712537.0,,,,,,,,,,,,,,,,436269.0,431067.0,,6422.176560002896,631677.0,625230.0,,,,,,,,,26.0,27488072.677499995,8155774.124999997,2628342353.385,901436383.5750004,33428520.675,637724.9249999999,54.0,8524.0,-9004485.5,4119637.0,-4642028.0,-5035669.0,-12.5,8595.0,0.0,175405.5,92365.02,0.0,0.0,0.0,0.0,-853.0,108.0,-100.0,-757.0,104083031.87999992,1484820562.410001,1675644870.3750002,23946040.035,1484820562.410001,107379.0,-7357280.0,1700075317.5,73988094.0,371959634.0,171567690.0,388164361.5,106379.0,1695.0,290.9721250879917,2700200.0,879899.5,537571.0,-1761012.5,719096.0,96979.0,1188033585.165014,1197883649.6100106,-72661866.0,-72067291.0,1358463.0,59008.0,,,,,,,,,,,,,,,,,,,,,1466708.0,14753672.0,3230603.0,8551079.0,11602162.0,1414971.0,1057828191.102001,801525230.1899952,72072704363.9171,21669623138.47512,582146666.891999,5792665.7475,689.5,94245.0,-276800399.5,21934449.5,-123736913.5,-218604604.5,-2016257.5,,,,,,,,,,,,,,,,,,,,,4270892.5,2478071.5,-8999465.5,921269.0,37582.5,3731593232.1149626,3656160666.809961,-260510020.5,-257200502.5,2525320.5,269075.5,3924323779.6799545,33239829044.79092,36667686545.57264,1728549285.1425498,48061602014.49072,3986172.0,-247471834.0,103038366018.0,1053210930.0,17266093764.0,3502119081.5,18879929977.0,3670374.0,71884.0,20860.99936115149,89764390.5,,1.3842285714285714,9.076763485477178,481.34201102711313,12.564315352697095,666.2873642926163,78750.0,0.6234898018587336,0.7818314824680298,0.0,0.0,0.0,0.0,0.0,0.0,1.0,0.0,0.0,1.0,0.0,0.0,0.0,0.0,0.0,0.0,0.0,0.0,1.0,0.0,1.0,0.0,0.0,0.0,0.0,1.0,0.0,0.0,0.0,0.0,0.0,0.0,0.0,0.0,0.0,0.0,0.0,0.0,0.0,0.0,0.0,0.0,0.0,0.0,0.0,0.0,0.0,0.0,0.0,0.0,0.0,0.0,0.0,0.0,0.0,0.0,0.0,0.0,0.0,0.0,0.0,0.0,0.0,0.0,0.0,0.0,0.0,0.0,0.0,0.0,0.0,0.0,0.0,0.0,0.0,0.0,0.0,0.0,0.0,0.0,0.0,0.0,0.0,0.0,0.0,0.0,0.0,0.0,0.0,0.0,0.0,0.0,0.0,0.0,0.0,0.0,0.0,0.0,0.0,0.0,0.0,0.0,0.0,0.0,0.0,1.0,0.0,0.0,0.0,0.0,0.0,0.0,0.0,0.0,0.0,0.0,0.0,0.0,0.0,0.0
101757,0,0.0,0.0,0.0,0.0,0.0,94500.0,174132.0,20664.0,157500.0,0.011703,64.21643835616439,,-10725.0,-4641.0,,2.0,2.0,2.0,15.0,0.3023100978146823,0.3359861074328905,0.2896112383820055,0.033,,0.9603,,,0.0,0.1379,0.125,,0.0347,,0.0436,,0.0,0.0336,,0.9603,,,0.0,0.1379,0.125,,0.0355,,0.0455,,0.0,0.0333,,0.9603,,,0.0,0.1379,0.125,,0.0353,,0.0444,,0.0,0.0343,1.0,2.0,1.0,2.0,1.0,-732.0,0.0,0.0,0.0,0.0,2.0,3.0,1.0,0.0,0.0,1.0,0.0,0.0,0.0,0.0,0.0,0.0,0.0,0.0,0.0,1.0,0.0,0.0,0.0,0.0,0.0,0.0,0.0,0.0,0.0,0.0,0.0,0.0,0.0,0.0,0.0,0.0,0.0,0.0,9.0,0.0,0.0,40500.0,0.0,0.0,0.0,0.0,0.0,-277.0,-142.0,-131.0,-252.0,220.0,-20.0,5.0,10557.4275,135283.5,135283.5,0.0,149037.75,18.0,-518.0,365243.0,-498.5,-36.5,98.5,-31.0,12.0,0.0,0.0,20.0,54.0,24.0,12.0,-11.0,0.0,0.0,75.0,15020.325,6766.11,-249.0,-247.0,9.0,1.0,13.0,115309.35,135000.0,0.0,0.0,0.0,0.0,0.0,6750.0,0.0,113619.915,115309.35,115309.35,0.0,0.0,0.0,0.0,0.0,-7.0,0.0,0.0,8342790588.0,184327344828.0,165520467697.5,51947611957.935,1863.0,1704.0,71125.0,70754.0,9140.0,505831.0,17800.079300002293,17862.214399999117,17313.808399998066,,,,128351.0,662512.0,,,,13521907.25479412,,-921494100.0,-296357937.0,-1534469917.0416667,43996.0,30692.0,11344.08879999918,11220.059999998972,10704.419099997298,22876.688300009657,22798.56430000962,22184.34650000817,67420.01263737048,157970.21398109847,126046.62198921526,34984.50990002791,34924.88680002834,34370.96670002875,,,,3712552.0,8291.476000000168,8395.950400000083,8119.647100000227,,,,16460.54949999975,16645.71139999969,16242.525099999695,,,,3911.986200000125,3895.191600000161,3727.831600000159,436271.0,431069.0,,6422.188263002896,631679.0,625232.0,,16324.8573999998,154107.11519999054,154109.86329999013,154001.63579998715,,,,10.0,27635550.299999997,8175895.514999999,2672221758.7049994,913047650.1000004,33857681.175,637724.9249999999,55.0,8524.0,-9150615.0,4114054.0,-4725760.0,-5124395.0,-4.5,0.0,0.0,40500.0,0.0,0.0,0.0,0.0,0.0,-1357.0,-770.0,-749.0,-770.0,105030706.31999992,1499068495.170001,1691945418.3750002,24228128.29499999,1499090995.170001,108505.0,-7447886.0,1721074469.0,75017605.5,377204577.0,173898779.0,393409874.5,107916.0,1713.0,295.68142507856675,2737131.0,888510.0,542805.5,-1782401.0,719185.0,97015.0,1198943768.745016,1208721490.7850115,-73569981.0,-72967078.0,1375410.0,59663.0,1167942696.2549994,3025975500.0,101163237.57,160169150.42999998,6616971.9,52294684.58999997,66496127.26499989,172185092.45999882,160118586.76499963,1121110600.0499997,1163262253.364998,1163307030.2999983,5119.0,13144.0,93.0,7932.0,377665.0,-662265.0,248085.0,588.0,1466717.0,14753892.0,3230616.0,8551133.0,11602237.0,1414976.0,1057828191.102001,801525230.1899952,72072744863.9171,21669623138.47512,582146666.891999,5792665.7475,689.5,94245.0,-276800676.5,21934307.5,-123737044.5,-218604856.5,-2016277.5,5919628260.7349615,18711731250.0,198745595.325,447802478.6174977,1948107.735,256654969.0200008,308949504.59249866,636280560.2249981,458947431.9224992,5704898181.862532,5882928616.012499,5883171798.7575,13376.0,80808.0,44.0,70326.5,970967.0,-1697433.5,177364.0,6755.0,4270916.5,2478083.5,-8999476.5,921269.0,37582.5,3731608252.439962,3656167432.919961,-260510269.5,-257200749.5,2525329.5,269076.5,3924334337.107455,33239964328.29092,36667821829.07264,1728549285.1425498,48061751052.24072,3986190.0,-247472352.0,103038731261.0,1053210431.5,17266093727.5,3502119180.0,18879929946.0,3670386.0,71884.0,20860.99936115149,89764410.5,,1.842666666666667,4.573170731707316,293.6727363848981,8.426829268292684,541.1409622452388,47250.0,0.6234898018587336,0.7818314824680298,0.0,0.0,0.0,0.0,0.0,0.0,1.0,0.0,0.0,1.0,0.0,0.0,0.0,0.0,0.0,0.0,0.0,0.0,1.0,1.0,0.0,0.0,0.0,0.0,0.0,1.0,0.0,0.0,0.0,0.0,0.0,0.0,0.0,0.0,0.0,0.0,0.0,0.0,0.0,0.0,0.0,0.0,0.0,0.0,0.0,0.0,0.0,0.0,0.0,0.0,0.0,0.0,0.0,0.0,0.0,0.0,0.0,0.0,0.0,0.0,0.0,0.0,0.0,0.0,0.0,0.0,0.0,0.0,0.0,0.0,0.0,0.0,0.0,0.0,0.0,0.0,0.0,0.0,0.0,0.0,0.0,0.0,0.0,0.0,0.0,0.0,0.0,0.0,0.0,0.0,0.0,0.0,0.0,0.0,0.0,0.0,0.0,0.0,0.0,0.0,0.0,0.0,0.0,0.0,0.0,1.0,0.0,0.0,0.0,0.0,1.0,0.0,0.0,1.0,0.0,0.0,0.0,0.0,0.0,0.0
101758,0,0.0,1.0,1.0,1.0,1.0,216000.0,163512.0,10449.0,135000.0,0.028663,25.2,-1074.0,-806.0,-1626.0,7.0,3.0,2.0,2.0,8.0,0.3401025670068576,0.5880481690382212,0.511891801533151,0.0639,0.0234,0.9747,,,0.0,0.1207,0.1667,,,,0.0373,,0.0,0.063,0.0,0.9747,,,0.0,0.1034,0.1667,,,,0.036,,0.0,0.0645,0.0234,0.9747,,,0.0,0.1207,0.1667,,,,0.038,,0.0,0.0522,1.0,1.0,0.0,1.0,0.0,-803.0,0.0,0.0,0.0,0.0,0.0,2.0,1.0,1.0,1.0,1.0,0.0,1.0,0.0,0.0,0.0,0.0,0.0,0.0,0.0,0.0,0.0,0.0,0.0,0.0,1.0,0.0,0.0,0.0,0.0,0.0,0.0,0.0,0.0,0.0,0.0,0.0,0.0,0.0,3.0,49419.0,0.0,135000.0,0.0,0.0,0.0,0.0,0.0,-748.0,660.0,-141.0,-192.0,57.0,-10.0,2.0,4832.55,43976.25,43976.25,0.0,43976.25,10.0,-720.0,365243.0,-673.5,-448.5,-403.5,-444.0,10.5,0.0,0.0,35.0,20.0,10.0,6.0,-19.5,0.0,0.0,17.0,6070.05,6070.05,-582.0,-567.0,5.0,1.0,0.0,,,,,,,,,,,,,,,,,,,,,8342801037.0,184327508340.0,165520602697.5,51947827957.935,1863.0,1704.0,71125.0,70754.0,9140.0,505833.0,17800.143200002294,17862.278899999117,17313.871399998065,11290.350600000083,11228.176800000088,11175.49970000006,128352.0,662515.0,,,,13521932.454794118,-601600174.0,-921495726.0,-296358740.0,-1534470723.0416667,43996.0,30692.0,11344.08879999918,11220.059999998972,10704.419099997298,22876.80900000966,22798.68500000962,22184.44990000817,67420.35273993747,157970.80202926748,126047.13388101678,34984.67660002791,34925.05350002834,34371.13340002875,,,,3712560.0,,,,,,,16460.58679999975,16645.74939999969,16242.561099999695,,,,3911.986200000125,3895.191600000161,3727.831600000159,436272.0,431070.0,1262497.0,6422.216926002896,631681.0,625234.0,,16324.9095999998,154108.08989999053,154110.83799999012,154002.61049998715,,,,25.0,27714919.32,8178563.744999997,2674644648.7049994,914715363.6000004,33857681.175,637724.9249999999,55.0,8524.0,-9155170.0,4113731.0,-4727604.0,-5126663.0,-12.0,49419.0,0.0,135000.0,0.0,0.0,0.0,0.0,0.0,-748.0,660.0,-141.0,-192.0,105068445.83999991,1499707632.420001,1692631058.6250002,24228128.29499999,1499707632.420001,108544.0,-7450146.5,1721987450.5,75015759.0,377386430.0,174080755.0,393591739.5,107960.5,1713.0,295.68142507856675,2737233.5,889242.0,543204.0,-1782956.0,719201.0,97031.0,1199988170.3700137,1209496032.40501,-73588529.0,-72985121.0,1375866.0,59706.0,,,,,,,,,,,,,,,,,,,,,1466720.0,14753949.0,3230616.0,8551153.0,11602254.0,1414978.0,1057877610.102001,801525230.1899952,72072879863.9171,21669623138.47512,582146666.891999,5792665.7475,689.5,94245.0,-276801424.5,21934967.5,-123737185.5,-218605048.5,-2016287.5,,,,,,,,,,,,,,,,,,,,,4270926.5,2478089.5,-8999496.0,921269.0,37582.5,3731614322.4899626,3656173502.969961,-260510851.5,-257201316.5,2525334.5,269077.5,3924339169.657455,33240008304.54092,36667865805.32264,1728549285.1425498,48061795028.49072,3986200.0,-247473072.0,103039096504.0,1053209758.0,17266093279.0,3502118776.5,18879929502.0,3670396.5,71884.0,20860.99936115149,89764445.5,-42.61904761904762,0.757,20.671834625323,520.9302325581397,15.648578811369507,394.3441860465116,72000.0,-0.2225209339563143,0.9749279121818236,0.0,0.0,0.0,0.0,0.0,0.0,1.0,0.0,0.0,0.0,0.0,0.0,0.0,1.0,0.0,0.0,0.0,0.0,1.0,1.0,0.0,0.0,0.0,0.0,0.0,1.0,0.0,0.0,0.0,0.0,0.0,0.0,0.0,0.0,0.0,0.0,0.0,0.0,0.0,0.0,0.0,0.0,0.0,0.0,0.0,0.0,0.0,0.0,0.0,0.0,0.0,0.0,0.0,1.0,0.0,0.0,0.0,0.0,0.0,0.0,0.0,0.0,0.0,0.0,0.0,0.0,0.0,0.0,0.0,0.0,0.0,0.0,0.0,0.0,0.0,0.0,0.0,0.0,0.0,0.0,0.0,0.0,0.0,0.0,0.0,0.0,0.0,0.0,0.0,0.0,0.0,0.0,0.0,0.0,0.0,0.0,0.0,0.0,0.0,0.0,0.0,0.0,0.0,0.0,0.0,0.0,0.0,0.0,0.0,0.0,1.0,0.0,0.0,0.0,0.0,0.0,0.0,0.0,1.0,0.0
101759,0,0.0,0.0,0.0,0.0,1.0,157500.0,468333.0,30060.0,382500.0,0.00496,35.536986301369865,-1774.0,-2704.0,-4319.0,,3.0,2.0,2.0,12.0,0.2763185054472403,0.6418724119778133,0.5602843280409464,,,,,,,,,,,,,,,,,,,,,,,,,,,,,,,,,,,,,,,,,,,,,0.0,0.0,0.0,0.0,-1612.0,0.0,0.0,0.0,0.0,0.0,4.0,1.0,1.0,0.0,1.0,0.0,0.0,0.0,0.0,0.0,0.0,0.0,0.0,0.0,1.0,0.0,0.0,0.0,0.0,0.0,0.0,0.0,0.0,0.0,0.0,0.0,0.0,0.0,0.0,0.0,0.0,0.0,0.0,2.0,0.0,,62032.5,27481.5,0.0,0.0,0.0,0.0,-898.0,-547.5,-635.0,-1240.0,61.0,-23.0,3.0,17582.625,135000.0,163255.5,7029.0,135000.0,12.0,-1164.0,365243.0,-1134.0,-804.0,-804.0,-801.0,13.0,1.0,0.1042632998283892,-1.0,42.0,24.0,7.5,-21.5,0.0,0.0,41.0,24512.49,24512.49,-604.0,-598.0,8.0,1.0,0.0,,,,,,,,,,,,,,,,,,,,,8342831097.0,184327976673.0,165520985197.5,51947985457.935,1863.0,1704.0,71125.0,70754.0,9140.0,505837.0,,,,,,,128353.0,662518.0,,,,13521967.99178042,-601601948.0,-921500045.0,-296360352.0,-1534473427.0416667,43996.0,30692.0,,,,,,,67420.62905844292,157971.44390167945,126047.69416534484,,,,,,,3712572.0,,,,,,,,,,,,,,,,436272.0,431070.0,,6422.221886002895,631683.0,625236.0,,,,,,,,,30.5,27714919.32,,2674823744.97,914742845.1000004,33857681.175,637724.9249999999,55.0,8524.0,-9157622.0,4112545.5,-4729044.0,-5127903.0,-14.75,0.0,,37993.5,0.0,0.0,0.0,0.0,0.0,-1612.0,-1276.0,-1240.0,-1240.0,105102601.0199999,1499940541.170001,1692888325.8750002,24235157.29499999,1499940541.170001,108567.0,-7453241.0,1722900558.0,75012753.0,377384843.0,174078396.0,393590161.0,107992.0,1714.0,295.7856883783952,2737338.0,889578.0,543375.5,-1783881.0,719201.0,97031.0,1200402303.8400135,1209910165.8750098,-73614410.0,-73010495.0,1376043.0,59735.0,,,,,,,,,,,,,,,,,,,,,1466722.0,14754010.0,3230616.0,8551195.0,11602295.0,1414981.0,1057877610.102001,,72072941896.4171,21669650619.97512,582146666.891999,5792665.7475,689.5,94245.0,-276802322.5,21934420.0,-123737820.5,-218606288.5,-2016310.5,,,,,,,,,,,,,,,,,,,,,4270950.5,2478097.0,-8999517.5,921269.0,37582.5,3731638834.979962,3656198015.459961,-260511455.5,-257201914.5,2525342.5,269078.5,3924356752.282455,33240143304.54092,36668029060.82264,1728556314.1425498,48061930028.49072,3986212.0,-247474236.0,103039461747.0,1053208624.0,17266092475.0,3502117972.5,18879928701.0,3670409.5,71885.0,20861.103624451323,89764444.5,-49.91982113946496,2.9735428571428573,5.239520958083832,186.19678451316545,15.57994011976048,553.6641186120909,52500.0,-0.2225209339563143,0.9749279121818236,0.0,0.0,0.0,0.0,0.0,0.0,1.0,0.0,0.0,0.0,0.0,0.0,0.0,1.0,0.0,0.0,0.0,0.0,1.0,0.0,1.0,0.0,0.0,0.0,0.0,1.0,0.0,0.0,0.0,0.0,0.0,0.0,0.0,0.0,0.0,0.0,0.0,0.0,1.0,0.0,0.0,0.0,0.0,0.0,0.0,0.0,0.0,0.0,0.0,0.0,0.0,0.0,0.0,1.0,0.0,0.0,0.0,0.0,0.0,0.0,0.0,0.0,0.0,0.0,0.0,0.0,0.0,0.0,0.0,0.0,0.0,0.0,0.0,0.0,0.0,0.0,0.0,0.0,0.0,0.0,0.0,0.0,0.0,0.0,0.0,0.0,0.0,0.0,0.0,0.0,0.0,0.0,0.0,0.0,0.0,0.0,0.0,0.0,0.0,0.0,0.0,0.0,0.0,0.0,0.0,0.0,0.0,0.0,0.0,0.0,0.0,0.0,0.0,0.0,0.0,0.0,0.0,0.0,0.0,0.0
101762,0,0.0,0.0,0.0,0.0,0.0,675000.0,941580.0,98874.0,900000.0,0.072508,47.20821917808219,-2061.0,-7999.0,-774.0,,2.0,1.0,1.0,18.0,0.7539386106949737,0.6871350905026973,0.4525335592581747,0.3804,,0.9811,,,0.64,0.2759,0.4583,,,,,,,0.3876,,0.9811,,,0.6445,0.2759,0.4583,,,,,,,0.3841,,0.9811,,,0.64,0.2759,0.4583,,,,,,,0.3072,1.0,0.0,0.0,0.0,0.0,-1128.0,0.0,0.0,0.0,0.0,0.0,2.0,1.0,1.0,0.0,1.0,1.0,0.0,0.0,0.0,0.0,0.0,0.0,0.0,0.0,1.0,0.0,0.0,0.0,0.0,0.0,0.0,0.0,0.0,0.0,0.0,0.0,0.0,0.0,0.0,0.0,0.0,0.0,0.0,7.0,4500.0,16971.525,450000.0,0.0,0.0,0.0,0.0,0.0,-2676.0,-54.5,-317.0,-1248.5,503.0,-40.0,1.0,14592.69,156339.0,156339.0,0.0,156339.0,12.0,-1128.0,365243.0,-1095.0,-1095.0,-765.0,-1092.0,21.0,0.0,0.0,30.0,2.0,6.5,6.0,-36.5,0.0,0.0,1.0,159128.19,159128.19,-1114.0,-1095.0,1.0,2.0,0.0,,,,,,,,,,,,,,,,,,,,,8342929971.0,184328918253.0,165521885197.5,51948660457.935,1863.0,1704.0,71125.0,70754.0,9140.0,505839.0,17800.523600002292,17862.662999999116,17314.258999998063,,,,128353.0,662520.0,,,,13522015.199999597,-601604009.0,-921500819.0,-296361480.0,-1534481426.0416667,43996.0,30692.0,11344.72879999918,11220.699999998971,10705.063599997298,22877.084900009657,22798.96090000962,22184.725800008186,67421.38299705362,157972.13103676995,126048.14669890408,34985.13490002791,34925.51180002834,34371.59170002875,,,,3712590.0,,,,,,,,,,,,,,,,436272.0,431070.0,,6422.294394002895,631684.0,625237.0,,16325.216799999798,154109.07099999054,154111.81909999013,154003.59159998718,,,,88.0,27741113.82,8210695.769999998,2676869280.72,914857680.6000004,34195181.175,637724.9249999999,55.0,8524.0,-9169044.0,4108674.5,-4732638.0,-5132382.5,-43.5,0.0,3622.05,225000.0,0.0,0.0,0.0,0.0,0.0,-2676.0,-323.0,-362.0,-2135.0,105187923.4049999,1500956380.170001,1694053852.8750002,24235157.29499999,1500956380.170001,108645.0,-7456251.0,1724361530.0,75009868.0,378112901.0,174077699.0,394318232.0,108055.0,1715.0,295.7856883783952,2737726.0,890806.5,544163.0,-1785393.0,719201.0,97031.0,1201891767.705017,1211375117.2500136,-73786599.0,-73182166.0,1379249.0,59788.0,,,,,,,,,,,,,,,,,,,,,1466729.0,14754513.0,3230616.0,8551197.0,11602296.0,1414982.0,1057882110.102001,801542201.7149951,72073391896.4171,21669650619.97512,582146666.891999,5792665.7475,689.5,94245.0,-276804998.5,21934365.5,-123738137.5,-218607537.0,-2016350.5,,,,,,,,,,,,,,,,,,,,,4270957.0,2478103.0,-8999554.0,921269.0,37582.5,3731797963.169962,3656357143.649961,-260512569.5,-257203009.5,2525343.5,269080.5,3924371344.972455,33240299643.54092,36668185399.82264,1728556314.1425498,48062086367.49072,3986224.0,-247475364.0,103039826990.0,1053207529.0,17266091380.0,3502117207.5,18879927609.0,3670430.5,71885.0,20861.103624451323,89764474.5,-43.65765190644768,1.3949333333333334,6.8268705625341335,322.28440181650865,9.523029310030946,449.5652549072418,337500.0,-0.2225209339563146,-0.9749279121818236,0.0,1.0,0.0,0.0,0.0,0.0,0.0,0.0,0.0,0.0,0.0,0.0,0.0,1.0,0.0,1.0,0.0,0.0,0.0,0.0,1.0,0.0,0.0,0.0,0.0,1.0,0.0,0.0,0.0,0.0,0.0,0.0,0.0,0.0,0.0,0.0,0.0,0.0,0.0,0.0,1.0,0.0,0.0,0.0,0.0,0.0,0.0,0.0,0.0,0.0,0.0,0.0,0.0,0.0,0.0,0.0,0.0,0.0,0.0,0.0,0.0,0.0,0.0,0.0,0.0,0.0,0.0,0.0,0.0,0.0,0.0,0.0,0.0,0.0,0.0,0.0,0.0,0.0,0.0,0.0,0.0,1.0,0.0,0.0,0.0,0.0,0.0,0.0,0.0,0.0,0.0,0.0,0.0,0.0,0.0,0.0,0.0,0.0,0.0,0.0,0.0,0.0,0.0,0.0,0.0,0.0,0.0,0.0,0.0,0.0,1.0,0.0,0.0,0.0,0.0,0.0,0.0,1.0,0.0,0.0
101764,0,0.0,0.0,0.0,0.0,0.0,157500.0,272520.0,21528.0,225000.0,0.02461,44.00821917808219,-2374.0,-9993.0,-4294.0,,2.0,2.0,2.0,11.0,0.3697550911164367,0.6121300460815481,0.5298898341969072,0.2309,0.1506,0.9876,0.83,0.0581,0.24,0.2069,0.3333,0.375,0.0982,0.1883,0.246,0.0,0.0,0.2353,0.1563,0.9876,0.8367,0.0586,0.2417,0.2069,0.3333,0.375,0.1005,0.2057,0.2563,0.0,0.0,0.2332,0.1506,0.9876,0.8323,0.0585,0.24,0.2069,0.3333,0.375,0.0999,0.1915,0.2504,0.0,0.0,0.2606,1.0,0.0,0.0,0.0,0.0,-1553.0,0.0,0.0,0.0,0.0,0.0,0.0,1.0,1.0,1.0,1.0,1.0,0.0,0.0,0.0,0.0,0.0,0.0,0.0,0.0,1.0,0.0,0.0,0.0,0.0,0.0,0.0,0.0,0.0,0.0,0.0,0.0,0.0,0.0,0.0,0.0,0.0,0.0,0.0,7.0,2432.43,2153.8125,360000.0,0.0,0.0,0.0,0.0,0.0,-1198.0,31.5,-197.0,-770.0,290.0,-22.0,8.0,16507.53,155025.0,169481.25,0.0,155025.0,15.0,-1688.5,365243.0,-1658.0,-1403.0,-1238.0,-1395.0,12.5,1.0,0.0,0.0,105.0,12.0,9.0,-51.0,0.0,0.0,126.0,24264.99,15347.43,-1427.5,-1417.0,8.0,1.0,0.0,,,,,,,,,,,,,,,,,,,,,8342951499.0,184329190773.0,165522110197.5,51948817957.935,1863.0,1704.0,71125.0,70754.0,9140.0,505839.0,17800.75450000229,17862.896199999115,17314.494299998063,11290.501200000086,11228.327400000093,11175.65600000006,128353.0,662522.0,4136.400300000122,4134.059400000017,3944.712300000095,13522059.208218776,-601606383.0,-921505113.0,-296363033.0,-1534491419.0416667,43996.0,30692.0,11344.968799999177,11220.939999998973,10705.3052999973,22877.291800009654,22799.167800009614,22184.932700008183,67421.75275214473,157972.74316681604,126048.67658873828,34985.468200027906,34925.84510002834,34371.92500002875,22943.79709999592,22917.067499995497,22564.37319999573,3712601.0,8291.574200000168,8396.050300000083,8119.747600000226,9813.56480000072,9928.473200002156,10287.994999999644,16460.832799999753,16645.999799999692,16242.817399999694,828.504100000176,813.6799000000459,759.6622000000133,3911.986200000125,3895.191600000161,3727.831600000159,436272.0,431070.0,,6422.319004002897,631686.0,625239.0,,16325.477399999798,154110.05859999056,154112.80669999012,154004.57919998714,77576.14359999624,77913.80450000658,78315.06320000651,40.0,27778740.75,8255672.999999997,2681231218.2449994,915084885.6000004,34195181.175,637724.9249999999,55.0,8524.0,-9187295.0,4131142.5,-4739040.0,-5140127.0,-19.5,0.0,4307.625,360000.0,0.0,0.0,0.0,0.0,0.0,-1590.0,-74.0,-770.0,-770.0,105384704.93999992,1504378540.170001,1697751853.8750002,24260213.29499999,1504378540.170001,108831.0,-7476311.0,1729292288.5,75355550.0,378462183.0,174428556.0,394667589.5,108259.5,1720.0,296.59614323857426,2738534.0,893151.0,545748.0,-1791235.0,719205.0,97035.0,1207318207.3875134,1215945766.9125123,-73958918.5,-73353201.5,1380638.5,59957.0,,,,,,,,,,,,,,,,,,,,,1466736.0,14754803.0,3230616.0,8551302.0,11602422.0,1414990.0,1057884542.5320008,801544355.5274951,72073751896.4171,21669650619.97512,582146666.891999,5792665.7475,689.5,94245.0,-276806196.5,21934397.0,-123738334.5,-218608307.0,-2016372.5,,,,,,,,,,,,,,,,,,,,,4270969.0,2478112.0,-8999605.0,921269.0,37582.5,3731822228.1599617,3656372491.079961,-260513997.0,-257204426.5,2525351.5,269081.5,3924387852.502455,33240454668.54092,36668354881.07264,1728556314.1425498,48062241392.49072,3986239.0,-247477052.5,103040192233.0,1053205871.0,17266089977.0,3502115969.5,18879926214.0,3670443.0,71886.0,20861.103624451323,89764474.5,-53.94446865467222,1.7302857142857142,7.316053511705687,321.9664864617218,12.65886287625418,557.094012003482,78750.0,1.0,0.0,0.0,0.0,0.0,0.0,0.0,0.0,1.0,0.0,0.0,0.0,0.0,0.0,0.0,1.0,0.0,0.0,0.0,0.0,1.0,0.0,1.0,0.0,0.0,0.0,0.0,1.0,0.0,0.0,0.0,0.0,0.0,0.0,0.0,0.0,0.0,0.0,0.0,0.0,0.0,0.0,0.0,0.0,0.0,0.0,1.0,0.0,0.0,0.0,0.0,0.0,0.0,0.0,0.0,0.0,0.0,0.0,0.0,0.0,0.0,0.0,0.0,0.0,0.0,0.0,0.0,0.0,0.0,0.0,0.0,0.0,0.0,0.0,0.0,0.0,0.0,0.0,0.0,0.0,0.0,0.0,0.0,0.0,0.0,0.0,0.0,0.0,0.0,0.0,0.0,0.0,1.0,0.0,0.0,0.0,0.0,0.0,0.0,0.0,0.0,0.0,0.0,0.0,0.0,0.0,0.0,0.0,0.0,0.0,0.0,0.0,1.0,0.0,0.0,0.0,0.0,0.0,0.0,1.0,0.0,0.0
101780,1,0.0,1.0,0.0,1.0,1.0,225000.0,432990.0,34339.5,382500.0,0.018634,30.153424657534245,-542.0,-942.0,-3574.0,,3.0,2.0,2.0,13.0,0.1612752860762618,0.3521715316098029,0.2127563054543414,0.1031,0.113,0.9767,,,,0.2069,0.1667,,0.0205,,0.0609,,0.1749,0.105,0.1173,0.9767,,,,0.2069,0.1667,,0.021,,0.0634,,0.1851,0.1041,0.113,0.9767,,,,0.2069,0.1667,,0.0209,,0.062,,0.1785,0.0859,1.0,3.0,2.0,3.0,2.0,-767.0,0.0,0.0,0.0,0.0,2.0,3.0,1.0,1.0,0.0,1.0,0.0,0.0,0.0,0.0,0.0,0.0,0.0,0.0,0.0,0.0,0.0,0.0,0.0,0.0,1.0,0.0,0.0,0.0,0.0,0.0,0.0,0.0,0.0,0.0,0.0,0.0,0.0,0.0,15.0,0.0,0.0,225756.0,0.0,0.0,0.0,0.0,0.0,-1580.0,-673.0,-781.0,-1368.5,708.0,-25.0,13.0,5800.365,0.0,0.0,0.0,58632.75,11.0,-373.0,365243.0,-419.0,-43.0,-13.0,-41.0,14.0,0.0,0.0,-1.0,34.0,12.0,7.0,-11.5,0.0,0.0,62.0,7100.73,5360.85,-299.0,-298.0,8.0,1.0,15.0,166.365,90000.0,0.0,0.0,0.0,0.0,166.365,2477.5875,288.81,0.0,0.0,0.0,0.0,0.0,0.0,0.0,6.0,-8.0,0.0,0.0,8342985838.5,184329623763.0,165522492697.5,51949042957.935,1863.0,1704.0,71125.0,70756.0,9140.0,505842.0,17800.85760000229,17863.000299999116,17314.599299998063,11290.614200000084,11228.440400000089,11175.77330000006,128354.0,662525.0,,,,13522089.361643435,-601606925.0,-921508687.0,-296363800.0,-1534492361.0416667,43998.0,30694.0,,,,22877.498700009663,22799.374700009623,22185.139600008184,67421.91402743082,157973.09533834766,126048.88934504372,34985.63490002791,34926.01180002834,34372.09170002875,,,,3712614.0,8291.594700000169,8396.071200000082,8119.768600000226,,,,16460.89369999975,16646.061799999694,16242.880799999692,,,,3912.161100000125,3895.370100000161,3728.0167000001593,436275.0,431073.0,,6422.337638002897,631688.0,625241.0,,16325.563299999798,154111.03529999056,154113.78339999012,154005.55589998714,,,,52.0,27869035.67999999,8380771.244999997,2798883521.01,920163336.7950006,34732934.19,638615.07,56.0,8639.0,-9323008.0,4194621.0,-4806954.0,-5215991.5,-25.5,0.0,0.0,225000.0,0.0,0.0,0.0,0.0,0.0,-1788.0,-1078.0,-1046.0,-1640.0,106336111.63499989,1518755321.0700011,1714343444.7750006,24719807.29499999,1518846333.5700011,110065.0,-7562008.0,1746636676.0,76023895.0,383527121.0,176585050.0,400465453.0,109543.0,1740.0,300.8604577025475,2752492.0,903802.0,552615.0,-1811229.0,719206.0,97036.0,1216510859.4300106,1225506704.4450092,-74700848.0,-74088440.0,1391208.0,60564.5,1175147083.9799993,3083971500.0,101638212.57,160814676.46499997,6616971.9,52465235.62499998,67067674.19999989,172977329.5424989,160883188.87499985,1127999386.08,1170451192.184997,1170495969.1199975,5148.0,13201.0,93.0,7960.0,384839.0,-678055.0,248088.0,591.0,1466751.0,14755511.0,3230631.0,8551336.0,11602484.0,1415003.0,1057884542.5320008,801544355.5274951,72073977652.4171,21669650619.97512,582146666.891999,5792665.7475,689.5,94245.0,-276807776.5,21933724.0,-123739115.5,-218609675.5,-2016397.5,5919628427.099961,18711821250.0,198745595.325,447802478.6174977,1948107.735,256654969.0200008,308949670.95749867,636283037.8124981,458947720.7324992,5704898181.862532,5882928616.012499,5883171798.7575,13376.0,80808.0,44.0,70326.5,970973.0,-1697441.5,177364.0,6755.0,4270981.0,2478119.0,-8999616.5,921269.0,37582.5,3731829328.8899617,3656377851.9299607,-260514296.0,-257204724.5,2525359.5,269082.5,3924393652.867455,33240454668.54092,36668354881.07264,1728556314.1425498,48062300025.24072,3986250.0,-247477425.5,103040557476.0,1053205452.0,17266089934.0,3502115956.5,18879926173.0,3670457.0,71886.0,20861.103624451323,89764473.5,-17.97474105033618,1.9244,6.552221202987813,197.5719083837914,12.609094483029748,380.20738049376814,75000.0,-0.2225209339563146,-0.9749279121818236,0.0,0.0,0.0,0.0,0.0,0.0,1.0,0.0,0.0,0.0,0.0,0.0,0.0,1.0,0.0,0.0,0.0,0.0,1.0,0.0,1.0,0.0,0.0,0.0,0.0,1.0,0.0,0.0,0.0,0.0,0.0,0.0,0.0,0.0,1.0,0.0,0.0,0.0,0.0,0.0,0.0,0.0,0.0,0.0,0.0,0.0,0.0,0.0,0.0,0.0,0.0,0.0,0.0,1.0,0.0,0.0,0.0,0.0,0.0,0.0,0.0,0.0,0.0,0.0,0.0,0.0,0.0,0.0,0.0,0.0,0.0,0.0,0.0,0.0,0.0,0.0,0.0,0.0,0.0,0.0,0.0,0.0,0.0,0.0,0.0,0.0,0.0,0.0,0.0,0.0,0.0,0.0,0.0,0.0,0.0,0.0,0.0,0.0,0.0,0.0,0.0,0.0,0.0,0.0,0.0,0.0,0.0,0.0,0.0,0.0,1.0,0.0,0.0,0.0,0.0,0.0,0.0,0.0,1.0,0.0
101784,0,0.0,1.0,0.0,1.0,1.0,261000.0,1030680.0,63184.5,900000.0,0.006629,52.61917808219178,-3770.0,-3731.0,-2760.0,,3.0,2.0,2.0,8.0,0.7335121392834241,0.7741961093525733,0.6769925032909132,0.1299,0.1484,0.9826,0.762,0.0276,0.0,0.2528,0.1667,0.0417,0.1013,0.1059,0.113,0.0,0.0138,0.084,0.0909,0.9821,0.7648,0.0106,0.0,0.1379,0.1667,0.0417,0.0796,0.0735,0.074,0.0,0.0093,0.1135,0.1314,0.9826,0.7652,0.0363,0.0,0.2414,0.1667,0.0417,0.1031,0.0932,0.0992,0.0,0.016,0.1574,1.0,0.0,0.0,0.0,0.0,-461.0,0.0,0.0,0.0,0.0,0.0,0.0,1.0,1.0,0.0,1.0,0.0,0.0,0.0,0.0,0.0,0.0,0.0,0.0,0.0,1.0,0.0,0.0,0.0,0.0,0.0,0.0,0.0,0.0,0.0,0.0,0.0,0.0,0.0,0.0,0.0,0.0,0.0,0.0,6.0,12188.25,0.0,239584.5,0.0,0.0,0.0,0.0,0.0,-1588.5,-1889.5,-1269.0,-1972.0,318.0,-29.0,1.0,12372.705,96741.0,105255.0,0.0,96741.0,10.0,-461.0,365243.0,-431.0,-371.0,-161.0,-363.0,7.0,1.0,0.0,150.0,5.0,10.0,8.0,-13.0,0.0,0.0,4.0,17214.6375,49840.785,-410.0,-401.0,2.0,1.5,0.0,,,,,,,,,,,,,,,,,,,,,8343049023.0,184330654443.0,165523392697.5,51949303957.935,1863.0,1704.0,71125.0,70756.0,9140.0,505842.0,17800.98750000229,17863.113799999115,17314.683299998058,11290.762600000086,11228.571800000089,11175.864200000058,128355.0,662528.0,4136.4279000001225,4134.095700000016,3944.7229000000953,13522141.980821516,-601610695.0,-921511447.0,-296364261.0,-1534496092.0416667,43998.0,30694.0,11344.968799999177,11220.939999998973,10705.3052999973,22877.751500009657,22799.616100009614,22185.277500008186,67422.6475395701,157973.86953445704,126049.56633754705,34985.80160002791,34926.17850002834,34372.25840002875,22943.838799995923,22917.109199995502,22564.41489999573,3712622.0,8291.696000000169,8396.174300000082,8119.848200000226,9813.67070000072,9928.566400002155,10288.068499999645,16461.00669999975,16646.160999999694,16242.954799999694,828.504100000176,813.6799000000459,759.6622000000133,3912.174900000125,3895.386100000161,3728.02600000016,436275.0,431073.0,,6422.344267002897,631690.0,625243.0,,16325.720699999798,154112.01789999055,154114.7659999901,154006.53799998714,77576.90559999624,77914.56970000657,78315.8280000065,53.0,28056645.80999999,8448352.064999998,2813205049.199999,921865834.2150006,35515183.77,638615.07,56.0,8639.0,-9374672.0,4205618.5,-4838613.5,-5248166.5,-26.0,24376.5,0.0,232524.0,0.0,0.0,0.0,0.0,0.0,-2408.0,-2135.0,-2292.0,-2294.0,106495986.05999988,1520907500.0700011,1716630290.7750006,24796680.79499999,1520907500.0700011,110181.0,-7579350.0,1750288784.0,76013548.0,384249875.0,176943237.0,401188254.0,109835.0,1744.0,302.0829706805025,2754098.0,904909.0,553251.0,-1814098.0,719206.0,97036.0,1219041458.6175096,1228618391.1975093,-74803006.0,-74189990.5,1392066.5,60743.5,,,,,,,,,,,,,,,,,,,,,1466757.0,14755829.0,3230631.0,8551341.0,11602488.0,1415004.0,1057896730.7820008,801544355.5274951,72074217236.9171,21669650619.97512,582146666.891999,5792665.7475,689.5,94245.0,-276809365.0,21931834.5,-123740384.5,-218611647.5,-2016426.5,,,,,,,,,,,,,,,,,,,,,4270991.0,2478127.0,-8999629.5,921269.0,37582.5,3731846543.5274615,3656427692.714961,-260514706.0,-257205125.5,2525361.5,269084.0,3924406025.5724554,33240551409.54092,36668460136.07264,1728556314.1425498,48062396766.24072,3986260.0,-247477886.5,103040922719.0,1053205021.0,17266089563.0,3502115795.5,18879925810.0,3670464.0,71887.0,20861.103624451323,89764623.5,-71.64688118296365,3.9489655172413793,4.130759917384801,217.35719170765063,16.31222847375543,858.3360549779362,87000.0,-0.2225209339563146,-0.9749279121818236,0.0,0.0,0.0,0.0,0.0,0.0,1.0,0.0,0.0,0.0,0.0,0.0,0.0,1.0,0.0,0.0,0.0,0.0,1.0,1.0,0.0,0.0,0.0,0.0,0.0,1.0,0.0,0.0,0.0,0.0,0.0,0.0,0.0,0.0,0.0,0.0,0.0,0.0,1.0,0.0,0.0,0.0,0.0,0.0,0.0,0.0,0.0,0.0,0.0,0.0,0.0,0.0,0.0,0.0,0.0,0.0,0.0,0.0,0.0,0.0,0.0,0.0,0.0,0.0,0.0,0.0,0.0,0.0,0.0,0.0,0.0,0.0,0.0,0.0,1.0,0.0,0.0,0.0,0.0,0.0,0.0,0.0,0.0,0.0,0.0,0.0,0.0,0.0,0.0,0.0,0.0,0.0,0.0,0.0,0.0,0.0,0.0,0.0,0.0,0.0,0.0,0.0,0.0,0.0,0.0,0.0,0.0,0.0,1.0,0.0,1.0,0.0,0.0,0.0,0.0,0.0,0.0,1.0,0.0,0.0
101789,0,0.0,1.0,1.0,1.0,0.0,337500.0,1350000.0,43681.5,1350000.0,0.0196889999999999,47.8,-3152.0,-3039.0,-879.0,7.0,2.0,2.0,2.0,9.0,0.7846190258656609,0.6578229893376922,0.5316861425197883,,,,,,,,,,,,,,,,,,,,,,,,,,,,,,,,,,,,,,,,,,,,,5.0,1.0,5.0,0.0,-2379.0,0.0,0.0,0.0,0.0,0.0,0.0,1.0,1.0,0.0,1.0,0.0,0.0,0.0,0.0,0.0,0.0,0.0,0.0,0.0,0.0,0.0,0.0,0.0,0.0,1.0,0.0,0.0,0.0,0.0,0.0,0.0,0.0,0.0,0.0,0.0,0.0,0.0,0.0,9.0,13509.0,0.0,454500.0,0.0,0.0,0.0,0.0,0.0,-1458.0,712.0,-671.0,-1306.0,399.0,-23.0,2.0,14506.7175,72096.12,67781.25,7212.870000000001,72096.12,5.0,-2596.0,365243.0,-2565.0,-2445.0,-2445.0,-2434.0,14.0,0.5,0.1050853085195716,350.0,11.0,6.0,3.0,-78.0,0.0,0.0,75.0,571.23,571.23,-2240.0,-2240.0,53.0,0.0,93.0,0.0,0.0,0.0,0.0,0.0,0.0,0.0,571.23,0.0,0.0,0.0,0.0,0.0,0.0,0.0,0.0,18.0,-50.0,0.0,0.0,8343092704.5,184332004443.0,165524742697.5,51949641457.935,1863.0,1704.0,71125.0,70756.0,9140.0,505842.0,,,,,,,128355.0,662530.0,,,,13522189.780821515,-601613847.0,-921512326.0,-296366640.0,-1534499131.0416667,43999.0,30694.0,,,,,,,67423.43215859597,157974.52735744635,126050.09802368956,,,,,,,3712631.0,,,,,,,,,,,,,,,,436280.0,431078.0,1262504.0,6422.363956002897,631692.0,625245.0,,,,,,,,,48.0,28070154.80999999,8466368.444999997,2817234101.969999,922898408.7150006,35785183.77,638615.07,56.0,8639.0,-9389045.0,4202150.0,-4846757.0,-5257893.0,-23.5,0.0,0.0,454500.0,0.0,0.0,0.0,0.0,0.0,-1462.0,-325.0,-1027.0,-1306.0,106595593.15499988,1522165807.2600012,1718062960.2750006,24813901.48499999,1522165807.2600012,110223.0,-7590958.5,1751931532.5,76006367.0,384974712.0,177303246.0,401913120.0,109951.5,1746.0,302.3460072605892,2764662.0,905312.0,553484.0,-1816036.0,719235.0,97036.0,1220475476.8800118,1230098929.5150113,-74950108.0,-74336571.0,1395364.0,60807.0,1178532795.8699992,3092278500.0,101967162.57,161439722.23499992,6616971.9,52761331.39499995,67282845.56999989,173672021.24999872,161434646.86499992,1131285794.85,1173806943.1649966,1173851720.099997,5169.0,13297.0,93.0,8035.0,386033.0,-681312.0,248088.0,591.0,1466766.0,14756228.0,3230724.0,8551352.0,11602563.0,1415006.0,1057910239.7820008,801544355.5274951,72074671736.9171,21669650619.97512,582146666.891999,5792665.7475,689.5,94245.0,-276810823.0,21932546.5,-123741055.5,-218612953.5,-2016449.5,5919628427.099961,18711821250.0,198745595.325,447802478.6174977,1948107.735,256654969.0200008,308949670.95749867,636283609.0424981,458947720.7324992,5704898181.862532,5882928616.012499,5883171798.7575,13376.0,80808.0,44.0,70326.5,970991.0,-1697491.5,177364.0,6755.0,4270997.0,2478130.0,-8999707.5,921269.0,37582.5,3731847114.7574615,3656428263.944961,-260516946.0,-257207365.5,2525414.5,269084.0,3924420532.289954,33240623505.66091,36668527917.32264,1728563527.0125494,48062468862.36071,3986265.0,-247480482.5,103041287962.0,1053202456.0,17266087118.0,3502113350.5,18879923376.0,3670478.0,71887.5,20861.20870975984,89764973.5,-65.94142259414228,4.0,7.726383022561039,369.3211084784176,30.905532090244154,1477.2844339136705,168750.0,-0.9009688679024191,-0.433883739117558,0.0,0.0,0.0,0.0,0.0,0.0,1.0,0.0,1.0,0.0,0.0,0.0,0.0,0.0,0.0,1.0,0.0,0.0,0.0,0.0,1.0,0.0,0.0,0.0,0.0,1.0,0.0,0.0,0.0,0.0,0.0,0.0,0.0,0.0,0.0,0.0,1.0,0.0,0.0,0.0,0.0,0.0,0.0,0.0,0.0,0.0,0.0,0.0,0.0,0.0,0.0,0.0,0.0,1.0,0.0,0.0,0.0,0.0,0.0,0.0,0.0,0.0,0.0,0.0,0.0,0.0,0.0,0.0,0.0,0.0,0.0,0.0,0.0,0.0,0.0,0.0,0.0,0.0,0.0,0.0,0.0,0.0,0.0,0.0,0.0,0.0,0.0,0.0,0.0,0.0,0.0,0.0,0.0,0.0,0.0,0.0,0.0,0.0,0.0,0.0,0.0,0.0,0.0,0.0,0.0,0.0,0.0,0.0,0.0,0.0,0.0,0.0,0.0,0.0,0.0,0.0,0.0,0.0,0.0,0.0
101816,0,0.0,0.0,0.0,1.0,0.0,90000.0,420498.0,20358.0,351000.0,0.025164,63.13150684931506,,-3559.0,-4974.0,,1.0,2.0,2.0,8.0,,0.3853791593532381,,,,,,,,,,,,,,,,,,,,,,,,,,,,,,,,,,,,,,,,,,,,,,0.0,0.0,0.0,0.0,-657.0,,,,,,,1.0,0.0,0.0,1.0,0.0,0.0,0.0,0.0,0.0,0.0,0.0,0.0,0.0,1.0,0.0,0.0,0.0,0.0,0.0,0.0,0.0,0.0,0.0,0.0,0.0,0.0,0.0,0.0,0.0,0.0,0.0,0.0,0.0,,,,,,,,,,,,,0.0,,11.0,14452.5825,180000.0,203760.0,1237.5,198000.0,15.0,-626.0,365243.0,-713.0,-353.0,-113.0,-347.5,9.0,1.0,0.0552889052981354,-1.0,61.0,18.0,10.0,-20.0,0.0,0.0,73.0,12705.705,12705.705,-507.0,-499.0,6.0,1.0,11.0,0.0,270000.0,0.0,0.0,0.0,0.0,0.0,2510.415,70.83,0.0,0.0,0.0,0.0,0.0,0.0,0.0,1.0,-6.0,0.0,0.0,8343113062.5,184332424941.0,165525093697.5,51949731457.935,,,,,,,,,,,,,128355.0,662531.0,,,,13522252.912328364,,-921517300.0,-296367297.0,-1534502690.0416667,43999.0,30694.0,,,,,,,,157974.9127366057,,,,,,,,3712639.0,,,,,,,,,,,,,,,,436280.0,431078.0,,6422.389120002897,631694.0,625247.0,,,,,,,,,,,,,,,,,,,,,,,,,,,,,,,,,,,107549237.76749995,1533811411.7100012,1730669251.2750006,25162089.43499999,1533010411.7100012,111194.0,-7681179.0,1776033888.5,76664048.5,390399160.0,179447470.5,408069075.0,111144.0,1764.5,306.7888616275284,2793207.0,914469.0,558994.0,-1837188.0,719931.0,97052.0,1230825314.835004,1240027324.7399983,-75829941.0,-75208080.0,1409370.0,61440.0,1187928918.854998,3120516000.0,102598062.57,162696973.58999994,6616971.9,53324128.75499994,67955907.55499989,175053393.40499854,162784607.26499996,1140219783.9449997,1183176348.5249958,1183221125.459996,5208.0,13561.0,93.0,8259.0,390928.0,-693035.0,248188.0,595.0,1466766.0,14756228.0,3230735.0,8551413.0,11602636.0,1415017.0,,,,,,,,,,,,,,5919628427.099961,18712091250.0,198745595.325,447802478.6174977,1948107.735,256654969.0200008,308949670.95749867,636286119.4574982,458947791.5624992,5704898181.862532,5882928616.012499,5883171798.7575,13376.0,80808.0,44.0,70326.5,970992.0,-1697497.5,177364.0,6755.0,4271015.0,2478140.0,-8999727.5,921269.0,37582.5,3731859820.462462,3656440969.649961,-260517453.0,-257207864.5,2525420.5,269085.0,3924434984.872455,33240803505.66091,36668731677.32264,1728564764.5125494,48062666862.36071,3986280.0,-247481108.5,103041653205.0,1053201743.0,17266086765.0,3502113237.5,18879923028.5,3670487.0,71888.5,20861.26399866514,89764972.5,,4.6722,4.420866489832006,279.09596308273683,20.655172413793107,1303.992158715163,90000.0,1.0,0.0,0.0,0.0,0.0,0.0,0.0,0.0,1.0,0.0,0.0,1.0,0.0,0.0,0.0,0.0,0.0,0.0,0.0,0.0,1.0,0.0,0.0,0.0,0.0,1.0,0.0,1.0,0.0,0.0,0.0,0.0,0.0,0.0,0.0,0.0,0.0,0.0,0.0,0.0,0.0,0.0,0.0,0.0,0.0,0.0,0.0,0.0,0.0,0.0,0.0,0.0,0.0,0.0,0.0,0.0,0.0,0.0,0.0,0.0,0.0,0.0,0.0,0.0,0.0,0.0,0.0,0.0,0.0,0.0,0.0,0.0,0.0,0.0,0.0,0.0,0.0,0.0,0.0,0.0,0.0,0.0,0.0,0.0,0.0,0.0,0.0,0.0,0.0,0.0,0.0,0.0,0.0,0.0,0.0,0.0,0.0,0.0,0.0,0.0,0.0,0.0,0.0,0.0,0.0,0.0,0.0,1.0,0.0,0.0,0.0,0.0,0.0,0.0,0.0,0.0,0.0,0.0,0.0,0.0,0.0,0.0
101819,0,0.0,1.0,1.0,1.0,0.0,180000.0,135000.0,11583.0,135000.0,0.022625,48.44109589041096,-452.0,-5965.0,-1215.0,2.0,2.0,2.0,2.0,11.0,,0.6788593728419312,0.4938628816996244,0.3670000000000001,0.2283,0.9886,0.8436,0.1482,0.44,0.3793,0.3333,0.375,0.3209,0.2992,0.403,0.0,0.3784,0.3739,0.2369,0.9886,0.8497,0.1496,0.4431,0.3793,0.3333,0.375,0.3282,0.3269,0.4198,0.0,0.4006,0.3706,0.2283,0.9886,0.8457,0.1492,0.44,0.3793,0.3333,0.375,0.3264,0.3044,0.4102,0.0,0.3863,0.3992,1.0,0.0,0.0,0.0,0.0,-1899.0,0.0,0.0,0.0,0.0,1.0,0.0,1.0,1.0,0.0,1.0,1.0,0.0,0.0,0.0,0.0,0.0,0.0,0.0,0.0,1.0,0.0,0.0,0.0,0.0,0.0,0.0,0.0,0.0,0.0,0.0,0.0,0.0,0.0,0.0,0.0,0.0,0.0,0.0,6.0,27909.0,17617.5,517500.0,164799.0,0.0,0.0,0.0,0.0,-803.5,339.0,-18.5,-988.0,207.0,-19.0,1.0,7719.975,64080.0,54751.5,13500.0,64080.0,10.0,-1899.0,365243.0,-1845.0,-1575.0,-1575.0,-1571.0,17.0,0.0,0.215419840922577,91.0,12.0,10.0,5.5,-56.5,0.0,0.0,10.0,7719.975,7719.975,-1743.5,-1710.0,5.5,1.0,0.0,,,,,,,,,,,,,,,,,,,,,8343124645.5,184332559941.0,165525228697.5,51949911457.935,1863.0,1704.0,71125.0,70757.0,9140.0,505842.0,17801.35450000229,17863.484399999114,17315.05719999806,11290.990900000086,11228.80010000009,11176.101100000058,128355.0,662533.0,4136.576100000122,4134.244900000016,3944.872500000095,13522301.353424257,-601614299.0,-921518515.0,-296369196.0,-1534508655.0416667,43999.0,30694.0,11345.40879999918,11221.379999998971,10705.7483999973,22878.130800009654,22799.995400009622,22185.656800008182,,157975.59159597856,126050.59188657124,34986.13490002791,34926.51180002834,34372.59170002875,22944.213799995923,22917.484199995502,22564.78989999573,3712650.0,8292.016900000172,8396.500700000082,8120.176400000226,9813.96990000072,9928.870800002156,10288.395399999645,16461.409699999753,16646.571199999693,16243.374599999695,828.504100000176,813.6799000000459,759.6622000000133,3912.553300000125,3895.772400000161,3728.42660000016,436280.0,431078.0,1262506.0,6422.411745002895,631696.0,625249.0,,16326.119899999798,154113.00649999056,154115.75459999012,154007.52659998718,77577.74919999624,77915.41540000658,78316.6777000065,27.0,28438511.849999998,8602804.799999999,2855272848.794998,933946557.4800009,36110044.62,638619.57,56.0,8639.0,-9523441.0,4212977.0,-4920574.5,-5329130.0,-13.0,0.0,17617.5,1736559.0,0.0,0.0,0.0,0.0,0.0,-988.0,-7.0,-136.0,-988.0,108104798.29499994,1543504987.7100012,1742240339.7750006,25190124.43499999,1543504987.7100012,111763.0,-7702175.0,1781329912.0,77014966.0,391118569.0,179808026.0,408423138.0,111474.0,1773.0,307.3025855842532,2793604.0,917216.0,560990.0,-1843007.5,719931.0,97052.0,1236061319.557503,1245318877.4624977,-75974080.0,-75350260.5,1410153.5,61592.5,,,,,,,,,,,,,,,,,,,,,1466772.0,14756435.0,3230735.0,8551425.0,11602646.0,1415018.0,1057938148.7820008,801561973.0274951,72075189236.9171,21669815418.97512,582146666.891999,5792665.7475,689.5,94245.0,-276811626.5,21932885.5,-123741074.0,-218613941.5,-2016468.5,,,,,,,,,,,,,,,,,,,,,4271025.0,2478145.5,-8999784.0,921269.0,37582.5,3731867540.437462,3656448689.62496,-260519196.5,-257209574.5,2525426.0,269086.0,3924442704.847455,33240867585.66091,36668786428.82264,1728578264.5125494,48062730942.36071,3986290.0,-247483007.5,103042018448.0,1053199898.0,17266085190.0,3502111662.5,18879921457.5,3670504.0,71888.5,20861.479418506064,89765063.5,-9.330920196821449,0.75,15.54001554001554,752.7753829123692,11.655011655011654,564.581537184277,90000.0,-0.2225209339563143,0.9749279121818236,0.0,0.0,0.0,0.0,0.0,0.0,1.0,0.0,0.0,0.0,0.0,0.0,0.0,1.0,0.0,1.0,0.0,0.0,0.0,0.0,1.0,0.0,0.0,0.0,0.0,1.0,0.0,0.0,0.0,0.0,0.0,0.0,0.0,0.0,1.0,0.0,0.0,0.0,0.0,0.0,0.0,0.0,0.0,0.0,0.0,0.0,0.0,0.0,0.0,0.0,0.0,0.0,0.0,1.0,0.0,0.0,0.0,0.0,0.0,0.0,0.0,0.0,0.0,0.0,0.0,0.0,0.0,0.0,0.0,0.0,0.0,0.0,0.0,0.0,0.0,0.0,0.0,0.0,0.0,0.0,0.0,0.0,0.0,0.0,0.0,0.0,0.0,0.0,0.0,0.0,0.0,0.0,0.0,0.0,0.0,0.0,0.0,0.0,0.0,0.0,0.0,0.0,0.0,0.0,0.0,0.0,1.0,0.0,0.0,0.0,1.0,0.0,0.0,0.0,0.0,0.0,0.0,1.0,0.0,0.0
101827,0,0.0,0.0,0.0,1.0,0.0,112500.0,460692.0,17496.0,301500.0,0.01885,57.13150684931506,,-8462.0,-4370.0,,2.0,2.0,2.0,11.0,0.7849579263546149,0.7645433280960092,0.6817058776720116,0.1856,0.1485,0.9881,0.8368,0.0374,0.2,0.1724,0.3333,0.375,0.0834,0.1513,0.2097,0.0,0.0,0.1891,0.1541,0.9881,0.8432,0.0377,0.2014,0.1724,0.3333,0.375,0.0853,0.1653,0.2185,0.0,0.0,0.1874,0.1485,0.9881,0.8390000000000001,0.0376,0.2,0.1724,0.3333,0.375,0.0849,0.1539,0.2135,0.0,0.0,0.1854,1.0,0.0,0.0,0.0,0.0,-371.0,0.0,0.0,0.0,0.0,0.0,3.0,1.0,0.0,0.0,1.0,1.0,0.0,0.0,0.0,0.0,0.0,0.0,0.0,0.0,1.0,0.0,0.0,0.0,0.0,0.0,0.0,0.0,0.0,0.0,0.0,0.0,0.0,0.0,0.0,0.0,0.0,0.0,0.0,4.0,0.0,,105750.0,0.0,0.0,0.0,0.0,0.0,-1125.0,8.5,-393.5,-1687.0,170.0,-24.5,3.0,5358.96,77895.0,77895.0,0.0,77895.0,10.0,-371.0,365243.0,-340.0,365243.0,350.0,365243.0,15.0,0.0,0.0,1500.0,22.0,24.0,13.5,-11.5,0.0,0.0,21.0,5358.96,5358.96,-329.0,-310.0,6.0,1.0,12.0,0.0,135000.0,,0.0,,,0.0,,0.0,0.0,0.0,0.0,,0.0,,,0.0,-6.5,0.0,0.0,8343142141.5,184333020633.0,165525530197.5,51950023957.935,1863.0,1704.0,71125.0,70757.0,9140.0,505845.0,17801.54010000229,17863.671799999112,17315.24629999806,11291.139400000086,11228.948600000089,11176.255200000058,128355.0,662535.0,4136.613500000122,4134.282500000016,3944.9102000000953,13522358.484931106,,-921522885.0,-296369567.0,-1534517117.0416667,43999.0,30694.0,11345.60879999918,11221.579999998972,10705.9497999973,22878.303200009657,22800.167800009614,22185.829200008186,67424.21711652233,157976.35613930665,126051.27359244892,34986.468200027906,34926.84510002834,34372.92500002875,22944.588799995923,22917.859199995502,22565.16489999573,3712661.0,8292.100300000171,8396.585600000082,8120.261700000226,9814.121200000718,9929.024700002155,10288.560699999643,16461.619399999752,16646.784699999695,16243.593099999694,828.504100000176,813.6799000000459,759.6622000000133,3912.553300000125,3895.772400000161,3728.42660000016,436280.0,431078.0,,6422.430595002897,631698.0,625251.0,,16326.305299999798,154113.99459999055,154116.7426999901,154008.51469998714,77578.58599999624,77916.25440000657,78317.52090000651,37.5,28576049.895,,2866673491.0649986,936897503.5350008,36218383.155,638619.57,56.0,8639.0,-9555532.5,4246828.5,-4930937.5,-5345763.0,-18.25,0.0,,53736.75,0.0,0.0,0.0,0.0,0.0,-1929.0,-1643.0,-642.0,-2374.0,108480571.91999994,1547953422.2100012,1747565626.2750006,25247953.93499999,1547953422.2100012,112313.0,-7725232.0,1787539043.0,77365135.0,392570032.0,180165555.0,409874682.0,111834.0,1777.0,307.9765203361836,2809980.0,922580.0,564122.5,-1849558.5,719979.0,97065.0,1239884768.565,1249240419.3149955,-76196223.0,-75569566.0,1412747.0,61870.0,1188170378.864998,3130393500.0,,162876973.58999994,,,67969816.37999989,,163001057.26499996,1140446370.4199998,1183409329.3649962,1183454106.299996,,13566.0,,,390937.0,-693449.5,248188.0,595.0,1466776.0,14756605.0,3230747.0,8551447.0,11602667.0,1415021.0,1057938148.7820008,,72075294986.9171,21669815418.97512,582146666.891999,5792665.7475,689.5,94245.0,-276812751.5,21932894.0,-123741467.5,-218615628.5,-2016493.0,5919628427.099961,18712226250.0,,447802478.6174977,,,308949670.95749867,,458947791.5624992,5704898181.862532,5882928616.012499,5883171798.7575,,80808.0,,,970992.0,-1697504.0,177364.0,6755.0,4271049.0,2478159.0,-8999795.5,921269.0,37582.5,3731872899.397462,3656454048.584961,-260519525.5,-257209884.5,2525432.0,269087.0,3924448063.807455,33240945480.66091,36668864323.82264,1728578264.5125494,48062808837.36071,3986300.0,-247483378.5,103042383691.0,1053199558.0,17266450433.0,3502112012.5,18880286700.5,3670519.0,71888.5,20861.479418506064,89766563.5,,4.09504,6.430041152263375,367.3579401319127,26.33127572016461,1504.345459157788,56250.0,-0.9009688679024191,0.4338837391175582,0.0,0.0,0.0,0.0,0.0,0.0,1.0,0.0,0.0,1.0,0.0,0.0,0.0,0.0,0.0,0.0,0.0,0.0,1.0,0.0,1.0,0.0,0.0,0.0,0.0,1.0,0.0,0.0,0.0,0.0,0.0,0.0,0.0,0.0,0.0,0.0,0.0,0.0,0.0,0.0,0.0,0.0,0.0,0.0,0.0,0.0,0.0,0.0,0.0,0.0,0.0,0.0,0.0,0.0,0.0,0.0,0.0,0.0,0.0,0.0,0.0,0.0,0.0,0.0,0.0,0.0,0.0,0.0,0.0,0.0,0.0,0.0,0.0,0.0,0.0,0.0,0.0,0.0,0.0,0.0,0.0,0.0,0.0,0.0,0.0,0.0,0.0,0.0,0.0,0.0,0.0,0.0,0.0,0.0,0.0,0.0,0.0,0.0,0.0,0.0,0.0,0.0,0.0,0.0,0.0,1.0,0.0,0.0,1.0,0.0,1.0,0.0,0.0,0.0,0.0,0.0,0.0,1.0,0.0,0.0
101863,0,0.0,1.0,1.0,1.0,0.0,360000.0,225000.0,10822.5,225000.0,0.018209,52.12328767123286,-1578.0,-1858.0,-2543.0,19.0,2.0,3.0,3.0,7.0,0.4742848705373512,0.5189083209607123,0.375711009574066,0.1052,,0.9767,,,0.0,0.1724,0.1667,,,,,,,0.1071,,0.9767,,,0.0,0.1724,0.1667,,,,,,,0.1062,,0.9767,,,0.0,0.1724,0.1667,,,,,,,0.0697,1.0,0.0,0.0,0.0,0.0,-2076.0,0.0,0.0,0.0,0.0,0.0,3.0,1.0,1.0,0.0,1.0,1.0,0.0,0.0,1.0,1.0,0.0,1.0,1.0,0.0,1.0,0.0,0.0,0.0,0.0,0.0,0.0,0.0,0.0,0.0,0.0,0.0,0.0,0.0,0.0,0.0,0.0,0.0,0.0,3.0,24327.0,0.0,391500.0,97861.5,0.0,0.0,0.0,0.0,-326.0,493.0,-13.0,-263.0,73.0,-18.0,3.0,8186.625,112500.0,112500.0,11252.07,112500.0,24.0,-2076.0,365243.0,-2046.0,-1386.0,-1356.0,-1383.0,10.0,1.0,0.1900246637721412,-1.0,55.0,24.0,11.0,-47.0,0.0,0.0,58.0,8935.38,8186.625,-960.0,-959.0,12.0,1.0,0.0,,,,,,,,,,,,,,,,,,,,,8343152964.0,184333245633.0,165525755197.5,51950383957.935,1863.0,1704.0,71125.0,70757.0,9140.0,505848.0,17801.645300002292,17863.777999999107,17315.353399998057,,,,128355.0,662537.0,,,,13522410.608218774,-601615877.0,-921525428.0,-296371643.0,-1534518975.0416667,43999.0,30694.0,11345.60879999918,11221.579999998972,10705.9497999973,22878.475600009657,22800.340200009618,22186.001600008185,67424.69140139286,157976.8750476276,126051.64930345849,34986.63490002791,34927.01180002834,34373.09170002875,,,,3712668.0,,,,,,,,,,,,,,,,436280.0,431078.0,1262525.0,6422.448804002896,631701.0,625254.0,,16326.374999999798,154114.97129999055,154117.7193999901,154009.49139998714,,,,11.0,28843316.774999995,8749411.019999998,2969235140.759999,965263280.2200006,36822355.78499999,638619.57,58.0,8639.0,-9754091.0,4457334.0,-5043432.0,-5447181.0,-5.0,24327.0,0.0,391500.0,97861.5,0.0,0.0,0.0,0.0,-1663.0,493.0,-5.0,-263.0,110378726.37,1572489688.3200016,1775397797.3250003,25579613.56499999,1572489688.3200016,114435.0,-7875093.0,1824058555.0,80175230.0,401621344.0,184119614.0,418927931.0,113867.0,1811.0,313.34724270422845,2856213.0,947548.0,578101.0,-1896146.0,720273.0,97077.0,1263314272.0499904,1271347854.2999892,-77807967.5,-77164848.0,1436167.0,63279.5,,,,,,,,,,,,,,,,,,,,,1466779.0,14756678.0,3230747.0,8551502.0,11602725.0,1415024.0,1057962475.7820008,801561973.0274951,72075686486.9171,21669913280.47512,582146666.891999,5792665.7475,689.5,94245.0,-276813077.5,21933387.0,-123741480.5,-218615891.5,-2016511.0,,,,,,,,,,,,,,,,,,,,,4271073.0,2478170.0,-8999842.5,921269.0,37582.5,3731881834.7774615,3656462235.209961,-260520485.5,-257210843.5,2525444.0,269088.0,3924456250.432455,33241057980.66091,36668976823.82264,1728589516.582549,48062921337.36071,3986324.0,-247485454.5,103042748934.0,1053197512.0,17266449047.0,3502110656.5,18880285317.5,3670529.0,71889.5,20861.66944316984,89766562.5,-30.27437582128778,0.625,33.264033264033266,1733.8307749266653,20.79002079002079,1083.6442343291658,180000.0,-0.9009688679024191,-0.433883739117558,0.0,0.0,0.0,0.0,0.0,0.0,1.0,0.0,1.0,0.0,0.0,0.0,0.0,0.0,0.0,0.0,0.0,0.0,1.0,0.0,1.0,0.0,0.0,0.0,0.0,1.0,0.0,0.0,0.0,0.0,0.0,0.0,0.0,0.0,0.0,0.0,0.0,0.0,1.0,0.0,0.0,0.0,0.0,0.0,0.0,0.0,0.0,0.0,0.0,0.0,0.0,0.0,0.0,0.0,0.0,1.0,0.0,0.0,0.0,0.0,0.0,0.0,0.0,0.0,0.0,0.0,0.0,0.0,0.0,0.0,0.0,0.0,0.0,0.0,0.0,0.0,0.0,0.0,0.0,0.0,0.0,0.0,0.0,0.0,0.0,0.0,0.0,0.0,0.0,0.0,0.0,0.0,0.0,0.0,0.0,0.0,0.0,0.0,0.0,0.0,0.0,0.0,0.0,0.0,0.0,0.0,0.0,0.0,0.0,0.0,1.0,0.0,0.0,0.0,0.0,0.0,0.0,1.0,0.0,0.0
101867,0,0.0,0.0,0.0,0.0,0.0,144000.0,769896.0,61857.0,720000.0,0.006296,40.77534246575343,-2292.0,-2282.0,-2074.0,,2.0,3.0,3.0,12.0,0.4768399951410392,0.6327085715722629,,,,,,,,,,,,,,,,,,,,,,,,,,,,,,,,,,,,,,,,,,,,,,0.0,0.0,0.0,0.0,0.0,0.0,0.0,0.0,0.0,1.0,2.0,1.0,1.0,0.0,1.0,0.0,0.0,0.0,1.0,1.0,0.0,1.0,1.0,0.0,1.0,0.0,0.0,0.0,0.0,0.0,0.0,0.0,0.0,0.0,0.0,0.0,0.0,0.0,0.0,0.0,0.0,0.0,0.0,1.0,,,675000.0,,,0.0,0.0,0.0,-258.0,468.0,-9.0,,9.0,-4.0,4.0,25369.7175,241978.5,280761.75,9189.0,241978.5,14.0,-1136.5,365243.0,-1106.0,-719.0,-629.0,-713.5,13.5,0.5,0.0954129131156792,1099.5,66.0,18.0,9.0,-25.0,0.0,0.0,62.0,43043.13000000001,43043.13000000001,-743.5,-733.0,9.5,1.0,0.0,,,,,,,,,,,,,,,,,,,,,8343214821.0,184334015529.0,165526475197.5,51950527957.935,1863.0,1704.0,71125.0,70758.0,9140.0,505850.0,,,,,,,128355.0,662539.0,,,,13522451.383561242,-601618169.0,-921527502.0,-296371643.0,-1534521257.0416667,43999.0,30694.0,,,,,,,67425.168241388,157977.5077561991,,,,,,,,3712680.0,,,,,,,,,,,,,,,,436280.0,431078.0,,6422.455100002896,631704.0,625257.0,,,,,,,,,9.0,,,2974163639.759999,,,638619.57,58.0,8639.0,-9764749.0,4485622.0,-5048251.0,,-4.0,,,675000.0,,,0.0,0.0,0.0,-258.0,468.0,-9.0,,110570558.1075,1575400386.9600017,1778821176.8250003,25627727.38499999,1575400386.9600017,114588.0,-7896132.0,1826797018.5,80161864.5,401976389.5,184475049.5,419283027.0,114042.5,1813.0,314.21002777367005,2861975.0,949932.0,579326.0,-1902802.0,720273.0,97077.0,1266855714.3824902,1274774400.9224887,-78019337.0,-77374936.0,1439035.0,63407.5,,,,,,,,,,,,,,,,,,,,,1466780.0,14756687.0,3230747.0,8551568.0,11602787.0,1415028.0,,,72076361486.9171,,,5792665.7475,689.5,94245.0,-276813335.5,21933855.0,-123741489.5,,-2016515.0,,,,,,,,,,,,,,,,,,,,,4271091.0,2478179.0,-8999867.5,921269.0,37582.5,3731924877.9074616,3656505278.339961,-260521229.0,-257211576.5,2525453.5,269089.0,3924481620.149955,33241299959.16091,36669257585.57264,1728598705.582549,48063163315.86071,3986338.0,-247486591.0,103043114177.0,1053196406.0,17266448328.0,3502110027.5,18880284604.0,3670542.5,71890.0,20861.764856082948,89767662.0,-56.21044144325741,5.3465,2.3279499490760958,94.922956416711,12.44638440273534,507.5055864819453,72000.0,-0.2225209339563143,0.9749279121818236,0.0,0.0,0.0,0.0,0.0,0.0,1.0,0.0,0.0,0.0,0.0,0.0,0.0,1.0,0.0,0.0,0.0,0.0,1.0,0.0,1.0,0.0,0.0,0.0,0.0,1.0,0.0,0.0,0.0,0.0,0.0,0.0,0.0,0.0,0.0,0.0,0.0,0.0,0.0,0.0,0.0,0.0,0.0,0.0,1.0,0.0,0.0,0.0,0.0,0.0,0.0,0.0,0.0,0.0,0.0,0.0,0.0,0.0,0.0,0.0,0.0,0.0,0.0,0.0,0.0,0.0,0.0,0.0,0.0,0.0,0.0,0.0,0.0,0.0,0.0,0.0,0.0,0.0,0.0,0.0,0.0,0.0,0.0,0.0,0.0,0.0,0.0,0.0,0.0,0.0,1.0,0.0,0.0,0.0,0.0,0.0,0.0,0.0,0.0,0.0,0.0,0.0,0.0,0.0,0.0,0.0,0.0,0.0,0.0,0.0,0.0,0.0,0.0,0.0,0.0,0.0,0.0,0.0,0.0,0.0
101870,0,0.0,0.0,0.0,0.0,0.0,135000.0,670500.0,38623.5,670500.0,0.072508,39.660273972602745,-4495.0,-8619.0,-5106.0,,2.0,1.0,1.0,14.0,0.6249137674100521,0.6949039670491008,0.7476633896301825,0.2598,0.1108,0.9856,,,0.16,0.069,0.875,,0.1804,,0.2582,,0.0777,0.2647,0.0886,0.9851,,,0.1611,0.069,0.875,,0.1845,,0.2669,,0.0693,0.2623,0.1108,0.9856,,,0.16,0.069,0.875,,0.1835,,0.2629,,0.0793,0.2157,1.0,3.0,0.0,3.0,0.0,-501.0,1.0,0.0,0.0,0.0,0.0,2.0,1.0,1.0,1.0,1.0,1.0,0.0,0.0,0.0,0.0,0.0,0.0,0.0,0.0,1.0,0.0,0.0,0.0,0.0,0.0,0.0,0.0,0.0,0.0,0.0,0.0,0.0,0.0,0.0,0.0,0.0,0.0,0.0,2.0,0.0,,53641.35,0.0,0.0,0.0,0.0,0.0,-538.0,-262.0,-301.0,-459.0,36.0,-8.5,3.0,7194.3525,45000.0,45000.0,0.0,88773.75,6.0,-501.0,365243.0,182386.0,182521.0,182551.0,182523.5,13.0,0.0,0.0,50.0,11.0,12.0,7.0,-11.0,0.0,0.0,10.0,12138.705,12138.705,-348.0,-336.0,5.5,1.0,14.0,0.0,90000.0,,0.0,,,0.0,,0.0,0.0,0.0,0.0,,0.0,,,0.0,-9.5,0.0,0.0,8343253444.5,184334686029.0,165527145697.5,51950662957.935,1863.0,1705.0,71125.0,70758.0,9140.0,505852.0,17801.905100002292,17864.04029999911,17315.61809999806,11291.250200000086,11229.059400000093,11176.34380000006,128355.0,662541.0,,,,13522491.043835215,-601622664.0,-921532608.0,-296372144.0,-1534529876.0416667,43999.0,30694.0,11345.76879999918,11221.739999998972,10706.110899997298,22878.54460000966,22800.40920000962,22186.070600008185,67425.79315515544,157978.20266016622,126052.39696684811,34987.50990002791,34927.88680002834,34373.96670002875,,,,3712694.0,8292.280700000169,8396.769100000081,8120.446200000226,,,,16461.877599999752,16647.047599999696,16243.859999999697,,,,3912.631000000125,3895.851700000161,3728.49590000016,436283.0,431081.0,,6422.527608002895,631705.0,625258.0,,16326.5906999998,154115.95689999056,154118.70499999012,154010.47649998715,,,,18.0,28843316.774999995,,2976324560.4599986,966866671.5300006,36822355.78499999,638619.57,58.0,8639.0,-9771086.0,4486643.0,-5050994.0,-5455006.0,-8.5,0.0,,25515.0,0.0,0.0,0.0,0.0,0.0,-634.0,-600.0,-592.0,-600.0,110838824.415,1579212120.9600017,1783243871.3250003,25636815.13499999,1579234620.9600017,114783.0,-7909553.0,1830083341.5,80334090.5,402517650.5,185017669.5,420190173.5,114213.0,1816.0,314.3616496516848,2864129.0,952607.0,580835.0,-1907238.0,720273.0,97077.0,1270652434.2674887,1279144256.4224882,-78166981.5,-77521129.5,1441028.0,63640.5,1218756585.8249984,3204576000.0,,165585259.79999983,,,69562930.04999991,,165296546.14499992,1170006590.6099994,1213999485.9299965,1214044262.8649964,,13752.0,,,394846.0,-708382.5,248218.0,613.0,1466782.0,14756723.0,3230761.0,8551579.0,11602797.0,1415031.0,1057962475.7820008,,72076415128.2671,21669913280.47512,582146666.891999,5792665.7475,689.5,94245.0,-276813873.5,21933593.0,-123741790.5,-218616350.5,-2016523.5,5919628427.099961,18712316250.0,,447802478.6174977,,,308949670.95749867,,458947791.5624992,5704898181.862532,5882928616.012499,5883171798.7575,,80808.0,,,970992.0,-1697513.5,177364.0,6755.0,4271103.0,2478186.0,-8999878.5,921269.0,37582.5,3731937016.6124616,3656517417.044961,-260521577.0,-257211912.5,2525459.0,269090.0,3924488814.502455,33241344959.16091,36669302585.57264,1728598705.582549,48063252089.61071,3986344.0,-247487092.0,103043479420.0,1053378792.0,17266630849.0,3502292578.5,18880467127.5,3670555.5,71890.0,20861.764856082948,89767712.0,-113.33759325780603,4.966666666666667,3.4952813701502965,138.62381675149507,17.359897471746475,688.4982898657588,67500.0,0.6234898018587334,-0.7818314824680299,0.0,0.0,0.0,0.0,0.0,1.0,0.0,0.0,1.0,0.0,0.0,0.0,0.0,0.0,0.0,0.0,0.0,0.0,1.0,1.0,0.0,0.0,0.0,0.0,0.0,0.0,1.0,0.0,0.0,0.0,0.0,0.0,0.0,0.0,0.0,0.0,0.0,0.0,0.0,0.0,0.0,0.0,0.0,0.0,0.0,0.0,0.0,0.0,0.0,0.0,0.0,0.0,0.0,1.0,0.0,0.0,0.0,0.0,0.0,0.0,0.0,0.0,0.0,0.0,0.0,0.0,0.0,0.0,0.0,0.0,0.0,0.0,0.0,0.0,0.0,0.0,0.0,0.0,0.0,0.0,0.0,0.0,0.0,0.0,0.0,0.0,0.0,0.0,0.0,0.0,0.0,0.0,0.0,0.0,0.0,0.0,0.0,0.0,0.0,0.0,0.0,0.0,0.0,0.0,0.0,0.0,0.0,0.0,0.0,0.0,1.0,0.0,0.0,0.0,0.0,0.0,0.0,1.0,0.0,0.0
101873,0,0.0,1.0,1.0,1.0,0.0,112500.0,407520.0,32328.0,360000.0,0.035792,46.336986301369855,-910.0,-6422.0,-458.0,25.0,2.0,2.0,2.0,10.0,,0.69083223184818,0.1293142889822697,,,,,,,,,,,,,,,,,,,,,,,,,,,,,,,,,,,,,,,,,,,,,0.0,0.0,0.0,0.0,-826.0,0.0,0.0,0.0,0.0,0.0,0.0,1.0,1.0,0.0,1.0,0.0,0.0,0.0,0.0,0.0,0.0,0.0,0.0,0.0,1.0,0.0,0.0,0.0,0.0,0.0,0.0,0.0,0.0,0.0,0.0,0.0,0.0,0.0,0.0,0.0,0.0,0.0,0.0,2.0,12743.325,3132.0,438463.1925,586490.895,0.0,0.0,0.0,0.0,-1823.0,-696.0,-1240.5,-2432.0,121.0,-34.0,15.0,27106.965,76500.0,101673.0,3602.25,213750.0,24.0,-570.0,365243.0,-1225.0,-106.0,-106.0,-104.0,11.0,1.0,0.112321931920867,-1.0,29.0,24.0,13.0,-17.0,0.0,0.0,133.0,4500.0,4500.0,-1064.0,-1064.0,34.0,0.0,95.0,88097.13,90000.0,0.0,0.0,0.0,0.0,4500.0,4500.0,4500.0,83979.675,88097.13,88097.13,0.0,0.0,0.0,0.0,47.0,-48.0,0.0,0.0,8343285772.5,184335093549.0,165527505697.5,51950775457.935,1863.0,1705.0,71125.0,70758.0,9140.0,505852.0,,,,,,,128355.0,662543.0,,,,13522537.380821517,-601623574.0,-921533066.0,-296372970.0,-1534536298.0416667,43999.0,30694.0,,,,,,,,157978.89349239806,126052.52628113706,,,,,,,3712704.0,,,,,,,,,,,,,,,,436283.0,431081.0,1262550.0,6422.563400002896,631707.0,625260.0,,,,,,,,,60.5,28866810.105,8760938.354999999,2984490421.1999984,972276158.9250004,36822355.78499999,638619.57,58.0,8639.0,-9782954.5,4485053.5,-5056550.0,-5463138.0,-29.75,12743.325,6264.0,47979.0,586490.895,0.0,0.0,0.0,0.0,-2861.0,-2433.0,-2428.0,-2432.0,110973597.525,1581311402.2350016,1785766778.3250003,25644651.65999999,1581335537.9850016,114941.0,-7920787.0,1831724045.0,80513263.0,402697979.0,185198808.0,420370519.0,114361.0,1818.0,314.6374303630637,2864701.0,953138.0,581116.0,-1907919.0,720274.0,97078.0,1271942925.704985,1280280277.9349856,-78241671.0,-77595045.0,1443273.0,63693.0,1222837175.7899988,3209481000.0,105142812.57,165712609.79999983,6630336.9,53804149.96499997,69774430.04999991,178300886.08499953,165532796.14499992,1173841080.1649992,1218080075.8949964,1218124852.8299966,5323.0,13767.0,95.0,8348.0,396959.0,-710838.0,248225.0,620.0,1466784.0,14756844.0,3230856.0,8551608.0,11602930.0,1415046.0,1057975219.107001,801565105.0274951,72076853591.45961,21670499771.37012,582146666.891999,5792665.7475,689.5,94245.0,-276815696.5,21932897.0,-123743031.0,-218618782.5,-2016557.5,5919716524.229961,18712406250.0,198745595.325,447802478.6174977,1948107.735,256654969.0200008,308954170.95749867,636290619.4574982,458952291.5624992,5704982161.537532,5883016713.142499,5883259895.8875,13376.0,80808.0,44.0,70326.5,971039.0,-1697561.5,177364.0,6755.0,4271127.0,2478199.0,-8999895.5,921269.0,37582.5,3731941516.6124616,3656521917.044961,-260522641.0,-257212976.5,2525493.0,269090.0,3924515921.467455,33241421459.16091,36669404258.57264,1728602307.832549,48063465839.61071,3986368.0,-247487662.0,103043844663.0,1053377567.0,17266630743.0,3502292472.5,18880467023.5,3670566.5,71891.0,20861.877178014867,89767711.0,-19.63873943120677,3.6224,3.4799554565701563,161.25064832046863,12.605790645879734,584.1143484760655,56250.0,-0.2225209339563146,-0.9749279121818236,0.0,0.0,0.0,0.0,0.0,0.0,1.0,0.0,1.0,0.0,0.0,0.0,0.0,0.0,0.0,0.0,0.0,0.0,1.0,0.0,1.0,0.0,0.0,0.0,0.0,1.0,0.0,0.0,0.0,0.0,0.0,0.0,0.0,0.0,0.0,0.0,0.0,0.0,1.0,0.0,0.0,0.0,0.0,0.0,0.0,0.0,0.0,0.0,0.0,0.0,0.0,0.0,0.0,1.0,0.0,0.0,0.0,0.0,0.0,0.0,0.0,0.0,0.0,0.0,0.0,0.0,0.0,0.0,0.0,0.0,0.0,0.0,0.0,0.0,0.0,0.0,0.0,0.0,0.0,0.0,0.0,0.0,0.0,0.0,0.0,0.0,0.0,0.0,0.0,0.0,0.0,0.0,0.0,0.0,0.0,0.0,0.0,0.0,0.0,0.0,0.0,0.0,0.0,0.0,0.0,0.0,0.0,0.0,0.0,0.0,0.0,0.0,0.0,0.0,0.0,0.0,0.0,0.0,0.0,0.0
101878,0,0.0,1.0,1.0,1.0,1.0,292500.0,393543.0,20223.0,328500.0,0.00963,40.745205479452046,-1577.0,-7598.0,-5222.0,4.0,3.0,2.0,2.0,12.0,0.3958933802827122,0.2934296202605516,0.3031463744186309,,,,,,,,,,,,,,,,,,,,,,,,,,,,,,,,,,,,,,,,,,,,,1.0,0.0,1.0,0.0,-1544.0,0.0,0.0,0.0,0.0,1.0,2.0,1.0,1.0,0.0,1.0,0.0,1.0,0.0,0.0,0.0,0.0,0.0,0.0,0.0,1.0,0.0,0.0,0.0,0.0,0.0,0.0,0.0,0.0,0.0,0.0,0.0,0.0,0.0,0.0,0.0,0.0,0.0,0.0,12.0,0.0,0.0,272740.05,0.0,0.0,0.0,0.0,0.0,-599.5,538.5,-52.0,-457.5,295.0,-14.0,5.0,8157.195,52677.0,52677.0,0.0,52677.0,12.0,-809.0,365243.0,-1071.0,-951.0,-651.0,-945.5,14.0,0.0,0.0,50.0,22.0,8.5,7.5,-41.5,0.0,0.0,18.0,16125.165,16125.165,-1302.0,-1289.0,3.0,1.0,0.0,,,,,,,,,,,,,,,,,,,,,8343305995.5,184335487092.0,165527834197.5,51951067957.935,1863.0,1705.0,71125.0,70759.0,9140.0,505854.0,,,,,,,128356.0,662546.0,,,,13522578.126026995,-601625151.0,-921538288.0,-296374514.0,-1534543896.0416667,43999.0,30694.0,,,,,,,67426.1890485357,157979.18692201833,126052.8294275115,,,,,,,3712716.0,,,,,,,,,,,,,,,,436284.0,431082.0,1262554.0,6422.573030002895,631709.0,625262.0,,,,,,,,,20.5,28885582.75499999,8828430.209999999,2991609829.979998,974839872.7800006,37052615.42999999,638619.57,58.0,8639.0,-9822624.5,4501701.5,-5079739.5,-5482073.0,-9.75,0.0,0.0,333000.0,0.0,0.0,0.0,0.0,0.0,-1206.0,456.0,-296.0,-459.0,111192353.86499996,1583478318.7350016,1788126641.3250003,25686796.40999999,1583478318.7350016,115173.0,-7933810.0,1834463367.5,80505587.0,403790077.0,185561488.0,421462663.0,114582.0,1821.0,315.0664867377106,2868395.0,954084.0,581733.5,-1909009.5,720290.0,97094.0,1272846331.6199863,1281202433.7299874,-78361805.5,-77714184.0,1446768.5,63757.5,,,,,,,,,,,,,,,,,,,,,1466796.0,14757139.0,3230856.0,8551630.0,11602948.0,1415051.0,1057975219.107001,801565105.0274951,72077126331.50961,21670499771.37012,582146666.891999,5792665.7475,689.5,94245.0,-276816296.0,21933435.5,-123743083.0,-218619240.0,-2016571.5,,,,,,,,,,,,,,,,,,,,,4271135.5,2478206.5,-8999937.0,921269.0,37582.5,3731957641.7774615,3656538042.209961,-260523943.0,-257214265.5,2525496.0,269091.0,3924524078.662455,33241474136.16091,36669456935.57264,1728602307.832549,48063518516.61071,3986380.0,-247488471.0,103044209906.0,1053376496.0,17266629792.0,3502291821.5,18880466078.0,3670580.5,71891.0,20861.877178014867,89767761.0,-38.70394029047876,1.3454461538461535,14.463729417000446,589.3276270948784,19.46016911437472,792.9085892300845,97500.0,-0.9009688679024191,0.4338837391175582,0.0,0.0,0.0,0.0,0.0,0.0,1.0,0.0,0.0,0.0,1.0,0.0,0.0,0.0,0.0,1.0,0.0,0.0,0.0,0.0,1.0,0.0,0.0,0.0,0.0,1.0,0.0,0.0,0.0,0.0,0.0,0.0,0.0,1.0,0.0,0.0,0.0,0.0,0.0,0.0,0.0,0.0,0.0,0.0,0.0,0.0,0.0,0.0,0.0,0.0,0.0,0.0,0.0,0.0,0.0,0.0,0.0,0.0,0.0,0.0,0.0,1.0,0.0,0.0,0.0,0.0,0.0,0.0,0.0,0.0,0.0,0.0,0.0,0.0,0.0,0.0,0.0,0.0,0.0,0.0,0.0,0.0,0.0,0.0,0.0,0.0,0.0,0.0,0.0,0.0,0.0,0.0,0.0,0.0,0.0,0.0,0.0,0.0,0.0,0.0,0.0,0.0,0.0,0.0,0.0,0.0,0.0,0.0,0.0,0.0,0.0,0.0,0.0,0.0,0.0,0.0,0.0,0.0,0.0,0.0
101879,0,0.0,0.0,1.0,0.0,0.0,225000.0,986418.0,45837.0,810000.0,0.018801,62.2931506849315,,-299.0,-4512.0,4.0,2.0,2.0,2.0,11.0,,0.3747657772855717,0.6801388218428291,0.0474,0.1207,0.9791,0.7144,,0.0,0.2759,0.1667,,0.1442,0.0336,0.1021,0.0232,0.0,0.0483,0.1253,0.9791,0.7256,,0.0,0.2759,0.1667,,0.1475,0.0367,0.1064,0.0233,0.0,0.0479,0.1207,0.9791,0.7182,,0.0,0.2759,0.1667,,0.1467,0.0342,0.1039,0.0233,0.0,0.1323,1.0,12.0,0.0,12.0,0.0,-1785.0,0.0,0.0,0.0,0.0,1.0,5.0,1.0,0.0,0.0,1.0,0.0,1.0,0.0,0.0,0.0,0.0,0.0,0.0,0.0,1.0,0.0,0.0,0.0,0.0,0.0,0.0,0.0,0.0,0.0,0.0,0.0,0.0,0.0,0.0,0.0,0.0,0.0,0.0,9.0,4497.75,0.0,156988.89,0.0,0.0,0.0,0.0,0.0,-1665.0,-1081.0,-1081.0,-1358.0,449.0,-30.0,11.0,13040.91,159057.0,143149.5,4725.0,159057.0,18.0,-1891.0,365243.0,-1549.0,-614.0,361.0,-603.5,11.0,0.0,0.1089214158217722,34.0,68.0,36.0,25.5,-39.5,0.0,0.0,179.0,13500.0,13500.0,-1360.0,-1350.0,29.0,0.0,90.0,59654.9925,270000.0,0.0,0.0,0.0,0.0,9000.0,10518.9975,9000.0,49832.235,59654.9925,59654.9925,0.0,0.0,0.0,0.0,36.0,-45.5,0.0,0.0,8343351832.5,184336473510.0,165528644197.5,51951292957.935,1863.0,1705.0,71125.0,70760.0,9140.0,505859.0,17801.95250000229,17864.08819999911,17315.66639999806,11291.370900000084,11229.180100000089,11176.469100000058,128356.0,662548.0,,,,13522640.41917768,,-921542800.0,-296376299.0,-1534544195.0416667,43999.0,30694.0,11345.76879999918,11221.739999998972,10706.110899997298,22878.820500009657,22800.685100009618,22186.346500008185,,157979.56168779562,126053.50956633336,34987.67660002791,34928.05350002834,34374.13340002875,,,,3712727.0,8292.424900000171,8396.915800000079,8120.593700000226,9814.15480000072,9929.058900002155,10288.597399999646,16461.979699999752,16647.151499999694,16243.966399999696,828.527300000176,813.703200000046,759.6855000000131,3912.631000000125,3895.851700000161,3728.49590000016,436296.0,431094.0,1262558.0,6422.591831002896,631711.0,625264.0,,16326.722999999798,154116.93599999056,154119.68409999012,154011.45559998715,77579.30039999624,77916.97260000659,78318.24650000651,55.0,28989721.75499999,8828430.209999999,2995988028.119998,976341275.2800006,37052615.42999999,638619.57,58.0,8639.0,-9834016.0,4513795.0,-5086015.0,-5488590.0,-27.0,0.0,0.0,112356.0,0.0,0.0,0.0,0.0,0.0,-1890.0,-1692.0,-1336.0,-1570.0,111277726.37999997,1585295130.4650016,1790003618.3250003,25709948.63999999,1584912630.4650016,115331.0,-7944210.0,1836288213.0,80499632.0,403786661.0,185559094.5,421459267.0,114676.0,1821.5,315.42590255995617,2870038.0,954867.0,582287.0,-1911259.0,720290.0,97094.0,1276471407.6449869,1284816259.7549877,-78494726.0,-77845680.0,1450072.0,63813.0,1232187433.1999989,3225996000.0,106861362.57,167428426.04999983,6630336.9,53805916.21499997,70275627.71999991,179779279.40999955,166864188.64499992,1182657071.8799992,1227427578.5849967,1227472355.5199971,5384.0,13829.0,95.0,8350.0,400587.0,-714887.5,248231.0,626.0,1466805.0,14757588.0,3230946.0,8551698.0,11603127.0,1415062.0,1057979716.857001,801565105.0274951,72077283320.39961,21670499771.37012,582146666.891999,5792665.7475,689.5,94245.0,-276817961.0,21932354.5,-123744164.0,-218620598.0,-2016601.5,5919776179.222462,18712676250.0,198745595.325,447802478.6174977,1948107.735,256654969.0200008,308963170.95749867,636301138.454998,458961291.5624992,5705031993.772532,5883076368.134999,5883319550.88,13376.0,80808.0,44.0,70326.5,971075.0,-1697607.0,177364.0,6755.0,4271171.5,2478232.0,-8999976.5,921269.0,37582.5,3731971141.7774615,3656551542.209961,-260525303.0,-257215615.5,2525525.0,269091.0,3924537119.5724554,33241633193.16091,36669600085.07264,1728607032.832549,48063677573.61071,3986398.0,-247490362.0,103044575149.0,1053374947.0,17266629178.0,3502292182.5,18880465474.5,3670591.5,71891.0,20861.98609943069,89767795.0,,4.38408,4.9086982132338495,305.77827746383025,21.52012566267426,1340.556430663629,112500.0,-0.2225209339563146,-0.9749279121818236,0.0,0.0,0.0,0.0,0.0,0.0,1.0,0.0,0.0,1.0,0.0,0.0,0.0,0.0,0.0,0.0,0.0,0.0,1.0,0.0,1.0,0.0,0.0,0.0,0.0,1.0,0.0,0.0,0.0,0.0,0.0,0.0,0.0,0.0,0.0,0.0,0.0,0.0,0.0,0.0,0.0,0.0,0.0,0.0,0.0,0.0,0.0,0.0,0.0,0.0,0.0,0.0,0.0,0.0,0.0,0.0,0.0,0.0,0.0,0.0,0.0,0.0,0.0,0.0,0.0,0.0,0.0,0.0,0.0,0.0,0.0,0.0,0.0,0.0,0.0,0.0,0.0,0.0,0.0,0.0,0.0,0.0,0.0,0.0,0.0,0.0,0.0,0.0,0.0,0.0,0.0,0.0,0.0,0.0,0.0,0.0,0.0,0.0,0.0,0.0,0.0,0.0,0.0,0.0,0.0,1.0,0.0,0.0,0.0,1.0,1.0,0.0,0.0,0.0,0.0,0.0,0.0,1.0,0.0,0.0
101880,0,0.0,0.0,1.0,1.0,0.0,360000.0,819000.0,39532.5,819000.0,0.04622,40.63287671232877,-879.0,-324.0,-2381.0,2.0,2.0,1.0,1.0,17.0,,0.7229717982865411,0.6006575372857061,,,,,,,,,,,,,,,,,,,,,,,,,,,,,,,,,,,,,,,,,,,,,0.0,0.0,0.0,0.0,-1715.0,0.0,0.0,0.0,0.0,0.0,0.0,1.0,1.0,0.0,1.0,0.0,0.0,0.0,1.0,1.0,0.0,0.0,0.0,0.0,1.0,0.0,0.0,0.0,0.0,0.0,0.0,0.0,0.0,0.0,0.0,0.0,0.0,0.0,0.0,0.0,0.0,0.0,0.0,5.0,65250.0,0.0,652500.0,0.0,64069.965,0.0,0.0,0.0,-669.0,1443.0,-56.0,-638.0,165.0,-19.0,14.0,22500.0,128877.75,258750.0,2520.0,360000.0,12.0,-583.0,365243.0,-891.0,-651.0,-621.0,-636.0,17.0,0.0,0.0262115742260146,-1.0,30.0,10.0,6.5,-28.5,0.0,0.0,84.0,13505.58,13505.58,-625.5,-603.0,16.5,0.0,30.0,128550.7575,450000.0,0.0,8306.775,0.0,0.0,6331.455,9096.75,861.4125,125343.4725,127674.315,127674.315,0.0,1.0,0.0,0.0,10.0,-15.5,0.0,0.0,8343391365.0,184337292510.0,165529463197.5,51951652957.935,1863.0,1705.0,71125.0,70760.0,9140.0,505859.0,,,,,,,128356.0,662550.0,,,,13522681.052054396,-601626030.0,-921545181.0,-296378014.0,-1534544519.0416667,43999.0,30694.0,,,,,,,,157980.28465959392,126054.11022387064,,,,,,,3712744.0,,,,,,,,,,,,,,,,436296.0,431094.0,1262560.0,6422.638051002896,631712.0,625265.0,,,,,,,,,23.0,29098621.75499999,8828430.209999999,3007928242.8899984,976635489.7800006,37116685.39499999,638619.57,58.0,8639.0,-9841485.0,4516601.0,-5090817.0,-5493191.0,-11.0,0.0,0.0,450000.0,0.0,447991.155,0.0,0.0,0.0,-1789.0,1022.0,-638.0,-638.0,111515677.55999994,1588774084.9650016,1794491607.8250003,25744283.63999999,1589002639.9650016,115509.0,-7959585.5,1837564289.0,80492516.0,404513259.0,186288730.0,422185907.0,114867.5,1823.0,315.66995696582575,2871880.0,956614.0,583710.0,-1912577.5,720290.0,97094.0,1281571303.4099894,1289855374.8749902,-78630582.5,-77980246.5,1455512.0,63833.0,1238895761.9849992,3244986000.0,108039912.57,168730308.22499982,6630336.9,53929248.38999997,70670881.3949999,181709276.0849996,168554866.00499988,1189091803.2299984,1234121829.5249972,1234166606.4599974,5415.0,13884.0,95.0,8374.0,401917.0,-717335.0,248231.0,626.0,1466810.0,14757753.0,3230976.0,8551728.0,11603211.0,1415076.0,1058044966.857001,801565105.0274951,72077935820.39961,21670499771.37012,582210736.856999,5792665.7475,689.5,94245.0,-276818630.0,21933797.5,-123744220.0,-218621236.0,-2016620.5,5919904729.979961,18713126250.0,198745595.325,447810785.39249766,1948107.735,256654969.0200008,308969502.41249865,636310235.204998,458962152.9749993,5705157337.245031,5883204042.449999,5883447225.195,13376.0,80809.0,44.0,70326.5,971085.0,-1697622.5,177364.0,6755.0,4271181.5,2478238.5,-9000005.0,921269.0,37582.5,3731984647.357462,3656565047.78996,-260525928.5,-257216218.5,2525541.5,269091.0,3924559619.5724554,33241762070.91091,36669858835.07264,1728609552.832549,48064037573.61071,3986410.0,-247490945.0,103044940392.0,1053374056.0,17266628527.0,3502291561.5,18880464838.5,3670608.5,71891.0,20862.01231100492,89767794.0,-21.632728743847352,2.275,9.106431417188393,370.0205050638932,20.717131474103585,841.7966490203569,180000.0,-0.2225209339563146,-0.9749279121818236,0.0,0.0,0.0,0.0,0.0,1.0,0.0,0.0,1.0,0.0,0.0,0.0,0.0,0.0,0.0,0.0,0.0,0.0,1.0,0.0,1.0,0.0,0.0,0.0,0.0,1.0,0.0,0.0,0.0,0.0,0.0,0.0,0.0,0.0,0.0,0.0,0.0,0.0,0.0,0.0,0.0,0.0,0.0,0.0,1.0,0.0,0.0,0.0,0.0,0.0,0.0,0.0,0.0,1.0,0.0,0.0,0.0,0.0,0.0,0.0,0.0,0.0,0.0,0.0,0.0,0.0,0.0,0.0,0.0,0.0,0.0,0.0,0.0,0.0,0.0,0.0,0.0,0.0,0.0,0.0,0.0,0.0,0.0,0.0,0.0,0.0,0.0,0.0,0.0,0.0,0.0,0.0,0.0,0.0,0.0,0.0,0.0,0.0,0.0,0.0,0.0,0.0,0.0,0.0,0.0,0.0,0.0,0.0,0.0,0.0,0.0,0.0,0.0,0.0,0.0,0.0,0.0,0.0,0.0,0.0
101887,0,0.0,1.0,0.0,1.0,1.0,247500.0,1094688.0,39451.5,945000.0,0.04622,26.12328767123288,-328.0,-4248.0,-1764.0,,3.0,1.0,1.0,16.0,0.6106549667474371,0.6741936035034893,0.2778856891082046,,,,,,,,,,,,,,,,,,,,,,,,,,,,,,,,,,,,,,,,,,,,,1.0,0.0,1.0,0.0,-703.0,0.0,0.0,0.0,0.0,0.0,0.0,1.0,1.0,0.0,1.0,0.0,1.0,0.0,1.0,1.0,0.0,0.0,0.0,0.0,1.0,0.0,0.0,0.0,0.0,0.0,0.0,0.0,0.0,0.0,0.0,0.0,0.0,0.0,0.0,0.0,0.0,0.0,0.0,4.0,17138.25,61.02,101837.25,0.0,0.0,0.0,0.0,0.0,-987.5,-335.0,-178.5,-780.5,127.0,-16.0,1.0,10857.195,104103.0,105903.0,0.0,104103.0,12.0,-703.0,365243.0,-672.0,-462.0,-342.0,-459.0,13.0,0.0,0.0,100.0,9.0,12.0,8.0,-19.0,0.0,0.0,8.0,10857.195,10857.195,-635.5,-567.0,4.5,1.0,0.0,,,,,,,,,,,,,,,,,,,,,8343430816.5,184338387198.0,165530408197.5,51951900457.935,1863.0,1705.0,71125.0,70760.0,9140.0,505859.0,,,,,,,128357.0,662553.0,,,,13522707.175342064,-601626358.0,-921546945.0,-296378717.0,-1534548767.0416667,43999.0,30694.0,,,,,,,67426.79970350245,157980.95885319743,126054.38810955976,,,,,,,3712760.0,,,,,,,,,,,,,,,,436297.0,431095.0,,6422.684271002896,631713.0,625266.0,,,,,,,,,32.0,29188772.50499999,8867945.879999999,3015290833.0199986,979077234.7350006,37642556.69999999,638619.57,58.0,8639.0,-9859201.0,4522014.0,-5097288.5,-5499870.0,-16.5,15525.0,61.02,155250.0,0.0,0.0,0.0,0.0,0.0,-1015.0,-335.0,-29.0,-1226.0,112367322.80999991,1602346080.6900015,1809687039.435,25795680.25499999,1602346080.6900015,116201.0,-7979412.0,1843042934.0,80478973.0,405964128.0,186280497.0,423636894.0,115334.0,1827.0,316.22473656561624,2875567.0,958556.0,584926.0,-1916406.0,720343.0,97147.0,1285652895.1874895,1293822091.0574892,-78776065.5,-78123669.0,1456745.5,64000.5,,,,,,,,,,,,,,,,,,,,,1466814.0,14757880.0,3230976.0,8551737.0,11603219.0,1415077.0,1058062105.107001,801565166.0474951,72078037657.64961,21670499771.37012,582210736.856999,5792665.7475,689.5,94245.0,-276819617.5,21933462.5,-123744398.5,-218622016.5,-2016636.5,,,,,,,,,,,,,,,,,,,,,4271193.5,2478246.5,-9000024.0,921269.0,37582.5,3731995504.5524616,3656575904.984961,-260526564.0,-257216785.5,2525546.0,269092.0,3924570476.767455,33241866173.91091,36669964738.07264,1728609552.832549,48064141676.61071,3986422.0,-247491648.0,103045305635.0,1053373384.0,17266628065.0,3502291219.5,18880464379.5,3670621.5,71891.0,20862.01231100492,89767894.0,-12.555846879916098,4.422981818181818,6.273525721455457,163.88511713445968,27.747690201893462,724.8608933563127,82500.0,-0.9009688679024191,0.4338837391175582,0.0,0.0,0.0,0.0,0.0,0.0,1.0,0.0,0.0,0.0,0.0,0.0,0.0,1.0,0.0,0.0,1.0,0.0,0.0,0.0,1.0,0.0,0.0,0.0,0.0,1.0,0.0,0.0,0.0,0.0,0.0,0.0,0.0,0.0,0.0,0.0,0.0,0.0,0.0,0.0,0.0,0.0,0.0,0.0,1.0,0.0,0.0,0.0,0.0,0.0,0.0,0.0,0.0,1.0,0.0,0.0,0.0,0.0,0.0,0.0,0.0,0.0,0.0,0.0,0.0,0.0,0.0,0.0,0.0,0.0,0.0,0.0,0.0,0.0,0.0,0.0,0.0,0.0,0.0,0.0,0.0,0.0,0.0,0.0,0.0,0.0,0.0,0.0,0.0,0.0,0.0,0.0,0.0,0.0,0.0,0.0,0.0,0.0,0.0,0.0,0.0,0.0,0.0,0.0,0.0,0.0,0.0,0.0,0.0,0.0,0.0,0.0,0.0,0.0,0.0,0.0,0.0,0.0,0.0,0.0
101897,0,0.0,0.0,0.0,0.0,0.0,90000.0,539100.0,26064.0,450000.0,0.005002,57.56438356164385,,-10155.0,-4432.0,,1.0,3.0,3.0,13.0,,0.5485042373543773,0.7922644738669378,0.0021,,0.9861,,,,0.0345,0.0,,0.0009,,0.0027,,0.0036,0.0021,,0.9861,,,,0.0345,0.0,,0.001,,0.0028,,0.0038,0.0021,,0.9861,,,,0.0345,0.0,,0.001,,0.0028,,0.0037,0.0021,1.0,0.0,0.0,0.0,0.0,-240.0,0.0,0.0,0.0,0.0,1.0,0.0,1.0,0.0,0.0,1.0,1.0,0.0,0.0,0.0,0.0,0.0,0.0,0.0,0.0,0.0,0.0,0.0,1.0,0.0,0.0,0.0,0.0,0.0,0.0,0.0,0.0,0.0,0.0,0.0,0.0,0.0,0.0,0.0,3.0,0.0,,202500.0,0.0,0.0,0.0,0.0,0.0,-2613.0,-2065.0,-1130.0,-2066.0,261.0,-43.0,1.0,25975.935,144787.5,139765.5,14481.0,144787.5,6.0,-240.0,365243.0,-203.0,-53.0,-53.0,-45.0,10.0,0.0,0.1022462451630698,80.0,6.0,6.0,3.5,-5.5,0.0,0.0,6.0,25975.935,25975.935,-153.0,-128.0,3.5,1.0,0.0,,,,,,,,,,,,,,,,,,,,,8343456880.5,184338926298.0,165530858197.5,51951990457.935,1863.0,1705.0,71125.0,70761.0,9140.0,505859.0,17801.954600002293,17864.090299999112,17315.66849999806,,,,128357.0,662554.0,,,,13522764.739725623,,-921551377.0,-296378957.0,-1534558922.0416667,43999.0,30694.0,,,,22878.855000009666,22800.719600009623,22186.381000008183,,157981.50735743478,126055.18037403365,34987.67660002791,34928.05350002834,34374.13340002875,,,,3712773.0,8292.425800000168,8396.916800000081,8120.594700000226,,,,16461.98239999975,16647.154299999693,16243.969199999694,,,,3912.634600000125,3895.855400000162,3728.49970000016,436297.0,431095.0,,6422.689273002896,631716.0,625269.0,,16326.725099999798,154117.92209999054,154120.67019999013,154012.44169998716,,,,86.0,29211193.75499999,,3036210272.1449986,984299741.2800006,37890119.69999999,638619.57,58.0,8639.0,-9924958.0,4534616.0,-5129815.0,-5536555.0,-42.5,0.0,,202500.0,0.0,0.0,0.0,0.0,0.0,-2613.0,-2065.0,-1130.0,-2066.0,112527795.23999992,1604314555.2900016,1811871768.735,25894214.05499999,1604314555.2900016,116443.0,-8002064.0,1848155146.0,80461563.0,406681830.0,186636032.0,424721012.0,115620.0,1830.0,317.5157809481778,2880585.0,962363.0,587394.0,-1923086.0,720376.0,97180.0,1287626047.4474864,1295637638.1524866,-79010135.5,-78356330.5,1459314.5,64192.5,,,,,,,,,,,,,,,,,,,,,1466817.0,14758141.0,3230976.0,8551743.0,11603225.0,1415078.0,1058062105.107001,,72078240157.64961,21670499771.37012,582210736.856999,5792665.7475,689.5,94245.0,-276822230.5,21931397.5,-123745528.5,-218624082.5,-2016679.5,,,,,,,,,,,,,,,,,,,,,4271199.5,2478250.0,-9000029.5,921269.0,37582.5,3732021480.4874616,3656601880.919961,-260526717.0,-257216913.5,2525549.5,269093.0,3924596452.702455,33242010961.41091,36670104503.57264,1728624033.832549,48064286464.11071,3986428.0,-247491888.0,103045670878.0,1053373181.0,17266628012.0,3502291166.5,18880464334.5,3670631.5,71891.0,20862.11455725008,89767974.0,,5.99,3.4530386740331487,198.77204268523425,20.683701657458567,1190.6445356845531,90000.0,1.0,0.0,0.0,0.0,0.0,0.0,0.0,0.0,1.0,0.0,0.0,1.0,0.0,0.0,0.0,0.0,0.0,0.0,0.0,0.0,1.0,0.0,0.0,0.0,0.0,1.0,0.0,1.0,0.0,0.0,0.0,0.0,0.0,0.0,0.0,0.0,0.0,0.0,0.0,0.0,0.0,0.0,0.0,0.0,0.0,0.0,0.0,0.0,0.0,0.0,0.0,0.0,0.0,0.0,0.0,0.0,0.0,0.0,0.0,0.0,0.0,0.0,0.0,0.0,0.0,0.0,0.0,0.0,0.0,0.0,0.0,0.0,0.0,0.0,0.0,0.0,0.0,0.0,0.0,0.0,0.0,0.0,0.0,0.0,0.0,0.0,0.0,0.0,0.0,0.0,0.0,0.0,0.0,0.0,0.0,0.0,0.0,0.0,0.0,0.0,0.0,0.0,0.0,0.0,0.0,0.0,0.0,1.0,0.0,0.0,0.0,0.0,1.0,0.0,0.0,0.0,0.0,0.0,1.0,0.0,0.0,0.0
101901,0,0.0,0.0,1.0,1.0,1.0,135000.0,509400.0,32683.5,450000.0,0.020246,33.30958904109589,-175.0,-2045.0,-1514.0,8.0,3.0,3.0,3.0,9.0,0.4236263652307243,0.2629104517846353,0.4066174366275036,0.1485,0.1228,0.9846,0.7892,0.0,0.18,0.1552,0.3333,0.375,0.0857,0.121,0.173,,0.1125,0.1513,0.1138,0.9846,0.7975,0.0,0.1611,0.1379,0.3333,0.375,0.0441,0.1322,0.1608,,0.0972,0.1499,0.1228,0.9846,0.792,0.0,0.18,0.1552,0.3333,0.375,0.0872,0.1231,0.1761,,0.1149,0.1797,1.0,0.0,0.0,0.0,0.0,-2734.0,0.0,0.0,0.0,0.0,0.0,0.0,1.0,1.0,0.0,1.0,0.0,1.0,0.0,0.0,0.0,0.0,0.0,0.0,0.0,1.0,0.0,0.0,0.0,0.0,0.0,0.0,0.0,0.0,0.0,0.0,0.0,0.0,0.0,0.0,0.0,0.0,0.0,0.0,2.0,0.0,0.0,189000.0,0.0,0.0,0.0,0.0,0.0,-1056.0,-525.0,-521.0,-525.0,70.0,-17.0,3.0,10275.48,62995.5,65074.5,0.0,62995.5,8.0,-2644.0,365243.0,-2128.0,-1978.0,-1978.0,-1971.0,10.0,0.5,0.0,140.0,15.0,8.0,3.0,-51.0,0.0,0.0,13.0,10275.48,10275.48,-1511.0,-1497.0,4.0,1.0,0.0,,,,,,,,,,,,,,,,,,,,,8343489564.0,184339435698.0,165531308197.5,51952125457.935,1863.0,1705.0,71125.0,70761.0,9140.0,505859.0,17802.103100002292,17864.240199999113,17315.819799998062,11291.493700000085,11229.302900000088,11176.58290000006,128358.0,662557.0,4136.613500000122,4134.282500000016,3944.9102000000953,13522798.049314668,-601626533.0,-921552891.0,-296381691.0,-1534560967.0416667,43999.0,30694.0,11345.94879999918,11221.919999998972,10706.271999997298,22879.010200009663,22800.874800009624,22186.518900008185,67427.22332986767,157981.77026788658,126055.58699147023,34988.00990002791,34928.38680002834,34374.46670002875,22944.963799995923,22918.234199995502,22565.53989999573,3712782.0,8292.511500000168,8397.004000000079,8120.638800000226,9814.275800000718,9929.182000002156,10288.729599999646,16462.155399999752,16647.330399999693,16244.129999999695,,,,3912.747100000125,3895.970300000162,3728.59690000016,436297.0,431095.0,1262568.0,6422.709519002896,631719.0,625272.0,,16326.904799999797,154118.90669999053,154121.65479999012,154013.42629998716,77580.08959999624,77917.76460000659,78319.04400000651,35.0,29211193.75499999,8900000.145,3037637262.6449986,984339413.2800006,37890119.69999999,638619.57,58.0,8639.0,-9944444.5,4553384.5,-5141525.0,-5549504.5,-17.0,0.0,0.0,306000.0,0.0,0.0,0.0,0.0,0.0,-1267.0,-389.0,-388.0,-389.0,112664042.99999993,1605918530.7900016,1813659416.235,25904595.55499999,1605918530.7900016,116669.0,-8023692.0,1851990197.5,80447350.5,407035950.5,186626724.5,425075196.5,115862.0,1838.0,317.71753771977706,2881932.0,964711.0,588917.0,-1928505.0,720376.0,97180.0,1289712919.0949855,1297651708.799986,-79390723.0,-78733887.0,1471772.0,64327.0,,,,,,,,,,,,,,,,,,,,,1466819.0,14758211.0,3230976.0,8551758.0,11603238.0,1415081.0,1058062105.107001,801565166.0474951,72078429157.64961,21670499771.37012,582210736.856999,5792665.7475,689.5,94245.0,-276823286.5,21930872.5,-123746049.5,-218624607.5,-2016696.5,,,,,,,,,,,,,,,,,,,,,4271207.5,2478253.0,-9000080.5,921269.0,37582.5,3732031755.9674616,3656612156.399961,-260528228.0,-257218410.5,2525553.5,269094.0,3924606728.182455,33242073956.91091,36670169578.07264,1728624033.832549,48064349459.61071,3986436.0,-247494532.0,103046036121.0,1053371053.0,17266626034.0,3502289188.5,18880462363.5,3670641.5,71891.5,20862.11455725008,89768114.0,-5.253742391840762,3.773333333333333,4.130524576621231,137.5860761713998,15.585846069117446,519.1581274200819,45000.0,-0.9009688679024191,0.4338837391175582,0.0,0.0,0.0,0.0,0.0,0.0,1.0,0.0,0.0,0.0,0.0,0.0,0.0,1.0,0.0,1.0,0.0,0.0,0.0,0.0,1.0,0.0,0.0,0.0,0.0,1.0,0.0,0.0,0.0,0.0,1.0,0.0,0.0,0.0,0.0,0.0,0.0,0.0,0.0,0.0,0.0,0.0,0.0,0.0,0.0,0.0,0.0,0.0,0.0,0.0,0.0,0.0,0.0,0.0,0.0,0.0,0.0,0.0,0.0,0.0,0.0,0.0,0.0,0.0,0.0,0.0,0.0,0.0,0.0,0.0,0.0,0.0,0.0,0.0,0.0,0.0,0.0,0.0,1.0,0.0,0.0,0.0,0.0,0.0,0.0,0.0,0.0,0.0,0.0,0.0,0.0,0.0,0.0,0.0,0.0,0.0,0.0,0.0,0.0,0.0,0.0,0.0,0.0,0.0,0.0,0.0,0.0,0.0,1.0,0.0,1.0,0.0,0.0,0.0,0.0,0.0,0.0,1.0,0.0,0.0
101903,0,0.0,1.0,1.0,1.0,0.0,135000.0,265500.0,17869.5,265500.0,0.018209,22.78904109589041,-1335.0,-8318.0,-995.0,19.0,1.0,3.0,3.0,11.0,0.1483976415363148,0.1133063880700191,0.4722533429586386,0.067,0.075,0.9767,0.6804,0.0124,0.0,0.1379,0.1667,0.2083,0.0322,0.0538,0.0509,0.0039,0.0666,0.0683,0.0778,0.9767,0.6929,0.0126,0.0,0.1379,0.1667,0.2083,0.0329,0.0588,0.053,0.0039,0.0705,0.0677,0.075,0.9767,0.6847,0.0125,0.0,0.1379,0.1667,0.2083,0.0327,0.0547,0.0518,0.0039,0.068,0.0613,1.0,0.0,0.0,0.0,0.0,-883.0,0.0,0.0,0.0,0.0,1.0,1.0,1.0,1.0,0.0,1.0,0.0,1.0,0.0,0.0,0.0,0.0,0.0,0.0,0.0,1.0,0.0,0.0,0.0,0.0,0.0,0.0,0.0,0.0,0.0,0.0,0.0,0.0,0.0,0.0,0.0,0.0,0.0,0.0,2.0,18560.61,0.0,118516.2075,70668.0,22132.935,0.0,0.0,0.0,-500.5,,-229.5,-450.0,34.0,-12.5,1.0,6110.325,121923.0,135634.5,0.0,121923.0,24.0,-883.0,365243.0,-852.0,-162.0,-162.0,-158.0,12.0,0.0,0.0,100.0,25.0,24.0,12.0,-17.0,0.0,0.0,35.0,6110.325,5116.95,-519.0,-522.0,12.0,1.0,0.0,,,,,,,,,,,,,,,,,,,,,8343507433.5,184339701198.0,165531573697.5,51952260457.935,1863.0,1705.0,71125.0,70762.0,9140.0,505860.0,17802.17010000229,17864.307899999112,17315.888099998057,11291.568700000083,11229.377900000089,11176.660700000057,128358.0,662558.0,4136.625900000122,4134.295000000016,3944.9228000000953,13522820.838355765,-601627868.0,-921553886.0,-296382574.0,-1534569285.0416667,43999.0,30694.0,11345.94879999918,11221.919999998972,10706.271999997298,22879.148100009665,22801.012700009625,22186.656800008182,67427.3717275092,157981.88357427466,126056.0592448132,34988.17660002791,34928.55350002834,34374.63340002875,22945.17209999592,22918.442499995497,22565.74819999573,3712793.0,8292.54370000017,8397.036700000079,8120.671700000225,9814.329600000718,9929.236700002157,10288.788399999648,16462.206299999747,16647.382199999694,16244.182999999695,828.5312000001759,813.7071000000459,759.6894000000133,3912.813700000125,3896.0383000001616,3728.66740000016,436297.0,431095.0,1262587.0,6422.727728002896,631722.0,625275.0,,16326.966099999798,154119.88339999053,154122.63149999012,154014.40299998716,77580.76999999624,77918.44930000657,78319.73690000651,17.0,29229754.36499999,8900000.145,3039302981.992499,985640619.7800006,37934385.56999999,638619.57,58.0,8639.0,-9947181.5,,-5142636.5,-5550760.0,-8.0,18560.61,0.0,51426.135,0.0,0.0,0.0,0.0,0.0,-907.0,,-445.0,-450.0,112698288.98999992,1606240838.7900016,1813995957.735,25918973.05499999,1606240838.7900016,116719.0,-8028438.0,1853268548.0,80443512.0,407033177.0,186624161.0,425072440.0,115912.0,1838.0,318.09228807270785,2882441.0,965183.0,589203.0,-1929563.0,720376.0,97180.0,1290049068.7799866,1297943222.6699862,-79422114.0,-78764959.0,1472014.0,64365.0,,,,,,,,,,,,,,,,,,,,,1466821.0,14758245.0,3230976.0,8551783.0,11603273.0,1415082.0,1058080665.717001,801565166.0474951,72078547673.85713,21670570439.37012,582232869.791999,5792665.7475,689.5,94245.0,-276823787.0,,-123746279.0,-218625057.5,-2016709.0,,,,,,,,,,,,,,,,,,,,,4271231.5,2478265.0,-9000097.5,921269.0,37582.5,3732037866.292462,3656617273.34996,-260528747.0,-257218932.5,2525565.5,269095.0,3924612838.507455,33242195879.91091,36670305212.57264,1728624033.832549,48064471382.61071,3986460.0,-247495415.0,103046401364.0,1053370201.0,17266625872.0,3502289026.5,18880462205.5,3670653.5,71891.5,20862.11455725008,89768214.0,-58.58078865111806,1.9666666666666663,7.554772097708386,172.1660118047626,14.857718458826492,338.5931565493665,135000.0,-0.9009688679024191,0.4338837391175582,0.0,0.0,0.0,0.0,0.0,0.0,1.0,0.0,0.0,0.0,0.0,0.0,0.0,1.0,0.0,0.0,0.0,0.0,1.0,0.0,0.0,0.0,1.0,0.0,0.0,0.0,0.0,0.0,0.0,1.0,0.0,0.0,0.0,0.0,1.0,0.0,0.0,0.0,0.0,0.0,0.0,0.0,0.0,0.0,0.0,0.0,0.0,0.0,0.0,0.0,0.0,0.0,0.0,0.0,0.0,0.0,0.0,0.0,0.0,0.0,0.0,0.0,0.0,0.0,0.0,0.0,0.0,0.0,0.0,0.0,0.0,0.0,0.0,0.0,0.0,0.0,0.0,0.0,0.0,0.0,0.0,0.0,0.0,0.0,0.0,0.0,0.0,0.0,0.0,0.0,1.0,0.0,0.0,0.0,0.0,0.0,0.0,0.0,0.0,0.0,0.0,0.0,0.0,0.0,0.0,0.0,0.0,0.0,1.0,0.0,1.0,0.0,0.0,0.0,0.0,0.0,0.0,0.0,1.0,0.0
101920,0,0.0,1.0,1.0,1.0,0.0,360000.0,958225.5,92529.0,904500.0,0.020246,60.24383561643835,-6189.0,-9684.0,-5257.0,4.0,2.0,3.0,3.0,6.0,,0.6286797412272094,0.5867400085415683,0.0567,0.055,0.9906,0.8708,0.0147,0.08,0.069,0.3333,0.375,0.0493,0.0462,0.0762,0.0,0.0,0.0578,0.0571,0.9906,0.8759,0.0149,0.0806,0.069,0.3333,0.375,0.0505,0.0505,0.0794,0.0,0.0,0.0573,0.055,0.9906,0.8725,0.0148,0.08,0.069,0.3333,0.375,0.0502,0.047,0.0776,0.0,0.0,0.068,1.0,6.0,0.0,5.0,0.0,-797.0,0.0,0.0,0.0,0.0,1.0,1.0,1.0,1.0,0.0,1.0,1.0,0.0,0.0,0.0,0.0,0.0,0.0,0.0,0.0,1.0,0.0,0.0,0.0,0.0,0.0,0.0,0.0,0.0,0.0,0.0,0.0,0.0,0.0,0.0,0.0,0.0,0.0,0.0,6.0,22289.265,8990.4825,1249562.25,0.0,0.0,0.0,0.0,0.0,-806.5,-65.0,-381.5,-501.0,185.0,-17.0,1.0,14298.3,334228.5,334228.5,0.0,334228.5,36.0,-797.0,365243.0,-752.0,-302.0,298.0,-296.0,18.0,0.0,0.0,50.0,17.0,36.0,28.0,-18.0,0.0,0.0,16.0,14298.3,14298.3,-556.5,-527.0,8.5,1.0,0.0,,,,,,,,,,,,,,,,,,,,,8343599962.5,184340659423.5,165532478197.5,51952620457.935,1863.0,1705.0,71125.0,70763.0,9140.0,505861.0,17802.226800002292,17864.365199999113,17315.94589999806,11291.623700000086,11229.432900000087,11176.717800000057,128358.0,662560.0,4136.6406000001225,4134.309800000016,3944.937700000095,13522881.08219138,-601634057.0,-921559143.0,-296383371.0,-1534578969.0416667,43999.0,30694.0,11346.02879999918,11221.999999998972,10706.352599997295,22879.217100009664,22801.081700009625,22186.725800008186,,157982.5122540159,126056.64598482176,34988.50990002791,34928.88680002834,34374.96670002875,22945.54709999592,22918.817499995497,22566.12319999573,3712799.0,8292.593000000168,8397.086900000078,8120.722200000227,9814.375800000718,9929.283700002155,10288.838899999646,16462.28249999975,16647.459799999695,16244.262399999694,828.5312000001759,813.7071000000459,759.6894000000133,3912.813700000125,3896.0383000001616,3728.66740000016,436303.0,431100.0,1262591.0,6422.747974002896,631725.0,625278.0,,16327.034099999795,154120.87399999055,154123.62209999008,154015.39359998715,77581.64079999624,77919.32180000657,78320.61280000651,27.0,29843329.09499999,8929150.6275,3086182314.179999,1015984080.9450004,37937041.51499999,638619.57,58.0,8639.0,-10044751.0,4576532.5,-5193038.5,-5612902.5,-13.0,22289.265,17980.965,1243624.5,0.0,0.0,0.0,0.0,0.0,-1420.0,-236.0,-394.0,-603.0,113266485.6299999,1613160515.7900016,1821348458.235,25999325.05499999,1613160515.7900016,117311.0,-8071949.0,1865684073.0,80776450.0,408836640.0,187339093.0,427242860.0,116500.0,1847.0,319.34772791477025,2899289.0,970922.0,592841.0,-1939435.0,720526.0,97330.0,1297877219.729989,1306456317.1349888,-80132496.0,-79471242.0,1488349.0,64829.5,,,,,,,,,,,,,,,,,,,,,1466827.0,14758430.0,3230976.0,8551800.0,11603289.0,1415083.0,1058102954.982001,801574156.5299951,72079797236.10713,21670570439.37012,582232869.791999,5792665.7475,689.5,94245.0,-276824593.5,21930807.5,-123746660.5,-218625558.5,-2016726.0,,,,,,,,,,,,,,,,,,,,,4271267.5,2478293.0,-9000115.5,921269.0,37582.5,3732052164.5924616,3656631571.649961,-260529303.5,-257219459.5,2525574.0,269096.0,3924627136.807455,33242530108.41091,36670639441.07264,1728624033.832549,48064805611.11071,3986496.0,-247496212.0,103046766607.0,1053369449.0,17266625570.0,3502289324.5,18880461909.5,3670671.5,71891.5,20862.11455725008,89768264.0,-102.73250261494384,2.6617375,3.8906721136076263,234.38901124963857,10.355947864993675,623.8820208310848,180000.0,0.6234898018587336,0.7818314824680298,0.0,0.0,0.0,0.0,0.0,0.0,1.0,0.0,0.0,0.0,0.0,0.0,0.0,1.0,0.0,0.0,0.0,0.0,1.0,0.0,1.0,0.0,0.0,0.0,0.0,1.0,0.0,0.0,0.0,0.0,0.0,0.0,0.0,0.0,1.0,0.0,0.0,0.0,0.0,0.0,0.0,0.0,0.0,0.0,0.0,0.0,0.0,0.0,0.0,0.0,0.0,0.0,0.0,0.0,0.0,0.0,0.0,0.0,0.0,0.0,0.0,0.0,0.0,0.0,0.0,0.0,0.0,0.0,0.0,0.0,0.0,0.0,0.0,0.0,0.0,0.0,0.0,0.0,0.0,0.0,0.0,1.0,0.0,0.0,0.0,0.0,0.0,0.0,0.0,0.0,0.0,0.0,0.0,0.0,0.0,0.0,0.0,0.0,0.0,0.0,0.0,0.0,0.0,0.0,0.0,0.0,0.0,0.0,1.0,0.0,1.0,0.0,0.0,0.0,0.0,0.0,0.0,1.0,0.0,0.0
101921,0,0.0,0.0,0.0,1.0,2.0,157500.0,1575000.0,65128.5,1575000.0,0.030755,37.11506849315069,-400.0,-2691.0,-1696.0,,4.0,2.0,2.0,11.0,0.3802897186318461,0.6046173113179778,0.6626377922738201,0.0247,,0.9836,,,0.0,0.1034,0.0833,,,,0.0259,,,0.0252,,0.9836,,,0.0,0.1034,0.0833,,,,0.027,,,0.025,,0.9836,,,0.0,0.1034,0.0833,,,,0.0264,,,0.0224,1.0,0.0,0.0,0.0,0.0,-2625.0,0.0,0.0,0.0,0.0,0.0,2.0,1.0,1.0,0.0,1.0,0.0,0.0,0.0,0.0,0.0,0.0,0.0,0.0,0.0,1.0,0.0,0.0,0.0,0.0,0.0,0.0,0.0,0.0,0.0,0.0,0.0,0.0,0.0,0.0,0.0,0.0,0.0,0.0,1.0,,0.0,302791.095,0.0,0.0,0.0,0.0,0.0,-907.0,-238.0,-236.0,-238.0,30.0,-14.5,4.0,8373.42,122148.0,122148.0,0.0,122148.0,5.0,-453.0,365243.0,-213.0,365243.0,58.0,365243.0,14.5,0.0,0.0,1276.5,30.0,24.0,9.5,-10.5,0.0,0.0,26.0,8871.84,8871.84,-274.0,-257.0,8.5,1.0,7.0,0.0,157500.0,,0.0,,,0.0,,0.0,0.0,0.0,0.0,,0.0,,,0.0,-5.0,0.0,0.0,8343665091.0,184342234423.5,165534053197.5,51952777957.935,1863.0,1705.0,71125.0,70763.0,9140.0,505863.0,17802.251500002294,17864.390199999114,17315.97109999806,,,,128360.0,662564.0,,,,13522918.197259871,-601634457.0,-921560839.0,-296385996.0,-1534581660.0416667,43999.0,30694.0,11346.02879999918,11221.999999998972,10706.352599997295,22879.320500009664,22801.185100009625,22186.829200008186,67427.75201722782,157983.11687132722,126057.30862261404,34988.593200027906,34928.97010002834,34375.05000002875,,,,3712810.0,,,,,,,16462.308399999747,16647.486199999694,16244.289399999694,,,,,,,436303.0,431100.0,,6422.778729002896,631727.0,625280.0,,16327.056499999797,154121.85759999056,154124.60569999012,154016.37719998715,,,,30.0,,8938141.11,3088990210.2749987,1017117963.9450004,37937041.51499999,638619.57,58.0,8639.0,-10048871.0,4576466.0,-5193998.0,-5614147.0,-14.5,,0.0,302791.095,0.0,0.0,0.0,0.0,0.0,-907.0,-238.0,-236.0,-238.0,113286174.77249992,1613523026.7900016,1821713219.235,26008325.05499999,1613523026.7900016,117337.0,-8074167.5,1866414559.0,81140848.0,409567033.0,187704331.0,427973257.0,116534.0,1847.0,319.678256263508,2901383.5,971562.0,593260.0,-1939763.0,720526.0,97330.0,1298104226.8199878,1306683324.224987,-80141562.0,-79479759.0,1488558.5,64850.5,1255810871.8350005,3298077000.0,,170598271.45499983,,,71891708.39999993,,171260035.1549998,1205347160.0249994,1250962662.1499984,1251017834.0849984,,13937.0,,,416688.0,-741153.0,274607.0,673.0,1466828.0,14758460.0,3230983.0,8551830.0,11603315.0,1415087.0,,801574156.5299951,72080100027.20212,21670570439.37012,582232869.791999,5792665.7475,689.5,94245.0,-276825500.5,21930569.5,-123746896.5,-218625796.5,-2016740.5,5919904729.979961,18713283750.0,,447810785.39249766,,,308969502.41249865,,458962152.9749993,5705157337.245031,5883204042.449999,5883447225.195,,80809.0,,,971085.0,-1697627.5,177364.0,6755.0,4271291.5,2478302.5,-9000126.0,921269.0,37582.5,3732061036.4324617,3656640443.489961,-260529577.5,-257219716.5,2525582.5,269097.0,3924635510.227455,33242652256.41091,36670761589.07264,1728624033.832549,48064927759.11071,3986501.0,-247496665.0,103047131850.0,1053369236.0,17266990813.0,3502289382.5,18880827152.5,3670686.0,71891.5,20862.11455725008,89769540.5,-10.777293865800548,10.0,2.4182961376355974,89.75522678506695,24.18296137635597,897.5522678506695,39375.0,-0.9009688679024191,-0.433883739117558,0.0,0.0,0.0,0.0,0.0,1.0,0.0,0.0,0.0,0.0,0.0,0.0,0.0,1.0,0.0,0.0,0.0,0.0,1.0,0.0,1.0,0.0,0.0,0.0,0.0,1.0,0.0,0.0,0.0,0.0,0.0,0.0,0.0,0.0,0.0,0.0,0.0,0.0,0.0,0.0,0.0,0.0,0.0,0.0,1.0,0.0,0.0,0.0,0.0,0.0,0.0,0.0,0.0,0.0,0.0,0.0,0.0,0.0,0.0,0.0,0.0,0.0,0.0,0.0,0.0,0.0,0.0,0.0,0.0,0.0,0.0,0.0,0.0,0.0,0.0,0.0,0.0,0.0,0.0,0.0,0.0,0.0,0.0,0.0,0.0,0.0,0.0,0.0,0.0,0.0,1.0,0.0,0.0,0.0,0.0,0.0,0.0,0.0,0.0,0.0,0.0,0.0,0.0,0.0,0.0,0.0,0.0,0.0,0.0,0.0,1.0,0.0,0.0,0.0,0.0,0.0,0.0,0.0,1.0,0.0
101922,0,0.0,1.0,0.0,1.0,2.0,121500.0,172597.5,8433.0,117000.0,0.01885,61.26027397260274,,-1876.0,-5063.0,,4.0,2.0,2.0,12.0,0.1567259752466681,0.6248738849061876,0.7776594425716818,,,,,,,,,,,,,,,,,,,,,,,,,,,,,,,,,,,,,,,,,,,,,0.0,0.0,0.0,0.0,-1597.0,0.0,0.0,0.0,0.0,0.0,5.0,1.0,0.0,0.0,1.0,0.0,1.0,0.0,0.0,0.0,0.0,0.0,0.0,0.0,0.0,0.0,0.0,1.0,0.0,0.0,0.0,0.0,0.0,0.0,0.0,0.0,0.0,0.0,0.0,0.0,0.0,0.0,0.0,2.0,0.0,,174372.75,0.0,0.0,0.0,0.0,0.0,-1717.5,-1292.0,-1476.0,-1489.0,114.0,-28.0,12.0,9684.6975,135534.2175,151567.7175,4500.0,158568.435,18.0,-1047.0,365243.0,-1006.0,-437.0,-287.0,-432.0,13.0,1.0,0.0994603569946035,-1.0,126.0,37.0,21.5,-25.0,0.0,0.0,125.0,12357.315,12357.315,-708.0,-706.0,7.0,1.0,8.0,0.0,202500.0,,0.0,,,0.0,,0.0,0.0,0.0,0.0,,0.0,,,0.0,-5.5,0.0,0.0,8343673524.0,184342407021.0,165534170197.5,51952899457.935,1863.0,1705.0,71125.0,70763.0,9140.0,505868.0,,,,,,,128362.0,662568.0,,,,13522979.457533846,,-921565902.0,-296387593.0,-1534583536.0416667,43999.0,30694.0,,,,,,,67427.90874320308,157983.74174521212,126058.0862820566,,,,,,,3712822.0,,,,,,,,,,,,,,,,436303.0,431100.0,,6422.797579002896,631729.0,625282.0,,,,,,,,,57.0,29907229.85999999,,3089176955.7749987,1017117963.9450004,37937041.51499999,638619.57,58.0,8639.0,-10051626.5,4574288.0,-5196364.0,-5616537.5,-28.0,0.0,,24745.5,0.0,0.0,0.0,0.0,0.0,-2076.0,-1772.0,-1780.0,-1803.0,113383072.9799999,1614960997.2900016,1823351120.235,26012825.05499999,1614960997.2900016,117479.0,-8083081.5,1868971260.0,81138629.0,409928975.0,187704555.0,428335218.0,116647.5,1852.0,319.77771662050264,2906784.5,973920.0,594856.5,-1941342.0,720526.0,97330.0,1300349461.6799858,1308806916.8849847,-80181096.0,-79518451.0,1489382.0,64951.0,1255810871.8350005,3299460750.0,,170598271.45499983,,,71891708.39999993,,171260035.1549998,1205347160.0249994,1250962662.1499984,1251017834.0849984,,13937.0,,,416688.0,-741195.0,274607.0,673.0,1466830.0,14758574.0,3230991.0,8551956.0,11603440.0,1415099.0,1058102954.982001,,72080274399.95212,21670570439.37012,582232869.791999,5792665.7475,689.5,94245.0,-276827218.0,21929277.5,-123748372.5,-218627285.5,-2016768.5,5919904729.979961,18713486250.0,,447810785.39249766,,,308969502.41249865,,458962152.9749993,5705157337.245031,5883204042.449999,5883447225.195,,80809.0,,,971085.0,-1697633.0,177364.0,6755.0,4271328.5,2478324.0,-9000151.0,921269.0,37582.5,3732073393.7474623,3656652800.8049607,-260530285.5,-257220422.5,2525589.5,269098.0,3924645194.924955,33242787790.62841,36670913156.79014,1728628533.832549,48065086327.54572,3986519.0,-247497712.0,103047497093.0,1053368230.0,17266990376.0,3502289095.5,18880826720.5,3670699.0,71892.5,20862.214017607075,89769539.5,,1.4205555555555556,14.4076840981857,882.6186751655678,20.466915688367127,1253.8088624435316,30375.0,-0.9009688679024191,-0.433883739117558,0.0,0.0,0.0,0.0,0.0,0.0,1.0,0.0,0.0,1.0,0.0,0.0,0.0,0.0,0.0,0.0,0.0,0.0,1.0,0.0,1.0,0.0,0.0,0.0,0.0,1.0,0.0,0.0,0.0,0.0,0.0,0.0,0.0,0.0,0.0,0.0,0.0,0.0,0.0,0.0,0.0,0.0,0.0,0.0,0.0,0.0,0.0,0.0,0.0,0.0,0.0,0.0,0.0,0.0,0.0,0.0,0.0,0.0,0.0,0.0,0.0,0.0,0.0,0.0,0.0,0.0,0.0,0.0,0.0,0.0,0.0,0.0,0.0,0.0,0.0,0.0,0.0,0.0,0.0,0.0,0.0,0.0,0.0,0.0,0.0,0.0,0.0,0.0,0.0,0.0,0.0,0.0,0.0,0.0,0.0,0.0,0.0,0.0,0.0,0.0,0.0,0.0,0.0,0.0,0.0,1.0,0.0,0.0,0.0,0.0,0.0,0.0,0.0,0.0,0.0,0.0,0.0,0.0,0.0,0.0
101961,0,0.0,1.0,1.0,0.0,0.0,94500.0,265500.0,16965.0,265500.0,0.019101,22.34246575342466,-1543.0,-2540.0,-86.0,2.0,1.0,2.0,2.0,11.0,0.1798907885079064,0.3981235583087968,,,,,,,,,,,,,,,,,,,,,,,,,,,,,,,,,,,,,,,,,,,,,,2.0,1.0,2.0,1.0,-224.0,,,,,,,1.0,1.0,0.0,1.0,0.0,0.0,0.0,0.0,0.0,0.0,1.0,1.0,0.0,0.0,0.0,0.0,0.0,0.0,0.0,1.0,0.0,0.0,0.0,0.0,0.0,0.0,0.0,0.0,0.0,0.0,0.0,0.0,0.0,,,,,,,,,,,,,0.0,,13.0,12991.05,60705.0,63612.0,0.0,60705.0,6.0,-997.0,365243.0,-373.0,-193.0,-163.0,-190.0,14.0,0.0,0.0,60.0,28.0,8.0,5.5,-14.0,0.0,0.0,38.0,6721.38,6721.38,-259.0,-259.0,4.5,1.0,13.0,0.0,45000.0,0.0,0.0,0.0,0.0,0.0,208.665,208.665,0.0,0.0,0.0,0.0,0.0,0.0,0.0,1.0,-7.0,0.0,0.0,8343690489.0,184342672521.0,165534435697.5,51952993957.935,,,,,,,,,,,,,128362.0,662569.0,,,,13523001.799999598,-601636000.0,-921565988.0,-296387817.0,-1534586076.0416667,44000.0,30695.0,,,,,,,67428.08863399159,157984.13986877043,,,,,,,,3712833.0,,,,,,,,,,,,,,,,436305.0,431102.0,1262593.0,6422.816680002896,631731.0,625284.0,,,,,,,,,,,,,,,,,,,,,,,,,,,,,,,,,,,116015668.82999983,1654525868.1300015,1867905082.17,26492169.959999982,1654525868.1300015,120614.0,-8245349.0,1908044936.0,82479919.0,418972781.0,191292620.0,437746428.0,119316.0,1901.0,326.5021413351876,2933401.0,993193.0,607687.0,-1973541.0,720554.0,97347.0,1327769820.269992,1335466318.499991,-81360485.0,-80688200.0,1509683.5,65992.5,1281694637.9699998,3350083500.0,111555312.57,173996586.94499984,6909384.6000000015,55401256.66499995,73225517.30999993,188486211.95999983,174477570.43500027,1230208667.1900003,1276694768.3849983,1276749940.3199985,5583.0,14228.0,102.0,8543.5,420075.0,-747067.0,274642.0,680.0,1466830.0,14758574.0,3231004.0,8551984.0,11603478.0,1415112.0,,,,,,,,,,,,,,5919904729.979961,18713531250.0,198745595.325,447810785.39249766,1948107.735,256654969.0200008,308969502.41249865,636310443.8699981,458962361.6399993,5705157337.245031,5883204042.449999,5883447225.195,13376.0,80809.0,44.0,70326.5,971086.0,-1697640.0,177364.0,6755.0,4271336.5,2478329.5,-9000165.0,921269.0,37582.5,3732080115.1274624,3656659522.184961,-260530544.5,-257220681.5,2525594.0,269099.0,3924658185.974956,33242848495.62841,36670976768.79014,1728628533.832549,48065147032.54572,3986525.0,-247498709.0,103047862336.0,1053367857.0,17266990183.0,3502288932.5,18880826530.5,3670713.0,71892.5,20862.214017607075,89769599.5,-69.06131207847946,2.8095238095238093,5.57029177718833,124.45405326841322,15.649867374005304,349.65662584935137,94500.0,1.0,0.0,0.0,0.0,0.0,0.0,0.0,0.0,1.0,0.0,0.0,0.0,0.0,0.0,0.0,1.0,0.0,0.0,1.0,0.0,0.0,0.0,0.0,0.0,1.0,0.0,0.0,0.0,0.0,0.0,0.0,1.0,0.0,0.0,0.0,0.0,0.0,0.0,0.0,0.0,0.0,0.0,0.0,0.0,0.0,0.0,0.0,0.0,0.0,1.0,0.0,0.0,0.0,0.0,0.0,1.0,0.0,0.0,0.0,0.0,0.0,0.0,0.0,0.0,0.0,0.0,0.0,0.0,0.0,0.0,0.0,0.0,0.0,0.0,0.0,0.0,0.0,0.0,0.0,0.0,0.0,0.0,0.0,0.0,0.0,0.0,0.0,0.0,0.0,0.0,0.0,0.0,0.0,0.0,0.0,0.0,0.0,0.0,0.0,0.0,0.0,0.0,0.0,0.0,0.0,0.0,0.0,0.0,0.0,0.0,0.0,0.0,0.0,0.0,0.0,0.0,0.0,0.0,0.0,0.0,0.0,0.0
101962,0,0.0,1.0,0.0,1.0,1.0,202500.0,112500.0,11812.5,112500.0,0.020246,30.786301369863008,-2196.0,-8070.0,-3488.0,,3.0,3.0,3.0,3.0,,0.7051115162192986,0.5424451438613613,0.0845,0.1145,0.9781,0.7008,0.0,0.0,0.2069,0.1667,0.2083,0.0974,0.0807,0.0777,0.0,0.0516,0.063,0.1019,0.9782,0.7125,0.0,0.0,0.1379,0.1667,0.2083,0.0637,0.0882,0.0561,0.0,0.0,0.0937,0.1145,0.9781,0.7048,0.0,0.0,0.2069,0.1667,0.2083,0.0934,0.0821,0.0888,0.0,0.0,0.0423,1.0,1.0,0.0,1.0,0.0,-2232.0,0.0,0.0,0.0,0.0,0.0,0.0,1.0,1.0,1.0,1.0,1.0,0.0,0.0,0.0,0.0,0.0,0.0,0.0,0.0,1.0,0.0,0.0,0.0,0.0,0.0,0.0,0.0,0.0,0.0,0.0,0.0,0.0,0.0,0.0,0.0,0.0,0.0,0.0,16.0,0.0,0.0,72909.0,0.0,0.0,0.0,0.0,0.0,-1632.5,-917.5,-863.5,-1319.0,903.0,-29.0,11.0,5960.7,35955.0,35230.5,3915.0,36760.5,6.0,-2574.0,365243.0,-2202.0,-2044.0,-1701.0,-1879.0,8.0,0.0,0.1089228854303197,664.0,31.0,6.0,2.0,-73.0,0.0,0.0,129.0,939.465,939.465,-1831.0,-1831.0,41.0,0.0,95.0,0.0,135000.0,0.0,0.0,0.0,0.0,0.0,939.465,0.0,0.0,0.0,0.0,0.0,0.0,0.0,0.0,11.0,-48.0,0.0,0.0,8343702301.5,184342785021.0,165534548197.5,51953196457.935,1863.0,1705.0,71125.0,70763.0,9140.0,505868.0,17802.336000002295,17864.483899999115,17316.034099998058,11291.738200000083,11229.547400000089,11176.819700000056,128363.0,662572.0,4136.6406000001225,4134.309800000016,3944.937700000095,13523032.58630097,-601638196.0,-921569476.0,-296390049.0,-1534594146.0416667,44000.0,30695.0,11346.02879999918,11221.999999998972,10706.352599997295,22879.52740000966,22801.392000009622,22186.967100008187,,157984.84498028667,126058.62872720046,34988.75990002791,34929.13680002834,34375.21670002875,22945.75539999592,22919.0257999955,22566.331499995733,3712836.0,8292.690400000169,8397.18030000008,8120.785900000225,9814.45650000072,9929.365800002157,10288.927099999646,16462.386099999752,16647.574999999695,16244.345499999696,828.5312000001759,813.7071000000459,759.6894000000133,3912.865300000125,3896.0383000001616,3728.66740000016,436306.0,431103.0,,6422.836926002896,631734.0,625287.0,,16327.098799999794,154122.83569999054,154125.58379999013,154017.35539998714,77582.34159999625,77920.02660000659,78321.3253000065,54.0,30033961.244999997,9106726.230000002,3157437069.6299987,1037088256.7700005,39398726.56499999,638619.57,60.0,8639.0,-10283538.0,4759516.0,-5297403.0,-5723515.5,-26.5,0.0,0.0,51088.5,0.0,0.0,0.0,0.0,0.0,-1910.0,-1096.0,-880.0,-1610.0,116117299.52999984,1655074800.6300015,1868775080.67,26524466.459999982,1655133255.6300015,120676.0,-8265536.0,1909503036.0,82472372.0,418967346.0,191652422.0,438106188.0,119456.0,1902.0,327.3638584047744,2944300.0,993403.0,607778.0,-1974790.0,720554.0,97347.0,1328285515.9499896,1335982014.1799884,-81469309.0,-80796660.0,1512967.0,66018.0,1282268594.3850002,3355663500.0,111567462.57,174121914.55499983,6909384.6000000015,55513984.27499995,73259717.30999993,188743721.98499995,174684356.59500024,1230759741.1050005,1277261444.249999,1277316616.1849992,5585.0,14261.0,102.0,8574.0,420554.0,-749364.0,274642.0,680.0,1466846.0,14759477.0,3231099.0,8552015.0,11603607.0,1415123.0,1058102954.982001,801574156.5299951,72080347308.95212,21670570439.37012,582232869.791999,5792665.7475,689.5,94245.0,-276828850.5,21928360.0,-123749236.0,-218628604.5,-2016797.5,5919904729.979961,18713666250.0,198745595.325,447810785.39249766,1948107.735,256654969.0200008,308969502.41249865,636311383.334998,458962361.6399993,5705157337.245031,5883204042.449999,5883447225.195,13376.0,80809.0,44.0,70326.5,971097.0,-1697688.0,177364.0,6755.0,4271342.5,2478331.5,-9000238.0,921269.0,37582.5,3732081054.592464,3656660461.649961,-260532375.5,-257222512.5,2525635.0,269099.0,3924664146.674955,33242884450.62841,36671011999.29014,1728632448.832549,48065183793.04572,3986531.0,-247501283.0,103048227579.0,1053365655.0,17266988139.0,3502287231.5,18880824651.5,3670721.0,71892.5,20862.322940492504,89770263.5,-71.33042627035685,0.5555555555555556,17.142857142857142,527.7651663405088,9.523809523809524,293.2028701891716,67500.0,-0.2225209339563143,0.9749279121818236,0.0,0.0,0.0,0.0,0.0,0.0,1.0,0.0,0.0,0.0,0.0,0.0,0.0,1.0,0.0,1.0,0.0,0.0,0.0,0.0,1.0,0.0,0.0,0.0,0.0,1.0,0.0,0.0,0.0,0.0,0.0,0.0,0.0,1.0,0.0,0.0,0.0,0.0,0.0,0.0,0.0,0.0,0.0,0.0,0.0,0.0,0.0,0.0,0.0,0.0,0.0,0.0,0.0,0.0,0.0,0.0,0.0,0.0,0.0,0.0,0.0,0.0,0.0,0.0,0.0,0.0,0.0,0.0,0.0,0.0,0.0,0.0,0.0,0.0,0.0,0.0,0.0,0.0,0.0,0.0,0.0,0.0,0.0,0.0,0.0,0.0,0.0,0.0,0.0,0.0,0.0,0.0,1.0,0.0,0.0,0.0,0.0,0.0,0.0,0.0,0.0,0.0,0.0,0.0,0.0,0.0,1.0,0.0,0.0,0.0,1.0,0.0,0.0,0.0,0.0,0.0,0.0,1.0,0.0,0.0
101971,0,0.0,1.0,1.0,0.0,0.0,135000.0,454500.0,19386.0,454500.0,0.020713,43.15616438356165,-2918.0,-4353.0,-4851.0,8.0,2.0,3.0,2.0,14.0,0.4698789230860687,0.6116834442283942,,0.3711,0.3023,0.9846,0.7892,0.0923,0.44,0.3793,0.3333,0.375,0.3323,0.3026,0.4185,0.0,0.0,0.3782,0.3137,0.9846,0.7975,0.0931,0.4431,0.3793,0.3333,0.375,0.3399,0.3306,0.436,0.0,0.0,0.3747,0.3023,0.9846,0.792,0.0929,0.44,0.3793,0.3333,0.375,0.3381,0.3078,0.426,0.0,0.0,0.3796,1.0,0.0,0.0,0.0,0.0,-1433.0,,,,,,,1.0,1.0,0.0,1.0,1.0,0.0,0.0,0.0,0.0,0.0,0.0,0.0,0.0,1.0,0.0,0.0,0.0,0.0,0.0,0.0,0.0,0.0,0.0,0.0,0.0,0.0,0.0,0.0,0.0,0.0,0.0,0.0,0.0,,,,,,,,,,,,,0.0,,5.0,36437.67,1237500.0,1274625.0,123750.0,1237500.0,60.0,-759.0,365243.0,-953.5,-863.5,636.5,-858.0,12.0,0.0,0.096379726468222,-1.0,74.0,43.0,34.0,-52.5,0.0,0.0,70.0,35294.355,35294.355,-1656.5,-1655.0,14.0,1.0,0.0,,,,,,,,,,,,,,,,,,,,,8343721687.5,184343239521.0,165535002697.5,51953331457.935,,,,,,,17802.707100002295,17864.858599999116,17316.412299998057,11292.040500000085,11229.849700000088,11177.133400000055,128363.0,662574.0,4136.732900000122,4134.402700000015,3945.030800000095,13523075.742465353,-601641114.0,-921574327.0,-296391482.0,-1534598499.0416667,44000.0,30695.0,11346.46879999918,11222.439999998973,10706.7956999973,22879.906700009666,22801.771300009623,22187.346400008188,67428.55851291468,157985.4566637309,,34989.093200027906,34929.47010002834,34375.55000002875,22946.13039999592,22919.4007999955,22566.706499995733,3712850.0,8293.022700000169,8397.518400000079,8121.125800000226,9814.75910000072,9929.673600002156,10289.257699999644,16462.804599999752,16648.000999999695,16244.781499999695,828.5312000001759,813.7071000000459,759.6894000000133,3912.865300000125,3896.0383000001616,3728.66740000016,436306.0,431103.0,1262601.0,6422.857639002896,631737.0,625289.0,,16327.478399999794,154123.82029999053,154126.56839999012,154018.33999998716,77583.13079999624,77920.81860000659,78322.1228000065,,,,,,,,,,,,,,,,,,,,,,,,,,,116609960.92499983,1663967485.6200016,1877854744.17,26811927.44999999,1663967485.6200016,121202.0,-8308451.0,1916990265.5,82444856.5,420041794.0,192002596.5,439183237.0,119973.0,1909.0,329.15032809423303,2962553.0,996836.5,609840.0,-1985940.0,720558.0,97351.0,1334509154.3924842,1342192732.132483,-81831494.0,-81157350.0,1517116.5,66215.5,,,,,,,,,,,,,,,,,,,,,1466846.0,14759477.0,3231099.0,8552089.0,11603677.0,1415128.0,,,,,,,,,,,,,,,,,,,,,,,,,,,,,,,,,,4271385.5,2478365.5,-9000290.5,921269.0,37582.5,3732116348.947464,3656695756.004961,-260534032.0,-257224167.5,2525649.0,269100.0,3924700584.3449545,33244121950.62841,36672286624.29014,1728756198.832549,48066421293.04572,3986591.0,-247502042.0,103048592822.0,1053364701.5,17266987275.5,3502287868.0,18880823793.5,3670733.0,71892.5,20862.41932021897,89770262.5,-67.614906043677,3.3666666666666667,6.963788300835653,300.53039264318693,23.444753946146704,1011.7856552320628,67500.0,-0.9009688679024191,-0.433883739117558,0.0,0.0,0.0,0.0,0.0,0.0,1.0,0.0,0.0,0.0,0.0,0.0,0.0,1.0,0.0,0.0,0.0,0.0,1.0,0.0,1.0,0.0,0.0,0.0,0.0,1.0,0.0,0.0,0.0,0.0,0.0,0.0,0.0,0.0,0.0,0.0,0.0,0.0,1.0,0.0,0.0,0.0,0.0,0.0,0.0,0.0,0.0,0.0,0.0,0.0,0.0,0.0,0.0,0.0,0.0,1.0,0.0,0.0,0.0,0.0,0.0,0.0,0.0,0.0,0.0,0.0,0.0,0.0,0.0,0.0,0.0,0.0,0.0,0.0,0.0,0.0,0.0,0.0,0.0,0.0,0.0,0.0,0.0,0.0,0.0,0.0,0.0,0.0,0.0,0.0,0.0,0.0,0.0,0.0,0.0,0.0,0.0,0.0,0.0,0.0,0.0,0.0,0.0,0.0,0.0,0.0,0.0,0.0,1.0,0.0,1.0,0.0,0.0,0.0,0.0,0.0,0.0,1.0,0.0,0.0
101976,1,0.0,1.0,0.0,0.0,0.0,171000.0,407520.0,32328.0,360000.0,0.025164,36.71232876712329,-305.0,-7490.0,-4571.0,,1.0,2.0,2.0,12.0,,0.2513211638505997,,0.0825,0.0733,0.9752,0.66,0.0079,0.0,0.1379,0.1667,0.2083,0.016,0.0672,0.0702,0.0,0.0,0.084,0.076,0.9752,0.6733,0.008,0.0,0.1379,0.1667,0.2083,0.0163,0.0735,0.0732,0.0,0.0,0.0833,0.0733,0.9752,0.6645,0.008,0.0,0.1379,0.1667,0.2083,0.0163,0.0684,0.0715,0.0,0.0,0.0552,1.0,1.0,0.0,1.0,0.0,0.0,,,,,,,1.0,1.0,0.0,1.0,0.0,0.0,0.0,0.0,0.0,0.0,0.0,0.0,0.0,1.0,0.0,0.0,0.0,0.0,0.0,0.0,0.0,0.0,0.0,0.0,0.0,0.0,0.0,0.0,0.0,0.0,0.0,0.0,0.0,,,,,,,,,,,,,0.0,,2.0,8060.04,51750.0,141498.0,13500.0,51750.0,12.0,-1787.0,365243.0,-2007.0,-1317.0,-1317.0,-1311.0,14.0,0.0,0.1057780603235148,7.0,25.0,24.0,12.0,-56.0,0.0,0.0,29.0,8245.08,8245.08,-1646.0,-1647.0,13.0,1.0,0.0,,,,,,,,,,,,,,,,,,,,,8343754015.5,184343647041.0,165535362697.5,51953502457.935,,,,,,,17802.789600002296,17864.941899999114,17316.496299998056,11292.113800000085,11229.923000000088,11177.209400000056,128363.0,662575.0,4136.7408000001205,4134.410700000015,3945.0388000000953,13523112.45479412,-601641419.0,-921578898.0,-296391482.0,-1534605989.0416667,44000.0,30695.0,11346.46879999918,11222.439999998973,10706.7956999973,22880.044600009667,22801.909200009628,22187.48430000819,,157985.70798489475,,34989.25990002791,34929.63680002834,34375.71670002875,22946.33869999592,22919.609099995498,22566.914799995728,3712862.0,8293.038700000168,8397.53470000008,8121.142100000226,9814.82630000072,9929.742000002158,10289.331199999646,16462.874799999747,16648.072499999693,16244.854699999694,828.5312000001759,813.7071000000459,759.6894000000133,3912.865300000125,3896.0383000001616,3728.66740000016,436307.0,431104.0,,6422.882803002895,631739.0,625291.0,,16327.533599999795,154124.79549999055,154127.5435999901,154019.31519998715,77583.79079999625,77921.48310000659,78322.7961000065,,,,,,,,,,,,,,,,,,,,,,,,,,,116852286.23999986,1669064276.5200016,1883341049.67,26852198.84999999,1669064276.5200016,121462.0,-8323760.0,1920094831.0,82436230.0,420399721.0,191998235.0,439541250.0,120220.0,1910.0,329.7661845969763,2967877.5,999817.0,611756.0,-1991278.0,720605.0,97398.0,1337711077.7099862,1345122785.6099849,-81939851.0,-81264870.0,1518155.0,66330.0,,,,,,,,,,,,,,,,,,,,,1466846.0,14759477.0,3231099.0,8552114.0,11603706.0,1415130.0,,,,,,,,,,,,,,,,,,,,,,,,,,,,,,,,,,4271409.5,2478377.5,-9000346.5,921269.0,37582.5,3732124594.027464,3656704001.084961,-260535678.0,-257225814.5,2525662.0,269101.0,3924708644.3849545,33244173700.62841,36672428122.29014,1728769698.832549,48066473043.04572,3986603.0,-247503829.0,103048958065.0,1053362694.5,17266985958.5,3502286551.0,18880822482.5,3670747.0,71892.5,20862.525098279293,89770269.5,-8.307835820895523,2.3831578947368417,5.289532293986637,194.19104860115328,12.605790645879734,462.7879305610642,171000.0,0.6234898018587336,0.7818314824680298,0.0,0.0,0.0,0.0,0.0,0.0,1.0,0.0,0.0,0.0,0.0,0.0,0.0,1.0,0.0,0.0,0.0,0.0,1.0,0.0,0.0,1.0,0.0,0.0,0.0,1.0,0.0,0.0,0.0,0.0,0.0,0.0,0.0,0.0,0.0,0.0,0.0,0.0,0.0,0.0,0.0,0.0,0.0,0.0,1.0,0.0,0.0,0.0,0.0,0.0,0.0,0.0,0.0,1.0,0.0,0.0,0.0,0.0,0.0,0.0,0.0,0.0,0.0,0.0,0.0,0.0,0.0,0.0,0.0,0.0,0.0,0.0,0.0,0.0,0.0,0.0,0.0,0.0,0.0,0.0,0.0,0.0,0.0,0.0,0.0,0.0,0.0,0.0,0.0,0.0,0.0,0.0,0.0,0.0,0.0,0.0,0.0,0.0,0.0,0.0,0.0,0.0,0.0,0.0,0.0,0.0,0.0,0.0,1.0,0.0,1.0,0.0,0.0,0.0,0.0,0.0,0.0,1.0,0.0,0.0
102002,0,0.0,0.0,0.0,1.0,0.0,225000.0,729792.0,39721.5,630000.0,0.006207,32.049315068493144,-2928.0,-89.0,-2402.0,,2.0,2.0,2.0,11.0,0.2126266723616332,0.5988737797985781,0.5298898341969072,,,,,,,,,,,,,,,,,,,,,,,,,,,,,,,,,,,,,,,,,,,,,6.0,0.0,6.0,0.0,-969.0,0.0,0.0,0.0,0.0,2.0,0.0,1.0,1.0,0.0,1.0,0.0,1.0,0.0,0.0,0.0,0.0,0.0,0.0,0.0,1.0,0.0,0.0,0.0,0.0,0.0,0.0,0.0,0.0,0.0,0.0,0.0,0.0,0.0,0.0,0.0,0.0,0.0,0.0,5.0,15787.5075,268.56,157500.0,0.0,0.0,0.0,0.0,0.0,-538.0,153.0,-28.0,-891.0,98.0,-13.0,2.0,7531.6275,57384.0,52492.5,11115.0,57384.0,9.0,-767.5,365243.0,-736.5,-496.5,-496.5,-490.5,12.0,0.0,0.1939135824048177,525.0,20.0,12.0,4.5,-16.5,0.0,0.0,24.0,6665.13,6665.13,-479.0,-490.0,5.0,1.0,0.0,,,,,,,,,,,,,,,,,,,,,8343793737.0,184344376833.0,165535992697.5,51953727457.935,1863.0,1705.0,71125.0,70765.0,9140.0,505868.0,,,,,,,128363.0,662577.0,,,,13523144.504109189,-601644347.0,-921581300.0,-296392451.0,-1534606078.0416667,44000.0,30695.0,,,,,,,67428.77113958704,157986.30685867456,126059.15861703464,,,,,,,3712873.0,,,,,,,,,,,,,,,,436313.0,431110.0,,6422.889010002896,631741.0,625293.0,,,,,,,,,18.0,30234537.27,9163759.500000004,3216427692.9299984,1060525190.5200005,39805342.01999999,638619.57,60.0,8639.0,-10427175.0,4909278.0,-5380386.0,-5806784.0,-8.5,17625.015,404.19,157500.0,0.0,0.0,0.0,0.0,0.0,-692.0,-894.0,-31.0,-891.0,117781470.4049998,1680742125.9900017,1896529561.785,27110562.70499999,1680742125.9900017,122456.0,-8419191.0,1941456098.5,83451672.5,423991008.5,194136905.5,443498937.0,121289.5,1929.0,333.2399154345584,3008988.0,1010655.0,617950.5,-2020257.0,720817.0,97416.0,1351277490.1949954,1358270908.2449925,-82927218.5,-82244078.5,1533135.0,67029.5,,,,,,,,,,,,,,,,,,,,,1466851.0,14759575.0,3231099.0,8552134.0,11603730.0,1415132.0,1058118742.489501,801574425.089995,72080504808.95212,21670570439.37012,582232869.791999,5792665.7475,689.5,94245.0,-276829388.5,21928513.0,-123749264.0,-218629495.5,-2016810.5,,,,,,,,,,,,,,,,,,,,,4271421.5,2478382.0,-9000363.0,921269.0,37582.5,3732131259.157463,3656710666.214961,-260536157.0,-257226304.5,2525667.0,269102.0,3924716176.012456,33244231084.62841,36672480614.79014,1728780813.832549,48066530427.04572,3986612.0,-247504596.5,103049323308.0,1053361958.0,17266985462.0,3502286054.5,18880821992.0,3670759.0,71892.5,20862.719011861696,89770794.5,-91.35920670200036,3.24352,5.664438654129376,181.5413791123437,18.37272006344171,588.8330939784688,112500.0,-0.9009688679024191,0.4338837391175582,0.0,0.0,0.0,0.0,0.0,0.0,1.0,0.0,0.0,0.0,0.0,0.0,0.0,1.0,0.0,0.0,0.0,0.0,1.0,0.0,1.0,0.0,0.0,0.0,0.0,1.0,0.0,0.0,0.0,0.0,0.0,0.0,0.0,0.0,0.0,0.0,0.0,0.0,0.0,0.0,0.0,0.0,0.0,0.0,1.0,0.0,0.0,0.0,0.0,0.0,0.0,0.0,0.0,0.0,0.0,0.0,0.0,0.0,0.0,0.0,0.0,0.0,0.0,0.0,0.0,0.0,0.0,0.0,0.0,0.0,0.0,0.0,0.0,0.0,0.0,0.0,0.0,0.0,0.0,0.0,0.0,0.0,0.0,0.0,0.0,0.0,0.0,0.0,0.0,0.0,1.0,0.0,0.0,0.0,0.0,0.0,0.0,0.0,0.0,0.0,0.0,0.0,0.0,0.0,0.0,0.0,0.0,0.0,0.0,0.0,0.0,0.0,0.0,0.0,0.0,0.0,0.0,0.0,0.0,0.0
102005,0,0.0,0.0,0.0,1.0,1.0,189000.0,1354500.0,47209.5,1354500.0,0.019101,41.12054794520548,-92.0,-1375.0,-3527.0,,3.0,2.0,2.0,18.0,0.5957978437709005,0.6363445629313793,0.6263042766749393,,,,,,,,,,,,,,,,,,,,,,,,,,,,,,,,,,,,,,,,,,,,,3.0,1.0,3.0,1.0,-1066.0,0.0,0.0,0.0,0.0,0.0,0.0,1.0,1.0,0.0,1.0,0.0,0.0,0.0,0.0,0.0,1.0,0.0,1.0,0.0,1.0,0.0,0.0,0.0,0.0,0.0,0.0,0.0,0.0,0.0,0.0,0.0,0.0,0.0,0.0,0.0,0.0,0.0,0.0,3.0,,,78652.17,0.0,,0.0,0.0,0.0,-1261.0,-1048.0,-888.0,-1107.0,127.0,-21.0,3.0,11554.56,117000.0,105300.0,12282.75,122825.25,11.0,-321.0,365243.0,-663.0,182164.0,-363.0,182170.0,16.0,0.0,0.1089109956467681,86.0,16.0,12.0,7.0,-9.5,0.0,0.0,15.0,11410.29,11410.29,-239.0,-231.0,4.0,1.0,0.0,,,,,,,,,,,,,,,,,,,,,8343840946.5,184345731333.0,165537347197.5,51953916457.935,1863.0,1705.0,71125.0,70765.0,9140.0,505868.0,,,,,,,128364.0,662580.0,,,,13523185.624657135,-601644439.0,-921584827.0,-296393517.0,-1534607453.0416667,44001.0,30696.0,,,,,,,67429.36693743081,157986.94320323743,126059.78492131137,,,,,,,3712891.0,,,,,,,,,,,,,,,,436316.0,431113.0,,6422.908111002896,631743.0,625295.0,,,,,,,,,42.0,,,3217821211.5299983,1060525190.5200005,,638619.57,60.0,8639.0,-10438171.0,4936160.0,-5385884.0,-5812579.0,-20.5,,,78652.17,0.0,,0.0,0.0,0.0,-1261.0,-1048.0,-888.0,-1107.0,118012228.19999984,1683345803.4900017,1899181380.285,27151053.70499999,1683404303.4900017,122641.0,-8436260.0,1945839014.5,83438584.5,424711510.5,194127387.5,444219502.5,121511.0,1934.0,334.02536119431227,3011157.0,1012166.0,618778.0,-2023938.5,720826.0,97425.0,1353663251.9549935,1360353301.1999896,-83213229.0,-82528688.0,1540880.0,67177.0,,,,,,,,,,,,,,,,,,,,,1466854.0,14759702.0,3231099.0,8552150.0,11603745.0,1415135.0,,,72080583461.12213,21670570439.37012,,5792665.7475,689.5,94245.0,-276830649.5,21927465.0,-123750152.0,-218630602.5,-2016831.5,,,,,,,,,,,,,,,,,,,,,4271433.5,2478389.0,-9000372.5,921269.0,37582.5,3732142669.447464,3656722076.504961,-260536396.0,-257226535.5,2525671.0,269103.0,3924727730.572456,33244348084.62841,36672585914.79014,1728793096.582549,48066653252.29572,3986623.0,-247504917.5,103049688551.0,1053361295.0,17267167626.0,3502285691.5,18881004162.0,3670775.0,71892.5,20862.827922857345,89770880.5,-2.237324272103405,7.166666666666668,4.003431512725194,164.62329746436282,28.69125917453055,1179.8002984946002,63000.0,1.0,0.0,0.0,0.0,0.0,0.0,0.0,0.0,1.0,0.0,1.0,0.0,0.0,0.0,0.0,0.0,0.0,1.0,0.0,0.0,0.0,0.0,1.0,0.0,0.0,0.0,0.0,1.0,0.0,0.0,0.0,0.0,0.0,0.0,0.0,1.0,0.0,0.0,0.0,0.0,0.0,0.0,0.0,0.0,0.0,0.0,0.0,0.0,0.0,0.0,0.0,0.0,0.0,0.0,0.0,1.0,0.0,0.0,0.0,0.0,0.0,0.0,0.0,0.0,0.0,0.0,0.0,0.0,0.0,0.0,0.0,0.0,0.0,0.0,0.0,0.0,0.0,0.0,0.0,0.0,0.0,0.0,0.0,0.0,0.0,0.0,0.0,0.0,0.0,0.0,0.0,0.0,0.0,0.0,0.0,0.0,0.0,0.0,0.0,0.0,0.0,0.0,0.0,0.0,0.0,0.0,0.0,0.0,0.0,0.0,0.0,0.0,0.0,0.0,0.0,0.0,0.0,0.0,0.0,0.0,0.0,0.0
102007,1,0.0,1.0,0.0,0.0,0.0,162000.0,332946.0,17127.0,238500.0,0.010147,45.871232876712334,-3105.0,-6998.0,-293.0,,2.0,2.0,2.0,13.0,0.7081416629007508,0.0384266717944184,0.1402431837080297,,0.1186,0.9757,,,,0.2069,0.1667,,,,0.0956,,0.0991,,0.123,0.9757,,,,0.2069,0.1667,,,,0.0997,,0.1049,,0.1186,0.9757,,,,0.2069,0.1667,,,,0.0974,,0.1012,0.0998,1.0,0.0,0.0,0.0,0.0,-1162.0,0.0,0.0,0.0,0.0,0.0,0.0,1.0,1.0,0.0,1.0,0.0,0.0,0.0,0.0,0.0,0.0,0.0,0.0,0.0,1.0,0.0,0.0,0.0,0.0,0.0,0.0,0.0,0.0,0.0,0.0,0.0,0.0,0.0,0.0,0.0,0.0,0.0,0.0,7.0,0.0,639.4725,24705.0,0.0,0.0,0.0,0.0,0.0,-765.0,-582.0,-97.0,-479.0,259.0,-19.0,8.0,13102.155,119346.75,120024.0,0.0,225000.0,36.0,-875.0,365243.0,-1035.0,182313.5,105.0,365243.0,13.0,1.0,0.0,-1.0,81.0,36.0,19.0,-22.0,0.0,0.0,124.0,12063.5775,12063.5775,-629.0,-612.0,17.5,1.0,31.0,0.0,225000.0,0.0,0.0,0.0,0.0,0.0,21.42,21.42,0.0,0.0,0.0,0.0,0.0,0.0,0.0,10.0,-17.0,0.0,0.0,8343858073.5,184346064279.0,165537585697.5,51954078457.935,1863.0,1705.0,71125.0,70765.0,9140.0,505868.0,,,,11292.232400000084,11230.041600000088,11177.332400000056,128364.0,662582.0,,,,13523231.49589001,-601647544.0,-921585120.0,-296394679.0,-1534614451.0416667,44001.0,30696.0,,,,22880.25150000967,22802.11610000963,22187.69120000819,67430.07507909372,157986.98162990925,126059.92516449506,34989.42660002791,34929.80350002834,34375.88340002875,,,,3712904.0,,,,,,,16462.970399999747,16648.16989999969,16244.954399999697,,,,3912.964400000125,3896.1395000001617,3728.7723000001592,436316.0,431113.0,,6422.918258002896,631745.0,625297.0,,16327.633399999797,154125.77119999056,154128.51929999012,154020.29089998716,,,,26.0,30277362.285,9181101.915000005,3218443789.859998,1060745399.7300004,40094823.59999999,638619.57,60.0,8639.0,-10445037.0,4963751.0,-5388473.0,-5815870.0,-12.5,3307.5,1278.945,19845.0,0.0,0.0,0.0,0.0,0.0,-1515.0,-1149.0,-97.0,-479.0,118097945.05499984,1684618355.2950015,1900661260.59,27197007.70499999,1684618355.2950015,122772.0,-8444040.0,1948029995.5,83797232.0,425801771.0,194489996.0,445311243.0,121621.0,1937.5,334.7936930529757,3011721.5,1013854.0,619640.0,-2025379.0,720826.0,97425.0,1354975525.0124912,1361827574.2574873,-83267732.5,-82581516.0,1542080.0,67325.5,1304593645.9950006,3425098500.0,112353612.57,176265681.2099998,7494384.6000000015,56286600.92999996,74679674.57999992,191586872.74500072,177217558.65000018,1252150798.320001,1299546324.4049993,1299601496.3399994,5658.0,14438.0,104.0,8676.0,429734.0,-764173.0,274693.0,728.0,1466861.0,14759961.0,3231130.0,8552231.0,11603869.0,1415143.0,1058118742.489501,801575064.562495,72080608166.12213,21670570439.37012,582232869.791999,5792665.7475,689.5,94245.0,-276831414.5,21926883.0,-123750249.0,-218631081.5,-2016850.5,5919904729.979961,18713891250.0,198745595.325,447810785.39249766,1948107.735,256654969.0200008,308969502.41249865,636311404.7549981,458962383.0599993,5705157337.245031,5883204042.449999,5883447225.195,13376.0,80809.0,44.0,70326.5,971107.0,-1697705.0,177364.0,6755.0,4271469.5,2478408.0,-9000394.5,921269.0,37582.5,3732154733.024962,3656734140.082461,-260537025.0,-257227147.5,2525688.5,269104.0,3924740832.727456,33244467431.37841,36672705938.79014,1728793096.582549,48066878252.29572,3986659.0,-247505792.5,103050053794.0,1053360260.0,17267349939.5,3502285796.5,18881369405.0,3670788.0,71893.5,20862.827922857345,89770879.5,-67.68948217165382,2.0552222222222216,9.458749343142406,433.8844938417352,19.439831844456123,891.7290536211749,81000.0,0.6234898018587336,0.7818314824680298,0.0,0.0,0.0,0.0,0.0,0.0,1.0,0.0,0.0,0.0,0.0,0.0,0.0,1.0,0.0,0.0,0.0,0.0,1.0,0.0,1.0,0.0,0.0,0.0,0.0,1.0,0.0,0.0,0.0,0.0,0.0,0.0,0.0,0.0,1.0,0.0,0.0,0.0,0.0,0.0,0.0,0.0,0.0,0.0,0.0,0.0,0.0,0.0,0.0,0.0,0.0,0.0,0.0,0.0,0.0,0.0,0.0,0.0,0.0,0.0,0.0,0.0,0.0,0.0,0.0,0.0,0.0,0.0,0.0,0.0,0.0,0.0,0.0,0.0,0.0,0.0,0.0,0.0,0.0,0.0,0.0,0.0,0.0,1.0,0.0,0.0,0.0,0.0,0.0,0.0,0.0,0.0,0.0,0.0,0.0,0.0,0.0,0.0,0.0,0.0,0.0,0.0,0.0,0.0,0.0,0.0,0.0,0.0,0.0,0.0,0.0,0.0,0.0,0.0,0.0,0.0,0.0,0.0,1.0,0.0
102017,0,0.0,0.0,0.0,1.0,0.0,216000.0,539100.0,22968.0,450000.0,0.006207,53.26849315068493,-3395.0,-11525.0,-2981.0,,1.0,2.0,2.0,13.0,,0.7506269355149643,0.6722428897082422,,,0.9722,,,0.0,0.1724,0.1667,,0.0274,,0.0557,,0.0415,,,0.9722,,,0.0,0.1724,0.1667,,0.028,,0.058,,0.0439,,,0.9722,,,0.0,0.1724,0.1667,,0.0278,,0.0567,,0.0424,0.0763,1.0,0.0,0.0,0.0,0.0,-3356.0,0.0,0.0,0.0,0.0,1.0,2.0,1.0,1.0,0.0,1.0,0.0,1.0,0.0,0.0,0.0,0.0,0.0,0.0,0.0,1.0,0.0,0.0,0.0,0.0,0.0,0.0,0.0,0.0,0.0,0.0,0.0,0.0,0.0,0.0,0.0,0.0,0.0,0.0,4.0,0.0,,137023.1325,0.0,0.0,0.0,0.0,0.0,-1793.0,-1387.5,-1044.5,-1192.0,224.0,-28.0,2.0,11218.455,62145.0,71248.5,0.0,62145.0,12.0,-723.5,365243.0,-628.0,-478.0,-298.0,-472.0,12.0,1.0,0.0,13.5,8.0,12.0,8.5,-18.5,0.0,0.0,110.0,4500.0,3375.0,-1464.5,-1464.5,55.5,0.0,96.0,0.0,180000.0,0.0,0.0,0.0,0.0,539.1,713.565,0.0,0.0,0.0,0.0,0.0,0.0,0.0,0.0,52.0,-48.5,0.0,0.0,8343881041.5,184346603379.0,165538035697.5,51954294457.935,1863.0,1705.0,71125.0,70766.0,9140.0,505870.0,,,,,,,128364.0,662583.0,,,,13523284.76438316,-601650939.0,-921588101.0,-296398035.0,-1534625976.0416667,44001.0,30696.0,11346.46879999918,11222.439999998973,10706.7956999973,22880.423900009668,22802.28850000963,22187.86360000819,,157987.73225684476,126060.59740738476,34989.59330002791,34929.97020002834,34376.050100028755,,,,3712917.0,8293.066100000171,8397.56250000008,8121.170100000227,,,,16463.026099999748,16648.226599999693,16245.012399999698,,,,3913.005900000125,3896.181900000162,3728.81620000016,436316.0,431113.0,,6422.924465002896,631747.0,625299.0,,16327.709699999798,154126.74339999055,154129.4914999901,154021.26309998715,,,,59.5,30352929.434999995,,3228723481.949998,1062958498.6950004,40485514.725,638619.57,61.0,8639.0,-10496783.5,4980982.5,-5412954.5,-5841575.0,-29.25,0.0,,139500.0,0.0,0.0,0.0,0.0,0.0,-2035.0,-1527.0,-1189.0,-1192.0,118474211.9249998,1691401291.9200015,1908096034.59,27286558.82999999,1691401291.9200015,123348.0,-8483036.5,1957707929.0,84131798.0,427606259.0,195564871.0,447845718.0,122244.5,1945.0,336.81811895628505,3030998.0,1019119.0,622823.0,-2036749.0,720846.0,97438.0,1358121234.8924935,1364853956.557489,-83694592.0,-83005183.0,1548217.5,67644.0,1308360129.3675,3441433500.0,112503012.57,176652256.3649998,7494384.6000000015,56523776.08499996,74889894.95999993,192229283.8350005,177826790.3850001,1255762371.2625003,1303310888.4824991,1303366060.4174993,5676.0,14511.0,104.0,8731.0,431904.5,-766979.0,274698.0,733.0,1466865.0,14760185.0,3231226.0,8552239.0,11603979.0,1415145.0,1058118742.489501,,72080745189.25462,21670570439.37012,582232869.791999,5792665.7475,689.5,94245.0,-276833207.5,21925495.5,-123751293.5,-218632273.5,-2016878.5,5919904729.979961,18714071250.0,198745595.325,447810785.39249766,1948107.735,256654969.0200008,308970041.5124987,636312118.319998,458962383.0599993,5705157337.245031,5883204042.449999,5883447225.195,13376.0,80809.0,44.0,70326.5,971159.0,-1697753.5,177364.0,6755.0,4271481.5,2478416.5,-9000413.0,921269.0,37582.5,3732159233.024962,3656737515.082461,-260538489.5,-257228612.0,2525744.0,269104.0,3924752051.182456,33244529576.37841,36672777187.29014,1728793096.582549,48066940397.29572,3986671.0,-247506516.0,103050419037.0,1053359632.0,17267349461.5,3502285498.5,18881368933.0,3670800.0,71894.5,20862.827922857345,89770893.0,-63.73373450599188,2.495833333333333,9.404388714733544,500.9576158371624,23.4717868338558,1250.3067161935844,216000.0,-0.2225209339563143,0.9749279121818236,0.0,0.0,0.0,0.0,0.0,0.0,1.0,0.0,0.0,0.0,0.0,0.0,0.0,1.0,0.0,1.0,0.0,0.0,0.0,0.0,0.0,0.0,0.0,1.0,0.0,1.0,0.0,0.0,0.0,0.0,0.0,0.0,0.0,0.0,0.0,0.0,0.0,0.0,0.0,0.0,0.0,0.0,0.0,0.0,1.0,0.0,0.0,0.0,0.0,0.0,0.0,0.0,0.0,0.0,0.0,0.0,0.0,0.0,0.0,0.0,0.0,0.0,0.0,0.0,0.0,0.0,0.0,0.0,0.0,0.0,0.0,0.0,0.0,0.0,0.0,0.0,0.0,0.0,0.0,0.0,0.0,0.0,0.0,0.0,0.0,0.0,0.0,0.0,0.0,0.0,1.0,0.0,0.0,0.0,0.0,0.0,0.0,0.0,0.0,0.0,0.0,0.0,0.0,0.0,0.0,0.0,0.0,0.0,0.0,0.0,1.0,0.0,0.0,0.0,0.0,0.0,0.0,0.0,1.0,0.0
102019,0,0.0,1.0,0.0,1.0,2.0,180000.0,481176.0,24696.0,360000.0,0.009175,44.12876712328767,-651.0,-1531.0,-3773.0,,4.0,2.0,2.0,13.0,,0.742350922893129,0.0754609403067,,,,,,,,,,,,,,,,,,,,,,,,,,,,,,,,,,,,,,,,,,,,,2.0,0.0,2.0,0.0,-537.0,0.0,0.0,0.0,0.0,1.0,1.0,1.0,1.0,0.0,1.0,0.0,0.0,0.0,0.0,0.0,0.0,0.0,0.0,0.0,1.0,0.0,0.0,0.0,0.0,0.0,0.0,0.0,0.0,0.0,0.0,0.0,0.0,0.0,0.0,0.0,0.0,0.0,0.0,4.0,4500.0,1850.265,47250.0,43726.56750000001,0.0,0.0,0.0,0.0,-307.5,14050.5,-27.5,,41.0,-5.0,3.0,11024.46,55800.0,62401.5,2405.25,55800.0,6.0,-342.0,365243.0,-172.0,-22.0,-22.0,-18.0,17.0,0.0,0.051693374559017,12.0,15.0,6.0,3.0,-11.0,0.0,0.0,12.0,9679.7025,9679.7025,-271.5,-263.5,3.5,1.0,11.0,0.0,270000.0,,0.0,,,0.0,,0.0,0.0,0.0,0.0,,0.0,,,0.0,-6.0,0.0,0.0,8343905737.5,184347084555.0,165538395697.5,51954474457.935,1863.0,1705.0,71125.0,70767.0,9140.0,505871.0,,,,,,,128366.0,662587.0,,,,13523328.893150285,-601651590.0,-921591874.0,-296398572.0,-1534627507.0416667,44001.0,30696.0,,,,,,,,157988.47460776765,126060.67286832504,,,,,,,3712930.0,,,,,,,,,,,,,,,,436318.0,431115.0,,6422.933640002895,631749.0,625301.0,,,,,,,,,11.0,30361929.434999995,9197250.525000002,3229269723.449998,1063057201.8300004,40493812.59,638619.57,61.0,8639.0,-10505566.0,5019235.5,-5417671.5,,-5.0,4500.0,1850.265,45000.0,46251.0,0.0,0.0,0.0,0.0,-367.0,840.0,-27.0,,118517298.9749998,1691883097.9200015,1908580522.59,27298130.57999999,1691883097.9200015,123384.0,-8490022.0,1958438415.0,84496215.0,428336368.0,195929738.0,448575839.0,122368.0,1946.0,337.07882433117686,3031294.0,1019359.0,622946.0,-2038038.0,720850.0,97442.0,1358590020.007496,1365322741.672491,-83804274.5,-83114535.0,1551653.5,67665.5,1312655936.1749992,3449983500.0,,176804581.3649998,,,75110394.95999993,,178137290.3850001,1259880896.5199995,1307605268.1599982,1307660440.0949984,,14529.0,,,433807.0,-769380.0,274703.0,738.0,1466869.0,14760226.0,3231237.0,8552254.0,11603991.0,1415148.0,1058123242.489501,801576914.827495,72080792439.25462,21670614165.93762,582232869.791999,5792665.7475,689.5,94245.0,-276833515.0,21939546.0,-123751321.0,,-2016883.5,5919904729.979961,18714341250.0,,447810785.39249766,,,308970041.5124987,,458962383.0599993,5705157337.245031,5883204042.449999,5883447225.195,,80809.0,,,971159.0,-1697759.5,177364.0,6755.0,4271487.5,2478419.5,-9000424.0,921269.0,37582.5,3732168912.7274623,3656747194.7849607,-260538761.0,-257228875.5,2525747.5,269105.0,3924763075.642456,33244585376.37841,36672839588.79014,1728795501.832549,48066996197.29572,3986677.0,-247506858.0,103050784280.0,1053359460.0,17267349439.5,3502285476.5,18881368915.0,3670817.0,71894.5,20862.879616231905,89770905.0,-14.752281616688396,2.6732,7.288629737609329,321.63824433883144,19.48396501457725,859.8033547665642,45000.0,-0.9009688679024191,0.4338837391175582,0.0,0.0,0.0,0.0,0.0,0.0,1.0,0.0,0.0,0.0,0.0,0.0,0.0,1.0,0.0,0.0,0.0,0.0,1.0,0.0,1.0,0.0,0.0,0.0,0.0,1.0,0.0,0.0,0.0,0.0,0.0,0.0,0.0,0.0,0.0,0.0,0.0,0.0,0.0,0.0,0.0,0.0,0.0,0.0,0.0,0.0,0.0,0.0,0.0,0.0,0.0,0.0,0.0,0.0,0.0,0.0,0.0,0.0,0.0,0.0,0.0,0.0,0.0,0.0,0.0,0.0,0.0,0.0,0.0,0.0,0.0,0.0,0.0,0.0,0.0,0.0,0.0,0.0,0.0,0.0,0.0,0.0,0.0,0.0,0.0,0.0,0.0,0.0,0.0,0.0,1.0,0.0,0.0,0.0,0.0,0.0,0.0,0.0,0.0,0.0,0.0,0.0,0.0,0.0,0.0,0.0,0.0,0.0,0.0,0.0,0.0,0.0,0.0,0.0,0.0,0.0,0.0,0.0,0.0,0.0
102029,0,0.0,0.0,0.0,1.0,0.0,112500.0,296280.0,23539.5,225000.0,0.009334,46.47945205479452,-3162.0,-7437.0,-521.0,,2.0,2.0,2.0,18.0,,0.7610536087385463,0.7981372313187245,0.101,0.0884,0.9791,0.7144,,0.0,0.2069,0.1667,0.2083,0.0685,0.0824,0.0913,0.0,0.0082,0.1029,0.0918,0.9791,0.7256,,0.0,0.2069,0.1667,0.2083,0.0701,0.09,0.0951,0.0,0.0087,0.102,0.0884,0.9791,0.7182,,0.0,0.2069,0.1667,0.2083,0.0697,0.0838,0.0929,0.0,0.0084,0.0736,1.0,7.0,0.0,7.0,0.0,-2616.0,0.0,0.0,0.0,0.0,0.0,0.0,1.0,1.0,0.0,1.0,1.0,0.0,0.0,0.0,0.0,0.0,0.0,0.0,0.0,1.0,0.0,0.0,0.0,0.0,0.0,0.0,0.0,0.0,0.0,0.0,0.0,0.0,0.0,0.0,0.0,0.0,0.0,0.0,2.0,,0.0,69494.625,0.0,0.0,0.0,0.0,0.0,-1170.5,-835.5,-835.5,-835.5,78.0,-20.5,5.0,8766.765,34605.0,94446.0,3600.0,91345.5,9.0,-1259.0,365243.0,-1424.0,-1214.0,-1094.0,-1207.5,14.0,0.0,0.0598293817133874,797.0,30.0,12.0,7.5,-51.5,0.0,0.0,91.0,6152.22,6152.22,-690.0,-684.0,18.0,0.0,33.0,111631.635,450000.0,0.0,0.0,0.0,0.0,5462.37,7200.0,7200.0,106705.845,111631.635,111631.635,0.0,0.0,0.0,0.0,15.5,-17.0,0.0,0.0,8343929277.0,184347380835.0,165538620697.5,51954586957.935,1863.0,1705.0,71125.0,70767.0,9140.0,505871.0,17802.890600002294,17865.043899999113,17316.599199998058,11292.320800000083,11230.130000000088,11177.424200000056,128366.0,662589.0,,,,13523375.37260234,-601654752.0,-921592395.0,-296401188.0,-1534634944.0416667,44001.0,30696.0,11346.46879999918,11222.439999998973,10706.7956999973,22880.63080000967,22802.49540000963,22188.070500008187,,157989.23566137635,126061.47100555636,34989.76000002791,34930.136900028345,34376.216800028764,22946.54699999592,22919.8173999955,22567.12309999573,3712948.0,8293.134600000169,8397.63220000008,8121.240200000227,9814.908700000718,9929.825800002158,10289.421199999646,16463.117399999748,16648.319499999692,16245.107499999698,828.5312000001759,813.7071000000459,759.6894000000133,3913.014100000125,3896.1903000001616,3728.8249000001592,436325.0,431122.0,,6422.942974002895,631751.0,625303.0,,16327.783299999795,154127.72249999054,154130.4705999901,154022.24219998714,77584.50519999625,77922.20130000659,78323.5217000065,39.0,,9603650.475,3242366639.909998,1065307460.1300004,40493812.59,638619.57,61.0,8639.0,-10554483.0,5060690.0,-5440585.0,-5868385.0,-19.0,,0.0,76929.75,0.0,0.0,0.0,0.0,0.0,-1824.0,-1520.0,-1520.0,-1520.0,118913686.55999982,1697568104.0250018,1914858963.09,27426853.93499999,1697659449.5250018,123786.0,-8521753.0,1967750769.5,84469869.0,430144527.0,196643423.0,450384104.0,122901.0,1948.0,339.10197201518355,3048883.0,1023750.0,625370.5,-2046288.0,721039.0,97533.0,1362809441.8349972,1368932993.0549908,-84095025.0,-83402628.0,1556314.0,67978.0,1320845118.074999,3468523500.0,113268687.57,178116643.8449998,7494384.6000000015,57222488.56499995,75461927.82749999,193139608.9500005,178712964.9000001,1267721391.1949997,1315674074.7899983,1315729246.7249985,5749.0,14728.0,104.0,8875.0,434100.5,-769791.0,274703.0,738.0,1466871.0,14760304.0,3231270.0,8552284.0,11604082.0,1415153.0,,801576914.827495,72080861933.87962,21670614165.93762,582232869.791999,5792665.7475,689.5,94245.0,-276834685.5,21938710.5,-123752156.5,-218633109.0,-2016904.0,5920016361.614962,18714791250.0,198745595.325,447810785.39249766,1948107.735,256654969.0200008,308975503.8824987,636319318.319998,458969583.0599993,5705264043.090032,5883315674.084999,5883558856.83,13376.0,80809.0,44.0,70326.5,971174.5,-1697776.5,177364.0,6755.0,4271499.5,2478427.0,-9000475.5,921269.0,37582.5,3732175064.9474616,3656753347.004961,-260539451.0,-257229559.5,2525765.5,269105.0,3924771842.407456,33244619981.37841,36672934034.79014,1728799101.832549,48067087542.79572,3986686.0,-247508117.0,103051149523.0,1053358036.0,17267348225.5,3502284382.5,18881367707.5,3670831.0,71894.5,20862.93944561361,89771702.0,-68.03006189213086,2.6336,4.779200917606576,222.1346399101249,12.58650353660868,585.0137876673048,56250.0,-0.9009688679024191,-0.433883739117558,0.0,0.0,0.0,0.0,0.0,0.0,1.0,0.0,0.0,0.0,1.0,0.0,0.0,0.0,0.0,0.0,0.0,0.0,1.0,0.0,1.0,0.0,0.0,0.0,0.0,0.0,1.0,0.0,0.0,0.0,0.0,0.0,0.0,0.0,0.0,0.0,0.0,0.0,0.0,0.0,0.0,1.0,0.0,0.0,0.0,0.0,0.0,0.0,0.0,0.0,0.0,0.0,0.0,0.0,0.0,0.0,0.0,0.0,0.0,0.0,0.0,0.0,0.0,0.0,0.0,0.0,0.0,0.0,0.0,0.0,0.0,0.0,0.0,0.0,0.0,0.0,0.0,0.0,1.0,0.0,0.0,0.0,0.0,0.0,0.0,0.0,0.0,0.0,0.0,0.0,0.0,0.0,0.0,0.0,0.0,0.0,0.0,0.0,0.0,0.0,0.0,0.0,0.0,0.0,0.0,0.0,0.0,0.0,1.0,0.0,1.0,0.0,0.0,0.0,0.0,0.0,0.0,1.0,0.0,0.0
102051,0,0.0,0.0,0.0,1.0,2.0,180000.0,450000.0,23107.5,450000.0,0.001276,27.295890410958904,-786.0,-918.0,-2382.0,,4.0,2.0,2.0,7.0,0.5058675660669479,0.0433620698958804,0.5424451438613613,0.0278,0.0583,0.9831,0.7688,0.0143,0.0,0.0572,0.1804,0.2221,0.0431,0.0227,0.0518,0.0,0.0178,0.0179,0.0372,0.9836,0.7844,0.0095,0.0,0.069,0.1667,0.2083,0.0363,0.0156,0.0304,0.0,0.0,0.026,0.0674,0.9836,0.7786,0.0124,0.0,0.069,0.1667,0.2083,0.0376,0.0214,0.0605,0.0,0.0,0.037,1.0,7.0,0.0,7.0,0.0,-671.0,0.0,0.0,0.0,0.0,0.0,2.0,1.0,1.0,1.0,1.0,1.0,0.0,0.0,0.0,0.0,0.0,0.0,0.0,0.0,1.0,0.0,0.0,0.0,0.0,0.0,0.0,0.0,0.0,0.0,0.0,0.0,0.0,0.0,0.0,0.0,0.0,0.0,0.0,6.0,6462.0,0.0,151267.5,35775.0,0.0,0.0,0.0,0.0,-596.5,324.0,-25.0,-966.0,149.0,-13.0,2.0,7023.6675,92452.5,91692.0,2740.5,92452.5,27.0,-1025.0,365243.0,-994.5,-874.5,-214.5,-869.5,5.5,0.0,0.104269197238856,19.5,12.0,6.0,4.5,-39.5,0.0,0.0,10.0,5277.735,5277.735,-1223.5,-1213.0,3.0,1.0,0.0,,,,,,,,,,,,,,,,,,,,,8343952384.5,184347830835.0,165539070697.5,51954766957.935,1863.0,1705.0,71125.0,70767.0,9140.0,505873.0,17802.918400002294,17865.069899999115,17316.617099998057,11292.379100000086,11230.197400000088,11177.461400000057,128368.0,662593.0,4136.755100000121,4134.423100000015,3945.048300000096,13523402.668492751,-601655538.0,-921594777.0,-296401859.0,-1534635862.0416667,44001.0,30696.0,11346.46879999918,11222.439999998973,10706.7956999973,22880.688000009668,22802.56440000963,22188.13950000819,67430.58094665979,157989.27902344632,126062.01345070024,34989.94040002791,34930.30360002835,34376.383500028765,22946.76909999592,22920.02569999549,22567.33139999572,3712955.0,8293.177700000171,8397.66980000008,8121.2765000002255,9814.931400000718,9929.847200002156,10289.436799999648,16463.16919999975,16648.379999999688,16245.137899999698,828.5312000001759,813.7071000000459,759.6894000000133,3913.031900000125,3896.1903000001616,3728.8249000001592,436332.0,431129.0,,6422.944250002895,631753.0,625305.0,,16327.820299999796,154128.70559999056,154131.4541999901,154023.22579998715,77585.27399999625,77922.9799000066,78324.3061000065,20.0,30516090.434999995,9609194.475,3275510536.0349984,1084342188.8250003,40772652.88499999,638619.57,61.0,8639.0,-10647427.0,5098030.5,-5477950.0,-5912394.5,-9.5,4959.0,0.0,61110.0,0.0,0.0,0.0,0.0,0.0,-916.0,-550.0,-641.0,-1291.0,119894901.88499984,1708358386.6350017,1928024730.18,27649826.95499999,1708358386.6350017,124677.0,-8615090.5,1988564540.5,85494748.5,435204152.5,199153597.5,455445607.0,124009.5,1967.0,343.4524997005554,3059335.5,1032468.0,630662.0,-2068745.5,721107.0,97562.0,1376525176.5374975,1382774902.2224922,-85133988.0,-84434896.0,1576505.5,68617.5,,,,,,,,,,,,,,,,,,,,,1466877.0,14760453.0,3231270.0,8552296.0,11604092.0,1415155.0,1058129704.489501,801576914.827495,72081013201.37962,21670649940.93762,582232869.791999,5792665.7475,689.5,94245.0,-276835282.0,21939034.5,-123752181.5,-218634075.0,-2016917.0,,,,,,,,,,,,,,,,,,,,,4271505.5,2478431.5,-9000515.0,921269.0,37582.5,3732180342.6824617,3656758624.739961,-260540674.5,-257230772.5,2525768.5,269106.0,3924778866.074957,33244712433.87841,36673025726.79014,1728801842.332549,48067179995.29572,3986713.0,-247509142.0,103051514766.0,1053357041.5,17267347351.0,3502284168.0,18881366838.0,3670836.5,71894.5,20863.043714810858,89771721.5,-28.79554351099066,2.5,7.789678675754625,212.62621546998173,19.474196689386567,531.5655386749543,45000.0,-0.9009688679024191,-0.433883739117558,0.0,0.0,0.0,0.0,0.0,0.0,1.0,0.0,1.0,0.0,0.0,0.0,0.0,0.0,0.0,0.0,0.0,0.0,1.0,1.0,0.0,0.0,0.0,0.0,0.0,1.0,0.0,0.0,0.0,0.0,0.0,0.0,0.0,0.0,0.0,0.0,0.0,0.0,0.0,0.0,0.0,0.0,0.0,0.0,0.0,0.0,0.0,0.0,0.0,0.0,0.0,0.0,0.0,0.0,0.0,0.0,0.0,0.0,0.0,0.0,0.0,0.0,0.0,0.0,0.0,0.0,0.0,0.0,0.0,0.0,0.0,0.0,0.0,0.0,0.0,0.0,0.0,0.0,0.0,0.0,0.0,1.0,0.0,0.0,0.0,0.0,0.0,0.0,0.0,0.0,0.0,0.0,0.0,0.0,0.0,0.0,0.0,0.0,0.0,0.0,0.0,0.0,0.0,0.0,0.0,0.0,0.0,0.0,1.0,0.0,1.0,0.0,0.0,0.0,0.0,0.0,0.0,1.0,0.0,0.0
102052,0,0.0,0.0,0.0,0.0,2.0,126000.0,289597.5,14062.5,234000.0,0.005313,39.484931506849314,-1846.0,-8394.0,-5264.0,,4.0,2.0,2.0,12.0,0.8139003403560853,0.7306523135936152,0.6363761710860439,0.1443,0.1338,0.9776,0.6940000000000001,0.0133,0.0,0.2414,0.1667,0.2083,0.0956,0.1177,0.1203,0.0,0.0,0.1471,0.1388,0.9777,0.706,0.0134,0.0,0.2414,0.1667,0.2083,0.0978,0.1286,0.1254,0.0,0.0,0.1457,0.1338,0.9776,0.6981,0.0133,0.0,0.2414,0.1667,0.2083,0.0973,0.1197,0.1225,0.0,0.0,0.1068,1.0,0.0,0.0,0.0,0.0,-2130.0,0.0,0.0,0.0,0.0,1.0,0.0,1.0,1.0,0.0,1.0,0.0,0.0,0.0,0.0,0.0,0.0,0.0,0.0,0.0,1.0,0.0,0.0,0.0,0.0,0.0,0.0,0.0,0.0,0.0,0.0,0.0,0.0,0.0,0.0,0.0,0.0,0.0,0.0,11.0,0.0,0.0,112500.0,0.0,0.0,0.0,0.0,0.0,-1513.0,-793.0,-794.0,-1213.5,496.0,-24.0,2.0,6923.4525,51232.5,29704.5,22837.5,51232.5,6.0,-1375.0,365243.0,-1344.0,-1239.0,-1194.0,-1232.5,17.5,0.0,0.4285507199722069,305.5,11.0,6.0,3.0,-65.0,0.0,0.0,9.0,3595.59,3595.59,-1991.0,-1979.0,3.0,1.0,0.0,,,,,,,,,,,,,,,,,,,,,8343966447.0,184348120432.5,165539304697.5,51954892957.935,1863.0,1705.0,71125.0,70768.0,9140.0,505873.0,17803.062700002294,17865.215599999116,17316.764199998055,11292.512900000083,11230.331200000088,11177.600200000055,128370.0,662597.0,4136.768400000121,4134.436400000014,3945.0617000000952,13523442.153424256,-601657384.0,-921600041.0,-296403989.0,-1534644256.0416667,44001.0,30696.0,11346.46879999918,11222.439999998973,10706.7956999973,22880.929400009667,22802.805800009628,22188.38090000819,67431.39484700015,157990.00967575988,126062.64982687132,34990.10710002791,34930.47030002835,34376.55020002877,22946.97739999592,22920.233999995493,22567.539699995723,3712967.0,8293.273300000172,8397.76710000008,8121.374300000226,9815.04910000072,9929.966900002157,10289.565399999648,16463.289499999748,16648.502499999693,16245.2632999997,828.5312000001759,813.7071000000459,759.6894000000133,3913.031900000125,3896.1903000001616,3728.8249000001592,436332.0,431129.0,,6422.949563002896,631755.0,625307.0,,16327.927099999795,154129.68319999054,154132.43179999013,154024.20349998714,77585.96799999625,77923.67800000659,78325.01210000651,50.0,30529392.434999995,9609194.475,3276607681.0349984,1084505138.3250003,40772652.88499999,638619.57,61.0,8639.0,-10657556.0,5095915.0,-5484577.0,-5918974.0,-24.5,0.0,0.0,112500.0,0.0,0.0,0.0,0.0,0.0,-1705.0,-1402.0,-1570.0,-1571.0,119908007.93249984,1708502926.6350017,1928143905.93,27677164.45499999,1708502926.6350017,124711.0,-8617866.0,1989295026.5,85492034.5,435201663.5,199151843.5,455443131.0,124038.5,1967.0,344.0420394684346,3059702.0,1032703.0,630867.0,-2069268.0,721107.0,97562.0,1376741147.7599971,1382990873.4449914,-85147244.0,-84448059.0,1576534.0,68629.0,,,,,,,,,,,,,,,,,,,,,1466888.0,14760949.0,3231270.0,8552307.0,11604101.0,1415157.0,1058129704.489501,801576914.827495,72081125701.37962,21670649940.93762,582232869.791999,5792665.7475,689.5,94245.0,-276836795.0,21938241.5,-123752975.5,-218635288.5,-2016941.0,,,,,,,,,,,,,,,,,,,,,4271511.5,2478434.5,-9000580.0,921269.0,37582.5,3732183938.2724624,3656762220.329961,-260542665.5,-257232751.5,2525771.5,269107.0,3924785789.527455,33244763666.37841,36673055431.29014,1728824679.832549,48067231227.79572,3986719.0,-247510517.0,103051880009.0,1053355697.5,17267346112.0,3502282974.0,18881365605.5,3670854.0,71894.5,20863.47226553083,89772027.0,-46.75201221204553,2.2983928571428573,8.96,353.7849863013699,20.5936,813.1368854794521,31500.0,-0.9009688679024191,0.4338837391175582,0.0,0.0,0.0,0.0,0.0,0.0,1.0,0.0,1.0,0.0,0.0,0.0,0.0,0.0,0.0,0.0,0.0,0.0,1.0,0.0,1.0,0.0,0.0,0.0,0.0,1.0,0.0,0.0,0.0,0.0,0.0,0.0,0.0,0.0,0.0,0.0,0.0,0.0,0.0,0.0,0.0,0.0,0.0,0.0,0.0,0.0,0.0,0.0,0.0,0.0,0.0,0.0,0.0,1.0,0.0,0.0,0.0,0.0,0.0,0.0,0.0,0.0,0.0,0.0,0.0,0.0,0.0,0.0,0.0,0.0,0.0,0.0,0.0,0.0,0.0,0.0,0.0,0.0,0.0,0.0,0.0,0.0,0.0,0.0,0.0,0.0,0.0,0.0,0.0,0.0,0.0,0.0,0.0,0.0,0.0,0.0,0.0,0.0,0.0,0.0,0.0,0.0,0.0,0.0,0.0,0.0,0.0,0.0,1.0,0.0,1.0,0.0,0.0,0.0,0.0,0.0,0.0,1.0,0.0,0.0
102054,0,0.0,1.0,1.0,1.0,3.0,315000.0,738108.0,45283.5,630000.0,0.030755,37.580821917808215,-4243.0,-4439.0,-4443.0,19.0,5.0,2.0,2.0,14.0,0.7774937461635107,0.5813896105430165,0.6430255641096323,,,,,,,,,,,,,,,,,,,,,,,,,,,,,,,,,,,,,,,,,,,,,1.0,0.0,1.0,0.0,-877.0,0.0,0.0,0.0,0.0,1.0,1.0,1.0,1.0,0.0,1.0,0.0,0.0,0.0,0.0,0.0,0.0,1.0,1.0,0.0,0.0,0.0,0.0,0.0,0.0,1.0,0.0,0.0,0.0,0.0,0.0,0.0,0.0,0.0,0.0,0.0,0.0,0.0,0.0,2.0,83504.25,,2173725.0,1379886.75,0.0,0.0,0.0,0.0,-479.5,800.5,-10.5,,33.0,-8.0,1.0,8762.85,112495.5,73435.5,45000.0,112495.5,10.0,-877.0,365243.0,-846.0,-576.0,-576.0,-571.0,11.0,0.0,0.4138040613590596,2160.0,11.0,10.0,5.0,-24.0,0.0,0.0,11.0,8762.85,8762.85,-724.0,-726.0,5.0,1.0,0.0,,,,,,,,,,,,,,,,,,,,,8344011730.5,184348858540.5,165539934697.5,51955207957.935,1863.0,1705.0,71125.0,70769.0,9140.0,505874.0,,,,,,,128373.0,662602.0,,,,13523479.734246176,-601661627.0,-921604484.0,-296404866.0,-1534648695.0416667,44001.0,30696.0,,,,,,,67432.17234074631,157990.59106537042,126063.29285243544,,,,,,,3712981.0,,,,,,,,,,,,,,,,436333.0,431130.0,1262620.0,6422.980318002896,631757.0,625309.0,,,,,,,,,16.5,30824009.684999995,,3282921959.5349984,1088838098.3250003,40772652.88499999,638619.57,61.0,8639.0,-10666467.5,5092931.5,-5490285.5,,-7.75,64458.0,,2250000.0,1537501.5,0.0,0.0,0.0,0.0,-594.0,1232.0,-16.0,,119966457.37499982,1710093087.1350017,1929677314.68,27740501.95499999,1710093087.1350017,124795.0,-8620702.0,1990573377.0,85490028.0,435565711.0,199152252.0,455807195.0,124109.0,1967.0,344.7234052018589,3062253.0,1033530.0,631572.0,-2069746.0,721107.0,97562.0,1377721881.314996,1384549112.2499907,-85161231.0,-84461539.0,1576681.0,68701.0,,,,,,,,,,,,,,,,,,,,,1466890.0,14760982.0,3231270.0,8552318.0,11604112.0,1415158.0,1058213208.739501,,72083299426.37962,21672029827.68762,582232869.791999,5792665.7475,689.5,94245.0,-276837274.5,21939042.0,-123752986.0,,-2016949.0,,,,,,,,,,,,,,,,,,,,,4271521.5,2478439.5,-9000604.0,921269.0,37582.5,3732192701.1224623,3656770983.1799607,-260543389.5,-257233477.5,2525776.5,269108.0,3924794552.377455,33244876161.87841,36673128866.79014,1728869679.832549,48067343723.29572,3986729.0,-247511394.0,103052245252.0,1053354851.5,17267345536.0,3502282398.0,18881365034.5,3670865.0,71894.5,20863.886069592187,89774187.0,-112.9033316322811,2.3432,6.956176090629038,261.4188148908452,16.299711815561963,612.5565670522285,63000.0,-0.9009688679024191,0.4338837391175582,0.0,0.0,0.0,0.0,0.0,0.0,1.0,0.0,0.0,0.0,0.0,0.0,0.0,1.0,0.0,1.0,0.0,0.0,0.0,0.0,1.0,0.0,0.0,0.0,0.0,1.0,0.0,0.0,0.0,0.0,0.0,0.0,0.0,0.0,0.0,0.0,0.0,0.0,0.0,0.0,1.0,0.0,0.0,0.0,0.0,0.0,0.0,0.0,0.0,0.0,0.0,0.0,0.0,0.0,0.0,1.0,0.0,0.0,0.0,0.0,0.0,0.0,0.0,0.0,0.0,0.0,0.0,0.0,0.0,0.0,0.0,0.0,0.0,0.0,0.0,0.0,0.0,0.0,0.0,0.0,0.0,0.0,0.0,0.0,0.0,0.0,0.0,0.0,0.0,0.0,0.0,0.0,0.0,0.0,0.0,0.0,0.0,0.0,0.0,0.0,0.0,0.0,0.0,0.0,0.0,0.0,0.0,0.0,0.0,0.0,0.0,0.0,0.0,0.0,0.0,0.0,0.0,0.0,0.0,0.0
102062,0,0.0,1.0,0.0,1.0,0.0,72000.0,225000.0,14508.0,225000.0,0.01885,44.273972602739725,-4716.0,-7637.0,-4350.0,,2.0,2.0,2.0,16.0,,0.6654257112313979,0.4329616670974407,,,,,,,,,,,,,,,,,,,,,,,,,,,,,,,,,,,,,,,,,,,,,1.0,1.0,1.0,1.0,-1530.0,0.0,0.0,0.0,0.0,0.0,1.0,1.0,1.0,1.0,1.0,1.0,0.0,0.0,0.0,0.0,0.0,0.0,0.0,0.0,1.0,0.0,0.0,0.0,0.0,0.0,0.0,0.0,0.0,0.0,0.0,0.0,0.0,0.0,0.0,0.0,0.0,0.0,0.0,4.0,0.0,0.0,90000.0,0.0,0.0,0.0,0.0,0.0,-1130.0,-635.5,-19.0,-391.0,138.0,-18.0,3.0,11461.5,123750.0,101250.0,6750.0,123750.0,12.0,-1855.0,365243.0,-1966.5,-1681.5,-1636.5,-1675.0,12.0,0.0,0.1000083479422322,35.0,23.0,12.0,5.0,-59.0,0.0,0.0,28.0,13244.4,3332.205,-1727.0,-1719.0,6.0,1.0,0.0,,,,,,,,,,,,,,,,,,,,,8344026238.5,184349083540.5,165540159697.5,51955279957.935,1863.0,1705.0,71125.0,70769.0,9140.0,505875.0,,,,,,,128373.0,662604.0,,,,13523524.008218778,-601666343.0,-921608834.0,-296406396.0,-1534656332.0416667,44002.0,30697.0,,,,,,,,157991.25649108164,126063.72581410252,,,,,,,3712997.0,,,,,,,,,,,,,,,,436334.0,431131.0,,6422.999168002895,631759.0,625311.0,,,,,,,,,37.5,30875284.934999995,9618869.475,3285525641.039998,1089802583.3250003,40772652.88499999,638619.57,61.0,8639.0,-10687108.0,5079681.0,-5503355.5,-5937554.0,-18.25,0.0,0.0,45000.0,0.0,0.0,0.0,0.0,0.0,-1504.0,-880.0,-19.0,-1319.0,120546850.8599998,1720417526.2350016,1941305795.28,27901205.95499999,1720417526.2350016,125709.0,-8672148.0,2003901857.5,85811703.0,438088069.0,199865664.0,458330382.0,124732.0,1989.0,347.0331924102463,3064169.0,1040302.0,636739.0,-2080771.0,721111.0,97566.0,1388085526.305,1395993231.4949925,-85725459.5,-85021463.0,1589041.0,69081.5,,,,,,,,,,,,,,,,,,,,,1466894.0,14761120.0,3231270.0,8552341.0,11604140.0,1415161.0,1058213208.739501,801576914.827495,72083389426.37962,21672029827.68762,582232869.791999,5792665.7475,689.5,94245.0,-276838404.5,21938406.5,-123753005.0,-218635679.5,-2016967.0,,,,,,,,,,,,,,,,,,,,,4271533.5,2478444.5,-9000663.0,921269.0,37582.5,3732205945.5224624,3656774315.384961,-260545116.5,-257235196.5,2525782.5,269109.0,3924806013.877455,33244999911.87841,36673230116.79014,1728876429.832549,48067467473.29572,3986741.0,-247513249.0,103052610495.0,1053352885.0,17267343854.5,3502280761.5,18881363359.5,3670877.0,71894.5,20863.986077940128,89774222.0,-106.51856435643565,3.125,4.962779156327543,219.7219484006934,15.508684863523571,686.631088752167,36000.0,0.6234898018587336,0.7818314824680298,0.0,0.0,0.0,0.0,0.0,0.0,1.0,0.0,0.0,0.0,0.0,0.0,0.0,1.0,0.0,0.0,0.0,0.0,1.0,0.0,1.0,0.0,0.0,0.0,0.0,1.0,0.0,0.0,0.0,0.0,0.0,0.0,0.0,0.0,0.0,0.0,0.0,0.0,1.0,0.0,0.0,0.0,0.0,0.0,0.0,0.0,0.0,0.0,0.0,0.0,0.0,0.0,0.0,0.0,0.0,0.0,0.0,0.0,0.0,0.0,0.0,0.0,0.0,0.0,0.0,0.0,0.0,0.0,0.0,0.0,0.0,0.0,0.0,0.0,0.0,0.0,0.0,0.0,0.0,0.0,0.0,0.0,0.0,0.0,0.0,0.0,0.0,0.0,0.0,0.0,1.0,0.0,0.0,0.0,0.0,0.0,0.0,0.0,0.0,0.0,0.0,0.0,0.0,0.0,0.0,0.0,0.0,0.0,0.0,0.0,0.0,0.0,0.0,0.0,0.0,0.0,0.0,0.0,0.0,0.0
102067,0,0.0,1.0,0.0,1.0,0.0,166500.0,431280.0,22149.0,360000.0,0.01885,60.65753424657535,,-12255.0,-4229.0,,1.0,2.0,2.0,11.0,,0.2167973120763193,0.5100895276257282,0.0309,0.0771,0.9717,0.6804,0.0542,0.0,0.1379,0.0833,0.125,0.0266,0.0252,0.0354,0.0,0.0,0.0315,0.08,0.9717,0.6929,0.0547,0.0,0.1379,0.0833,0.125,0.0272,0.0275,0.0368,0.0,0.0,0.0312,0.0771,0.9717,0.6847,0.0545,0.0,0.1379,0.0833,0.125,0.027,0.0257,0.036,0.0,0.0,0.0311,1.0,1.0,0.0,1.0,0.0,-441.0,0.0,0.0,0.0,0.0,1.0,2.0,1.0,0.0,0.0,1.0,0.0,0.0,0.0,0.0,0.0,0.0,0.0,0.0,0.0,1.0,0.0,0.0,0.0,0.0,0.0,0.0,0.0,0.0,0.0,0.0,0.0,0.0,0.0,0.0,0.0,0.0,0.0,0.0,8.0,0.0,0.0,100381.5,0.0,0.0,0.0,0.0,0.0,-767.0,154.0,-269.5,-1032.0,247.0,-15.0,4.0,8972.055,19253.25,20396.25,0.0,120503.25,3.0,-441.0,182404.5,-467.0,182380.5,182425.5,182385.0,13.5,0.0,0.0,0.0,5.0,6.0,4.0,-17.0,0.0,0.0,29.0,7107.57,7107.57,-228.0,-228.0,12.0,0.0,14.0,178343.48249999995,202500.0,13500.0,13500.0,0.0,0.0,9188.775,12600.0,11475.0,172747.845,176772.98249999995,176772.98249999995,1.0,1.0,0.0,0.0,5.0,-7.5,0.0,0.0,8344048387.5,184349514820.5,165540519697.5,51955446457.935,1863.0,1705.0,71125.0,70770.0,9140.0,505877.0,17803.093600002296,17865.246799999117,17316.795699998056,11292.590000000086,11230.408300000088,11177.680200000055,128373.0,662605.0,4136.8226000001205,4134.490900000014,3945.116400000096,13523584.665753026,,-921613063.0,-296406837.0,-1534668587.0416667,44002.0,30697.0,11346.46879999918,11222.439999998973,10706.7956999973,22881.06730000967,22802.94370000963,22188.518800008187,,157991.47328839372,126064.23590363016,34990.19040002791,34930.55360002835,34376.633500028765,22947.10239999592,22920.358999995493,22567.664699995723,3713008.0,8293.299900000171,8397.79410000008,8121.4015000002255,9815.07430000072,9929.992600002157,10289.592899999649,16463.324899999752,16648.538499999693,16245.300099999697,828.5312000001759,813.7071000000459,759.6894000000133,3913.031900000125,3896.1903000001616,3728.8249000001592,436335.0,431132.0,,6423.0180180028965,631761.0,625313.0,,16327.958199999795,154130.65489999054,154133.40349999012,154025.17519998713,77586.64839999625,77924.36270000659,78325.7050000065,26.0,30953429.415,9618869.475,3288141065.789998,1090999020.8250003,40861214.90999999,638619.57,61.0,8639.0,-10707401.0,5072553.0,-5512709.0,-5951711.0,-12.5,0.0,0.0,100381.5,0.0,0.0,0.0,0.0,0.0,-1309.0,-1032.0,-958.0,-1055.0,120634400.74499984,1721557603.4850016,1942415466.03,27947731.45499999,1721557603.4850016,125800.0,-8680009.5,2006458124.5,85805737.0,438814478.0,200227673.0,459056827.5,124865.0,1991.0,347.76827838685585,3067853.0,1041193.0,637316.0,-2082553.0,721126.0,97581.0,1389305907.9000025,1397338986.7349932,-85784538.0,-85079436.0,1589597.0,69173.0,1346024363.400001,3533672250.0,115299537.57,180531311.0399997,7674564.6000000015,57421922.48999996,76836836.25,196419804.7499998,181333457.8200001,1291790039.2650006,1340709717.105,1340764889.04,5883.0,14901.0,105.0,8913.0,444618.0,-785362.0,274751.0,754.0,1466902.0,14761367.0,3231284.0,8552346.0,11604169.0,1415165.0,1058213208.739501,801576914.827495,72083489807.87962,21672029827.68762,582232869.791999,5792665.7475,689.5,94245.0,-276839171.5,21938560.5,-123753274.5,-218636711.5,-2016982.0,5920194705.097462,18714993750.0,198759095.325,447824285.39249766,1948107.735,256654969.0200008,308984692.65749866,636331918.319998,458981058.0599993,5705436790.935032,5883492447.067499,5883735629.8125,13377.0,80810.0,44.0,70326.5,971179.5,-1697784.0,177364.0,6755.0,4271539.5,2478448.5,-9000680.0,921269.0,37582.5,3732213053.092464,3656781422.954961,-260545344.5,-257235424.5,2525794.5,269109.0,3924814985.932455,33245019165.12841,36673250513.04014,1728876429.832549,48067587976.54572,3986744.0,-247513690.0,103052792899.5,1053352418.0,17267526235.0,3502463187.0,18881545744.5,3670890.5,71894.5,20863.986077940128,89774222.0,,2.5902702702702705,7.517269402681838,455.9790262339065,19.471759447379117,1181.1089155204754,166500.0,-0.9009688679024191,0.4338837391175582,0.0,0.0,0.0,0.0,0.0,0.0,1.0,0.0,0.0,1.0,0.0,0.0,0.0,0.0,0.0,0.0,0.0,0.0,1.0,0.0,0.0,0.0,1.0,0.0,0.0,1.0,0.0,0.0,0.0,0.0,0.0,0.0,0.0,0.0,0.0,0.0,0.0,0.0,0.0,0.0,0.0,0.0,0.0,0.0,0.0,0.0,0.0,0.0,0.0,0.0,0.0,0.0,0.0,0.0,0.0,0.0,0.0,0.0,0.0,0.0,0.0,0.0,0.0,0.0,0.0,0.0,0.0,0.0,0.0,0.0,0.0,0.0,0.0,0.0,0.0,0.0,0.0,0.0,0.0,0.0,0.0,0.0,0.0,0.0,0.0,0.0,0.0,0.0,0.0,0.0,0.0,0.0,0.0,0.0,0.0,0.0,0.0,0.0,0.0,0.0,0.0,0.0,0.0,0.0,0.0,1.0,0.0,0.0,1.0,0.0,1.0,0.0,0.0,0.0,0.0,0.0,0.0,0.0,1.0,0.0
102068,0,0.0,1.0,1.0,1.0,2.0,180000.0,195543.0,13198.5,148500.0,0.025164,40.87945205479452,-1754.0,-559.0,-4965.0,13.0,4.0,2.0,2.0,11.0,0.4300252449319149,0.2698070729589465,0.5726825047161584,0.0325,0.0112,0.9682,0.5648,0.0327,0.0,0.0862,0.1042,0.1458,0.0134,0.024,0.0326,0.0116,0.0135,0.0252,0.0068,0.9682,0.5818,0.033,0.0,0.069,0.0833,0.125,0.0117,0.022,0.0288,0.0,0.0,0.0328,0.0112,0.9682,0.5706,0.0329,0.0,0.0862,0.1042,0.1458,0.0136,0.0244,0.0332,0.0116,0.0137,0.0397,1.0,0.0,0.0,0.0,0.0,-2154.0,0.0,0.0,0.0,0.0,2.0,4.0,1.0,1.0,0.0,1.0,0.0,0.0,0.0,0.0,0.0,0.0,0.0,0.0,0.0,1.0,0.0,0.0,0.0,0.0,0.0,0.0,0.0,0.0,0.0,0.0,0.0,0.0,0.0,0.0,0.0,0.0,0.0,0.0,7.0,0.0,6912.0,225000.0,121443.75,0.0,0.0,0.0,0.0,-566.0,-514.0,-89.0,-461.0,149.0,-13.0,12.0,11250.0,75575.25,155673.0,4500.0,153000.0,6.0,-962.5,365243.0,-1312.0,-1072.0,-982.0,-1068.0,11.0,0.0,0.1910015624501769,-1.0,59.0,36.0,9.0,-30.0,0.0,0.0,96.0,11503.575,11503.575,-490.0,-485.0,14.0,1.0,21.0,233606.25,225000.0,1800.0,3614.76,0.0,1203.84,11388.735,11700.0,11700.0,223661.7,232129.08,232129.08,1.0,2.0,0.0,1.0,9.0,-11.0,0.0,0.0,8344061586.0,184349710363.5,165540668197.5,51955626457.935,1863.0,1705.0,71125.0,70772.0,9140.0,505881.0,17803.126100002293,17865.279599999118,17316.820899998056,11292.601200000085,11230.419500000093,11177.687000000056,128375.0,662609.0,4136.85530000012,4134.523800000015,3945.1494000000953,13523625.54520508,-601668097.0,-921618028.0,-296408991.0,-1534669146.0416667,44002.0,30697.0,11346.46879999918,11222.439999998973,10706.7956999973,22881.153500009663,22803.029900009627,22188.58780000819,67432.60236599125,157991.7430954667,126064.80858613488,34990.29460002791,34930.65780002835,34376.716800028764,22947.24819999592,22920.504799995488,22567.789699995723,3713019.0,8293.313300000169,8397.80770000008,8121.4132000002255,9815.098300000718,9930.017000002155,10289.614899999648,16463.357499999747,16648.571699999695,16245.328899999697,828.5428000001759,813.7187000000459,759.6894000000133,3913.045400000125,3896.2040000001616,3728.8249000001592,436335.0,431132.0,1262633.0,6423.043182002895,631763.0,625315.0,,16327.997899999797,154131.62309999054,154134.37169999012,154026.14339998714,77587.21319999624,77924.9333000066,78326.2868000065,19.0,30974804.415,9625781.475,3289165808.039998,1091718552.8250003,40880233.03499999,638619.57,61.0,8639.0,-10714156.0,5069339.0,-5516878.0,-5955382.0,-9.0,0.0,6912.0,270000.0,0.0,0.0,0.0,0.0,0.0,-1006.0,-514.0,-459.0,-514.0,120739439.15999985,1722853007.2350016,1943883530.28,27959260.45499999,1722853007.2350016,125875.0,-8685621.0,2007370605.0,85802520.0,439540446.0,200591738.0,459782816.0,124956.0,1992.0,347.9805616270485,3068177.5,1042039.0,637712.0,-2083297.0,721126.0,97581.0,1389746257.335002,1397769606.2699928,-85810525.0,-85105216.0,1590608.0,69186.5,1349310606.7050009,3537463500.0,115541187.57,180789867.1799997,7674564.6000000015,57438828.62999996,76993058.74499997,196621610.5799998,181528513.65000013,1294945406.4600005,1343966350.41,1344021522.3450005,5904.0,14939.0,105.0,8930.0,444753.0,-785536.0,274751.0,754.0,1466909.0,14761516.0,3231305.0,8552405.0,11604265.0,1415177.0,1058213208.739501,801583826.827495,72083714807.87962,21672151271.43762,582232869.791999,5792665.7475,689.5,94245.0,-276839737.5,21938046.5,-123753363.5,-218637172.5,-2016995.0,5920428311.347462,18715218750.0,198760895.325,447827900.1524977,1948107.735,256656172.8600008,308996081.3924987,636343618.319998,458992758.0599993,5705660452.635032,5883724576.147499,5883967758.8925,13378.0,80812.0,44.0,70327.5,971188.5,-1697795.0,177364.0,6755.0,4271575.5,2478457.5,-9000710.0,921269.0,37582.5,3732224556.6674623,3656792926.529961,-260545834.5,-257235909.5,2525808.5,269110.0,3924826235.932455,33245094740.37841,36673406186.04014,1728880929.832549,48067740976.54572,3986750.0,-247514652.5,103053158142.5,1053351106.0,17267525163.0,3502462205.0,18881544676.5,3670901.5,71894.5,20864.177079502577,89774221.0,-42.906641646002285,1.08635,13.637913399249914,557.5104269320766,14.815547221275144,605.6514522976613,45000.0,-0.9009688679024191,0.4338837391175582,0.0,0.0,0.0,0.0,0.0,0.0,1.0,0.0,0.0,0.0,0.0,0.0,0.0,1.0,0.0,1.0,0.0,0.0,0.0,0.0,1.0,0.0,0.0,0.0,0.0,1.0,0.0,0.0,0.0,0.0,0.0,0.0,0.0,0.0,0.0,0.0,0.0,0.0,1.0,0.0,0.0,0.0,0.0,0.0,0.0,0.0,0.0,0.0,0.0,0.0,0.0,0.0,0.0,1.0,0.0,0.0,0.0,0.0,0.0,0.0,0.0,0.0,0.0,0.0,0.0,0.0,0.0,0.0,0.0,0.0,0.0,0.0,0.0,0.0,0.0,0.0,0.0,0.0,0.0,0.0,0.0,0.0,0.0,0.0,0.0,0.0,0.0,0.0,0.0,0.0,0.0,0.0,0.0,0.0,0.0,0.0,0.0,0.0,0.0,0.0,0.0,0.0,0.0,0.0,0.0,0.0,0.0,0.0,0.0,1.0,1.0,0.0,0.0,0.0,0.0,0.0,0.0,0.0,1.0,0.0
102070,0,0.0,0.0,0.0,1.0,0.0,247500.0,1107612.0,47677.5,990000.0,0.009175,37.42191780821918,-996.0,-4740.0,-4774.0,,2.0,2.0,2.0,14.0,0.4839292853811105,0.6168130371083316,0.3539876078507373,0.0928,0.156,0.9826,,,0.0,0.2069,0.1667,,0.0365,,0.0911,,0.0,0.0945,0.1619,0.9826,,,0.0,0.2069,0.1667,,0.0373,,0.095,,0.0,0.0937,0.156,0.9826,,,0.0,0.2069,0.1667,,0.0371,,0.0928,,0.0,0.0801,1.0,0.0,0.0,0.0,0.0,-1.0,0.0,0.0,0.0,0.0,0.0,0.0,1.0,1.0,1.0,1.0,0.0,0.0,1.0,1.0,0.0,1.0,1.0,0.0,0.0,0.0,0.0,0.0,0.0,0.0,0.0,0.0,0.0,1.0,0.0,0.0,0.0,0.0,0.0,0.0,0.0,0.0,0.0,0.0,3.0,0.0,,17775.0,0.0,,0.0,0.0,0.0,-1761.0,-1058.0,-13.0,-1517.0,178.0,-31.0,0.0,,,,,,,,,,,,,,,,,0.0,,,,,,0.0,,,,,,,0.0,,,,,,,,,,,,,,,,,,,,,8344109263.5,184350817975.5,165541658197.5,51955873957.935,1863.0,1705.0,71125.0,70772.0,9140.0,505881.0,17803.218900002295,17865.37329999912,17316.915399998055,11292.757200000087,11230.57550000009,11177.848900000055,128375.0,662611.0,,,,13523662.967122888,-601669093.0,-921622802.0,-296408992.0,-1534673886.0416667,44002.0,30697.0,11346.46879999918,11222.439999998973,10706.7956999973,22881.360400009668,22803.236800009632,22188.794700008188,67433.08629527662,157992.3599085038,126065.16257374274,34990.46130002791,34930.82450002835,34376.883500028765,,,,3713033.0,8293.349800000171,8397.844800000079,8121.4505000002255,,,,16463.448599999752,16648.664499999693,16245.423899999698,,,,3913.045400000125,3896.2040000001616,3728.8249000001592,436335.0,431132.0,,6423.052357002895,631765.0,625317.0,,16328.077999999796,154132.60569999056,154135.3542999901,154027.12599998713,,,,58.0,31459602.915,,3298774633.1549983,1099526970.8250003,,638619.57,61.0,8639.0,-10735223.0,5061583.0,-5525346.0,-5966566.0,-28.5,0.0,,17775.0,0.0,,0.0,0.0,0.0,-2843.0,-2661.0,-13.0,-2674.0,,,,,,,,,,,,,,,,,,,,,,,,,,,,,,,,,,,,,,,,,,,,,,,,1466912.0,14761694.0,3231305.0,8552405.0,11604265.0,1415177.0,1058213208.739501,,72083732582.87962,21672151271.43762,,5792665.7475,689.5,94245.0,-276841498.5,21936988.5,-123753376.5,-218638689.5,-2017026.0,,,,,,,,,,,,,,,,,,,,,,,,,,,,,,,,,,,,,,,,,,,,,,,,-26.615418405446963,4.4752,5.191127890514394,194.26196125078383,23.231335535630013,869.3611289895077,123750.0,-0.2225209339563143,0.9749279121818236,0.0,0.0,0.0,0.0,0.0,0.0,1.0,0.0,0.0,0.0,0.0,0.0,0.0,1.0,0.0,1.0,0.0,0.0,0.0,0.0,1.0,0.0,0.0,0.0,0.0,1.0,0.0,0.0,0.0,0.0,0.0,0.0,0.0,0.0,0.0,0.0,0.0,0.0,0.0,0.0,1.0,0.0,0.0,0.0,0.0,0.0,0.0,0.0,0.0,0.0,0.0,0.0,0.0,0.0,0.0,0.0,0.0,0.0,0.0,0.0,0.0,0.0,0.0,0.0,0.0,0.0,0.0,0.0,0.0,0.0,0.0,0.0,0.0,0.0,0.0,0.0,0.0,0.0,0.0,0.0,0.0,0.0,0.0,0.0,0.0,0.0,0.0,0.0,0.0,0.0,0.0,0.0,0.0,0.0,0.0,1.0,0.0,0.0,0.0,0.0,0.0,0.0,0.0,0.0,0.0,0.0,0.0,0.0,0.0,0.0,1.0,0.0,0.0,0.0,0.0,0.0,0.0,1.0,0.0,0.0
102090,0,0.0,0.0,0.0,0.0,0.0,90000.0,360000.0,18378.0,360000.0,0.0196889999999999,64.27123287671233,,-4140.0,-4731.0,,1.0,2.0,2.0,15.0,,0.1241829074405064,0.6178261467332483,0.0165,0.0,0.9876,0.83,0.0042,0.0,0.069,0.0417,0.0833,0.0117,0.0134,0.0219,0.0,0.0,0.0168,0.0,0.9876,0.8367,0.0043,0.0,0.069,0.0417,0.0833,0.0119,0.0147,0.0228,0.0,0.0,0.0167,0.0,0.9876,0.8323,0.0042,0.0,0.069,0.0417,0.0833,0.0119,0.0137,0.0223,0.0,0.0,0.0195,1.0,0.0,0.0,0.0,0.0,-7.0,0.0,0.0,0.0,0.0,1.0,0.0,1.0,0.0,0.0,1.0,1.0,0.0,0.0,0.0,0.0,1.0,0.0,0.0,0.0,1.0,0.0,0.0,0.0,0.0,0.0,0.0,0.0,0.0,0.0,0.0,0.0,0.0,0.0,0.0,0.0,0.0,0.0,0.0,1.0,0.0,,98113.5,0.0,0.0,0.0,0.0,0.0,-441.0,-263.0,-97.0,-102.0,15.0,-7.0,1.0,5611.41,57600.0,57600.0,0.0,57600.0,12.0,-260.0,365243.0,-230.0,365243.0,100.0,365243.0,8.0,0.0,0.0,85.0,8.0,12.0,8.5,-5.5,0.0,0.0,8.0,5611.41,5611.41,-139.5,-125.0,4.5,1.0,0.0,,,,,,,,,,,,,,,,,,,,,8344127641.5,184351177975.5,165542018197.5,51955963957.935,1863.0,1705.0,71125.0,70773.0,9140.0,505881.0,17803.235400002293,17865.38999999912,17316.932199998057,11292.757200000087,11230.57550000009,11177.848900000055,128375.0,662612.0,4136.8595000001205,4134.528000000016,3945.1537000000953,13523727.238355763,,-921627533.0,-296408999.0,-1534678026.0416667,44002.0,30697.0,11346.46879999918,11222.439999998973,10706.7956999973,22881.429400009667,22803.305800009628,22188.863700008187,,157992.48409141126,126065.78039988944,34990.503000027915,34930.86620002835,34376.92520002877,22947.331499995908,22920.58809999549,22567.87299999572,3713048.0,8293.361500000168,8397.856700000078,8121.462400000227,9815.111700000718,9930.030700002157,10289.62959999965,16463.470499999752,16648.686799999694,16245.446699999697,828.5428000001759,813.7187000000459,759.6894000000133,3913.045400000125,3896.2040000001616,3728.8249000001592,436335.0,431132.0,,6423.072046002895,631767.0,625319.0,,16328.097499999794,154133.59329999055,154136.3418999901,154028.11359998712,77588.04319999625,77925.76560000659,78327.1235000065,15.0,31711026.465,,3343820093.8199983,1121008667.8950007,40949910.89999999,638619.57,61.0,8639.0,-10847692.0,5069289.0,-5585618.0,-6036208.0,-7.0,0.0,,98113.5,0.0,0.0,0.0,0.0,0.0,-441.0,-263.0,-97.0,-102.0,121982408.6399998,1743664629.6000016,1967556729.78,28273090.31999999,1743664629.6000016,127416.0,-8813402.0,2032205994.0,86076042.0,442390926.0,201256273.0,462633743.0,126577.0,2004.0,353.3787198079552,3103655.0,1052481.0,643919.5,-2111471.0,721218.0,97626.0,1405185318.0000074,1412744084.0099988,-86724302.0,-86007226.0,1598466.5,69953.5,,,,,,,,,,,,,,,,,,,,,1466913.0,14761709.0,3231305.0,8552413.0,11604273.0,1415178.0,1058213208.739501,,72083830696.37962,21672151271.43762,582232869.791999,5792665.7475,689.5,94245.0,-276841939.5,21936725.5,-123753473.5,-218638791.5,-2017033.0,,,,,,,,,,,,,,,,,,,,,4271587.5,2478466.0,-9000715.5,921269.0,37582.5,3732230168.0774617,3656798537.939961,-260545974.0,-257236034.5,2525813.0,269111.0,3924831847.342455,33245152340.37841,36673463786.04014,1728880929.832549,48067798576.54572,3986762.0,-247514912.5,103053523385.5,1053350876.0,17267890406.0,3502462305.0,18881909919.5,3670909.5,71894.5,20864.177079502577,89774306.0,,4.0,4.897159647404505,314.74648813277344,19.58863858961802,1258.9859525310935,90000.0,1.0,0.0,0.0,0.0,0.0,0.0,0.0,0.0,1.0,0.0,0.0,1.0,0.0,0.0,0.0,0.0,0.0,0.0,0.0,0.0,1.0,0.0,0.0,0.0,0.0,1.0,0.0,1.0,0.0,0.0,0.0,0.0,0.0,0.0,0.0,0.0,0.0,0.0,0.0,0.0,0.0,0.0,0.0,0.0,0.0,0.0,0.0,0.0,0.0,0.0,0.0,0.0,0.0,0.0,0.0,0.0,0.0,0.0,0.0,0.0,0.0,0.0,0.0,0.0,0.0,0.0,0.0,0.0,0.0,0.0,0.0,0.0,0.0,0.0,0.0,0.0,0.0,0.0,0.0,0.0,0.0,0.0,0.0,0.0,0.0,0.0,0.0,0.0,0.0,0.0,0.0,0.0,0.0,0.0,0.0,0.0,0.0,0.0,0.0,0.0,0.0,0.0,0.0,0.0,0.0,0.0,0.0,1.0,0.0,0.0,1.0,0.0,1.0,0.0,0.0,0.0,0.0,0.0,0.0,0.0,0.0,1.0
102092,0,0.0,1.0,0.0,0.0,0.0,180000.0,88618.5,10021.5,76500.0,0.026392,23.682191780821924,-1310.0,-3080.0,-1300.0,,1.0,2.0,2.0,17.0,,0.5741132245686112,0.3723336657058204,,,,,,,,,,,,,,,,,,,,,,,,,,,,,,,,,,,,,,,,,,,,,1.0,0.0,0.0,0.0,-1082.0,0.0,0.0,0.0,0.0,1.0,2.0,1.0,1.0,0.0,1.0,0.0,0.0,0.0,0.0,0.0,1.0,1.0,0.0,0.0,1.0,0.0,0.0,0.0,0.0,0.0,0.0,0.0,0.0,0.0,0.0,0.0,0.0,0.0,0.0,0.0,0.0,0.0,0.0,3.0,0.0,0.0,32985.0,0.0,0.0,0.0,0.0,0.0,-454.0,-42.0,-59.0,-730.0,49.0,-9.0,6.0,6000.21,55660.5,50260.5,0.0,58824.0,12.0,-276.5,365243.0,-457.0,-187.0,-127.0,-185.0,19.0,0.0,0.0,40.5,25.0,12.0,11.0,-10.0,0.0,0.0,28.0,4442.31,4442.31,-285.0,-282.5,4.5,1.0,0.0,,,,,,,,,,,,,,,,,,,,,8344137663.0,184351266594.0,165542094697.5,51956143957.935,1863.0,1705.0,71125.0,70774.0,9140.0,505883.0,,,,,,,128375.0,662613.0,,,,13523750.920547549,-601670403.0,-921628833.0,-296410081.0,-1534681106.0416667,44002.0,30697.0,,,,,,,,157993.0582046358,126066.15273355517,,,,,,,3713065.0,,,,,,,,,,,,,,,,436336.0,431132.0,,6423.098438002896,631769.0,625321.0,,,,,,,,,15.0,31836201.524999995,9652427.145,3350297779.919998,1126065952.3950007,41030010.89999999,638619.57,61.0,8639.0,-10858901.0,5068402.0,-5591331.0,-6042887.0,-7.0,0.0,0.0,20650.5,0.0,0.0,0.0,0.0,0.0,-822.0,-730.0,-724.0,-730.0,122009290.8749998,1743936804.9450016,1967790529.53,28311465.91499999,1743984156.1950016,127456.0,-8815427.5,2033301723.0,86074308.0,442754716.0,201255522.0,462997549.0,126654.5,2004.0,353.81446349578783,3104294.0,1052806.0,644177.0,-2111752.0,721218.0,97626.0,1405416304.237508,1412974920.4649992,-86731431.0,-86014039.5,1598566.5,69980.5,,,,,,,,,,,,,,,,,,,,,1466916.0,14761758.0,3231305.0,8552438.0,11604301.0,1415184.0,1058213208.739501,801583826.827495,72083863681.37962,21672151271.43762,582232869.791999,5792665.7475,689.5,94245.0,-276842393.5,21936683.5,-123753532.5,-218639521.5,-2017042.0,,,,,,,,,,,,,,,,,,,,,4271599.5,2478477.0,-9000725.5,921269.0,37582.5,3732234610.3874617,3656802980.24996,-260546259.0,-257236317.0,2525817.5,269112.0,3924837847.5524554,33245208000.87841,36673514046.54014,1728880929.832549,48067857400.54572,3986774.0,-247515189.0,103053888628.5,1053350419.0,17267890219.0,3502462178.0,18881909734.5,3670928.5,71894.5,20864.177079502577,89774346.5,-55.31582600647848,0.492325,17.96138302649304,425.3649174822077,8.842837898518185,209.4177829994279,180000.0,0.6234898018587336,0.7818314824680298,0.0,0.0,0.0,0.0,0.0,0.0,1.0,0.0,0.0,0.0,0.0,0.0,0.0,1.0,0.0,0.0,1.0,0.0,0.0,0.0,0.0,0.0,1.0,0.0,0.0,1.0,0.0,0.0,0.0,0.0,0.0,0.0,0.0,1.0,0.0,0.0,0.0,0.0,0.0,0.0,0.0,0.0,0.0,0.0,0.0,0.0,0.0,0.0,0.0,0.0,1.0,0.0,0.0,0.0,0.0,0.0,0.0,0.0,0.0,0.0,0.0,0.0,0.0,0.0,0.0,0.0,0.0,0.0,0.0,0.0,0.0,0.0,0.0,0.0,0.0,0.0,0.0,0.0,0.0,0.0,0.0,0.0,0.0,0.0,0.0,0.0,0.0,0.0,0.0,0.0,0.0,0.0,0.0,0.0,0.0,0.0,0.0,0.0,0.0,0.0,0.0,0.0,0.0,0.0,0.0,0.0,0.0,0.0,0.0,0.0,0.0,0.0,0.0,0.0,0.0,0.0,0.0,0.0,0.0,0.0
102099,0,0.0,1.0,1.0,1.0,0.0,157500.0,247500.0,19683.0,247500.0,0.026392,25.235616438356168,-926.0,-9211.0,-1690.0,11.0,2.0,2.0,2.0,13.0,,0.5671267292517002,0.3656165070113335,,,,,,,,,,,,,,,,,,,,,,,,,,,,,,,,,,,,,,,,,,,,,0.0,0.0,0.0,0.0,-965.0,0.0,0.0,0.0,0.0,0.0,2.0,1.0,1.0,0.0,1.0,0.0,0.0,0.0,0.0,0.0,1.0,1.0,0.0,0.0,1.0,0.0,0.0,0.0,0.0,0.0,0.0,0.0,0.0,0.0,0.0,0.0,0.0,0.0,0.0,0.0,0.0,0.0,0.0,3.0,,,66483.0,262925.48250000004,18045.0,0.0,0.0,0.0,-341.0,756.0,-65.0,,39.0,-7.0,2.0,3754.5975,74664.0,80561.25,0.0,74664.0,12.0,-577.0,365243.0,182349.0,365243.0,182694.0,365243.0,20.0,0.0,0.0,5000.0,19.0,24.0,15.0,-10.0,0.0,0.0,21.0,5259.195,5259.195,-294.0,-275.0,10.0,2.0,19.0,0.0,135000.0,,0.0,,,0.0,,0.0,0.0,0.0,0.0,,0.0,,,0.0,-10.0,0.0,0.0,8344157346.0,184351514094.0,165542342197.5,51956301457.935,1863.0,1705.0,71125.0,70774.0,9140.0,505885.0,,,,,,,128375.0,662615.0,,,,13523776.156163985,-601671329.0,-921630523.0,-296411046.0,-1534690317.0416667,44002.0,30697.0,,,,,,,,157993.62533136507,126066.51835006216,,,,,,,3713078.0,,,,,,,,,,,,,,,,436336.0,431132.0,1262644.0,6423.124830002896,631771.0,625323.0,,,,,,,,,12.0,,,3365176629.149998,1129115824.5375006,41696980.15499999,638619.57,61.0,8639.0,-10901664.0,5189762.0,-5608181.0,,-5.5,,,66483.0,498895.965,18045.0,0.0,0.0,0.0,-681.0,-318.0,-406.0,,122529268.46249975,1749674563.6950016,1973723433.03,28554632.41499999,1749674563.6950016,127998.0,-8871248.5,2044806877.5,87130825.5,445096997.5,201957092.5,465340011.5,127281.0,2017.0,356.36744106184136,3120494.0,1056882.0,646614.0,-2125242.0,721263.0,97668.0,1409092144.6050117,1416516425.100006,-87322256.0,-86601021.0,1606757.0,70379.0,1359870846.6150012,3570376500.0,,183677169.5549997,,,77500849.99499996,,184337784.8550001,1305081648.9900005,1354460066.505,1354515238.4400003,,15106.0,,,446720.0,-792120.0,274754.0,757.0,1466919.0,14761797.0,3231324.0,8552457.0,11604322.0,1415186.0,,,72083930164.37962,21672414196.92012,582250914.791999,5792665.7475,689.5,94245.0,-276842734.5,21937439.5,-123753597.5,,-2017049.0,5920428311.347462,18715353750.0,,447827900.1524977,,,308996081.3924987,,458992758.0599993,5705660452.635032,5883724576.147499,5883967758.8925,,80812.0,,,971188.5,-1697805.0,177364.0,6755.0,4271623.5,2478492.0,-9000735.5,921269.0,37582.5,3732239869.5824623,3656808239.444961,-260546553.0,-257236592.0,2525827.5,269114.0,3924841602.149955,33245282664.87841,36673594607.79014,1728880929.832549,48067932064.54572,3986786.0,-247515766.0,103054253871.5,1053532768.0,17268255462.0,3502644872.0,18882274977.5,3670948.5,71894.5,20864.177079502577,89779346.5,-36.69417001411357,1.5714285714285714,8.001828989483311,201.93108718392,12.574302697759489,317.3202798604456,78750.0,1.0,0.0,0.0,0.0,0.0,0.0,0.0,0.0,0.0,0.0,0.0,0.0,0.0,0.0,0.0,1.0,0.0,0.0,0.0,0.0,1.0,0.0,1.0,0.0,0.0,0.0,0.0,1.0,0.0,0.0,0.0,0.0,0.0,0.0,0.0,0.0,0.0,0.0,0.0,0.0,1.0,0.0,0.0,0.0,0.0,0.0,0.0,0.0,0.0,0.0,0.0,0.0,0.0,0.0,0.0,1.0,0.0,0.0,0.0,0.0,0.0,0.0,0.0,0.0,0.0,0.0,0.0,0.0,0.0,0.0,0.0,0.0,0.0,0.0,0.0,0.0,0.0,0.0,0.0,0.0,0.0,0.0,0.0,0.0,0.0,0.0,0.0,0.0,0.0,0.0,0.0,0.0,0.0,0.0,0.0,0.0,0.0,0.0,0.0,0.0,0.0,0.0,0.0,0.0,0.0,0.0,0.0,0.0,0.0,0.0,0.0,0.0,0.0,0.0,0.0,0.0,0.0,0.0,0.0,0.0,0.0,0.0
102100,0,0.0,0.0,1.0,1.0,1.0,382500.0,2156400.0,67063.5,1800000.0,0.072508,45.24109589041096,-593.0,-10134.0,-27.0,3.0,3.0,1.0,1.0,13.0,0.3939247632456177,0.6732177687416366,0.4974688893052743,0.1134,0.2155,0.9563,,,0.0,0.2759,0.1667,,0.1018,,0.1333,,0.0794,0.1155,0.2236,0.9563,,,0.0,0.2759,0.1667,,0.1041,,0.1389,,0.084,0.1145,0.2155,0.9563,,,0.0,0.2759,0.1667,,0.1035,,0.1357,,0.081,0.1374,1.0,1.0,0.0,1.0,0.0,-475.0,0.0,0.0,0.0,0.0,0.0,1.0,1.0,1.0,0.0,1.0,0.0,1.0,0.0,0.0,0.0,0.0,0.0,0.0,0.0,1.0,0.0,0.0,0.0,0.0,0.0,0.0,0.0,0.0,0.0,0.0,0.0,0.0,0.0,0.0,0.0,0.0,0.0,0.0,1.0,,0.0,211208.4,0.0,0.0,0.0,0.0,0.0,-268.0,,-87.0,-89.0,9.0,-4.0,1.0,5708.205,70691.535,56556.0,14135.535,70691.535,12.0,-475.0,365243.0,-439.0,-139.0,-109.0,-136.0,21.0,0.0,0.2177754757148272,20.0,13.0,12.0,6.5,-10.0,0.0,0.0,11.0,5708.205,5708.205,-293.0,-289.0,6.0,1.0,0.0,,,,,,,,,,,,,,,,,,,,,8344224409.5,184353670494.0,165544142197.5,51956683957.935,1863.0,1705.0,71125.0,70774.0,9140.0,505886.0,17803.348800002295,17865.50449999912,17317.047699998056,11292.972700000088,11230.79100000009,11178.072500000057,128376.0,662618.0,,,,13523821.397259874,-601671922.0,-921630550.0,-296411521.0,-1534700451.0416667,44002.0,30697.0,11346.46879999918,11222.439999998973,10706.7956999973,22881.705300009668,22803.581700009632,22189.139600008188,67433.48022003987,157994.29854913382,126067.01581895148,34990.66970002792,34931.03290002835,34377.09190002876,,,,3713091.0,8293.463300000169,8397.960200000078,8121.5665000002255,,,,16463.60379999975,16648.822499999693,16245.585599999697,,,,3913.124800000125,3896.2850000001617,3728.90890000016,436337.0,431133.0,1262647.0,6423.197338002896,631772.0,625324.0,,16328.234899999796,154134.54959999054,154137.2981999901,154029.0698999871,,,,9.0,,9696361.995,3365454320.5499983,1129365272.5200007,41696980.15499999,638619.57,61.0,8639.0,-10902613.0,,-5608674.0,-6057211.0,-4.0,,0.0,211208.4,0.0,0.0,0.0,0.0,0.0,-268.0,,-87.0,-89.0,122537606.26499976,1749797419.2300014,1973838050.28,28568767.94999999,1749797419.2300014,128022.0,-8872012.0,2045354742.0,87130114.0,445279480.0,201957056.0,465522497.0,127312.0,2017.0,356.58521653755616,3123014.0,1057176.0,646754.0,-2125367.0,721263.0,97668.0,1409171397.480011,1416595066.2000055,-87326541.0,-86604995.0,1606910.0,70408.0,,,,,,,,,,,,,,,,,,,,,1466920.0,14761806.0,3231324.0,8552470.0,11604333.0,1415187.0,,801583826.827495,72084141372.77963,21672414196.92012,582250914.791999,5792665.7475,689.5,94245.0,-276843002.5,,-123753684.5,-218639610.5,-2017053.0,,,,,,,,,,,,,,,,,,,,,4271635.5,2478498.5,-9000745.5,921269.0,37582.5,3732245577.7874618,3656813947.649961,-260546846.0,-257236881.0,2525833.5,269115.0,3924847310.3549542,33245353356.41341,36673651163.79014,1728895065.3675494,48068002756.08071,3986798.0,-247516241.0,103054619114.5,1053532329.0,17268255323.0,3502644763.0,18882274841.5,3670969.5,71894.5,20864.39485497829,89779366.5,-13.107551625991643,5.6376470588235295,5.703549620881701,258.0348353140261,32.154599745017784,1454.7093303821334,127500.0,-0.2225209339563143,0.9749279121818236,0.0,1.0,0.0,0.0,0.0,0.0,0.0,0.0,1.0,0.0,0.0,0.0,0.0,0.0,0.0,1.0,0.0,0.0,0.0,0.0,1.0,0.0,0.0,0.0,0.0,1.0,0.0,0.0,0.0,0.0,0.0,0.0,1.0,0.0,0.0,0.0,0.0,0.0,0.0,0.0,0.0,0.0,0.0,0.0,0.0,0.0,0.0,0.0,0.0,0.0,0.0,0.0,0.0,0.0,0.0,0.0,0.0,0.0,0.0,0.0,0.0,0.0,0.0,0.0,0.0,0.0,0.0,0.0,0.0,0.0,0.0,0.0,0.0,0.0,0.0,0.0,0.0,0.0,0.0,0.0,0.0,0.0,0.0,0.0,0.0,0.0,0.0,0.0,0.0,0.0,0.0,0.0,0.0,0.0,0.0,0.0,0.0,0.0,0.0,0.0,0.0,0.0,0.0,1.0,0.0,0.0,0.0,0.0,0.0,0.0,1.0,0.0,0.0,0.0,0.0,0.0,0.0,0.0,1.0,0.0
102112,0,0.0,0.0,0.0,1.0,0.0,180000.0,632664.0,46165.5,540000.0,0.010276,30.736986301369864,-636.0,-5328.0,-1906.0,,1.0,2.0,2.0,12.0,0.4173604699821021,0.7033031841404925,,,,,,,,,,,,,,,,,,,,,,,,,,,,,,,,,,,,,,,,,,,,,,1.0,0.0,1.0,0.0,-579.0,,,,,,,1.0,1.0,0.0,1.0,0.0,0.0,0.0,0.0,0.0,0.0,0.0,0.0,0.0,1.0,0.0,0.0,0.0,0.0,0.0,0.0,0.0,0.0,0.0,0.0,0.0,0.0,0.0,0.0,0.0,0.0,0.0,0.0,0.0,,,,,,,,,,,,,0.0,,10.0,18510.7725,195727.5,233547.75,9000.0,450000.0,54.0,-505.0,365243.0,-1512.5,-1452.5,-702.5,-1448.0,15.0,1.0,0.29760647877877,-1.0,8.0,4.0,2.5,-78.5,0.0,0.0,6.0,11009.5875,11009.5875,-2405.5,-2401.0,2.0,1.0,0.0,,,,,,,,,,,,,,,,,,,,,8344270575.0,184354303158.0,165544682197.5,51956863957.935,,,,,,,,,,,,,128376.0,662619.0,,,,13523852.134246178,-601672558.0,-921632456.0,-296412100.0,-1534705779.0416667,44002.0,30697.0,,,,,,,67433.89758050986,157995.00185231795,,,,,,,,3713103.0,,,,,,,,,,,,,,,,436338.0,431134.0,,6423.207614002896,631774.0,625326.0,,,,,,,,,,,,,,,,,,,,,,,,,,,,,,,,,,,123352515.58499973,1761937585.3800015,1987730290.08,28725927.29999999,1761712585.3800015,128838.0,-8934466.0,2057585840.5,87453607.5,447439636.5,203762012.5,468050908.5,128174.0,2028.5,359.24180902166825,3152307.5,1066452.0,652503.0,-2138463.0,721282.0,97683.0,1420342869.7125158,1428344152.222509,-87914655.5,-87188441.0,1618167.5,71180.5,,,,,,,,,,,,,,,,,,,,,1466920.0,14761806.0,3231324.0,8552478.0,11604339.0,1415197.0,,,,,,,,,,,,,,,,,,,,,,,,,,,,,,,,,,4271639.5,2478501.0,-9000824.0,921269.0,37582.5,3732256587.374962,3656824957.237461,-260549251.5,-257239282.0,2525835.5,269116.0,3924865821.127455,33245549083.91341,36673884711.54014,1728904065.3675494,48068452756.08071,3986852.0,-247516746.0,103054984357.5,1053530816.5,17268253870.5,3502644060.5,18882273393.5,3670984.5,71895.5,20864.692461457067,89779365.5,-20.691683750779926,3.5148,3.899015498586607,119.8439859688853,13.704259674432206,421.227641883438,180000.0,-0.2225209339563146,-0.9749279121818236,0.0,0.0,0.0,0.0,0.0,0.0,1.0,0.0,0.0,0.0,0.0,0.0,0.0,1.0,0.0,0.0,0.0,0.0,1.0,0.0,0.0,0.0,1.0,0.0,0.0,1.0,0.0,0.0,0.0,0.0,0.0,0.0,1.0,0.0,0.0,0.0,0.0,0.0,0.0,0.0,0.0,0.0,0.0,0.0,0.0,0.0,0.0,0.0,0.0,0.0,0.0,0.0,0.0,0.0,0.0,0.0,0.0,0.0,0.0,0.0,0.0,0.0,0.0,0.0,0.0,0.0,0.0,0.0,0.0,0.0,0.0,0.0,0.0,0.0,0.0,0.0,1.0,0.0,0.0,0.0,0.0,0.0,0.0,0.0,0.0,0.0,0.0,0.0,0.0,0.0,0.0,0.0,0.0,0.0,0.0,0.0,0.0,0.0,0.0,0.0,0.0,0.0,0.0,0.0,0.0,0.0,0.0,0.0,0.0,0.0,0.0,0.0,0.0,0.0,0.0,0.0,0.0,0.0,0.0,0.0
102113,0,0.0,0.0,0.0,0.0,1.0,112500.0,202500.0,10467.0,202500.0,0.00823,27.682191780821924,-313.0,-4639.0,-2772.0,,2.0,2.0,2.0,16.0,0.4144400724810068,0.5394779959139062,0.6109913280868294,,,,,,,,,,,,,,,,,,,,,,,,,,,,,,,,,,,,,,,,,,,,,2.0,0.0,2.0,0.0,-11.0,0.0,0.0,0.0,0.0,0.0,0.0,1.0,1.0,0.0,1.0,0.0,1.0,0.0,0.0,0.0,0.0,0.0,0.0,0.0,1.0,0.0,0.0,0.0,0.0,0.0,0.0,0.0,0.0,0.0,0.0,0.0,0.0,0.0,0.0,0.0,0.0,0.0,0.0,3.0,0.0,0.0,81270.0,0.0,0.0,0.0,0.0,0.0,-1129.0,-945.0,-975.0,-975.0,103.0,-17.0,3.0,7870.5,0.0,0.0,8748.0,87453.0,12.0,-527.0,365243.0,-992.0,-662.0,-662.0,-654.0,13.0,0.0,0.1089427152039068,-1.0,13.0,12.0,6.0,-28.0,0.0,0.0,12.0,7870.5,7870.5,-839.5,-827.0,6.5,1.0,0.0,,,,,,,,,,,,,,,,,,,,,8344281042.0,184354505658.0,165544884697.5,51956976457.935,1863.0,1705.0,71125.0,70774.0,9140.0,505886.0,,,,,,,128377.0,662621.0,,,,13523879.81643796,-601672871.0,-921635228.0,-296412111.0,-1534710418.0416667,44002.0,30697.0,,,,,,,67434.31202058234,157995.54133031383,126067.62681027954,,,,,,,3713119.0,,,,,,,,,,,,,,,,436340.0,431136.0,,6423.215844002895,631776.0,625328.0,,,,,,,,,37.0,32067374.759999994,9838957.545000002,3407139564.1649985,1139415650.9550006,42088138.60499999,638619.57,63.0,8639.0,-11004118.0,5188665.0,-5667970.0,-6118063.0,-19.0,0.0,0.0,81270.0,0.0,0.0,0.0,0.0,0.0,-1129.0,-945.0,-975.0,-975.0,123415810.8299997,1762938538.3800015,1988899862.58,28734675.29999999,1762938538.3800015,128982.0,-8938411.0,2058133705.0,87452341.0,447438715.0,203761781.0,468049996.0,128271.0,2029.0,359.35075173687216,3152353.0,1066636.0,652646.0,-2138758.0,721282.0,97683.0,1420982138.4750154,1428983420.9850082,-87922297.0,-87195950.0,1618219.0,71190.5,,,,,,,,,,,,,,,,,,,,,1466923.0,14761909.0,3231324.0,8552491.0,11604351.0,1415200.0,1058213208.739501,801583826.827495,72084222642.77963,21672414196.92012,582250914.791999,5792665.7475,689.5,94245.0,-276844131.5,21936494.5,-123754659.5,-218640585.5,-2017070.0,,,,,,,,,,,,,,,,,,,,,4271651.5,2478507.0,-9000852.0,921269.0,37582.5,3732264457.874962,3656832827.737461,-260550091.0,-257240109.0,2525842.0,269117.0,3924873691.627455,33245549083.91341,36673884711.54014,1728912813.3675494,48068540209.08071,3986864.0,-247517273.0,103055349600.5,1053529824.5,17268253208.5,3502643398.5,18882272739.5,3670997.5,71895.5,20864.801404172274,89779364.5,-11.306908155186065,1.8,10.748065348237317,297.53000624271186,19.34651762682717,535.5540112368815,56250.0,-0.2225209339563143,0.9749279121818236,0.0,0.0,0.0,0.0,0.0,0.0,1.0,0.0,0.0,0.0,0.0,0.0,0.0,1.0,0.0,1.0,0.0,0.0,0.0,0.0,0.0,0.0,1.0,0.0,0.0,1.0,0.0,0.0,0.0,0.0,0.0,0.0,0.0,0.0,0.0,0.0,0.0,0.0,0.0,0.0,0.0,0.0,0.0,0.0,1.0,0.0,0.0,0.0,0.0,0.0,0.0,0.0,0.0,0.0,0.0,0.0,0.0,0.0,0.0,0.0,0.0,0.0,0.0,0.0,0.0,0.0,0.0,0.0,0.0,0.0,0.0,0.0,0.0,0.0,0.0,0.0,0.0,0.0,0.0,0.0,0.0,0.0,0.0,0.0,0.0,0.0,0.0,0.0,0.0,0.0,0.0,0.0,0.0,0.0,0.0,0.0,0.0,0.0,0.0,1.0,0.0,0.0,0.0,0.0,0.0,0.0,0.0,0.0,0.0,0.0,0.0,0.0,0.0,0.0,0.0,0.0,0.0,0.0,0.0,0.0
102122,0,0.0,0.0,1.0,1.0,0.0,180000.0,454500.0,36040.5,454500.0,0.015221,53.32328767123288,-7698.0,-9544.0,-2985.0,18.0,1.0,2.0,2.0,8.0,,0.2762829076899659,0.2392262794694045,0.066,0.0801,0.9742,0.6464,,0.0,0.1379,0.0833,0.0417,,0.0504,0.0327,0.0154,0.0472,0.0672,0.0832,0.9742,0.6602,,0.0,0.1379,0.0833,0.0417,,0.0551,0.0341,0.0156,0.05,0.0666,0.0801,0.9742,0.6511,,0.0,0.1379,0.0833,0.0417,,0.0513,0.0333,0.0155,0.0482,0.0391,1.0,3.0,0.0,3.0,0.0,-315.0,0.0,0.0,0.0,0.0,2.0,0.0,1.0,1.0,0.0,1.0,0.0,0.0,0.0,0.0,0.0,1.0,0.0,1.0,0.0,1.0,0.0,0.0,0.0,0.0,0.0,0.0,0.0,0.0,0.0,0.0,0.0,0.0,0.0,0.0,0.0,0.0,0.0,0.0,12.0,15439.5,0.0,169593.75,0.0,0.0,0.0,0.0,0.0,-800.0,-165.0,-153.5,-445.5,386.0,-16.5,2.0,9373.2975,71406.0,73129.5,0.0,71406.0,10.0,-236.5,365243.0,-204.5,182586.0,65.5,182587.5,9.5,0.0,0.0,8.0,13.0,10.0,7.0,-5.0,0.0,0.0,12.0,5178.195,5178.195,-143.0,-129.5,3.5,1.0,0.0,,,,,,,,,,,,,,,,,,,,,8344317082.5,184354960158.0,165545339197.5,51957156457.935,1863.0,1705.0,71125.0,70776.0,9140.0,505886.0,17803.414800002294,17865.571099999117,17317.114899998058,11293.052800000089,11230.87110000009,11178.155700000054,128377.0,662622.0,,,,13523933.139725631,-601680569.0,-921638213.0,-296412426.0,-1534719962.0416667,44002.0,30697.0,11346.46879999918,11222.439999998973,10706.7956999973,22881.84320000968,22803.719600009637,22189.2775000082,,157995.81761322153,126067.86603655903,34990.753000027915,34931.11620002835,34377.17520002877,22947.37319999592,22920.629799995488,22567.914699995723,3713127.0,,,,9815.162100000718,9930.082000002156,10289.684699999649,16463.63649999975,16648.855799999692,16245.6196999997,828.5582000001759,813.7342000000459,759.7050000000131,3913.172000000125,3896.333200000162,3728.9589000001592,436343.0,431139.0,1262665.0,6423.231065002896,631778.0,625330.0,,16328.273999999796,154135.52379999054,154138.2723999901,154030.0440999871,77588.68959999624,77926.41670000661,78327.7837000065,27.0,32164092.45,9854599.410000002,3430455299.5499983,1145610377.9550006,42110835.11999999,638619.57,63.0,8639.0,-11070113.0,5182537.0,-5702106.5,-6156515.0,-13.0,15439.5,0.0,270000.0,0.0,0.0,0.0,0.0,0.0,-1063.0,-1145.0,-390.0,-1174.0,124231879.86749968,1770707025.6300015,1997456511.33,29136156.29999999,1770707025.6300015,129277.0,-8967106.5,2067811926.5,88160178.5,449611962.5,204476083.5,470223428.0,128757.0,2034.0,363.3125994325845,3155791.5,1068609.0,653705.0,-2145742.0,721316.0,97685.0,1424985550.1775107,1434213436.4775033,-88114861.5,-87385825.5,1619341.0,71421.5,,,,,,,,,,,,,,,,,,,,,1466935.0,14762295.0,3231324.0,8552504.0,11604363.0,1415202.0,1058228648.239501,801583826.827495,72084392236.52963,21672414196.92012,582250914.791999,5792665.7475,689.5,94245.0,-276844931.5,21936329.5,-123754813.0,-218641031.0,-2017086.5,,,,,,,,,,,,,,,,,,,,,4271661.5,2478514.0,-9000857.0,921269.0,37582.5,3732269636.0699625,3656838005.932461,-260550234.0,-257240238.5,2525845.5,269118.0,3924883064.924955,33245620489.91341,36673957841.04014,1728912813.3675494,48068611615.08071,3986874.0,-247517509.5,103055714843.5,1053529620.0,17268435794.5,3502643464.0,18882455327.0,3671007.0,71895.5,20864.801404172274,89779372.5,-144.36469197965368,2.525,4.99438132101386,266.3168319202541,12.610812835559996,672.4500005986416,180000.0,-0.9009688679024191,-0.433883739117558,0.0,0.0,0.0,0.0,0.0,0.0,1.0,0.0,0.0,0.0,0.0,0.0,0.0,1.0,0.0,0.0,0.0,0.0,1.0,0.0,0.0,1.0,0.0,0.0,0.0,1.0,0.0,0.0,0.0,0.0,0.0,0.0,0.0,0.0,0.0,0.0,0.0,0.0,0.0,0.0,1.0,0.0,0.0,0.0,0.0,0.0,0.0,0.0,0.0,0.0,0.0,0.0,0.0,0.0,0.0,0.0,0.0,0.0,0.0,0.0,0.0,0.0,0.0,0.0,0.0,0.0,0.0,0.0,0.0,0.0,0.0,0.0,0.0,0.0,0.0,0.0,0.0,0.0,0.0,0.0,0.0,0.0,0.0,0.0,0.0,0.0,0.0,0.0,0.0,0.0,1.0,0.0,0.0,0.0,0.0,0.0,0.0,0.0,0.0,0.0,0.0,0.0,0.0,0.0,0.0,0.0,0.0,0.0,1.0,0.0,1.0,0.0,0.0,0.0,0.0,0.0,0.0,0.0,1.0,0.0
102123,0,0.0,0.0,0.0,0.0,0.0,148500.0,1350000.0,41904.0,1350000.0,0.028663,62.53424657534247,-11015.0,-5057.0,-1635.0,,2.0,2.0,2.0,14.0,,0.1479713129493035,0.6956219298394389,0.0825,0.0841,0.9771,0.6532,0.0087,0.0,0.1724,0.1667,0.2083,0.0734,0.0672,0.0672,0.0039,0.0,0.084,0.0702,0.9747,0.6668,0.0088,0.0,0.1379,0.1667,0.2083,0.075,0.0735,0.0495,0.0039,0.0,0.0833,0.0841,0.9771,0.6578,0.0087,0.0,0.1724,0.1667,0.2083,0.0746,0.0684,0.0684,0.0039,0.0,0.0617,1.0,6.0,0.0,6.0,0.0,-539.0,0.0,0.0,0.0,0.0,0.0,2.0,1.0,1.0,1.0,1.0,1.0,0.0,0.0,0.0,0.0,0.0,0.0,0.0,0.0,0.0,0.0,0.0,1.0,0.0,0.0,0.0,0.0,0.0,0.0,0.0,0.0,0.0,0.0,0.0,0.0,0.0,0.0,0.0,8.0,0.0,0.0,580950.0,0.0,0.0,0.0,0.0,0.0,-1141.0,189.0,-484.0,-811.5,285.0,-17.0,2.0,31852.71,553500.0,620770.5,0.0,553500.0,36.0,-383.5,365243.0,-505.0,-175.0,-175.0,-173.0,16.5,0.0,0.0,2.0,13.0,12.0,6.0,-11.0,0.0,0.0,12.0,39902.85,39902.85,-360.0,-340.0,6.5,1.0,0.0,,,,,,,,,,,,,,,,,,,,,8344358986.5,184356310158.0,165546689197.5,51957304957.935,1863.0,1705.0,71125.0,70776.0,9140.0,505888.0,17803.497300002295,17865.654399999115,17317.198899998057,11293.136900000089,11230.95520000009,11178.225900000054,128377.0,662624.0,4136.868200000121,4134.536700000015,3945.162500000096,13523995.673972204,-601691584.0,-921639848.0,-296412965.0,-1534725019.0416667,44002.0,30697.0,11346.46879999918,11222.439999998973,10706.7956999973,22882.015600009672,22803.892000009637,22189.4154000082,,157995.96558453448,126068.56165848886,34990.91970002792,34931.28290002835,34377.34190002876,22947.581499995908,22920.83809999549,22568.12299999572,3713141.0,8293.536700000168,8398.034800000078,8121.641500000226,9815.229300000718,9930.150400002156,10289.75819999965,16463.70369999975,16648.924199999692,16245.669199999697,828.5621000001761,813.738100000046,759.7089000000133,3913.172000000125,3896.333200000162,3728.9589000001592,436349.0,431145.0,,6423.259728002896,631780.0,625332.0,,16328.335699999794,154136.50089999053,154139.24949999008,154031.0187999871,77589.34279999624,77927.0745000066,78328.45050000651,38.0,32271484.95,9868027.410000002,3435816502.3499985,1146306469.4550006,42116545.61999999,638619.57,63.0,8639.0,-11078819.5,5218860.5,-5704599.5,-6158893.5,-18.5,0.0,0.0,859500.0,0.0,0.0,0.0,0.0,0.0,-1204.0,-244.0,-545.0,-1197.0,124286273.09999968,1771491683.8800015,1998310163.58,29136156.29999999,1771491683.8800015,129324.0,-8967917.0,2068359791.0,88159533.0,449611752.0,204475903.0,470223221.0,128784.5,2034.0,363.3125994325845,3155803.5,1068753.0,653785.0,-2145857.0,721316.0,97685.0,1425273398.77501,1434501285.0750024,-88118505.5,-87389228.5,1619400.5,71433.5,,,,,,,,,,,,,,,,,,,,,1466943.0,14762580.0,3231324.0,8552517.0,11604375.0,1415204.0,1058228648.239501,801583826.827495,72084973186.52963,21672414196.92012,582250914.791999,5792665.7475,689.5,94245.0,-276846072.5,21936518.5,-123755297.0,-218641842.5,-2017103.5,,,,,,,,,,,,,,,,,,,,,4271673.5,2478520.0,-9000868.0,921269.0,37582.5,3732309538.919962,3656877908.782461,-260550594.0,-257240578.5,2525852.0,269119.0,3924914917.6349545,33246173989.91341,36674578611.54014,1728912813.3675494,48069165115.08071,3986910.0,-247517893.0,103056080086.5,1053529115.0,17268435619.5,3502643289.0,18882455154.0,3671023.5,71895.5,20864.801404172274,89779374.5,-176.1434830230011,9.090909090909092,3.5438144329896906,221.6097655698348,32.21649484536083,2014.6342324530435,74250.0,-0.9009688679024191,0.4338837391175582,0.0,0.0,0.0,0.0,0.0,0.0,1.0,0.0,0.0,0.0,0.0,0.0,0.0,1.0,0.0,0.0,0.0,0.0,1.0,0.0,1.0,0.0,0.0,0.0,0.0,1.0,0.0,0.0,0.0,0.0,0.0,0.0,0.0,0.0,0.0,0.0,0.0,0.0,0.0,0.0,0.0,1.0,0.0,0.0,0.0,0.0,0.0,0.0,0.0,0.0,0.0,0.0,0.0,0.0,0.0,0.0,0.0,0.0,0.0,0.0,0.0,0.0,0.0,0.0,0.0,0.0,0.0,0.0,0.0,0.0,0.0,0.0,0.0,0.0,0.0,0.0,0.0,0.0,1.0,0.0,0.0,0.0,0.0,0.0,0.0,0.0,0.0,0.0,0.0,0.0,0.0,0.0,0.0,0.0,0.0,0.0,0.0,0.0,0.0,0.0,0.0,0.0,0.0,0.0,0.0,0.0,0.0,0.0,0.0,1.0,1.0,0.0,0.0,0.0,0.0,0.0,0.0,1.0,0.0,0.0
102125,0,0.0,1.0,1.0,1.0,0.0,225000.0,817560.0,30951.0,675000.0,0.030755,48.6958904109589,,-7671.0,-1320.0,2.0,2.0,2.0,2.0,10.0,,0.6045127553422173,0.5937175866150576,0.0186,0.0447,0.9851,0.7959999999999999,0.0181,0.0,0.1034,0.0417,0.0417,0.0309,0.0151,0.0172,0.0,0.0,0.0189,0.0463,0.9851,0.804,0.0182,0.0,0.1034,0.0417,0.0417,0.0316,0.0165,0.0179,0.0,0.0,0.0187,0.0447,0.9851,0.7987,0.0182,0.0,0.1034,0.0417,0.0417,0.0314,0.0154,0.0175,0.0,0.0,0.0234,1.0,0.0,0.0,0.0,0.0,-654.0,0.0,0.0,0.0,0.0,1.0,2.0,1.0,0.0,0.0,1.0,0.0,0.0,0.0,0.0,0.0,0.0,0.0,0.0,0.0,1.0,0.0,0.0,0.0,0.0,0.0,0.0,0.0,0.0,0.0,0.0,0.0,0.0,0.0,0.0,0.0,0.0,0.0,0.0,5.0,7537.5,0.0,67351.5,0.0,0.0,0.0,0.0,0.0,-392.0,-27.0,-40.0,-462.0,105.0,-11.0,4.0,11339.19,144870.75,144870.75,0.0,225000.0,12.0,-230.0,365243.0,182310.0,182595.0,182655.0,-47.5,11.5,0.0,0.0,22.0,23.0,24.0,13.0,-13.0,0.0,0.0,20.0,11428.38,11428.38,-353.5,-338.0,10.5,1.0,2.0,0.0,225000.0,,0.0,,,0.0,,0.0,0.0,0.0,0.0,,0.0,,,0.0,-1.5,0.0,0.0,8344389937.5,184357127718.0,165547364197.5,51957529957.935,1863.0,1705.0,71125.0,70777.0,9140.0,505890.0,17803.515900002294,17865.673099999116,17317.217799998056,11293.181600000087,11230.99990000009,11178.272200000054,128377.0,662626.0,4136.886300000121,4134.554900000016,3945.180700000096,13524044.369862618,,-921641168.0,-296413619.0,-1534732690.0416667,44002.0,30697.0,11346.46879999918,11222.439999998973,10706.7956999973,22882.119000009672,22803.995400009637,22189.5188000082,,157996.57009728983,126069.15537607548,34990.96140002792,34931.324600028354,34377.38360002876,22947.62319999592,22920.879799995488,22568.164699995723,3713151.0,8293.567600000168,8398.066200000078,8121.6731000002255,9815.244400000718,9930.165800002156,10289.774699999649,16463.72089999975,16648.941699999694,16245.6870999997,828.5621000001761,813.738100000046,759.7089000000133,3913.172000000125,3896.333200000162,3728.9589000001592,436349.0,431145.0,1262667.0,6423.290483002896,631782.0,625334.0,,16328.359099999794,154137.48599999052,154140.23459999007,154032.00389998712,77590.13879999625,77927.87320000661,78329.25450000651,13.0,32343964.2,9868027.410000002,3439026302.8499985,1147770620.9550006,42116545.61999999,638619.57,63.0,8639.0,-11088792.0,5215435.0,-5710600.0,-6164900.0,-6.0,0.0,0.0,62185.5,0.0,0.0,0.0,0.0,0.0,-992.0,-868.0,-868.0,-868.0,124325145.17999966,1772397209.8800015,1999282960.08,29136156.29999999,1772271817.3800015,129384.0,-8969506.0,2069272898.5,88523807.5,449976821.5,204841032.5,470223006.5,128838.5,2034.0,363.3125994325845,3155876.5,1069425.0,654175.0,-2146543.0,721316.0,97685.0,1425835208.565011,1435063094.865003,-88131318.0,-87401628.5,1619726.0,71485.5,1372240276.8750017,3613396500.0,,184796277.43499973,,,78089371.87499994,,185488494.795,1316939197.050001,1366779318.03,1366834489.9650002,,15166.0,,,448549.0,-797892.5,274755.0,758.0,1466948.0,14762685.0,3231326.0,8552540.0,11604395.0,1415208.0,1058236185.739501,801583826.827495,72085040538.02963,21672414196.92012,582250914.791999,5792665.7475,689.5,94245.0,-276846464.5,21936491.5,-123755337.0,-218642304.5,-2017114.5,5920428311.347462,18715578750.0,,447827900.1524977,,,308996081.3924987,,458992758.0599993,5705660452.635032,5883724576.147499,5883967758.8925,,80812.0,,,971188.5,-1697806.5,177364.0,6755.0,4271697.5,2478533.0,-9000881.0,921269.0,37582.5,3732320967.2999625,3656889337.162461,-260550947.5,-257240916.5,2525862.5,269120.0,3924926256.8249545,33246318860.66341,36674723482.29014,1728912813.3675494,48069390115.08071,3986922.0,-247518123.0,103056445329.5,1053711425.0,17268618214.5,3502825944.0,18882455106.5,3671035.0,71895.5,20864.801404172274,89779396.5,,3.6336,7.269555103227682,353.99745864320226,26.414655423088107,1286.2851657259398,112500.0,1.0,0.0,0.0,1.0,0.0,0.0,0.0,0.0,0.0,0.0,0.0,1.0,0.0,0.0,0.0,0.0,0.0,0.0,0.0,0.0,1.0,0.0,1.0,0.0,0.0,0.0,0.0,1.0,0.0,0.0,0.0,0.0,0.0,0.0,0.0,0.0,0.0,0.0,0.0,0.0,0.0,0.0,0.0,0.0,0.0,0.0,0.0,0.0,0.0,0.0,0.0,0.0,0.0,0.0,0.0,0.0,0.0,0.0,0.0,0.0,0.0,0.0,0.0,0.0,0.0,0.0,0.0,0.0,0.0,0.0,0.0,0.0,0.0,0.0,0.0,0.0,0.0,0.0,0.0,0.0,0.0,0.0,0.0,0.0,0.0,0.0,0.0,0.0,0.0,0.0,0.0,0.0,0.0,0.0,0.0,0.0,0.0,0.0,0.0,0.0,0.0,0.0,0.0,0.0,0.0,0.0,0.0,1.0,0.0,0.0,1.0,0.0,1.0,0.0,0.0,0.0,0.0,0.0,0.0,0.0,1.0,0.0
102126,0,0.0,1.0,1.0,1.0,0.0,90000.0,479799.0,24628.5,400500.0,0.019101,32.032876712328765,-2838.0,-958.0,-3849.0,16.0,2.0,2.0,2.0,16.0,0.2015198517303156,0.4576097079231993,0.2650494299443805,,,,,,,,,,,,,,,,,,,,,,,,,,,,,,,,,,,,,,,,,,,,,4.0,2.0,4.0,1.0,-121.0,0.0,0.0,0.0,0.0,1.0,7.0,1.0,1.0,0.0,1.0,0.0,0.0,0.0,0.0,0.0,0.0,0.0,0.0,0.0,0.0,0.0,0.0,0.0,0.0,1.0,0.0,0.0,0.0,0.0,0.0,0.0,0.0,0.0,0.0,0.0,0.0,0.0,0.0,1.0,0.0,,90000.0,0.0,,0.0,0.0,0.0,-20.0,30886.0,-19.0,,1.0,0.0,10.0,5970.014999999999,46811.25,53973.0,0.0,70391.25,15.0,-999.0,365243.0,-1017.0,-687.0,-687.0,-681.0,10.5,0.0,0.0,64.5,80.0,16.0,9.0,-29.5,0.0,0.0,78.0,6461.235,6461.235,-863.0,-868.0,6.0,1.0,0.0,,,,,,,,,,,,,,,,,,,,,8344414566.0,184357607517.0,165547764697.5,51957619957.935,1863.0,1705.0,71125.0,70778.0,9140.0,505897.0,,,,,,,128377.0,662628.0,,,,13524076.402739331,-601694422.0,-921645017.0,-296413740.0,-1534733648.0416667,44004.0,30698.0,,,,,,,67434.51354043407,157997.0277069978,126069.42042550544,,,,,,,3713167.0,,,,,,,,,,,,,,,,436353.0,431149.0,1262683.0,6423.309584002896,631784.0,625336.0,,,,,,,,,1.0,32356026.45,,3439200889.3499985,1147770620.9550006,,638619.57,63.0,8639.0,-11090193.0,5245453.0,-5711514.0,,0.0,0.0,,90000.0,0.0,,0.0,0.0,0.0,-20.0,30886.0,-19.0,,124392810.95999968,1773309224.8800015,2000265728.58,29136156.29999999,1773169083.6300015,129472.0,-8975465.5,2070916492.0,88519717.0,449975892.0,204839087.0,470222092.0,128931.0,2036.0,363.3125994325845,3157533.5,1070396.0,654736.0,-2147618.5,721316.0,97685.0,1426868944.830011,1436061240.090003,-88162433.5,-87432331.5,1620117.0,71536.5,,,,,,,,,,,,,,,,,,,,,1466949.0,14762686.0,3231326.0,8552620.0,11604473.0,1415218.0,1058236185.739501,,72085130538.02963,21672414196.92012,,5792665.7475,689.5,94245.0,-276846484.5,21967377.5,-123755356.0,,-2017114.5,,,,,,,,,,,,,,,,,,,,,4271713.5,2478542.0,-9000910.5,921269.0,37582.5,3732327428.534962,3656895798.397461,-260551810.5,-257241784.5,2525868.5,269121.0,3924932226.839955,33246365671.91341,36674777455.29014,1728912813.3675494,48069460506.33071,3986937.0,-247519122.0,103056810572.5,1053710408.0,17268617527.5,3502825257.0,18882454425.5,3671045.5,71895.5,20864.801404172274,89779461.0,-88.59647622305849,5.3311,3.654302941713868,117.05783560142063,19.4814544125708,624.0470273747337,45000.0,0.6234898018587336,0.7818314824680298,0.0,0.0,0.0,0.0,0.0,0.0,1.0,0.0,1.0,0.0,0.0,0.0,0.0,0.0,0.0,0.0,0.0,1.0,0.0,0.0,1.0,0.0,0.0,0.0,0.0,1.0,0.0,0.0,0.0,0.0,0.0,0.0,0.0,0.0,0.0,0.0,0.0,0.0,0.0,1.0,0.0,0.0,0.0,0.0,0.0,0.0,0.0,0.0,0.0,0.0,0.0,0.0,0.0,0.0,0.0,0.0,0.0,0.0,0.0,0.0,0.0,0.0,0.0,0.0,0.0,0.0,0.0,0.0,0.0,0.0,0.0,0.0,0.0,0.0,0.0,0.0,0.0,0.0,0.0,0.0,0.0,0.0,0.0,0.0,0.0,0.0,0.0,0.0,0.0,0.0,0.0,0.0,0.0,0.0,0.0,0.0,0.0,0.0,0.0,0.0,0.0,0.0,0.0,0.0,1.0,0.0,0.0,0.0,0.0,0.0,0.0,0.0,0.0,0.0,0.0,0.0,0.0,0.0,0.0,0.0
102146,0,0.0,1.0,1.0,1.0,1.0,157500.0,112500.0,11943.0,112500.0,0.006296,31.56164383561644,-376.0,-5047.0,-3721.0,10.0,3.0,3.0,3.0,10.0,0.3924147241336186,0.5310194291834504,,,,,,,,,,,,,,,,,,,,,,,,,,,,,,,,,,,,,,,,,,,,,,2.0,0.0,2.0,0.0,-923.0,,,,,,,1.0,1.0,1.0,1.0,1.0,0.0,0.0,0.0,0.0,0.0,0.0,0.0,0.0,1.0,0.0,0.0,0.0,0.0,0.0,0.0,0.0,0.0,0.0,0.0,0.0,0.0,0.0,0.0,0.0,0.0,0.0,0.0,0.0,,,,,,,,,,,,,0.0,,6.0,12179.25,94455.0,79742.25,9803.25,94455.0,6.0,-314.0,365243.0,-283.5,-148.5,-133.5,-141.5,16.0,0.0,0.1089090909090909,662.0,34.0,6.0,3.5,-11.5,0.0,0.0,30.0,10597.905,10597.905,-330.0,-315.0,3.5,1.0,0.0,,,,,,,,,,,,,,,,,,,,,8344426509.0,184357720017.0,165547877197.5,51957777457.935,,,,,,,,,,,,,128378.0,662631.0,,,,13524107.964383164,-601694798.0,-921648738.0,-296414663.0,-1534738695.0416667,44004.0,30698.0,,,,,,,67434.9059551582,157997.55872642694,,,,,,,,3713177.0,,,,,,,,,,,,,,,,436355.0,431151.0,1262693.0,6423.315880002896,631787.0,625339.0,,,,,,,,,,,,,,,,,,,,,,,,,,,,,,,,,,,126129682.57499968,1810498174.8750017,2041476890.58,29463819.79499999,1810498174.8750017,131592.0,-9062417.5,2091181983.5,88998647.5,455952762.5,206997810.5,476565192.5,130442.0,2057.0,366.5153985263198,3187297.0,1085073.0,664537.0,-2171694.0,721452.0,97767.0,1447943517.22502,1457202084.97501,-89240756.0,-88504175.5,1638690.0,72402.5,,,,,,,,,,,,,,,,,,,,,1466949.0,14762686.0,3231326.0,8552654.0,11604503.0,1415224.0,,,,,,,,,,,,,,,,,,,,,,,,,,,,,,,,,,4271719.5,2478545.5,-9000922.0,921269.0,37582.5,3732338026.4399633,3656906396.302461,-260552140.5,-257242099.5,2525872.0,269122.0,3924944406.089955,33246460126.91341,36674857197.54014,1728922616.6175494,48069554961.33071,3986943.0,-247519436.0,103057175815.5,1053710124.5,17268617379.0,3502825123.5,18882454284.0,3671061.5,71895.5,20864.910313263183,89780123.0,-11.913194444444445,0.7142857142857143,13.187641296156745,416.2236376211663,9.419743782969103,297.30259830083304,52500.0,-0.9009688679024191,-0.433883739117558,0.0,1.0,0.0,0.0,0.0,0.0,0.0,0.0,0.0,0.0,0.0,0.0,0.0,1.0,0.0,1.0,0.0,0.0,0.0,0.0,1.0,0.0,0.0,0.0,0.0,1.0,0.0,0.0,0.0,0.0,0.0,0.0,0.0,0.0,0.0,0.0,0.0,0.0,0.0,0.0,0.0,0.0,0.0,0.0,0.0,0.0,0.0,0.0,0.0,0.0,0.0,0.0,0.0,0.0,0.0,0.0,0.0,0.0,0.0,0.0,0.0,0.0,0.0,0.0,0.0,0.0,0.0,0.0,0.0,0.0,0.0,0.0,0.0,0.0,0.0,0.0,0.0,0.0,0.0,1.0,0.0,0.0,0.0,0.0,0.0,0.0,0.0,0.0,0.0,0.0,0.0,0.0,0.0,0.0,0.0,0.0,0.0,0.0,0.0,0.0,0.0,0.0,0.0,0.0,0.0,0.0,0.0,0.0,0.0,0.0,0.0,0.0,0.0,0.0,0.0,0.0,0.0,0.0,0.0,0.0
102147,0,0.0,0.0,0.0,1.0,0.0,103500.0,404325.0,20772.0,337500.0,0.0060079999999999,48.02465753424657,-10292.0,-10328.0,-1071.0,,2.0,2.0,2.0,9.0,,0.5549239318893553,0.2822484337007223,,,,,,,,,,,,,,,,,,,,,,,,,,,,,,,,,,,,,,,,,,,,,3.0,0.0,3.0,0.0,-766.0,0.0,0.0,0.0,0.0,0.0,4.0,1.0,1.0,0.0,1.0,0.0,0.0,0.0,0.0,0.0,0.0,0.0,0.0,0.0,1.0,0.0,0.0,0.0,0.0,0.0,0.0,0.0,0.0,0.0,0.0,0.0,0.0,0.0,0.0,0.0,0.0,0.0,0.0,10.0,6750.0,0.0,74250.0,0.0,0.0,0.0,0.0,0.0,-247.0,-46.0,-43.0,-81.0,162.0,-14.0,7.0,11812.905,36261.0,42619.5,0.0,137250.0,6.0,-538.0,365243.0,-415.5,182442.5,4.5,182444.0,9.0,0.5,0.0,-1.0,27.0,6.0,6.0,-13.0,0.0,0.0,23.0,8928.27,8928.27,-364.0,-358.0,4.0,1.0,20.0,0.0,405000.0,,0.0,,,0.0,,0.0,0.0,0.0,0.0,,0.0,,,0.0,-10.5,0.0,0.0,8344447281.0,184358124342.0,165548214697.5,51957880957.935,1863.0,1705.0,71125.0,70778.0,9140.0,505901.0,,,,,,,128378.0,662633.0,,,,13524155.9890407,-601705090.0,-921649809.0,-296415429.0,-1534749023.0416667,44004.0,30698.0,,,,,,,,157998.11365035884,126069.70267393911,,,,,,,3713186.0,,,,,,,,,,,,,,,,436358.0,431154.0,,6423.321888002895,631789.0,625341.0,,,,,,,,,8.5,32567075.145,9935273.61,3479844390.749999,1164022783.2900002,42368760.31499999,638619.57,63.0,9176.0,-11220721.0,5264056.0,-5783883.0,-6235975.0,-3.75,0.0,0.0,81000.0,0.0,0.0,0.0,0.0,0.0,-990.0,-625.0,-572.0,-1620.0,126198065.11499973,1810972384.8750017,2041954178.58,29487575.29499999,1811174884.8750017,131635.0,-9065140.0,2093008198.5,89361922.5,456681982.0,207179485.0,477294429.0,130518.0,2059.0,366.8479595608668,3188712.0,1085372.0,664729.0,-2172028.0,721452.0,97767.0,1448278057.3950195,1457536625.1450095,-89248879.0,-88512038.0,1638802.0,72429.0,1400108606.6400006,3674484000.0,,187534345.8599997,,,79554917.65499991,,187808070.6,1343968136.9099998,1394597155.949999,1394652327.8849998,,15502.0,,,454559.0,-806532.5,274829.0,816.0,1466959.0,14762848.0,3231346.0,8552681.0,11604526.0,1415231.0,1058242935.739501,801583826.827495,72085204788.02963,21672414196.92012,582250914.791999,5792665.7475,689.5,94245.0,-276846731.5,21967331.5,-123755399.0,-218642385.5,-2017128.5,5920428311.347462,18715983750.0,,447827900.1524977,,,308996081.3924987,,458992758.0599993,5705660452.635032,5883724576.147499,5883967758.8925,,80812.0,,,971188.5,-1697817.0,177364.0,6755.0,4271725.5,2478551.5,-9000935.0,921269.0,37582.5,3732346954.7099633,3656915324.572461,-260552504.5,-257242457.5,2525876.0,269123.0,3924956218.9949546,33246496387.91341,36674899817.04014,1728922616.6175494,48069692211.33071,3986949.0,-247519974.0,103057541058.5,1053709709.0,17268799821.5,3502825128.0,18882636728.0,3671070.5,71896.0,20864.910313263183,89780122.0,-214.3065776712876,3.9065217391304334,4.982668977469671,239.2909712494955,19.464904679376083,934.79538116379,51750.0,-0.9009688679024191,-0.433883739117558,0.0,0.0,0.0,0.0,0.0,0.0,1.0,0.0,0.0,0.0,0.0,0.0,0.0,1.0,0.0,0.0,0.0,0.0,1.0,0.0,1.0,0.0,0.0,0.0,0.0,1.0,0.0,0.0,0.0,0.0,0.0,0.0,0.0,0.0,0.0,0.0,0.0,0.0,0.0,0.0,0.0,0.0,0.0,0.0,0.0,0.0,1.0,0.0,0.0,0.0,0.0,0.0,0.0,0.0,0.0,0.0,0.0,0.0,0.0,0.0,0.0,1.0,0.0,0.0,0.0,0.0,0.0,0.0,0.0,0.0,0.0,0.0,0.0,0.0,0.0,0.0,0.0,0.0,0.0,0.0,0.0,0.0,0.0,0.0,0.0,0.0,0.0,0.0,0.0,0.0,0.0,0.0,0.0,0.0,0.0,0.0,0.0,0.0,0.0,0.0,0.0,0.0,0.0,0.0,0.0,0.0,0.0,0.0,0.0,0.0,0.0,0.0,0.0,0.0,0.0,0.0,0.0,0.0,0.0,0.0
102151,0,0.0,0.0,1.0,1.0,1.0,90000.0,360000.0,18508.5,360000.0,0.01885,28.97260273972603,-2428.0,-2143.0,-2147.0,17.0,3.0,2.0,2.0,14.0,0.4677238793009951,0.4527236783723602,0.7194907850918436,,,,,,,,,,,,,,,,,,,,,,,,,,,,,,,,,,,,,,,,,,,,,0.0,0.0,0.0,0.0,-2138.0,0.0,0.0,0.0,0.0,0.0,2.0,1.0,1.0,1.0,1.0,0.0,0.0,0.0,0.0,0.0,0.0,1.0,1.0,0.0,1.0,0.0,0.0,0.0,0.0,0.0,0.0,0.0,0.0,0.0,0.0,0.0,0.0,0.0,0.0,0.0,0.0,0.0,0.0,11.0,0.0,0.0,80505.0,0.0,0.0,0.0,0.0,0.0,-1002.0,-867.0,-832.0,-1053.0,383.0,-20.0,5.0,8726.175,51286.5,46413.0,4914.0,51286.5,10.0,-1446.0,365243.0,-1496.0,-1346.0,-1346.0,-1339.0,15.0,0.0,0.1089090909090909,100.0,44.0,6.0,1.5,-57.5,0.0,0.0,23.0,8656.2,8656.2,-1505.0,-1496.0,4.0,1.0,0.0,,,,,,,,,,,,,,,,,,,,,8344465789.5,184358484342.0,165548574697.5,51957970957.935,1863.0,1705.0,71125.0,70778.0,9140.0,505903.0,,,,,,,128379.0,662636.0,,,,13524184.96164344,-601707518.0,-921651956.0,-296417567.0,-1534751166.0416667,44004.0,30698.0,,,,,,,67435.3736790375,157998.56637403724,126070.42216472422,,,,,,,3713200.0,,,,,,,,,,,,,,,,436358.0,431154.0,1262710.0,6423.340738002896,631791.0,625343.0,,,,,,,,,33.0,32650254.945,9954402.075,3485632675.9949994,1166440030.2900002,42436260.31499999,638619.57,63.0,9176.0,-11250075.0,5252982.0,-5804426.0,-6258942.0,-16.0,0.0,0.0,72711.0,0.0,0.0,0.0,0.0,0.0,-1526.0,-1435.0,-1195.0,-1198.0,126452431.84499966,1814113722.3750017,2045966986.08,29520092.29499999,1814113722.3750017,132131.0,-9084155.0,2096111115.0,89533967.0,457221691.0,208451111.0,478200590.0,131101.0,2061.0,367.45020006657415,3189798.0,1086323.0,665253.0,-2174808.0,721787.0,97767.0,1450006324.1550212,1459256029.965011,-89333819.0,-88596205.0,1640501.0,72505.0,,,,,,,,,,,,,,,,,,,,,1466970.0,14763231.0,3231346.0,8552725.0,11604549.0,1415236.0,1058242935.739501,801583826.827495,72085285293.02963,21672414196.92012,582250914.791999,5792665.7475,689.5,94245.0,-276847733.5,21966464.5,-123756231.0,-218643438.5,-2017148.5,,,,,,,,,,,,,,,,,,,,,4271731.5,2478553.0,-9000992.5,921269.0,37582.5,3732355610.909962,3656923980.772461,-260554009.5,-257243953.5,2525880.0,269124.0,3924964945.169955,33246547674.41341,36674946230.04014,1728927530.6175494,48069743497.83071,3986959.0,-247521420.0,103057906301.5,1053708213.0,17268798475.5,3502823782.0,18882635389.0,3671085.5,71896.0,20865.01922235409,89780222.0,-83.80330969267139,4.0,4.862630683199611,140.8830670543449,19.450522732798444,563.5322682173796,30000.0,0.6234898018587336,0.7818314824680298,0.0,0.0,0.0,0.0,0.0,0.0,1.0,0.0,0.0,0.0,0.0,0.0,0.0,1.0,0.0,0.0,0.0,0.0,1.0,0.0,1.0,0.0,0.0,0.0,0.0,1.0,0.0,0.0,0.0,0.0,0.0,0.0,0.0,1.0,0.0,0.0,0.0,0.0,0.0,0.0,0.0,0.0,0.0,0.0,0.0,0.0,0.0,0.0,0.0,0.0,0.0,0.0,0.0,0.0,0.0,0.0,0.0,0.0,0.0,0.0,0.0,0.0,0.0,0.0,0.0,0.0,0.0,0.0,0.0,0.0,0.0,0.0,0.0,0.0,0.0,0.0,1.0,0.0,0.0,0.0,0.0,0.0,0.0,0.0,0.0,0.0,0.0,0.0,0.0,0.0,0.0,0.0,0.0,0.0,0.0,0.0,0.0,0.0,0.0,0.0,0.0,0.0,0.0,0.0,0.0,0.0,0.0,0.0,0.0,0.0,0.0,0.0,0.0,0.0,0.0,0.0,0.0,0.0,0.0,0.0
102158,0,0.0,0.0,0.0,0.0,0.0,301500.0,630000.0,32296.5,630000.0,0.00702,42.78356164383562,-3218.0,-3843.0,-4688.0,,2.0,2.0,2.0,11.0,,0.1879289071069704,0.2692857999073816,,,,,,,,,,,,,,,,,,,,,,,,,,,,,,,,,,,,,,,,,,,,1.0,5.0,0.0,5.0,0.0,-1901.0,0.0,0.0,0.0,0.0,0.0,5.0,1.0,1.0,1.0,1.0,1.0,0.0,0.0,0.0,0.0,0.0,0.0,0.0,0.0,1.0,0.0,0.0,0.0,0.0,0.0,0.0,0.0,0.0,0.0,0.0,0.0,0.0,0.0,0.0,0.0,0.0,0.0,0.0,10.0,40.5,225.0,83250.0,0.0,0.0,0.0,0.0,0.0,-744.0,554.0,-34.5,-906.0,247.0,-14.0,10.0,23620.77,227250.0,238387.5,0.0,227250.0,21.0,-1143.5,365243.0,-1483.5,-1318.5,-980.0,-1311.5,13.5,0.5,0.0,-1.0,70.0,12.0,8.5,-43.5,0.0,0.0,64.0,15606.81,15606.81,-1123.5,-1113.0,5.0,1.0,0.0,,,,,,,,,,,,,,,,,,,,,8344498086.0,184359114342.0,165549204697.5,51958272457.935,1863.0,1705.0,71125.0,70778.0,9140.0,505908.0,,,,,,,128379.0,662638.0,,,,13524227.745205086,-601710736.0,-921656644.0,-296419468.0,-1534755009.0416667,44004.0,30698.0,,,,,,,,157998.75430294435,126070.69145052411,,,,,,,3713211.0,,,,,,,,,,,,,,,,436363.0,431159.0,,6423.347758002896,631793.0,625345.0,,,,,,,,,25.0,32727245.445,9958711.545000002,3491209457.19,1168377302.7900002,42436260.31499999,638619.57,63.0,9176.0,-11280560.5,5247425.0,-5819016.0,-6273034.0,-12.0,0.0,225.0,54000.0,0.0,0.0,0.0,0.0,0.0,-909.0,554.0,-49.0,-906.0,126791057.42999968,1819592926.8750017,2051891150.58,29546385.79499999,1819592926.8750017,132551.0,-9110284.0,2102137624.5,89509200.0,457566786.0,208434391.5,478545805.0,131379.5,2067.0,368.1251583440936,3190407.5,1090130.0,667686.0,-2183280.0,722636.0,97767.0,1454342865.8400214,1463892672.6000118,-89566898.0,-88827123.5,1642102.0,72747.5,,,,,,,,,,,,,,,,,,,,,1466980.0,14763478.0,3231346.0,8552795.0,11604613.0,1415246.0,1058242976.239501,801584051.827495,72085368543.02963,21672414196.92012,582250914.791999,5792665.7475,689.5,94245.0,-276848477.5,21967018.5,-123756265.5,-218644344.5,-2017162.5,,,,,,,,,,,,,,,,,,,,,4271743.5,2478561.5,-9001036.0,921269.0,37582.5,3732371217.7199626,3656939587.582461,-260555133.0,-257245066.5,2525885.0,269125.0,3924988565.9399543,33246774924.41341,36675184617.54014,1728927530.6175494,48069970747.83071,3986980.0,-247522563.5,103058271544.5,1053706729.5,17268797157.0,3502822802.0,18882634077.5,3671099.0,71896.5,20865.01922235409,89780221.0,-75.21580430327869,2.08955223880597,9.335376898425526,399.4006730022274,19.50675769820259,834.5685704524154,150750.0,1.0,0.0,0.0,0.0,0.0,0.0,0.0,0.0,1.0,0.0,0.0,0.0,1.0,0.0,0.0,0.0,0.0,1.0,0.0,0.0,0.0,1.0,0.0,0.0,0.0,0.0,0.0,1.0,0.0,0.0,0.0,0.0,0.0,0.0,0.0,1.0,0.0,0.0,0.0,0.0,0.0,0.0,0.0,0.0,0.0,0.0,0.0,0.0,0.0,0.0,0.0,0.0,1.0,0.0,0.0,0.0,0.0,0.0,0.0,0.0,0.0,0.0,0.0,0.0,0.0,0.0,0.0,0.0,0.0,0.0,0.0,0.0,0.0,0.0,0.0,0.0,0.0,0.0,0.0,0.0,0.0,0.0,0.0,0.0,0.0,0.0,0.0,0.0,0.0,0.0,0.0,0.0,0.0,0.0,0.0,0.0,0.0,0.0,0.0,0.0,0.0,0.0,0.0,0.0,0.0,0.0,0.0,0.0,0.0,0.0,0.0,0.0,0.0,0.0,0.0,0.0,0.0,0.0,0.0,0.0,0.0,0.0
102159,0,0.0,0.0,0.0,1.0,1.0,135000.0,300046.5,10246.5,196366.5,0.031329,52.35890410958904,-2439.0,-10095.0,-2659.0,,2.0,2.0,2.0,11.0,0.6551132162019634,0.5575634108169126,0.4866531565147181,0.1495,0.0971,0.9856,,,0.16,0.1379,0.3333,,0.1515,,0.0974,,,0.1523,0.1008,0.9856,,,0.1611,0.1379,0.3333,,0.1549,,0.1015,,,0.1509,0.0971,0.9856,,,0.16,0.1379,0.3333,,0.1541,,0.0991,,,0.1254,1.0,4.0,0.0,4.0,0.0,-1455.0,0.0,0.0,0.0,0.0,1.0,0.0,1.0,1.0,0.0,1.0,1.0,0.0,0.0,0.0,0.0,0.0,0.0,0.0,0.0,1.0,0.0,0.0,0.0,0.0,0.0,0.0,0.0,0.0,0.0,0.0,0.0,0.0,0.0,0.0,0.0,0.0,0.0,0.0,9.0,3669.75,0.0,198000.0,0.0,0.0,0.0,0.0,0.0,-626.0,-11.0,-112.0,-671.5,283.0,-19.0,3.0,4780.395,45100.8,45100.8,0.0,45100.8,10.0,-1455.0,365243.0,-1156.5,181610.0,-886.5,181611.5,12.0,0.0,0.0,25.0,11.0,10.0,6.0,-72.0,0.0,0.0,12.0,5988.42,5988.42,-2158.0,-2158.0,4.5,1.0,0.0,,,,,,,,,,,,,,,,,,,,,8344508332.5,184359414388.5,165549401064.0,51958407457.935,1863.0,1705.0,71125.0,70779.0,9140.0,505908.0,17803.665400002294,17865.823999999116,17317.370099998057,11293.278700000088,11231.09700000009,11178.373000000054,128380.0,662640.0,,,,13524280.104109194,-601713175.0,-921659303.0,-296420923.0,-1534765104.0416667,44004.0,30698.0,11346.62879999918,11222.599999998973,10706.956799997295,22882.25690000968,22804.133300009635,22189.6567000082,67436.0287922537,157999.31186635516,126071.17810368064,34991.29470002792,34931.65790002835,34377.71690002876,,,,3713222.0,8293.719100000168,8398.220300000077,8121.828000000227,,,,16463.818299999748,16649.040799999693,16245.7885999997,,,,,,,436367.0,431163.0,,6423.379087002895,631795.0,625347.0,,16328.484499999797,154138.47159999053,154141.2201999901,154032.9894999871,,,,21.0,32825680.695,9958711.545000002,3495332699.19,1170672550.2900002,42436260.31499999,638619.57,63.0,9176.0,-11288128.0,5248320.5,-5822203.0,-6276847.5,-10.0,0.0,0.0,45477.0,0.0,0.0,0.0,0.0,0.0,-1450.0,-1088.0,-609.0,-1332.0,126887860.75499968,1821349058.1750016,2053725203.88,29562126.79499999,1821349058.1750016,132692.0,-9119573.0,2103963839.5,89502052.0,457743349.5,208429621.0,478722403.5,131460.0,2068.0,368.4587180299614,3191717.0,1091113.0,668367.0,-2184736.0,722636.0,97767.0,1456066038.1500225,1465612849.6200128,-89607112.0,-88867119.5,1642441.0,72789.5,,,,,,,,,,,,,,,,,,,,,1466989.0,14763761.0,3231346.0,8552806.0,11604625.0,1415249.0,1058246645.989501,801584051.827495,72085566543.02963,21672414196.92012,582250914.791999,5792665.7475,689.5,94245.0,-276849103.5,21967007.5,-123756377.5,-218645016.0,-2017181.5,,,,,,,,,,,,,,,,,,,,,4271753.5,2478567.5,-9001108.0,921269.0,37582.5,3732377206.139962,3656945576.002461,-260557291.0,-257247224.5,2525889.5,269126.0,3924993346.3349543,33246820025.213413,36675229718.34014,1728927530.6175494,48070015848.63072,3986990.0,-247524018.5,103058636787.5,1053705573.0,17268978767.0,3502821915.5,18882815689.0,3671111.0,71896.5,20865.01922235409,89780246.0,-46.58233478101617,2.222566666666667,13.175230566534914,689.8406338549281,29.282828282828284,1533.216798118168,67500.0,-0.9009688679024191,0.4338837391175582,0.0,0.0,0.0,0.0,1.0,0.0,0.0,0.0,0.0,0.0,0.0,0.0,0.0,1.0,0.0,0.0,0.0,0.0,1.0,0.0,0.0,0.0,0.0,1.0,0.0,1.0,0.0,0.0,0.0,0.0,0.0,0.0,0.0,0.0,0.0,0.0,1.0,0.0,0.0,0.0,0.0,0.0,0.0,0.0,0.0,0.0,0.0,0.0,0.0,0.0,0.0,0.0,0.0,0.0,0.0,0.0,0.0,0.0,0.0,1.0,0.0,0.0,0.0,0.0,0.0,0.0,0.0,0.0,0.0,0.0,0.0,0.0,0.0,0.0,0.0,0.0,0.0,0.0,0.0,0.0,0.0,0.0,0.0,0.0,0.0,0.0,0.0,0.0,0.0,0.0,0.0,0.0,0.0,0.0,0.0,0.0,0.0,0.0,0.0,0.0,0.0,0.0,0.0,0.0,0.0,0.0,0.0,0.0,0.0,0.0,1.0,0.0,0.0,0.0,0.0,0.0,0.0,1.0,0.0,0.0
102162,0,0.0,0.0,1.0,1.0,1.0,135000.0,269982.0,28480.5,238500.0,0.005084,29.04109589041096,-2274.0,-351.0,-662.0,65.0,3.0,2.0,2.0,14.0,0.5006348442265758,0.6274077574973501,0.1777040724853336,,,,,,,,,,,,,,,,,,,,,,,,,,,,,,,,,,,,,,,,,,,,,0.0,0.0,0.0,0.0,-574.0,0.0,0.0,0.0,0.0,0.0,1.0,1.0,1.0,0.0,1.0,0.0,0.0,0.0,0.0,0.0,0.0,0.0,0.0,0.0,1.0,0.0,0.0,0.0,0.0,0.0,0.0,0.0,0.0,0.0,0.0,0.0,0.0,0.0,0.0,0.0,0.0,0.0,0.0,4.0,0.0,,180000.0,0.0,0.0,0.0,0.0,0.0,-284.0,928.5,-75.5,-73.0,48.0,-5.5,1.0,6848.415,57280.5,62320.5,0.0,57280.5,10.0,-574.0,365243.0,-537.0,-327.0,-267.0,-321.0,16.0,0.0,0.0,15.0,10.0,10.0,6.5,-14.5,0.0,0.0,8.0,6848.415,6848.415,-461.5,-432.0,4.5,1.0,0.0,,,,,,,,,,,,,,,,,,,,,8344536813.0,184359684370.5,165549639564.0,51958542457.935,1863.0,1705.0,71125.0,70779.0,9140.0,505909.0,,,,,,,128381.0,662643.0,,,,13524309.145205084,-601715449.0,-921659965.0,-296421497.0,-1534765455.0416667,44004.0,30698.0,,,,,,,67436.52942709794,157999.93927411266,126071.35580775312,,,,,,,3713236.0,,,,,,,,,,,,,,,,436367.0,431163.0,1262775.0,6423.384171002896,631797.0,625349.0,,,,,,,,,10.0,32847588.945,,3498194784.69,1172028832.2900002,42436260.31499999,638619.57,63.0,9176.0,-11295843.0,5249920.5,-5826626.5,-6281584.0,-4.5,0.0,,90000.0,0.0,0.0,0.0,0.0,0.0,-284.0,708.0,-84.0,-73.0,126947395.25999968,1822041632.5200016,2054464317.225,29592987.79499999,1822041632.5200016,132815.0,-9127850.0,2107068405.0,89495585.0,458651381.0,208426289.0,479630476.0,131649.0,2072.0,369.35695315515,3194588.0,1091833.0,668872.0,-2186819.5,722642.0,97773.0,1456441431.4350224,1465983349.335013,-89667921.5,-88927166.5,1642672.0,72849.0,,,,,,,,,,,,,,,,,,,,,1466993.0,14763809.0,3231346.0,8552816.0,11604633.0,1415250.0,1058246645.989501,,72085746543.02963,21672414196.92012,582250914.791999,5792665.7475,689.5,94245.0,-276849387.5,21967936.0,-123756453.0,-218645089.0,-2017187.0,,,,,,,,,,,,,,,,,,,,,4271763.5,2478574.0,-9001122.5,921269.0,37582.5,3732384054.5549626,3656952424.417461,-260557752.5,-257247656.5,2525894.0,269127.0,3925000194.749954,33246877305.713413,36675292038.84014,1728927530.6175494,48070073129.13072,3987000.0,-247524592.5,103059002030.5,1053705036.0,17268978440.0,3502821648.5,18882815368.0,3671127.0,71896.5,20865.01922235409,89780261.0,-78.30283018867925,1.999866666666667,4.740085321535788,137.6572723514503,9.479538631695371,275.2961903999204,45000.0,-0.2225209339563146,-0.9749279121818236,0.0,0.0,0.0,0.0,0.0,0.0,1.0,0.0,1.0,0.0,0.0,0.0,0.0,0.0,0.0,1.0,0.0,0.0,0.0,0.0,1.0,0.0,0.0,0.0,0.0,1.0,0.0,0.0,0.0,0.0,0.0,0.0,0.0,1.0,0.0,0.0,0.0,0.0,0.0,0.0,0.0,0.0,0.0,0.0,0.0,0.0,0.0,0.0,0.0,0.0,0.0,0.0,0.0,0.0,0.0,0.0,0.0,0.0,0.0,0.0,0.0,0.0,0.0,0.0,0.0,0.0,0.0,0.0,0.0,0.0,0.0,0.0,0.0,0.0,0.0,0.0,0.0,0.0,1.0,0.0,0.0,0.0,0.0,0.0,0.0,0.0,0.0,0.0,0.0,0.0,0.0,0.0,0.0,0.0,0.0,0.0,0.0,0.0,0.0,0.0,0.0,0.0,0.0,0.0,0.0,0.0,0.0,0.0,0.0,0.0,0.0,0.0,0.0,0.0,0.0,0.0,0.0,0.0,0.0,0.0
102165,0,0.0,1.0,1.0,0.0,0.0,292500.0,1800000.0,56002.5,1800000.0,0.0145199999999999,30.427397260273967,-424.0,-1381.0,-3545.0,15.0,2.0,2.0,2.0,15.0,0.6091280953990665,0.6755802430159507,0.3185955240537633,0.0825,0.0877,0.9767,0.6804,0.0117,0.0,0.1379,0.1667,0.2083,0.0803,0.0672,0.077,0.0,0.0,0.084,0.091,0.9767,0.6929,0.0118,0.0,0.1379,0.1667,0.2083,0.0822,0.0735,0.0802,0.0,0.0,0.0833,0.0877,0.9767,0.6847,0.0118,0.0,0.1379,0.1667,0.2083,0.0817,0.0684,0.0784,0.0,0.0,0.0594,1.0,2.0,0.0,2.0,0.0,-652.0,0.0,0.0,0.0,0.0,0.0,1.0,1.0,1.0,0.0,1.0,0.0,0.0,0.0,0.0,0.0,0.0,0.0,0.0,0.0,1.0,0.0,0.0,0.0,0.0,0.0,0.0,0.0,0.0,0.0,0.0,0.0,0.0,0.0,0.0,0.0,0.0,0.0,0.0,5.0,0.0,0.0,88200.0,0.0,0.0,0.0,0.0,0.0,-2715.0,-2441.5,-1007.0,-2463.0,294.0,-43.0,1.0,13100.535,130995.0,117895.5,13099.5,130995.0,10.0,-652.0,365243.0,-621.0,-351.0,-351.0,-349.0,12.0,0.0,0.1089090909090909,150.0,11.0,10.0,5.0,-16.0,0.0,0.0,10.0,13100.535,13100.535,-489.5,-486.0,5.5,1.0,0.0,,,,,,,,,,,,,,,,,,,,,8344592815.5,184361484370.5,165551439564.0,51958834957.935,1863.0,1705.0,71125.0,70779.0,9140.0,505910.0,17803.747900002294,17865.907299999115,17317.454099998056,11293.366400000088,11231.18470000009,11178.464000000056,128381.0,662645.0,4136.898000000121,4134.566700000016,3945.192500000095,13524339.572602345,-601715873.0,-921663510.0,-296422149.0,-1534766836.0416667,44004.0,30698.0,11346.62879999918,11222.599999998973,10706.956799997295,22882.39480000968,22804.27120000964,22189.7946000082,67437.13855519332,158000.6148543557,126071.67440327715,34991.46140002792,34931.824600028354,34377.88360002876,22947.831499995908,22921.08809999549,22568.37299999572,3713251.0,8293.799400000167,8398.302000000078,8121.910200000227,9815.311600000718,9930.234200002156,10289.84819999965,16463.895299999753,16649.119199999688,16245.8687999997,828.5621000001761,813.738100000046,759.7089000000133,3913.172000000125,3896.333200000162,3728.9589000001592,436369.0,431165.0,1262790.0,6423.398691002895,631799.0,625351.0,,16328.543899999797,154139.44829999053,154142.1968999901,154033.9661999871,77590.81919999624,77928.55790000659,78329.94740000651,90.0,32847588.945,9958711.545000002,3500859981.69,1172549113.2900002,42548489.99999999,638619.57,63.0,9176.0,-11311090.0,5246211.0,-5834632.0,-6290365.0,-44.5,0.0,0.0,44082.0,0.0,0.0,0.0,0.0,0.0,-2832.0,-2466.0,-1067.0,-2463.0,127096957.03499968,1824017519.4750016,2056630428.18,29606087.29499999,1824017519.4750016,133005.0,-9137171.0,2110355592.0,89487787.0,459377497.0,208423201.0,480356623.0,131806.0,2078.0,369.4658622460591,3194802.0,1094763.0,670527.0,-2189692.0,722649.0,97780.0,1458305365.5225196,1467846559.5975106,-89751676.5,-89010058.5,1643972.0,73019.5,,,,,,,,,,,,,,,,,,,,,1466998.0,14764103.0,3231346.0,8552827.0,11604643.0,1415251.0,1058246645.989501,801584051.827495,72085834743.02963,21672414196.92012,582250914.791999,5792665.7475,689.5,94245.0,-276852102.5,21965494.5,-123757460.0,-218647552.0,-2017230.0,,,,,,,,,,,,,,,,,,,,,4271773.5,2478579.0,-9001138.5,921269.0,37582.5,3732397155.0899625,3656965524.952461,-260558242.0,-257248142.5,2525899.5,269128.0,3925013295.2849545,33247008300.713413,36675409934.34014,1728940630.1175494,48070204124.13072,3987010.0,-247525244.5,103059367273.5,1053704415.0,17268978089.0,3502821297.5,18882815019.0,3671139.0,71896.5,20865.128131445,89780411.0,-13.934810012605796,6.153846153846153,5.222981116914424,158.92172132726463,32.141422257934906,977.9798235523976,146250.0,0.6234898018587336,0.7818314824680298,0.0,0.0,0.0,0.0,0.0,0.0,1.0,0.0,1.0,0.0,0.0,0.0,0.0,0.0,0.0,0.0,1.0,0.0,0.0,0.0,1.0,0.0,0.0,0.0,0.0,1.0,0.0,0.0,0.0,0.0,0.0,0.0,0.0,0.0,0.0,0.0,0.0,0.0,0.0,0.0,0.0,0.0,0.0,0.0,0.0,0.0,0.0,0.0,0.0,0.0,0.0,0.0,0.0,0.0,0.0,0.0,0.0,0.0,0.0,0.0,0.0,0.0,0.0,0.0,0.0,0.0,0.0,0.0,0.0,0.0,0.0,0.0,0.0,0.0,0.0,0.0,0.0,0.0,0.0,0.0,0.0,0.0,0.0,0.0,0.0,0.0,0.0,0.0,0.0,0.0,0.0,0.0,0.0,0.0,0.0,0.0,0.0,0.0,0.0,0.0,0.0,0.0,0.0,1.0,0.0,0.0,0.0,0.0,1.0,0.0,1.0,0.0,0.0,0.0,0.0,0.0,0.0,1.0,0.0,0.0
102166,0,0.0,0.0,0.0,1.0,0.0,135000.0,172021.5,18193.5,148500.0,0.018634,48.82739726027398,-4054.0,-8057.0,-1376.0,,1.0,2.0,2.0,17.0,,0.5802236317935382,0.6956219298394389,,,,,,,,,,,,,,,,,,,,,,,,,,,,,,,,,,,,,,,,,,,,,0.0,0.0,0.0,0.0,-1161.0,0.0,0.0,0.0,0.0,0.0,3.0,1.0,1.0,0.0,1.0,0.0,0.0,0.0,0.0,0.0,0.0,0.0,0.0,0.0,1.0,0.0,0.0,0.0,0.0,0.0,0.0,0.0,0.0,0.0,0.0,0.0,0.0,0.0,0.0,0.0,0.0,0.0,0.0,2.0,3345.75,,137076.75,30210.75,0.0,0.0,0.0,0.0,-1671.0,-666.5,-680.0,-1605.0,110.0,-27.0,6.0,16215.75,50850.0,42828.75,20340.0,135000.0,12.0,-284.5,365243.0,-319.0,365243.0,11.0,365243.0,17.5,1.0,0.2089870901757974,-1.0,26.0,12.0,6.5,-7.0,0.0,0.0,26.0,16165.575,16215.75,-202.5,-179.0,5.0,1.0,0.0,,,,,,,,,,,,,,,,,,,,,8344611009.0,184361656392.0,165551588064.0,51958969957.935,1863.0,1705.0,71125.0,70779.0,9140.0,505913.0,,,,,,,128381.0,662646.0,,,,13524388.399999604,-601719927.0,-921664886.0,-296423310.0,-1534774893.0416667,44004.0,30698.0,,,,,,,,158001.19507798748,126072.37002520706,,,,,,,3713268.0,,,,,,,,,,,,,,,,436369.0,431165.0,,6423.417325002895,631801.0,625353.0,,,,,,,,,55.0,32895447.705,,3502792368.45,1174018907.7900002,42548489.99999999,638619.57,63.0,9176.0,-11314005.0,5245228.5,-5835370.5,-6294387.0,-27.0,0.0,,26878.5,0.0,0.0,0.0,0.0,0.0,-1794.0,-1611.0,-1335.0,-1605.0,127133524.39499968,1824557519.4750016,2057329026.18,29626427.29499999,1824625019.4750016,133065.0,-9138004.5,2111086078.0,89487279.0,460107003.0,208424422.0,481086131.0,131868.0,2080.0,369.6748493362349,3194799.5,1095227.0,670902.0,-2189842.0,722649.0,97780.0,1458595180.6650195,1468177766.86501,-89755578.5,-89013774.5,1644072.5,73051.0,,,,,,,,,,,,,,,,,,,,,1467000.0,14764213.0,3231346.0,8552853.0,11604669.0,1415257.0,1058249991.739501,,72085971819.77963,21672444407.67012,582250914.791999,5792665.7475,689.5,94245.0,-276853773.5,21964828.0,-123758140.0,-218649157.0,-2017257.0,,,,,,,,,,,,,,,,,,,,,4271785.5,2478585.5,-9001145.5,921269.0,37582.5,3732413320.664962,3656981740.702461,-260558444.5,-257248321.5,2525904.5,269129.0,3925029511.0349545,33247059150.713413,36675452763.09014,1728960970.1175494,48070339124.13072,3987022.0,-247525529.0,103059732516.5,1053704096.0,17269343332.0,3502821308.5,18883180262.0,3671156.5,71897.5,20865.33711853517,89780410.0,-83.02715744585343,1.274233333333333,7.420232500618352,362.3106400712885,9.45510759337126,461.6682946001715,135000.0,-0.9009688679024191,-0.433883739117558,0.0,0.0,0.0,0.0,0.0,0.0,1.0,0.0,0.0,0.0,0.0,0.0,0.0,1.0,0.0,0.0,0.0,0.0,1.0,0.0,0.0,1.0,0.0,0.0,0.0,1.0,0.0,0.0,0.0,0.0,0.0,0.0,0.0,0.0,0.0,0.0,0.0,0.0,1.0,0.0,0.0,0.0,0.0,0.0,0.0,0.0,0.0,0.0,0.0,0.0,0.0,0.0,0.0,0.0,0.0,0.0,0.0,0.0,0.0,0.0,0.0,0.0,0.0,0.0,0.0,0.0,0.0,0.0,0.0,0.0,0.0,0.0,0.0,0.0,0.0,0.0,0.0,0.0,0.0,0.0,0.0,0.0,0.0,0.0,0.0,0.0,0.0,0.0,0.0,0.0,1.0,0.0,0.0,0.0,0.0,0.0,0.0,0.0,0.0,0.0,0.0,0.0,0.0,0.0,0.0,0.0,0.0,0.0,0.0,0.0,0.0,0.0,0.0,0.0,0.0,0.0,0.0,0.0,0.0,0.0
102174,0,0.0,0.0,0.0,0.0,0.0,112500.0,225000.0,23184.0,225000.0,0.018209,44.04109589041096,-1013.0,-5106.0,-4690.0,,1.0,3.0,3.0,18.0,0.669492470401641,0.4135137881281711,0.7981372313187245,0.2057,0.1324,0.9891,0.8504,0.0845,0.2,0.1724,0.375,0.4167,0.1176,0.1622,0.2102,0.0232,0.0263,0.209,0.1374,0.9891,0.8563,0.0853,0.2014,0.1724,0.375,0.4167,0.1202,0.1772,0.2189,0.0233,0.0278,0.2077,0.1324,0.9891,0.8524,0.085,0.2,0.1724,0.375,0.4167,0.1196,0.165,0.2139,0.0233,0.0268,0.171,1.0,1.0,0.0,1.0,0.0,-2836.0,0.0,0.0,0.0,0.0,0.0,3.0,1.0,1.0,1.0,1.0,1.0,0.0,0.0,0.0,0.0,0.0,0.0,0.0,0.0,1.0,0.0,0.0,0.0,0.0,0.0,0.0,0.0,0.0,0.0,0.0,0.0,0.0,0.0,0.0,0.0,0.0,0.0,0.0,5.0,0.0,,65250.0,0.0,0.0,0.0,0.0,0.0,-1671.0,-1550.0,-1010.0,-1533.0,280.0,-27.5,5.0,11274.5475,39078.0,34101.0,5220.0,73584.0,8.0,-680.0,365243.0,-1584.5,-1404.5,-1374.5,-1400.5,12.0,0.5,0.1980165289256196,32.0,27.0,10.0,5.0,-82.0,0.0,0.0,68.0,4549.095,4549.095,-426.5,-422.0,10.5,0.0,19.0,9986.085,360000.0,0.0,27000.0,0.0,28023.6375,0.0,38491.47,38170.935,7504.065,9921.825,9921.825,0.0,3.0,0.0,3.5,5.0,-10.0,0.0,0.0,8344634193.0,184361881392.0,165551813064.0,51959082457.935,1863.0,1705.0,71125.0,70779.0,9140.0,505916.0,17803.953600002293,17866.114999999114,17317.663099998055,11293.498800000089,11231.317100000091,11178.601400000054,128381.0,662647.0,4136.982500000121,4134.651700000016,3945.2778000000953,13524432.441095496,-601720940.0,-921669576.0,-296426146.0,-1534779999.0416667,44004.0,30698.0,11346.82879999918,11222.799999998972,10707.158199997297,22882.56720000968,22804.44360000964,22189.9670000082,67437.80804766373,158001.6085917756,126073.16816243836,34991.83640002792,34932.199600028354,34378.25860002876,22948.24819999592,22921.504799995488,22568.789699995723,3713286.0,8293.917000000167,8398.421600000078,8122.030400000227,9815.473800000718,9930.399200002155,10290.025399999648,16464.10549999975,16649.33309999969,16246.0876999997,828.5853000001761,813.7614000000459,759.7322000000131,3913.198300000125,3896.3600000001616,3728.986700000159,436370.0,431166.0,,6423.435534002895,631804.0,625356.0,,16328.714899999795,154140.43739999054,154143.1859999901,154034.9552999871,77591.66959999624,77929.4103000066,78330.80370000651,55.0,33385625.505,,3516791422.0499988,1181862834.795,42769798.65,638619.57,64.0,9176.0,-11365518.0,5250103.0,-5865152.0,-6323628.0,-27.0,0.0,,112500.0,0.0,0.0,0.0,0.0,0.0,-1672.0,-1550.0,-1494.0,-1550.0,127323256.74749967,1826563482.0000017,2059667349.705,29668092.79499999,1826617527.0000017,133210.0,-9154852.0,2115650667.5,89473080.5,461192970.5,209144844.5,482172267.5,132123.0,2082.0,370.6463186033008,3195455.0,1096512.0,671535.0,-2194503.0,722674.0,97781.0,1460962237.5900211,1470479817.4650116,-89891275.0,-89148230.0,1646748.0,73181.0,1404392735.9700007,3693406500.0,121302987.57,189300487.18499973,7809564.6000000015,60028044.07499997,79748569.39499988,205323505.0650004,189301649.445,1348056472.0949998,1398810602.2949998,1398865774.23,6141.0,15881.0,106.0,9633.5,454971.0,-807433.0,274829.0,816.0,1467005.0,14764493.0,3231365.0,8552880.0,11604737.0,1415262.0,1058249991.739501,,72086037069.77963,21672444407.67012,582250914.791999,5792665.7475,689.5,94245.0,-276855444.5,21963278.0,-123759150.0,-218650690.0,-2017284.5,5920438297.432462,18716343750.0,198760895.325,447854900.1524977,1948107.735,256684196.49750075,308996081.3924987,636382109.789998,459030928.9949993,5705667956.700031,5883734497.972499,5883977680.7175,13378.0,80815.0,44.0,70331.0,971193.5,-1697827.0,177364.0,6755.0,4271795.5,2478590.5,-9001227.5,921269.0,37582.5,3732417869.7599616,3656986289.797461,-260558871.0,-257248743.5,2525915.0,269129.0,3925040785.582455,33247098228.713413,36675486864.09014,1728966190.1175494,48070412708.13072,3987030.0,-247526209.0,103060097759.5,1053702511.5,17269341927.5,3502819934.0,18883178861.5,3671168.5,71898.0,20865.5351350641,89780442.0,-23.001244167962675,2.0,4.8524844720496905,213.70873394027055,9.70496894409938,427.4174678805412,112500.0,1.0,0.0,0.0,0.0,0.0,0.0,0.0,0.0,1.0,0.0,1.0,0.0,0.0,0.0,0.0,0.0,0.0,0.0,0.0,0.0,1.0,0.0,0.0,0.0,1.0,0.0,0.0,1.0,0.0,0.0,0.0,0.0,0.0,0.0,0.0,1.0,0.0,0.0,0.0,0.0,0.0,0.0,0.0,0.0,0.0,0.0,0.0,0.0,0.0,0.0,0.0,0.0,0.0,0.0,0.0,0.0,0.0,0.0,0.0,0.0,0.0,0.0,0.0,0.0,0.0,0.0,0.0,0.0,0.0,0.0,0.0,0.0,0.0,0.0,0.0,0.0,0.0,0.0,0.0,0.0,0.0,0.0,0.0,0.0,0.0,0.0,0.0,0.0,0.0,0.0,0.0,0.0,1.0,0.0,0.0,0.0,0.0,0.0,0.0,0.0,0.0,0.0,0.0,0.0,0.0,0.0,0.0,0.0,0.0,1.0,0.0,0.0,1.0,0.0,0.0,0.0,0.0,0.0,0.0,1.0,0.0,0.0
102193,0,0.0,1.0,0.0,1.0,0.0,135000.0,382050.0,27801.0,337500.0,0.018801,55.75616438356165,-1486.0,-4757.0,-3044.0,,2.0,2.0,2.0,9.0,,0.1067763936299226,0.6109913280868294,,,,,,,,,,,,,,,,,,,,,,,,,,,,,,,,,,,,,,,,,,,,,0.0,0.0,0.0,0.0,-1887.0,0.0,0.0,0.0,0.0,1.0,5.0,1.0,1.0,0.0,1.0,0.0,0.0,0.0,0.0,0.0,1.0,1.0,0.0,0.0,1.0,0.0,0.0,0.0,0.0,0.0,0.0,0.0,0.0,0.0,0.0,0.0,0.0,0.0,0.0,0.0,0.0,0.0,0.0,3.0,1687.5,,108000.0,48937.5,0.0,0.0,0.0,0.0,-410.0,950.0,-166.0,-1894.0,101.0,-30.0,11.0,22500.0,90000.0,212737.5,0.0,227250.0,12.0,-514.0,365243.0,-1206.0,-611.5,-581.5,-607.5,14.0,0.5,0.0,-1.0,37.0,12.0,6.0,-31.0,0.0,0.0,106.0,17074.7775,16159.95,-688.5,-692.5,15.5,0.0,47.0,359803.935,450000.0,0.0,0.0,0.0,0.0,18231.6375,18231.8175,18000.0,344198.52,359803.935,359803.935,0.0,0.0,0.0,0.0,22.5,-24.0,0.0,0.0,8344661994.0,184362263442.0,165552150564.0,51959217457.935,1863.0,1705.0,71125.0,70780.0,9140.0,505921.0,,,,,,,128381.0,662649.0,,,,13524488.19725988,-601722426.0,-921672620.0,-296428033.0,-1534784756.0416667,44004.0,30698.0,,,,,,,,158001.71536816924,126073.77915376645,,,,,,,3713295.0,,,,,,,,,,,,,,,,436370.0,431166.0,,6423.454335002895,631806.0,625358.0,,,,,,,,,14.0,33426085.005,,3533383817.9549994,1187162135.01,42797827.935,638619.57,64.0,9176.0,-11445483.0,5241965.0,-5907064.0,-6368041.0,-6.5,0.0,,202500.0,0.0,0.0,0.0,0.0,0.0,-2437.0,-1891.0,-810.0,-1894.0,128527972.33499964,1842915244.1400013,2077722677.205,29846980.93499999,1843013206.8900013,134306.0,-9250003.0,2131898799.5,90143705.5,465348946.0,211846768.0,486695534.0,133309.0,2101.0,373.4544607149904,3207580.0,1104748.0,676547.0,-2212797.0,723025.0,97919.0,1474604444.3400214,1482849425.8350098,-91106939.5,-90357086.0,1671972.0,73723.0,1433687482.4400008,3756856500.0,123824787.57,192339695.02499968,7809564.6000000015,60547981.09499998,81309361.7699999,208490082.885,192106831.45499992,1376202500.595,1428026122.3949995,1428081294.3299994,6268.0,16113.0,106.0,9739.0,465377.0,-825788.0,274838.0,825.0,1467008.0,14764594.0,3231412.0,8552917.0,11604843.0,1415273.0,1058251679.239501,,72086145069.77963,21672493345.17012,582250914.791999,5792665.7475,689.5,94245.0,-276855854.5,21964228.0,-123759316.0,-218652584.0,-2017314.5,5920798101.367462,18716793750.0,198760895.325,447854900.1524977,1948107.735,256684196.49750075,309014313.02999866,636400341.607498,459048928.9949993,5706012155.220032,5884094301.907499,5884337484.6525,13378.0,80815.0,44.0,70331.0,971216.0,-1697851.0,177364.0,6755.0,4271807.5,2478596.5,-9001258.5,921269.0,37582.5,3732434944.5374618,3657002449.747461,-260559559.5,-257249436.0,2525930.5,269129.0,3925063285.582455,33247188228.713413,36675699601.59014,1728966190.1175494,48070639958.13072,3987042.0,-247526723.0,103060463002.5,1053701305.5,17269341316.0,3502819352.5,18883178254.0,3671182.5,71898.5,20865.5351350641,89780441.0,-26.65176158419733,2.83,4.855940433797344,270.74861306358844,13.74231142764649,766.2185749699553,67500.0,0.6234898018587336,0.7818314824680298,0.0,0.0,0.0,0.0,1.0,0.0,0.0,0.0,1.0,0.0,0.0,0.0,0.0,0.0,0.0,0.0,0.0,0.0,1.0,0.0,1.0,0.0,0.0,0.0,0.0,1.0,0.0,0.0,0.0,0.0,0.0,0.0,0.0,0.0,0.0,0.0,0.0,0.0,0.0,1.0,0.0,0.0,0.0,0.0,0.0,0.0,0.0,0.0,0.0,0.0,0.0,0.0,0.0,1.0,0.0,0.0,0.0,0.0,0.0,0.0,0.0,0.0,0.0,0.0,0.0,0.0,0.0,0.0,0.0,0.0,0.0,0.0,0.0,0.0,0.0,0.0,0.0,0.0,0.0,0.0,0.0,0.0,0.0,0.0,0.0,0.0,0.0,0.0,0.0,0.0,0.0,0.0,0.0,0.0,0.0,0.0,0.0,0.0,0.0,0.0,0.0,0.0,0.0,0.0,0.0,0.0,0.0,0.0,0.0,0.0,0.0,0.0,0.0,0.0,0.0,0.0,0.0,0.0,0.0,0.0
102198,0,0.0,1.0,0.0,1.0,0.0,94500.0,1226700.0,39703.5,900000.0,0.020246,56.909589041095884,,-10369.0,-4311.0,,2.0,3.0,3.0,11.0,0.6629549104911415,0.4598793087223197,0.7544061731797895,,,,,,,,,,,,,,,,,,,,,,,,,,,,,,,,,,,,,,,,,,,,,2.0,0.0,2.0,0.0,-2059.0,0.0,0.0,0.0,0.0,0.0,1.0,1.0,0.0,0.0,1.0,0.0,0.0,0.0,0.0,0.0,0.0,0.0,0.0,0.0,0.0,0.0,0.0,1.0,0.0,0.0,0.0,0.0,0.0,0.0,0.0,0.0,0.0,0.0,0.0,0.0,0.0,0.0,0.0,9.0,0.0,0.0,116550.0,0.0,0.0,0.0,0.0,0.0,-1250.0,-882.0,-834.0,-1068.0,473.0,-26.0,1.0,12176.775,112500.0,109602.0,11250.0,112500.0,10.0,-2059.0,365243.0,-2025.0,-1755.0,-1755.0,-1751.0,9.0,0.0,0.1013824572805806,62.0,10.0,10.0,5.5,-62.5,0.0,0.0,10.0,12176.775,12176.775,-1895.0,-1890.0,5.5,1.0,0.0,,,,,,,,,,,,,,,,,,,,,8344701697.5,184363490142.0,165553050564.0,51959311957.935,1863.0,1705.0,71125.0,70780.0,9140.0,505922.0,,,,,,,128381.0,662651.0,,,,13524545.10684892,,-921676931.0,-296430092.0,-1534795125.0416667,44004.0,30698.0,,,,,,,67438.47100257422,158002.17524747798,126074.5335599396,,,,,,,3713306.0,,,,,,,,,,,,,,,,436372.0,431168.0,,6423.474581002895,631809.0,625361.0,,,,,,,,,42.0,33427772.505,10103772.375000002,3540752398.3499994,1188115221.915,42797827.935,638619.57,64.0,9176.0,-11478516.0,5230125.0,-5920098.0,-6387252.5,-20.5,0.0,0.0,82800.0,0.0,0.0,0.0,0.0,0.0,-2112.0,-1288.0,-834.0,-1726.0,128866384.57499966,1847844161.2800016,2083621979.205,29939374.57499999,1847844161.2800016,134624.0,-9275395.0,2135913506.0,90128065.0,465886583.0,212386344.0,487598891.0,133655.0,2104.0,374.8658041995985,3213521.0,1106670.0,677706.0,-2216577.5,723035.0,97929.0,1479033840.8025222,1487144544.6375108,-91323673.0,-90572557.5,1677561.0,73851.5,,,,,,,,,,,,,,,,,,,,,1467017.0,14765067.0,3231412.0,8552927.0,11604853.0,1415274.0,1058251679.239501,801584051.827495,72086261619.77963,21672493345.17012,582250914.791999,5792665.7475,689.5,94245.0,-276857104.5,21963346.0,-123760150.0,-218653652.0,-2017340.5,,,,,,,,,,,,,,,,,,,,,4271817.5,2478602.0,-9001321.0,921269.0,37582.5,3732447121.3124623,3657014626.522461,-260561454.5,-257251326.0,2525936.0,269130.0,3925075462.357455,33247300728.713413,36675809203.59014,1728977440.1175494,48070752458.13072,3987052.0,-247528782.0,103060828245.5,1053699280.5,17269339561.0,3502817597.5,18883176503.0,3671191.5,71898.5,20865.636517521383,89780503.0,,12.98095238095238,2.380142808568514,135.4529490947539,30.89652045789414,1758.308282058567,47250.0,1.0,0.0,0.0,0.0,0.0,0.0,0.0,1.0,0.0,0.0,0.0,1.0,0.0,0.0,0.0,0.0,0.0,0.0,0.0,0.0,1.0,0.0,1.0,0.0,0.0,0.0,0.0,1.0,0.0,0.0,0.0,0.0,0.0,0.0,0.0,0.0,0.0,0.0,0.0,0.0,0.0,0.0,0.0,0.0,0.0,0.0,0.0,0.0,0.0,0.0,0.0,0.0,0.0,0.0,0.0,0.0,0.0,0.0,0.0,0.0,0.0,0.0,0.0,0.0,0.0,0.0,0.0,0.0,0.0,0.0,0.0,0.0,0.0,0.0,0.0,0.0,0.0,0.0,0.0,0.0,0.0,0.0,0.0,0.0,0.0,0.0,0.0,0.0,0.0,0.0,0.0,0.0,0.0,0.0,0.0,0.0,0.0,0.0,0.0,0.0,0.0,0.0,0.0,0.0,0.0,0.0,0.0,1.0,0.0,0.0,0.0,0.0,0.0,0.0,0.0,0.0,0.0,0.0,0.0,0.0,0.0,0.0
102205,0,0.0,0.0,0.0,1.0,0.0,292500.0,495000.0,25402.5,495000.0,0.00702,47.20821917808219,-3166.0,-6376.0,-774.0,,2.0,2.0,2.0,12.0,0.5569462985066813,0.402575306672201,0.3185955240537633,,,,,,,,,,,,,,,,,,,,,,,,,,,,,,,,,,,,,,,,,,,,,3.0,2.0,3.0,1.0,-3340.0,0.0,0.0,0.0,0.0,0.0,0.0,1.0,1.0,0.0,1.0,0.0,0.0,0.0,0.0,0.0,0.0,0.0,0.0,0.0,1.0,0.0,0.0,0.0,0.0,0.0,0.0,0.0,0.0,0.0,0.0,0.0,0.0,0.0,0.0,0.0,0.0,0.0,0.0,14.0,4274.055,0.0,126000.0,0.0,0.0,0.0,0.0,0.0,-305.5,-32.0,-120.0,-265.5,255.0,-12.0,28.0,10213.695,14314.5,14314.5,5004.0,136311.525,10.0,-383.0,365243.0,-459.0,-309.0,-309.0,-303.0,11.0,0.0,0.1089413674811261,-1.0,21.0,6.0,3.0,-14.0,0.0,0.0,18.0,8051.04,8051.04,-400.0,-384.0,3.5,1.0,0.0,,,,,,,,,,,,,,,,,,,,,8344727100.0,184363985142.0,165553545564.0,51959604457.935,1863.0,1705.0,71125.0,70780.0,9140.0,505922.0,,,,,,,128381.0,662653.0,,,,13524592.315068098,-601725592.0,-921677705.0,-296433432.0,-1534801501.0416667,44006.0,30699.0,,,,,,,67439.02794887272,158002.57782278466,126074.85215546364,,,,,,,3713318.0,,,,,,,,,,,,,,,,436375.0,431171.0,,6423.481601002895,631811.0,625363.0,,,,,,,,,10.5,33438678.705,10178049.240000002,3554850988.8899994,1193485274.415,42878234.06999999,638619.57,64.0,9176.0,-11511533.5,5218488.0,-5941841.5,-6410225.0,-4.75,0.0,0.0,102577.5,0.0,0.0,0.0,0.0,0.0,-1303.0,-998.0,-950.0,-953.0,129191168.51999964,1852236661.9050016,2089653198.705,29997000.67499999,1852176035.8800013,134985.0,-9305827.0,2140657780.0,90473253.0,467331285.0,213834600.0,489045696.0,134059.0,2107.0,376.0113067262562,3218298.0,1108047.0,678604.0,-2222036.0,723063.0,97948.0,1481545659.802517,1489582266.097505,-91662533.5,-90909858.5,1685930.5,73949.5,,,,,,,,,,,,,,,,,,,,,1467031.0,14765322.0,3231412.0,8552948.0,11604871.0,1415302.0,1058255953.294501,801584051.827495,72086387619.77963,21672493345.17012,582250914.791999,5792665.7475,689.5,94245.0,-276857410.0,21963314.0,-123760270.0,-218653917.5,-2017352.5,,,,,,,,,,,,,,,,,,,,,4271823.5,2478605.0,-9001335.0,921269.0,37582.5,3732455172.3524623,3657022677.562461,-260561854.5,-257251710.0,2525939.5,269131.0,3925085676.052456,33247315043.213413,36675823518.09014,1728982444.1175494,48070888769.65572,3987062.0,-247529165.0,103061193488.5,1053698821.5,17269339252.0,3502817288.5,18883176200.0,3671202.5,71898.5,20865.74545888886,89780502.0,-67.06459288491672,1.6923076923076923,11.514614703277235,543.5844546634796,19.486271036315323,919.9121540458884,146250.0,0.6234898018587336,0.7818314824680298,0.0,1.0,0.0,0.0,0.0,0.0,0.0,0.0,1.0,0.0,0.0,0.0,0.0,0.0,0.0,0.0,0.0,0.0,1.0,0.0,1.0,0.0,0.0,0.0,0.0,1.0,0.0,0.0,0.0,0.0,0.0,0.0,0.0,0.0,0.0,0.0,0.0,0.0,0.0,0.0,0.0,0.0,0.0,0.0,1.0,0.0,0.0,0.0,0.0,0.0,0.0,0.0,0.0,0.0,0.0,0.0,0.0,0.0,0.0,0.0,0.0,0.0,0.0,0.0,0.0,0.0,0.0,0.0,0.0,0.0,0.0,0.0,0.0,0.0,0.0,0.0,0.0,0.0,0.0,0.0,0.0,0.0,0.0,0.0,0.0,0.0,0.0,0.0,0.0,0.0,1.0,0.0,0.0,0.0,0.0,0.0,0.0,0.0,0.0,0.0,0.0,0.0,0.0,0.0,0.0,0.0,0.0,0.0,0.0,0.0,0.0,0.0,0.0,0.0,0.0,0.0,0.0,0.0,0.0,0.0
102206,0,0.0,0.0,0.0,0.0,1.0,112500.0,225000.0,16132.5,225000.0,0.025164,43.77260273972602,-9271.0,-9181.0,-4878.0,,3.0,2.0,2.0,10.0,0.521740930442588,0.7522769679006506,0.6041125998015721,,,,,,,,,,,,,,,,,,,,,,,,,,,,,,,,,,,,,,,,,,,,,2.0,0.0,2.0,0.0,-2005.0,0.0,0.0,0.0,0.0,1.0,4.0,1.0,1.0,1.0,1.0,1.0,0.0,0.0,0.0,0.0,0.0,0.0,0.0,0.0,1.0,0.0,0.0,0.0,0.0,0.0,0.0,0.0,0.0,0.0,0.0,0.0,0.0,0.0,0.0,0.0,0.0,0.0,0.0,4.0,0.0,0.0,123750.0,0.0,0.0,0.0,0.0,0.0,-1433.0,-1270.5,-1056.5,-1193.0,199.0,-26.0,17.0,8236.8,37750.5,37336.5,1800.0,67738.5,12.0,-434.0,365243.0,-878.0,-758.0,-548.0,-753.0,12.0,0.0,0.0487889308585915,-1.0,59.0,7.0,5.0,-30.0,0.0,0.0,53.0,8236.8,8236.8,-874.0,-818.0,4.0,1.0,14.0,0.0,123750.0,,0.0,,,0.0,,0.0,0.0,0.0,0.0,,0.0,,,0.0,-7.5,0.0,0.0,8344743232.5,184364210142.0,165553770564.0,51959716957.935,1863.0,1705.0,71125.0,70781.0,9140.0,505926.0,,,,,,,128382.0,662656.0,,,,13524636.087670837,-601734863.0,-921682583.0,-296435437.0,-1534810682.0416667,44006.0,30699.0,,,,,,,67439.54968980317,158003.33009975255,126075.45626806346,,,,,,,3713328.0,,,,,,,,,,,,,,,,436377.0,431173.0,,6423.506765002896,631813.0,625365.0,,,,,,,,,47.5,33495679.935,10186950.240000002,3557292193.8899994,1194582392.415,42878234.06999999,638619.57,64.0,9176.0,-11519152.0,5216649.5,-5946239.0,-6414891.0,-23.25,0.0,0.0,180000.0,0.0,0.0,0.0,0.0,0.0,-1820.0,-1679.0,-1190.0,-1193.0,129362455.61999965,1855314540.8550012,2093423274.63,30013157.47499999,1854837540.8550012,135223.0,-9317953.0,2142849238.0,90472932.0,467696507.0,213834805.0,489771964.0,134312.0,2109.0,376.2792534619146,3219236.0,1108499.0,678895.0,-2223037.0,723063.0,97948.0,1481939843.5350163,1489976449.8300045,-91684961.0,-90931656.0,1686110.0,74000.0,1455649998.93,3804286500.0,,193686651.62999973,,,82626792.47999997,,194336176.95000005,1397210674.2750006,1449959685.3449998,1450014857.28,,16165.0,,,470956.0,-833550.5,274859.0,828.0,1467035.0,14765521.0,3231426.0,8553007.0,11604924.0,1415319.0,1058255953.294501,801584051.827495,72086511369.77963,21672493345.17012,582250914.791999,5792665.7475,689.5,94245.0,-276858843.0,21962043.5,-123761326.5,-218655110.5,-2017378.5,5920798101.367462,18716917500.0,,447854900.1524977,,,309014313.02999866,,459048928.9949993,5706012155.220032,5884094301.907499,5884337484.6525,,80815.0,,,971216.0,-1697858.5,177364.0,6755.0,4271830.5,2478610.0,-9001365.0,921269.0,37582.5,3732463409.152464,3657030914.362461,-260562728.5,-257252528.0,2525943.5,269132.0,3925093912.852456,33247352793.713413,36675860854.59014,1728984244.1175494,48070956508.15572,3987074.0,-247529599.0,103061558731.5,1053697943.5,17269338494.0,3502816740.5,18883175447.0,3671214.5,71898.5,20865.79424781972,89780501.0,-211.799148776366,2.0,6.973500697350071,305.248275730307,13.94700139470014,610.496551460614,37500.0,-0.2225209339563143,0.9749279121818236,0.0,0.0,0.0,0.0,0.0,0.0,1.0,0.0,0.0,0.0,0.0,0.0,0.0,1.0,0.0,0.0,0.0,0.0,1.0,1.0,0.0,0.0,0.0,0.0,0.0,1.0,0.0,0.0,0.0,0.0,0.0,0.0,0.0,0.0,0.0,0.0,1.0,0.0,0.0,0.0,0.0,0.0,0.0,0.0,0.0,0.0,0.0,0.0,0.0,0.0,0.0,0.0,0.0,0.0,0.0,0.0,0.0,0.0,0.0,0.0,0.0,0.0,0.0,0.0,0.0,0.0,0.0,0.0,0.0,0.0,0.0,0.0,0.0,0.0,0.0,0.0,0.0,0.0,0.0,0.0,0.0,0.0,0.0,0.0,0.0,0.0,0.0,0.0,0.0,0.0,0.0,0.0,0.0,0.0,0.0,0.0,0.0,0.0,0.0,0.0,0.0,0.0,0.0,0.0,1.0,0.0,0.0,0.0,0.0,0.0,0.0,0.0,0.0,0.0,0.0,0.0,0.0,0.0,0.0,0.0
102218,0,0.0,0.0,0.0,0.0,0.0,90000.0,786528.0,43915.5,720000.0,0.00702,48.83561643835616,-909.0,-9788.0,-1372.0,,2.0,2.0,2.0,14.0,0.6648976653388068,0.4975089997529201,0.7688075728291359,,,,,,,,,,,,,,,,,,,,,,,,,,,,,,,,,,,,,,,,,,,,,6.0,1.0,6.0,1.0,-2389.0,0.0,0.0,0.0,0.0,0.0,4.0,1.0,1.0,1.0,1.0,0.0,0.0,0.0,0.0,0.0,0.0,0.0,0.0,0.0,1.0,0.0,0.0,0.0,0.0,0.0,0.0,0.0,0.0,0.0,0.0,0.0,0.0,0.0,0.0,0.0,0.0,0.0,0.0,8.0,0.0,0.0,119273.67,0.0,0.0,0.0,0.0,0.0,-1808.0,-1446.0,-1156.0,-1543.5,463.0,-31.0,4.0,15174.697500000002,51615.0,46453.5,10323.0,224865.0,17.0,-450.0,365243.0,-1483.5,181438.0,-1003.5,181439.5,12.5,0.5,0.1089090909090909,-1.0,26.0,24.0,10.5,-13.5,0.0,0.0,26.0,19730.115,19730.115,-416.0,-405.0,7.0,1.0,0.0,,,,,,,,,,,,,,,,,,,,,8344787148.0,184364996670.0,165554490564.0,51959806957.935,1863.0,1705.0,71125.0,70781.0,9140.0,505930.0,,,,,,,128382.0,662658.0,,,,13524684.923287274,-601735772.0,-921683955.0,-296437826.0,-1534820470.0416667,44007.0,30700.0,,,,,,,67440.21458746851,158003.8276087523,126076.22507563626,,,,,,,3713342.0,,,,,,,,,,,,,,,,436383.0,431179.0,,6423.513785002896,631815.0,625367.0,,,,,,,,,60.0,33636641.715,10222311.15,3590822085.749999,1196206269.84,43033845.465,638891.0099999999,64.0,10769.0,-11602307.0,5186922.0,-5993458.0,-6468450.0,-29.5,0.0,0.0,95964.84,0.0,0.0,0.0,0.0,0.0,-1897.0,-1662.0,-1250.0,-1641.0,130407544.55249964,1871391620.8350012,2111053653.63,30129198.70499999,1871218370.8350012,136437.0,-9384535.0,2156180330.5,91159506.0,471131307.5,214901910.0,492480214.5,135402.5,2122.5,378.836675518364,3246877.5,1113474.0,681867.5,-2234150.5,723093.0,97949.0,1489227409.2375107,1497397077.562499,-92355697.0,-91598035.0,1702943.0,74383.5,,,,,,,,,,,,,,,,,,,,,1467043.0,14765984.0,3231426.0,8553033.0,11604950.0,1415323.0,1058255953.294501,801584051.827495,72086630643.44963,21672493345.17012,582250914.791999,5792665.7475,689.5,94245.0,-276860651.0,21960597.5,-123762482.5,-218656654.0,-2017409.5,,,,,,,,,,,,,,,,,,,,,4271854.5,2478620.5,-9001378.5,921269.0,37582.5,3732483139.267463,3657050644.477461,-260563144.5,-257252933.0,2525950.5,269133.0,3925109087.549956,33247404408.713413,36675907308.09014,1728994567.1175494,48071181373.15572,3987091.0,-247530049.0,103061923974.5,1053696460.0,17269519932.0,3502815737.0,18883356886.5,3671227.0,71899.0,20865.903156910623,89780500.0,-18.613464235624125,8.7392,2.049390306383851,100.08323893504696,17.91003176554975,874.6474417011624,45000.0,0.6234898018587336,0.7818314824680298,0.0,0.0,0.0,0.0,0.0,0.0,1.0,0.0,1.0,0.0,0.0,0.0,0.0,0.0,0.0,0.0,0.0,0.0,1.0,0.0,1.0,0.0,0.0,0.0,0.0,1.0,0.0,0.0,0.0,0.0,0.0,0.0,0.0,0.0,0.0,0.0,0.0,0.0,0.0,0.0,0.0,0.0,0.0,0.0,1.0,0.0,0.0,0.0,0.0,0.0,0.0,0.0,0.0,0.0,0.0,0.0,0.0,0.0,0.0,0.0,0.0,0.0,0.0,0.0,0.0,0.0,0.0,0.0,0.0,0.0,0.0,0.0,0.0,0.0,0.0,0.0,0.0,0.0,0.0,0.0,0.0,0.0,0.0,0.0,0.0,0.0,0.0,0.0,0.0,0.0,1.0,0.0,0.0,0.0,0.0,0.0,0.0,0.0,0.0,0.0,0.0,0.0,0.0,0.0,0.0,0.0,0.0,0.0,0.0,0.0,0.0,0.0,0.0,0.0,0.0,0.0,0.0,0.0,0.0,0.0
102221,0,0.0,0.0,0.0,0.0,0.0,157500.0,522396.0,29299.5,472500.0,0.035792,43.84109589041096,-2736.0,-8276.0,-2845.0,,2.0,2.0,2.0,11.0,0.7017342549166703,0.587544827229703,0.4578995512067301,,,,,,,,,,,,,,,,,,,,,,,,,,,,,,,,,,,,,,,,,,,,,0.0,0.0,0.0,0.0,-2555.0,0.0,0.0,0.0,0.0,1.0,3.0,1.0,1.0,0.0,1.0,0.0,0.0,0.0,0.0,0.0,0.0,0.0,0.0,0.0,1.0,0.0,0.0,0.0,0.0,0.0,0.0,0.0,0.0,0.0,0.0,0.0,0.0,0.0,0.0,0.0,0.0,0.0,0.0,8.0,0.0,0.0,49326.39,0.0,0.0,0.0,0.0,0.0,-1783.5,-1421.0,-1212.5,-1228.0,420.0,-28.5,4.0,17603.2125,202500.0,223290.0,2472.75,202500.0,12.0,-1395.5,365243.0,-2374.0,-2104.0,-2074.0,-2094.5,15.0,0.5,0.0506907889670891,-0.5,32.0,10.0,7.0,-76.0,0.0,0.0,21.0,20983.995,6427.395,-2256.0,-2252.0,6.0,1.0,94.0,0.0,0.0,,0.0,,,0.0,,0.0,0.0,0.0,0.0,,0.0,,,0.0,-49.5,0.0,0.0,8344816447.5,184365519066.0,165554963064.0,51959964457.935,1863.0,1705.0,71125.0,70782.0,9140.0,505933.0,,,,,,,128382.0,662660.0,,,,13524728.764383163,-601738508.0,-921686800.0,-296440381.0,-1534828746.0416667,44007.0,30700.0,,,,,,,67440.91632172343,158004.41515357952,126076.68297518748,,,,,,,3713353.0,,,,,,,,,,,,,,,,436383.0,431179.0,,6423.549577002896,631817.0,625369.0,,,,,,,,,59.0,33818126.715,10222311.15,3595567898.7,1197200498.5349998,43238632.725,638891.0099999999,64.0,10769.0,-11637693.5,5192340.0,-6017399.0,-6493034.0,-29.0,0.0,0.0,49324.5,0.0,0.0,0.0,0.0,0.0,-2049.0,-1421.0,-1227.0,-1228.0,130518747.15749964,1872360398.8350012,2112026810.13,30179175.70499999,1872360398.8350012,136525.0,-9394340.5,2158736508.5,91152819.0,472404447.0,215628235.0,493753367.5,135548.0,2123.5,379.7763282830862,3247241.5,1114114.0,682324.0,-2235975.0,723093.0,97949.0,1490548498.8300097,1498718167.154997,-92402354.0,-91644124.0,1703826.0,74427.0,1460727565.5149994,3829684500.0,,194915405.4299997,,,82918163.29499997,,195385774.77000004,1402082887.995,1455008335.6950002,1455066342.6300006,,16387.0,,,474896.0,-846385.0,274871.0,840.0,1467051.0,14766404.0,3231520.0,8553065.0,11604971.0,1415327.0,1058255953.294501,801584051.827495,72086679969.83961,21672493345.17012,582250914.791999,5792665.7475,689.5,94245.0,-276862434.5,21959176.5,-123763695.0,-218657882.0,-2017438.0,5920798101.367462,18716917500.0,,447854900.1524977,,,309014313.02999866,,459048928.9949993,5706012155.220032,5884094301.907499,5884337484.6525,,80815.0,,,971216.0,-1697908.0,177364.0,6755.0,4271864.5,2478627.5,-9001454.5,921269.0,37582.5,3732504123.2624617,3657057071.872461,-260565400.5,-257255185.0,2525956.5,269134.0,3925126690.762456,33247606908.713413,36676130598.09014,1728997039.8675494,48071383873.15572,3987103.0,-247531444.5,103062289217.5,1053694086.0,17269517828.0,3502813663.0,18883354792.0,3671242.0,71899.5,20865.9538476996,89780499.5,-62.40719910011248,3.3168,5.375518353555522,235.66861559889168,17.829519275072954,781.6656642184039,78750.0,-0.9009688679024191,-0.433883739117558,0.0,0.0,0.0,0.0,0.0,0.0,1.0,0.0,0.0,0.0,0.0,0.0,0.0,1.0,0.0,0.0,0.0,0.0,1.0,0.0,1.0,0.0,0.0,0.0,0.0,1.0,0.0,0.0,0.0,0.0,0.0,0.0,0.0,0.0,0.0,0.0,0.0,0.0,0.0,0.0,1.0,0.0,0.0,0.0,0.0,0.0,0.0,0.0,0.0,0.0,0.0,0.0,0.0,0.0,0.0,0.0,0.0,0.0,0.0,0.0,0.0,0.0,0.0,0.0,0.0,0.0,0.0,0.0,0.0,0.0,0.0,0.0,0.0,0.0,0.0,0.0,0.0,0.0,0.0,0.0,0.0,0.0,0.0,0.0,0.0,0.0,0.0,0.0,0.0,0.0,1.0,0.0,0.0,0.0,0.0,0.0,0.0,0.0,0.0,0.0,0.0,0.0,0.0,0.0,0.0,0.0,0.0,0.0,0.0,0.0,0.0,0.0,0.0,0.0,0.0,0.0,0.0,0.0,0.0,0.0
102230,0,0.0,1.0,1.0,1.0,0.0,270000.0,646389.0,31225.5,558000.0,0.072508,49.85753424657535,-694.0,-3437.0,-1741.0,7.0,2.0,1.0,1.0,17.0,0.4395700072611405,0.6618721784739009,0.3706496323299817,,,,,,,,,,,,,,,,,,,,,,,,,,,,,,,,,,,,,,,,,,,,,1.0,0.0,1.0,0.0,-1242.0,0.0,0.0,0.0,0.0,1.0,0.0,1.0,1.0,0.0,1.0,0.0,1.0,0.0,0.0,0.0,0.0,0.0,0.0,0.0,0.0,0.0,0.0,0.0,0.0,1.0,0.0,0.0,0.0,0.0,0.0,0.0,0.0,0.0,0.0,0.0,0.0,0.0,0.0,16.0,0.0,0.0,265500.0,0.0,0.0,0.0,0.0,0.0,-1241.0,-4.0,-276.0,-670.0,634.0,-25.0,5.0,8495.325,71460.0,71545.5,3573.0,71685.0,12.0,-766.0,365243.0,-1046.0,-399.0,-399.0,-394.0,13.0,0.0,0.0497290345516235,20.0,26.0,12.0,5.5,-26.5,0.0,0.0,88.0,7899.705,7899.705,-641.0,-630.5,20.5,0.0,35.0,251392.5,450000.0,0.0,4500.0,0.0,0.0,12203.235,12825.0,12825.0,238898.43,249302.61,249302.61,0.0,1.0,0.0,0.0,16.5,-18.0,0.0,0.0,8344847673.0,184366165455.0,165555521064.0,51960234457.935,1863.0,1705.0,71125.0,70783.0,9140.0,505933.0,,,,,,,128382.0,662662.0,,,,13524778.621917412,-601739202.0,-921688541.0,-296441623.0,-1534832183.0416667,44007.0,30700.0,,,,,,,67441.35589173071,158005.07702575802,126077.05362481982,,,,,,,3713370.0,,,,,,,,,,,,,,,,436384.0,431180.0,1262797.0,6423.622085002896,631818.0,625370.0,,,,,,,,,41.5,33933839.80500001,10367503.155,3619976976.9,1201238121.6899998,43330432.725,638891.0099999999,64.0,10769.0,-11721824.0,5192505.0,-6061794.5,-6540187.5,-20.25,0.0,0.0,141383.34,0.0,0.0,0.0,0.0,0.0,-1859.0,-398.0,-709.0,-1422.0,131246421.43499966,1887868330.1100016,2129717437.83,30313884.77999999,1887832375.1100016,137527.0,-9428231.0,2165492430.0,91497603.0,474216081.0,215981174.0,495565084.0,136360.0,2131.0,381.62267794396337,3326290.0,1116819.0,683879.0,-2243500.5,723156.0,97966.0,1493976386.7450044,1501956184.8599944,-92656623.0,-91896565.0,1705813.5,74651.0,1465023072.7799995,3842973000.0,125511522.39,195464075.53499976,7821039.6000000015,61974151.78499997,83093319.60749996,212107363.5600012,195576349.77000004,1406172223.2599998,1459258650.765,1459316657.7000003,6335.0,16427.0,107.0,9985.0,475191.0,-850037.0,274871.0,840.0,1467067.0,14767038.0,3231555.0,8553091.0,11605059.0,1415332.0,1058255953.294501,801584051.827495,72086945469.83961,21672493345.17012,582250914.791999,5792665.7475,689.5,94245.0,-276863675.5,21959172.5,-123763971.0,-218658552.0,-2017463.0,5921049493.867462,18717367500.0,198760895.325,447859400.1524977,1948107.735,256684196.49750075,309026516.2649987,636413166.607498,459061753.9949993,5706251053.650032,5884343604.517499,5884586787.2625,13378.0,80816.0,44.0,70331.0,971232.5,-1697926.0,177364.0,6755.0,4271876.5,2478633.0,-9001481.0,921269.0,37582.5,3732512022.9674616,3657064971.57746,-260566041.5,-257255815.5,2525977.0,269134.0,3925135186.087456,33247678368.713413,36676202143.59014,1729000612.8675494,48071455558.15572,3987115.0,-247532210.5,103062654460.5,1053693040.0,17269517429.0,3502813264.0,18883354398.0,3671255.0,71899.5,20866.003576734147,89780519.5,-13.919661501263876,2.394033333333333,8.646779074794638,431.1070838441447,20.700677331027524,1032.0847289590106,135000.0,0.6234898018587336,0.7818314824680298,0.0,0.0,0.0,0.0,0.0,0.0,1.0,0.0,0.0,0.0,0.0,0.0,0.0,1.0,0.0,0.0,0.0,0.0,1.0,0.0,1.0,0.0,0.0,0.0,0.0,1.0,0.0,0.0,0.0,0.0,0.0,0.0,0.0,0.0,0.0,0.0,0.0,0.0,0.0,0.0,1.0,0.0,0.0,0.0,0.0,0.0,0.0,0.0,0.0,0.0,0.0,0.0,0.0,0.0,0.0,0.0,0.0,0.0,0.0,0.0,0.0,0.0,0.0,0.0,0.0,0.0,0.0,0.0,0.0,0.0,0.0,0.0,0.0,0.0,0.0,0.0,0.0,0.0,0.0,0.0,0.0,0.0,0.0,0.0,0.0,0.0,0.0,0.0,0.0,0.0,0.0,0.0,0.0,0.0,0.0,0.0,0.0,0.0,0.0,0.0,0.0,0.0,0.0,1.0,0.0,0.0,0.0,0.0,0.0,0.0,0.0,0.0,0.0,0.0,0.0,0.0,0.0,0.0,0.0,0.0
102238,0,0.0,1.0,1.0,1.0,1.0,225000.0,823882.5,86512.5,787500.0,0.00963,29.19178082191781,-1244.0,-5170.0,-3192.0,13.0,3.0,2.0,2.0,15.0,,0.2332307674455009,0.6144143775673561,0.1206,0.1264,0.9806,0.7348,0.0156,0.0,0.2759,0.1667,0.0417,0.1103,0.0983,0.1088,0.0,0.0,0.1229,0.1311,0.9806,0.7452,0.0157,0.0,0.2759,0.1667,0.0417,0.1128,0.1074,0.1134,0.0,0.0,0.1218,0.1264,0.9806,0.7383,0.0157,0.0,0.2759,0.1667,0.0417,0.1122,0.1,0.1108,0.0,0.0,0.0941,1.0,0.0,0.0,0.0,0.0,-1242.0,0.0,0.0,0.0,0.0,1.0,5.0,1.0,1.0,0.0,1.0,0.0,0.0,0.0,0.0,0.0,0.0,0.0,0.0,0.0,1.0,0.0,0.0,0.0,0.0,0.0,0.0,0.0,0.0,0.0,0.0,0.0,0.0,0.0,0.0,0.0,0.0,0.0,0.0,3.0,0.0,0.0,43456.5,0.0,0.0,0.0,0.0,0.0,-1242.0,-876.0,-623.0,-734.0,154.0,-25.5,10.0,35613.9675,65182.5,69516.0,0.0,124686.0,6.0,-493.0,365243.0,-513.5,-408.5,-273.5,-400.5,17.0,0.0,0.0,-1.0,33.0,6.0,6.0,-16.0,0.0,0.0,34.0,30536.7075,46819.5075,-466.0,-445.0,3.5,1.0,0.0,,,,,,,,,,,,,,,,,,,,,8344934185.5,184366989337.5,165556308564.0,51960459457.935,1863.0,1705.0,71125.0,70784.0,9140.0,505938.0,17804.07420000229,17866.236799999115,17317.785999998054,11293.625200000088,11231.44350000009,11178.732500000056,128383.0,662665.0,4136.998100000121,4134.667400000016,3945.2935000000953,13524807.813698236,-601740446.0,-921691733.0,-296442865.0,-1534837353.0416667,44007.0,30700.0,11346.82879999918,11222.799999998972,10707.158199997297,22882.84310000968,22804.71950000964,22190.2429000082,,158005.31025652544,126077.6680391974,34992.00310002792,34932.36630002836,34378.425300028764,22948.28989999592,22921.546499995493,22568.83139999572,3713385.0,8294.027300000167,8398.533800000077,8122.143200000227,9815.572100000718,9930.499200002158,10290.132799999648,16464.214299999752,16649.44389999969,16246.2010999997,828.5853000001761,813.7614000000459,759.7322000000131,3913.198300000125,3896.3600000001616,3728.986700000159,436384.0,431180.0,1262810.0,6423.631715002895,631820.0,625372.0,,16328.808999999796,154141.41799999055,154144.1665999901,154035.93589998712,77592.40439999625,77930.14860000659,78331.54890000651,41.0,33995638.30500001,10388518.965000002,3632938373.745,1204309454.7599995,43385496.92999999,638891.0099999999,64.0,10769.0,-11773760.0,5169732.0,-6086203.0,-6565365.5,-20.0,0.0,0.0,35280.0,0.0,0.0,0.0,0.0,0.0,-2626.0,-2440.0,-623.0,-841.0,131754845.27249968,1892739193.1100016,2135488759.83,30436199.27999999,1892739193.1100016,137941.0,-9459442.0,2172614668.5,91474572.5,476208764.5,216331482.0,497557861.0,136770.5,2140.0,382.72748554430535,3332689.5,1122302.0,687155.0,-2252171.0,723212.0,98022.0,1499919431.962504,1507976388.5399942,-92939370.0,-92175744.0,1710316.0,75130.5,,,,,,,,,,,,,,,,,,,,,1467070.0,14767192.0,3231555.0,8553124.0,11605093.0,1415342.0,1058255953.294501,801584051.827495,72086988926.33961,21672493345.17012,582250914.791999,5792665.7475,689.5,94245.0,-276864917.5,21958296.5,-123764594.0,-218659286.0,-2017488.5,,,,,,,,,,,,,,,,,,,,,4271882.5,2478639.0,-9001497.0,921269.0,37582.5,3732542559.6749616,3657111791.084961,-260566507.5,-257256260.5,2525980.5,269135.0,3925170800.054957,33247743551.213413,36676271659.59014,1729000612.8675494,48071580244.15572,3987121.0,-247532703.5,103063019703.5,1053692526.5,17269517020.5,3502812990.5,18883353997.5,3671272.0,71899.5,20866.003576734147,89780518.5,-42.61473486625997,3.6617,2.6007802340702204,75.92140655895398,9.523276983094927,278.00141439692186,75000.0,-0.9009688679024191,-0.433883739117558,0.0,0.0,0.0,0.0,0.0,0.0,1.0,0.0,1.0,0.0,0.0,0.0,0.0,0.0,0.0,0.0,0.0,0.0,1.0,0.0,1.0,0.0,0.0,0.0,0.0,1.0,0.0,0.0,0.0,0.0,0.0,0.0,0.0,0.0,0.0,0.0,0.0,0.0,0.0,0.0,0.0,0.0,0.0,0.0,1.0,0.0,0.0,0.0,0.0,0.0,0.0,0.0,0.0,1.0,0.0,0.0,0.0,0.0,0.0,0.0,0.0,0.0,0.0,0.0,0.0,0.0,0.0,0.0,0.0,0.0,0.0,0.0,0.0,0.0,0.0,0.0,0.0,0.0,0.0,0.0,0.0,0.0,0.0,0.0,0.0,0.0,0.0,0.0,0.0,0.0,0.0,0.0,0.0,0.0,0.0,0.0,0.0,0.0,0.0,0.0,0.0,0.0,0.0,0.0,0.0,0.0,0.0,0.0,1.0,0.0,1.0,0.0,0.0,0.0,0.0,0.0,0.0,1.0,0.0,0.0
102248,0,0.0,0.0,0.0,1.0,0.0,360000.0,675000.0,29862.0,675000.0,0.04622,63.31506849315068,,-3321.0,-5138.0,,1.0,1.0,1.0,17.0,0.7226029324229877,0.6575768360982405,0.2188590822283744,,,,,,,,,,,,,,,,,,,,,,,,,,,,,,,,,,,,,,,,,,,,,1.0,0.0,1.0,0.0,-59.0,0.0,0.0,0.0,0.0,1.0,0.0,1.0,0.0,0.0,1.0,0.0,1.0,0.0,0.0,0.0,0.0,0.0,0.0,0.0,0.0,0.0,0.0,1.0,0.0,0.0,0.0,0.0,0.0,0.0,0.0,0.0,0.0,0.0,0.0,0.0,0.0,0.0,0.0,9.0,12377.25,0.0,270000.0,0.0,0.0,0.0,0.0,0.0,-523.0,-79.0,-5.0,-395.5,258.0,-14.0,4.0,16220.9025,127020.7125,122193.0,2308.5,127020.7125,15.0,-2497.5,365243.0,-2467.0,-2302.5,-2197.5,-2294.5,17.0,0.0,0.0544617794429131,94.0,31.0,17.0,5.0,-82.0,0.0,0.0,34.0,14986.53,1800.675,-2476.0,-2445.5,5.0,1.0,0.0,,,,,,,,,,,,,,,,,,,,,8344964047.5,184367664337.5,165556983564.0,51960819457.935,1863.0,1705.0,71125.0,70785.0,9140.0,505938.0,,,,,,,128383.0,662666.0,,,,13524871.128766729,,-921696871.0,-296442924.0,-1534840674.0416667,44007.0,30700.0,,,,,,,67442.07849466313,158005.96783336153,126077.88689827964,,,,,,,3713402.0,,,,,,,,,,,,,,,,436385.0,431181.0,,6423.677935002896,631821.0,625373.0,,,,,,,,,18.0,34082198.05500001,10406293.965000002,3654021899.025,1215321549.7049994,43767110.295,638891.0099999999,64.0,10769.0,-11850916.0,5230775.0,-6124259.0,-6605606.0,-8.5,0.0,0.0,152820.0,0.0,0.0,0.0,0.0,0.0,-927.0,-79.0,-5.0,-358.0,132203956.31999968,1899118243.8225017,2142720025.83,30501646.49249999,1899118243.8225017,138506.0,-9493635.0,2181377209.5,92180633.5,477835054.5,217414287.5,499184689.0,137463.0,2148.0,383.9613390420026,3338963.5,1125050.0,688977.0,-2259190.0,723212.0,98022.0,1505502953.4600089,1514524274.2799993,-93248907.0,-92482880.5,1715011.5,75378.5,,,,,,,,,,,,,,,,,,,,,1467079.0,14767450.0,3231555.0,8553155.0,11605127.0,1415346.0,1058268330.544501,801584051.827495,72087258926.33961,21672493345.17012,582250914.791999,5792665.7475,689.5,94245.0,-276865440.5,21958217.5,-123764599.0,-218659681.5,-2017502.5,,,,,,,,,,,,,,,,,,,,,4271899.5,2478644.0,-9001579.0,921269.0,37582.5,3732557546.204962,3657113591.759961,-260568983.5,-257258706.0,2525985.5,269136.0,3925187020.957456,33247870571.92591,36676393852.59014,1729002921.3675494,48071707264.86822,3987136.0,-247535201.0,103063384946.5,1053690059.5,17269514718.0,3502810793.0,18883351703.0,3671289.0,71899.5,20866.05803851359,89780612.5,,1.875,12.055455093429774,763.2919649566086,22.603978300180827,1431.1724342936411,360000.0,0.6234898018587336,0.7818314824680298,0.0,0.0,0.0,0.0,0.0,0.0,1.0,0.0,0.0,1.0,0.0,0.0,0.0,0.0,0.0,1.0,0.0,0.0,0.0,0.0,0.0,1.0,0.0,0.0,0.0,1.0,0.0,0.0,0.0,0.0,0.0,0.0,0.0,0.0,0.0,0.0,0.0,0.0,0.0,0.0,0.0,0.0,0.0,0.0,0.0,0.0,0.0,0.0,0.0,0.0,0.0,0.0,0.0,0.0,0.0,0.0,0.0,0.0,0.0,0.0,0.0,0.0,0.0,0.0,0.0,0.0,0.0,0.0,0.0,0.0,0.0,0.0,0.0,0.0,0.0,0.0,0.0,0.0,0.0,0.0,0.0,0.0,0.0,0.0,0.0,0.0,0.0,0.0,0.0,0.0,0.0,0.0,0.0,0.0,0.0,0.0,0.0,0.0,0.0,0.0,0.0,0.0,0.0,0.0,0.0,1.0,0.0,0.0,0.0,0.0,0.0,0.0,0.0,0.0,0.0,0.0,0.0,0.0,0.0,0.0
102252,0,0.0,0.0,0.0,1.0,0.0,54000.0,292500.0,23238.0,292500.0,0.015221,28.81369863013699,-3198.0,-958.0,-2477.0,,2.0,2.0,2.0,15.0,0.2648780869978553,0.0077315584543989,0.4956658291397297,,,,,,,,,,,,,,,,,,,,,,,,,,,,,,,,,,,,,,,,,,,,,4.0,3.0,4.0,2.0,-1303.0,0.0,0.0,0.0,0.0,1.0,2.0,1.0,1.0,0.0,1.0,1.0,0.0,0.0,0.0,0.0,0.0,1.0,1.0,0.0,1.0,0.0,0.0,0.0,0.0,0.0,0.0,0.0,0.0,0.0,0.0,0.0,0.0,0.0,0.0,0.0,0.0,0.0,0.0,6.0,0.0,0.0,85092.75,0.0,0.0,0.0,0.0,0.0,-710.5,-513.5,-446.0,-498.0,148.0,-12.0,3.0,9242.01,81540.0,90148.5,2542.5,81540.0,10.0,-935.0,365243.0,-904.0,-644.0,-644.0,-641.0,12.0,0.0,0.0505492782088526,300.0,32.0,10.0,5.0,-27.5,0.0,0.0,36.0,9242.01,6633.09,-814.0,-804.0,5.5,1.0,0.0,,,,,,,,,,,,,,,,,,,,,8344987285.5,184367956837.5,165557276064.0,51960873457.935,1863.0,1705.0,71125.0,70786.0,9140.0,505940.0,,,,,,,128383.0,662668.0,,,,13524899.942465356,-601743644.0,-921699348.0,-296444227.0,-1534841632.0416667,44010.0,30702.0,,,,,,,67442.34337275011,158005.97556492,126078.38256410876,,,,,,,3713417.0,,,,,,,,,,,,,,,,436389.0,431185.0,,6423.693156002895,631823.0,625375.0,,,,,,,,,24.0,34094575.30500001,10488635.010000002,3661536393.45,1217754133.8299994,43902208.17,639629.0099999999,64.0,10769.0,-11883896.0,5259270.0,-6139376.0,-6620776.0,-11.5,0.0,5215.5,99022.5,0.0,0.0,0.0,0.0,0.0,-910.5,-637.5,-606.0,-609.0,132411963.01499967,1901711747.2050016,2145622000.5,30524159.20499999,1901711747.2050016,138719.0,-9504342.0,2185212261.0,92534847.0,478557585.0,217409642.0,499907309.0,137674.0,2150.0,384.3086438964242,3345804.0,1126717.0,689938.5,-2262554.0,723280.0,98090.0,1507343352.1200128,1516249372.0500016,-93359449.5,-92592560.0,1715787.0,75502.5,,,,,,,,,,,,,,,,,,,,,1467085.0,14767598.0,3231555.0,8553187.0,11605163.0,1415349.0,1058268330.544501,801584051.827495,72087344019.08961,21672493345.17012,582250914.791999,5792665.7475,689.5,94245.0,-276866151.0,21957704.0,-123765045.0,-218660179.5,-2017514.5,,,,,,,,,,,,,,,,,,,,,4271909.5,2478649.0,-9001606.5,921269.0,37582.5,3732566788.2149625,3657120224.849961,-260569797.5,-257259510.0,2525991.0,269137.0,3925196262.967456,33247952111.92591,36676484001.09014,1729005463.8675494,48071788804.86822,3987146.0,-247536136.0,103063750189.5,1053689155.5,17269514074.0,3502810149.0,18883351062.0,3671301.0,71899.5,20866.1085877918,89780912.5,-110.98887515451176,5.416666666666668,2.323780015491866,66.95669704911771,12.587141750580946,362.6821090160543,27000.0,-0.9009688679024191,0.4338837391175582,0.0,0.0,0.0,0.0,0.0,0.0,1.0,0.0,1.0,0.0,0.0,0.0,0.0,0.0,0.0,0.0,0.0,0.0,1.0,0.0,1.0,0.0,0.0,0.0,0.0,1.0,0.0,0.0,0.0,0.0,0.0,0.0,0.0,0.0,0.0,0.0,0.0,0.0,0.0,0.0,0.0,1.0,0.0,0.0,0.0,0.0,0.0,0.0,0.0,0.0,0.0,0.0,0.0,0.0,0.0,0.0,0.0,0.0,0.0,0.0,0.0,0.0,0.0,0.0,0.0,0.0,0.0,0.0,0.0,0.0,0.0,0.0,0.0,0.0,0.0,0.0,0.0,0.0,1.0,0.0,0.0,0.0,0.0,0.0,0.0,0.0,0.0,0.0,0.0,0.0,0.0,0.0,0.0,0.0,0.0,0.0,0.0,0.0,0.0,0.0,0.0,0.0,0.0,0.0,0.0,0.0,0.0,0.0,0.0,0.0,0.0,0.0,0.0,0.0,0.0,0.0,0.0,0.0,0.0,0.0
102259,0,0.0,0.0,0.0,1.0,0.0,112500.0,314055.0,13329.0,238500.0,0.002134,52.153424657534245,,-312.0,-2063.0,,1.0,3.0,3.0,11.0,0.4828410190144304,0.6822062961410338,,0.0206,0.0226,0.9861,,,0.0,0.0345,0.2083,,,,0.008,,0.0178,0.021,0.0234,0.9861,,,0.0,0.0345,0.2083,,,,0.0083,,0.0189,0.0208,0.0226,0.9861,,,0.0,0.0345,0.2083,,,,0.0082,,0.0182,0.0155,1.0,10.0,0.0,9.0,0.0,-233.0,,,,,,,1.0,0.0,0.0,1.0,0.0,0.0,0.0,0.0,0.0,0.0,0.0,0.0,0.0,0.0,0.0,0.0,1.0,0.0,0.0,0.0,0.0,0.0,0.0,0.0,0.0,0.0,0.0,0.0,0.0,0.0,0.0,0.0,0.0,,,,,,,,,,,,,0.0,,1.0,12561.93,97200.0,105754.5,0.0,97200.0,10.0,-233.0,365243.0,-202.0,365243.0,68.0,365243.0,5.0,0.0,0.0,2000.0,7.0,10.0,7.0,-5.0,0.0,0.0,7.0,12561.93,12561.93,-121.0,-112.0,4.0,1.0,0.0,,,,,,,,,,,,,,,,,,,,,8345000614.5,184368270892.5,165557514564.0,51960985957.935,,,,,,,17804.09480000229,17866.25759999911,17317.806999998054,11293.647800000088,11231.46610000009,11178.755900000056,128383.0,662669.0,,,,13524952.095890015,,-921701411.0,-296444460.0,-1534841944.0416667,44010.0,30702.0,11346.82879999918,11222.799999998972,10707.158199997297,22882.87760000968,22804.75400000964,22190.2774000082,67442.82621376912,158006.65777121612,,34992.21140002792,34932.574600028354,34378.63360002876,,,,3713428.0,,,,,,,16464.222299999754,16649.45209999969,16246.2093999997,,,,3913.216100000125,3896.3782000001615,3729.005600000159,436399.0,431194.0,,6423.695290002896,631826.0,625378.0,,16328.824499999797,154142.40409999056,154145.1526999901,154036.92199998713,,,,,,,,,,,,,,,,,,,,,,,,,,,,,,133054987.31999972,1907620674.4350016,2155708223.73,30609393.70499999,1907620674.4350016,139234.0,-9539073.0,2195804308.0,93606626.0,480730214.0,218125239.0,501349383.0,138252.0,2161.0,385.8015730716879,3350164.0,1130031.0,691872.0,-2271165.0,723286.0,98096.0,1511777037.1500132,1520636023.800002,-93590542.0,-92821447.0,1717299.0,75801.0,,,,,,,,,,,,,,,,,,,,,1467085.0,14767598.0,3231555.0,8553194.0,11605170.0,1415350.0,,,,,,,,,,,,,,,,,,,,,,,,,,,,,,,,,,4271919.5,2478656.0,-9001611.5,921269.0,37582.5,3732579350.144962,3657132786.779961,-260569918.5,-257259622.0,2525995.0,269138.0,3925208824.897456,33248049311.92591,36676589755.59014,1729005463.8675494,48071886004.86822,3987156.0,-247536369.0,103064115432.5,1053688953.5,17269879317.0,3502810217.0,18883716305.0,3671306.0,71899.5,20866.1085877918,89782912.5,,2.7916,8.440243079000675,440.18758151193657,23.561782579338285,1228.8276525487222,112500.0,-0.2225209339563143,0.9749279121818236,0.0,0.0,0.0,0.0,0.0,0.0,1.0,0.0,0.0,1.0,0.0,0.0,0.0,0.0,0.0,0.0,0.0,0.0,1.0,0.0,0.0,0.0,0.0,1.0,0.0,1.0,0.0,0.0,0.0,0.0,0.0,0.0,0.0,0.0,0.0,0.0,0.0,0.0,0.0,0.0,0.0,0.0,0.0,0.0,0.0,0.0,0.0,0.0,0.0,0.0,0.0,0.0,0.0,0.0,0.0,0.0,0.0,0.0,0.0,0.0,0.0,0.0,0.0,0.0,0.0,0.0,0.0,0.0,0.0,0.0,0.0,0.0,0.0,0.0,0.0,0.0,0.0,0.0,0.0,0.0,0.0,0.0,0.0,0.0,0.0,0.0,0.0,0.0,0.0,0.0,0.0,0.0,0.0,0.0,0.0,0.0,0.0,0.0,0.0,0.0,0.0,0.0,0.0,0.0,0.0,1.0,0.0,0.0,0.0,0.0,1.0,0.0,0.0,0.0,0.0,0.0,0.0,0.0,1.0,0.0
102262,0,0.0,1.0,0.0,0.0,0.0,103500.0,675000.0,21775.5,675000.0,0.005144,35.46027397260274,-3421.0,-801.0,-343.0,,2.0,2.0,2.0,17.0,0.2142442085642844,0.5846802770460587,0.2636468134452008,0.0773,0.0755,0.9762,0.6736,0.0893,0.0,0.1724,0.1667,0.2083,0.052,0.063,0.062,0.0,0.0,0.0788,0.0784,0.9762,0.6864,0.0901,0.0,0.1724,0.1667,0.2083,0.0532,0.0689,0.0646,0.0,0.0,0.0781,0.0755,0.9762,0.6779999999999999,0.0898,0.0,0.1724,0.1667,0.2083,0.0529,0.0641,0.0632,0.0,0.0,0.0488,1.0,0.0,0.0,0.0,0.0,-2681.0,0.0,0.0,0.0,0.0,0.0,0.0,1.0,1.0,0.0,1.0,0.0,0.0,0.0,0.0,0.0,0.0,1.0,1.0,0.0,1.0,0.0,0.0,0.0,0.0,0.0,0.0,0.0,0.0,0.0,0.0,0.0,0.0,0.0,0.0,0.0,0.0,0.0,0.0,5.0,0.0,,158566.5,122217.75,0.0,0.0,0.0,0.0,-290.0,410.0,-28.0,,86.0,-10.5,3.0,6237.045,38196.0,38196.0,1804.5,38196.0,8.0,-2254.0,365243.0,-2433.0,-2223.0,-2223.0,-2220.0,12.0,0.0,0.1042553006792681,159.0,17.0,10.0,4.0,-80.0,0.0,0.0,16.0,7115.85,7115.85,-2432.0,-2422.0,4.5,1.0,0.0,,,,,,,,,,,,,,,,,,,,,8345022390.0,184368945892.5,165558189564.0,51961089457.935,1863.0,1705.0,71125.0,70786.0,9140.0,505940.0,17804.17210000229,17866.335699999112,17317.885799998054,11293.723300000089,11231.541600000091,11178.834300000057,128383.0,662671.0,4137.08740000012,4134.757200000016,3945.383600000095,13524987.556163987,-601747065.0,-921701754.0,-296447141.0,-1534842745.0416667,44010.0,30702.0,11346.82879999918,11222.799999998972,10707.158199997297,22883.05000000968,22804.92640000964,22190.4498000082,67443.04045797768,158007.24245149313,126078.6462109222,34992.37810002792,34932.74130002836,34378.800300028764,22948.49819999592,22921.754799995488,22569.039699995723,3713445.0,8294.079300000167,8398.586700000078,8122.196400000227,9815.635100000718,9930.563300002155,10290.201699999649,16464.284299999756,16649.51529999969,16246.2739999997,828.5853000001761,813.7614000000459,759.7322000000131,3913.216100000125,3896.3782000001615,3729.005600000159,436399.0,431194.0,,6423.700434002895,631828.0,625380.0,,16328.873299999796,154143.38029999056,154146.12889999012,154037.89819998713,77593.07799999624,77930.82660000659,78332.23530000652,10.0,34194304.30500001,,3676137049.215,1223980001.5049994,43902865.97999999,639629.0099999999,65.0,10769.0,-11942349.0,5290474.0,-6171438.0,,-4.5,6934.5,,225000.0,202797.0,0.0,0.0,0.0,0.0,-669.0,899.0,-37.0,,133259208.20999968,1909722340.9350016,2157781796.73,30667335.70499999,1909722340.9350016,139302.0,-9558120.0,2198908481.5,93590736.5,481446448.5,218476579.5,502065644.0,138385.0,2166.0,386.5123348087268,3350827.0,1130612.0,692191.0,-2275760.0,723286.0,98096.0,1513708358.130016,1522374690.4650042,-93717480.5,-92947299.5,1718256.0,75862.5,,,,,,,,,,,,,,,,,,,,,1467090.0,14767684.0,3231555.0,8553211.0,11605186.0,1415353.0,1058268330.544501,,72087502585.58961,21672615562.92012,582250914.791999,5792665.7475,689.5,94245.0,-276866441.0,21958114.0,-123765073.0,,-2017525.0,,,,,,,,,,,,,,,,,,,,,4271929.5,2478660.0,-9001691.5,921269.0,37582.5,3732586465.9949617,3657139902.629961,-260572350.5,-257262044.0,2525999.5,269139.0,3925215061.942456,33248087507.92591,36676627951.59014,1729007268.3675494,48071924200.86822,3987164.0,-247538623.0,103064480675.5,1053686520.5,17269877094.0,3502807994.0,18883714085.0,3671318.0,71899.5,20866.21284309248,89783071.5,-96.47415591439388,6.521739130434782,4.7530481504443065,168.54438961972784,30.998140111593305,1099.2025409982252,51750.0,-0.2225209339563146,-0.9749279121818236,0.0,0.0,0.0,0.0,0.0,0.0,1.0,0.0,0.0,0.0,1.0,0.0,0.0,0.0,0.0,0.0,0.0,0.0,1.0,0.0,1.0,0.0,0.0,0.0,0.0,1.0,0.0,0.0,0.0,0.0,0.0,0.0,0.0,1.0,0.0,0.0,0.0,0.0,0.0,0.0,0.0,0.0,0.0,0.0,0.0,0.0,0.0,0.0,0.0,0.0,0.0,0.0,0.0,0.0,0.0,0.0,0.0,0.0,0.0,0.0,0.0,0.0,0.0,0.0,0.0,0.0,0.0,0.0,0.0,0.0,0.0,0.0,0.0,0.0,0.0,0.0,0.0,0.0,1.0,0.0,0.0,0.0,0.0,0.0,0.0,0.0,0.0,0.0,0.0,0.0,0.0,0.0,0.0,0.0,0.0,0.0,0.0,0.0,0.0,0.0,0.0,0.0,0.0,0.0,0.0,0.0,0.0,0.0,0.0,1.0,1.0,0.0,0.0,0.0,0.0,0.0,0.0,1.0,0.0,0.0
102273,0,0.0,1.0,0.0,1.0,0.0,112500.0,195543.0,14359.5,148500.0,0.0066709999999999,63.18356164383562,,-10583.0,-4749.0,,1.0,2.0,2.0,14.0,0.522676069841304,0.2477054647733482,0.6690566947824041,0.1093,0.0664,0.9856,,,0.12,0.1034,0.3333,,0.0411,,0.0741,,0.1534,0.1113,0.0689,0.9856,,,0.1208,0.1034,0.3333,,0.042,,0.0772,,0.1624,0.1103,0.0664,0.9856,,,0.12,0.1034,0.3333,,0.0418,,0.0754,,0.1566,0.1118,1.0,3.0,1.0,3.0,0.0,-167.0,0.0,0.0,0.0,0.0,1.0,0.0,1.0,0.0,0.0,1.0,0.0,1.0,0.0,0.0,0.0,0.0,0.0,0.0,0.0,0.0,0.0,0.0,1.0,0.0,0.0,0.0,0.0,0.0,0.0,0.0,0.0,0.0,0.0,0.0,0.0,0.0,0.0,0.0,5.0,0.0,0.0,63000.0,0.0,0.0,0.0,0.0,0.0,-866.0,-501.0,-264.0,-501.0,153.0,-15.0,2.0,3845.745,21618.0,20009.25,2250.0,21618.0,6.0,-899.5,365243.0,-869.0,181896.0,-719.0,181903.0,17.0,0.5,0.1132582060202692,24.0,13.0,6.0,3.0,-48.0,0.0,0.0,13.0,3466.62,3466.62,-1482.0,-1451.0,3.0,1.0,0.0,,,,,,,,,,,,,,,,,,,,,8345036749.5,184369141435.5,165558338064.0,51961201957.935,1863.0,1705.0,71125.0,70787.0,9140.0,505940.0,17804.28140000229,17866.445999999112,17317.997099998054,11293.789700000088,11231.608000000091,11178.903200000055,128383.0,662672.0,,,,13525050.73972563,,-921706503.0,-296447308.0,-1534853328.0416667,44011.0,30702.0,11346.948799999182,11222.919999998974,10707.278999997296,22883.15340000968,22805.02980000964,22190.5532000082,67443.56313404752,158007.49015695794,126079.31526761696,34992.71140002792,34933.074600028354,34379.13360002876,,,,3713459.0,8294.120400000167,8398.628500000079,8122.238400000228,,,,16464.358399999757,16649.59069999969,16246.3511999997,,,,3913.369500000125,3896.534800000162,3729.1680000001593,436402.0,431197.0,,6423.707105002895,631830.0,625382.0,,16328.985099999798,154144.36589999055,154147.11449999013,154038.88379998715,,,,29.0,34410004.74000001,10577099.115000002,3695058091.935,1229789338.334999,43902865.97999999,639629.0099999999,65.0,10769.0,-12037193.0,5239732.0,-6229261.0,-6719298.0,-14.0,0.0,0.0,63000.0,0.0,0.0,0.0,0.0,0.0,-1207.0,-721.0,-264.0,-501.0,133704242.05499972,1917129075.4350016,2165967240.48,30712704.70499999,1917129075.4350016,139939.0,-9592263.5,2208769634.5,93559099.5,482702633.5,218827545.5,503321973.5,138837.5,2170.5,387.38515792060167,3361578.0,1138818.0,697559.0,-2287342.0,723286.0,98096.0,1522045033.965017,1530606023.8200068,-94077279.0,-93302915.0,1721737.0,76270.0,,,,,,,,,,,,,,,,,,,,,1467095.0,14767837.0,3231555.0,8553224.0,11605199.0,1415355.0,1058268330.544501,801584051.827495,72087565585.58961,21672615562.92012,582250914.791999,5792665.7475,689.5,94245.0,-276867307.0,21957613.0,-123765337.0,-218660680.5,-2017540.0,,,,,,,,,,,,,,,,,,,,,4271935.5,2478663.0,-9001739.5,921269.0,37582.5,3732589932.6149616,3657143369.24996,-260573832.5,-257263495.0,2526002.5,269140.0,3925218907.687456,33248109125.92591,36676647960.84014,1729009518.3675494,48071945818.86822,3987170.0,-247539522.5,103064845918.5,1053685651.5,17270058990.0,3502807275.0,18883895988.0,3671335.0,71900.0,20866.326101298506,89783095.5,,1.73816,7.834534628643057,495.01380165963343,13.617674710122216,860.4131894927084,112500.0,0.6234898018587336,0.7818314824680298,0.0,0.0,0.0,0.0,0.0,0.0,1.0,0.0,0.0,1.0,0.0,0.0,0.0,0.0,0.0,1.0,0.0,0.0,0.0,0.0,0.0,0.0,0.0,1.0,0.0,1.0,0.0,0.0,0.0,0.0,0.0,0.0,0.0,0.0,0.0,0.0,0.0,0.0,0.0,0.0,0.0,0.0,0.0,0.0,0.0,0.0,0.0,0.0,0.0,0.0,0.0,0.0,0.0,0.0,0.0,0.0,0.0,0.0,0.0,0.0,0.0,0.0,0.0,0.0,0.0,0.0,0.0,0.0,0.0,0.0,0.0,0.0,0.0,0.0,0.0,0.0,0.0,0.0,0.0,0.0,0.0,0.0,0.0,0.0,0.0,0.0,0.0,0.0,0.0,0.0,0.0,0.0,0.0,0.0,0.0,0.0,0.0,0.0,0.0,0.0,0.0,0.0,0.0,0.0,0.0,1.0,0.0,0.0,0.0,0.0,1.0,0.0,0.0,0.0,0.0,0.0,0.0,1.0,0.0,0.0
102286,0,0.0,0.0,0.0,0.0,0.0,103500.0,454500.0,17131.5,454500.0,0.028663,60.950684931506856,,-7965.0,-2159.0,,1.0,2.0,2.0,16.0,,0.0670403009432061,0.4135967602644276,,,,,,,,,,,,,,,,,,,,,,,,,,,,,,,,,,,,,,,,,,,,,3.0,0.0,3.0,0.0,-2110.0,0.0,0.0,0.0,0.0,1.0,1.0,1.0,0.0,0.0,1.0,1.0,0.0,0.0,0.0,0.0,0.0,0.0,0.0,0.0,0.0,0.0,0.0,1.0,0.0,0.0,0.0,0.0,0.0,0.0,0.0,0.0,0.0,0.0,0.0,0.0,0.0,0.0,0.0,5.0,0.0,0.0,80631.0,6565.5,0.0,0.0,0.0,0.0,-571.0,-14.0,-45.0,-334.5,100.0,-11.5,2.0,9499.2975,108876.15,116257.5,3013.65,108876.15,17.0,-2398.0,365243.0,-2367.5,-1887.5,-1887.5,-1873.5,11.0,0.5,0.0544732536049548,74.5,37.0,24.0,8.0,-63.0,0.0,0.0,34.0,12974.175,12974.175,-1885.0,-1885.0,9.0,1.0,0.0,,,,,,,,,,,,,,,,,,,,,8345053881.0,184369595935.5,165558792564.0,51961305457.935,1863.0,1705.0,71125.0,70788.0,9140.0,505941.0,,,,,,,128383.0,662673.0,,,,13525111.690410562,,-921708662.0,-296449418.0,-1534861293.0416667,44011.0,30702.0,,,,,,,,158007.5571972589,126079.72886437723,,,,,,,3713475.0,,,,,,,,,,,,,,,,436405.0,431200.0,,6423.735768002895,631832.0,625384.0,,,,,,,,,19.0,34489776.24000001,10710445.095000004,3715971662.115,1237303820.0699997,44070703.96499999,696617.0099999999,66.0,11780.0,-12077752.0,5232473.0,-6247882.0,-6735834.0,-9.0,0.0,0.0,156042.0,619074.0,0.0,0.0,0.0,0.0,-756.0,-207.0,-167.0,-495.0,134126659.34999973,1922192829.000002,2171129386.23,30914905.76999999,1922192829.000002,140261.0,-9622769.0,2215709251.5,93536930.5,483964482.5,218811886.5,504583956.5,139127.0,2176.0,389.378788741502,3371775.0,1141924.0,699191.0,-2294817.0,723536.0,98123.0,1525530295.6875196,1533919488.4575086,-94316627.5,-93540534.0,1723546.0,76500.5,,,,,,,,,,,,,,,,,,,,,1467100.0,14767937.0,3231555.0,8553261.0,11605233.0,1415357.0,1058268330.544501,801584051.827495,72087646216.58961,21672622128.42012,582250914.791999,5792665.7475,689.5,94245.0,-276867878.0,21957599.0,-123765382.0,-218661015.0,-2017551.5,,,,,,,,,,,,,,,,,,,,,4271959.5,2478671.0,-9001802.5,921269.0,37582.5,3732602906.789962,3657156343.424961,-260575717.5,-257265380.0,2526011.5,269141.0,3925228406.984956,33248218002.075912,36676764218.34014,1729012532.0175498,48072054695.01822,3987187.0,-247541920.5,103065211161.5,1053683284.0,17270057102.5,3502805387.5,18883894114.5,3671346.0,71900.5,20866.380574552102,89783170.0,,4.391304347826087,6.041502495403205,368.2337151102332,26.530076175466245,1617.0263141797193,103500.0,-0.9009688679024191,0.4338837391175582,0.0,0.0,0.0,0.0,0.0,0.0,1.0,0.0,0.0,1.0,0.0,0.0,0.0,0.0,0.0,0.0,0.0,0.0,1.0,0.0,0.0,0.0,0.0,1.0,0.0,1.0,0.0,0.0,0.0,0.0,0.0,0.0,0.0,0.0,0.0,0.0,0.0,0.0,0.0,0.0,0.0,0.0,0.0,0.0,0.0,0.0,0.0,0.0,0.0,0.0,0.0,0.0,0.0,0.0,0.0,0.0,0.0,0.0,0.0,0.0,0.0,0.0,0.0,0.0,0.0,0.0,0.0,0.0,0.0,0.0,0.0,0.0,0.0,0.0,0.0,0.0,0.0,0.0,0.0,0.0,0.0,0.0,0.0,0.0,0.0,0.0,0.0,0.0,0.0,0.0,0.0,0.0,0.0,0.0,0.0,0.0,0.0,0.0,0.0,0.0,0.0,0.0,0.0,0.0,0.0,1.0,0.0,0.0,0.0,0.0,0.0,0.0,0.0,0.0,0.0,0.0,0.0,0.0,0.0,0.0
102293,0,0.0,0.0,0.0,1.0,0.0,135000.0,225000.0,22050.0,225000.0,0.026392,51.23561643835617,-1204.0,-10710.0,-2256.0,,2.0,2.0,2.0,16.0,,0.6489436484987066,0.7062051096536562,,,,,,,,,,,,,,,,,,,,,,,,,,,,,,,,,,,,,,,,,,,,,6.0,0.0,6.0,0.0,-1909.0,0.0,0.0,0.0,0.0,0.0,2.0,1.0,1.0,0.0,1.0,0.0,0.0,0.0,0.0,0.0,0.0,1.0,1.0,0.0,1.0,0.0,0.0,0.0,0.0,0.0,0.0,0.0,0.0,0.0,0.0,0.0,0.0,0.0,0.0,0.0,0.0,0.0,0.0,12.0,2450.25,0.0,162717.75,0.0,0.0,0.0,0.0,0.0,-1379.0,-404.5,-356.0,-846.0,546.0,-24.0,4.0,6516.675,57570.75,51108.75,8910.0,57570.75,12.0,-1223.5,365243.0,-1065.0,-915.0,-735.0,-909.5,18.5,0.0,0.1618495759198208,7.0,16.0,8.0,6.0,-55.5,0.0,0.0,15.0,6516.675,12150.0,-1674.0,-1664.0,3.0,1.0,96.0,0.0,0.0,0.0,0.0,0.0,0.0,0.0,1440.45,0.0,0.0,0.0,0.0,0.0,0.0,0.0,0.0,11.0,-48.5,0.0,0.0,8345075931.0,184369820935.5,165559017564.0,51961440457.935,1863.0,1705.0,71125.0,70788.0,9140.0,505943.0,,,,,,,128383.0,662675.0,,,,13525162.926027,-601748269.0,-921710918.0,-296451327.0,-1534872003.0416667,44011.0,30702.0,,,,,,,,158008.2061409074,126080.43506948688,,,,,,,3713491.0,,,,,,,,,,,,,,,,436411.0,431206.0,,6423.762160002895,631834.0,625386.0,,,,,,,,,46.0,34516758.24000001,10723391.595000004,3721884191.685,1239417600.5699997,44288953.96499999,696729.5099999999,66.0,11786.0,-12115661.0,5243541.0,-6267063.5,-6758851.5,-22.5,0.0,0.0,189720.0,0.0,0.0,0.0,0.0,0.0,-1882.0,-1145.0,-659.0,-1192.0,134596434.55499974,1926697833.900002,2176452244.98,30966672.41999999,1926697833.900002,140502.0,-9647587.0,2221918382.5,93884594.0,485410835.0,219165760.0,506031287.0,139506.0,2184.0,390.2719380617888,3379410.0,1144250.0,700602.0,-2301802.0,736244.0,98150.0,1529855577.5850203,1538014536.4500089,-94462740.0,-93686268.0,1724226.0,76708.0,1495782012.0150008,3905374500.0,127493772.39,198304795.1699997,7821039.6000000015,62832490.06499996,84614057.72999993,214891172.3250005,197971272.72000003,1435819674.915001,1489924196.7750008,1489982203.710001,6496.0,16739.0,107.0,10136.0,479099.5,-856608.0,274879.0,848.0,1467112.0,14768483.0,3231651.0,8553277.0,11605248.0,1415361.0,1058270780.794501,801584051.827495,72087808934.33961,21672622128.42012,582250914.791999,5792665.7475,689.5,94245.0,-276869257.0,21957194.5,-123765738.0,-218661861.0,-2017575.5,5921049493.867462,18717367500.0,198760895.325,447859400.1524977,1948107.735,256684196.49750075,309026516.2649987,636414607.0574981,459061753.9949993,5706251053.650032,5884343604.517499,5884586787.2625,13378.0,80816.0,44.0,70331.0,971243.5,-1697974.5,177364.0,6755.0,4271967.5,2478677.0,-9001858.0,921269.0,37582.5,3732609423.4649625,3657168493.424961,-260577391.5,-257267044.0,2526014.5,269142.0,3925234923.659957,33248275572.825912,36676815327.09014,1729021442.0175498,48072112265.76822,3987199.0,-247543144.0,103065576404.5,1053682219.0,17270056187.5,3502804652.5,18883893205.0,3671364.5,71900.5,20866.542424128027,89783177.0,-23.499278113469877,1.6666666666666667,6.122448979591836,313.6874475817725,10.20408163265306,522.8124126362874,67500.0,-0.2225209339563143,0.9749279121818236,0.0,0.0,0.0,0.0,0.0,0.0,1.0,0.0,1.0,0.0,0.0,0.0,0.0,0.0,0.0,0.0,0.0,0.0,1.0,0.0,1.0,0.0,0.0,0.0,0.0,1.0,0.0,0.0,0.0,0.0,0.0,1.0,0.0,0.0,0.0,0.0,0.0,0.0,0.0,0.0,0.0,0.0,0.0,0.0,0.0,0.0,0.0,0.0,0.0,0.0,0.0,0.0,0.0,1.0,0.0,0.0,0.0,0.0,0.0,0.0,0.0,0.0,0.0,0.0,0.0,0.0,0.0,0.0,0.0,0.0,0.0,0.0,0.0,0.0,0.0,0.0,0.0,0.0,0.0,0.0,0.0,0.0,0.0,0.0,0.0,0.0,0.0,0.0,0.0,0.0,0.0,0.0,0.0,0.0,0.0,0.0,0.0,0.0,0.0,0.0,0.0,0.0,0.0,0.0,0.0,0.0,0.0,0.0,0.0,0.0,0.0,0.0,0.0,0.0,0.0,0.0,0.0,0.0,0.0,0.0
102294,0,0.0,0.0,1.0,1.0,2.0,112500.0,479700.0,51790.5,450000.0,0.010966,38.18904109589041,-273.0,-1286.0,-3170.0,4.0,4.0,2.0,2.0,13.0,0.5235162365996221,0.6463687496015791,,0.0845,,0.9757,0.6668,0.011,0.0,0.1379,0.1667,,0.0514,,0.0774,,0.004,0.0861,,0.9757,0.6798,0.0111,0.0,0.1379,0.1667,,0.0526,,0.0806,,0.0042,0.0854,,0.9757,0.6713,0.0111,0.0,0.1379,0.1667,,0.0523,,0.0788,,0.004,0.0694,1.0,0.0,0.0,0.0,0.0,-411.0,,,,,,,1.0,1.0,0.0,1.0,0.0,1.0,0.0,0.0,0.0,0.0,0.0,0.0,0.0,1.0,0.0,0.0,0.0,0.0,0.0,0.0,0.0,0.0,0.0,0.0,0.0,0.0,0.0,0.0,0.0,0.0,0.0,0.0,0.0,,,,,,,,,,,,,0.0,,9.0,42549.66,0.0,0.0,,675000.0,12.0,-413.0,365243.0,-1188.5,-888.5,-858.5,-883.0,14.0,0.5,,-1.0,24.0,12.0,6.5,-45.5,0.0,0.0,26.0,69621.795,22904.28,-698.0,-697.0,6.0,2.0,0.0,,,,,,,,,,,,,,,,,,,,,8345127721.5,184370300635.5,165559467564.0,51961552957.935,,,,,,,17804.365900002293,17866.531399999112,17318.08319999806,,,,128385.0,662679.0,4137.098400000121,4134.768300000015,3945.3947000000953,13525201.115068097,-601748542.0,-921714088.0,-296451738.0,-1534873289.0416667,44011.0,30702.0,11346.948799999182,11222.919999998974,10707.278999997296,22883.29130000968,22805.16770000964,22190.6911000082,67444.08665028412,158008.85250965698,,34992.87810002792,34933.24130002836,34379.300300028764,,,,3713504.0,8294.171800000167,8398.680800000078,8122.291000000227,,,,16464.435799999756,16649.66949999969,16246.431799999697,,,,3913.373500000125,3896.5388000001617,3729.172200000159,436411.0,431206.0,1262814.0,6423.773126002896,631836.0,625388.0,,16329.054499999796,154145.34159999056,154148.09019999017,154039.85949998716,77593.74479999625,77931.49790000661,78332.91510000652,,,,,,,,,,,,,,,,,,,,,,,,,,,134789183.18999973,1927672752.150002,2177577314.73,,1928802252.150002,140562.0,-9650210.0,2222648868.5,93882929.0,485409650.0,219164755.0,506030111.5,139595.0,2185.0,,3379412.0,1144464.0,700735.0,-2302222.5,736246.0,98150.0,1531356068.9475205,1539983734.222509,-94471966.5,-93695264.5,1724320.0,76788.5,,,,,,,,,,,,,,,,,,,,,1467112.0,14768483.0,3231651.0,8553301.0,11605274.0,1415370.0,,,,,,,,,,,,,,,,,,,,,,,,,,,,,,,,,,4271979.5,2478683.5,-9001903.5,921269.0,37582.5,3732679045.2599626,3657191397.704961,-260578089.5,-257267741.0,2526020.5,269144.0,3925277473.319956,33248275572.825912,36676815327.09014,,48072787265.76822,3987211.0,-247543557.0,103065941647.5,1053681030.5,17270055299.0,3502803794.0,18883892322.0,3671378.5,71901.0,,89783176.0,-7.148647679173544,4.263999999999999,2.1722130506560084,82.95473346053178,9.26231644799722,353.71898347570755,28125.0,1.0,0.0,0.0,0.0,0.0,0.0,0.0,0.0,1.0,0.0,0.0,0.0,0.0,0.0,0.0,1.0,0.0,1.0,0.0,0.0,0.0,0.0,1.0,0.0,0.0,0.0,0.0,1.0,0.0,0.0,0.0,0.0,1.0,0.0,0.0,0.0,0.0,0.0,0.0,0.0,0.0,0.0,0.0,0.0,0.0,0.0,0.0,0.0,0.0,0.0,0.0,0.0,0.0,0.0,0.0,1.0,0.0,0.0,0.0,0.0,0.0,0.0,0.0,0.0,0.0,0.0,0.0,0.0,0.0,0.0,0.0,0.0,0.0,0.0,0.0,0.0,0.0,0.0,0.0,0.0,0.0,0.0,0.0,0.0,0.0,0.0,0.0,0.0,0.0,0.0,0.0,0.0,0.0,0.0,0.0,0.0,0.0,0.0,0.0,0.0,0.0,0.0,0.0,0.0,0.0,0.0,0.0,0.0,0.0,1.0,0.0,0.0,1.0,0.0,0.0,0.0,0.0,0.0,0.0,0.0,1.0,0.0
102296,0,0.0,0.0,0.0,1.0,0.0,135000.0,900000.0,57649.5,900000.0,0.010006,39.594520547945216,-2162.0,-2886.0,-4849.0,,2.0,2.0,2.0,16.0,0.4987498213237279,0.4199131984492126,,0.0309,0.0733,0.9955,0.9388,0.0082,0.0,0.069,0.0833,0.125,0.0327,0.0252,0.0328,0.0,0.0,0.0315,0.076,0.9955,0.9412,0.0083,0.0,0.069,0.0833,0.125,0.0335,0.0275,0.0342,0.0,0.0,0.0312,0.0733,0.9955,0.9396,0.0083,0.0,0.069,0.0833,0.125,0.0333,0.0257,0.0334,0.0,0.0,0.0303,1.0,0.0,0.0,0.0,0.0,-1179.0,0.0,0.0,0.0,0.0,1.0,2.0,1.0,1.0,1.0,1.0,1.0,0.0,0.0,0.0,0.0,0.0,0.0,0.0,0.0,1.0,0.0,0.0,0.0,0.0,0.0,0.0,0.0,0.0,0.0,0.0,0.0,0.0,0.0,0.0,0.0,0.0,0.0,0.0,1.0,31716.0,,450000.0,450000.0,,0.0,0.0,0.0,-747.0,1825.0,-7.0,,25.0,-12.0,2.0,43464.1275,562500.0,601704.0,,562500.0,21.0,-1025.0,365243.0,-995.0,-395.0,-395.0,-385.0,9.0,0.5,,23.0,44.0,36.0,13.5,-23.5,0.0,0.0,162.0,138.87,138.87,-926.5,-926.0,36.0,0.0,95.0,0.0,112500.0,0.0,0.0,0.0,0.0,0.0,99.54,0.0,0.0,0.0,0.0,0.0,0.0,0.0,0.0,11.0,-49.0,0.0,0.0,8345185371.0,184371200635.5,165560367564.0,51961687957.935,1863.0,1705.0,71125.0,70789.0,9140.0,505945.0,17804.396800002294,17866.56259999911,17318.114699998056,11293.863000000089,11231.681300000091,11178.979200000054,128385.0,662681.0,4137.106600000121,4134.776600000016,3945.4030000000953,13525240.709588643,-601750704.0,-921718937.0,-296452917.0,-1534876175.0416667,44011.0,30702.0,11346.948799999182,11222.919999998974,10707.278999997296,22883.36030000968,22805.23670000964,22190.7601000082,67444.58540010545,158009.27242285546,,34992.96140002792,34933.324600028354,34379.38360002876,22948.62319999592,22921.879799995488,22569.164699995723,3713520.0,8294.204500000167,8398.714100000077,8122.324500000227,9815.660300000718,9930.589000002155,10290.229199999649,16464.468599999756,16649.70289999969,16246.465999999697,828.5853000001761,813.7614000000459,759.7322000000131,3913.373500000125,3896.5388000001617,3729.172200000159,436411.0,431206.0,,6423.783132002895,631838.0,625390.0,,16329.0847999998,154146.33709999055,154149.08569999013,154040.85499998715,77594.68359999625,77932.43750000659,78333.85630000652,25.0,34554049.74000001,,3723928477.2,1240277874.5699997,,696729.5099999999,66.0,11786.0,-12127245.0,5238832.0,-6272829.0,,-12.0,31716.0,,450000.0,450000.0,,0.0,0.0,0.0,-747.0,1825.0,-7.0,,134921836.10249972,1930207107.150002,2180268670.23,,1930207107.150002,140640.0,-9658528.5,2224840326.5,94243091.5,486136318.5,219526927.5,506756805.5,139723.0,2188.5,,3379950.5,1145434.0,701182.0,-2304233.0,736261.0,98165.0,1532121164.370017,1540748770.7850056,-94641297.5,-93864292.5,1729734.0,76830.0,1495877228.595001,3912934500.0,127538772.39,198349795.1699997,7821039.6000000015,62832490.06499996,84641198.44499993,215015746.9949997,198025340.22000003,1435907972.2500007,1490014256.805001,1490072263.7400012,6497.0,16740.0,107.0,10136.0,480084.0,-861282.0,274879.0,848.0,1467113.0,14768508.0,3231746.0,8553345.0,11605436.0,1415372.0,1058302496.794501,,72088258934.33961,21673072128.42012,,5792665.7475,689.5,94245.0,-276870004.0,21959019.5,-123765745.0,,-2017587.5,5921049493.867462,18717480000.0,198760895.325,447859400.1524977,1948107.735,256684196.49750075,309026516.2649987,636414706.597498,459061753.9949993,5706251053.650032,5884343604.517499,5884586787.2625,13378.0,80816.0,44.0,70331.0,971254.5,-1698023.5,177364.0,6755.0,4272015.5,2478697.0,-9001927.0,921269.0,37582.5,3732679184.1299615,3657191536.5749607,-260579016.0,-257268667.0,2526056.5,269144.0,3925320937.447456,33248838072.825912,36677417031.09014,,48073349765.76822,3987232.0,-247544582.0,103066306890.5,1053680035.5,17270054904.0,3502803399.0,18883891937.0,3671387.5,71901.5,,89783199.0,-54.60351508441738,6.666666666666668,2.341737569276403,92.7199763046098,15.61158379517602,618.1331753640654,67500.0,0.6234898018587334,-0.7818314824680299,0.0,0.0,0.0,0.0,0.0,0.0,1.0,0.0,1.0,0.0,0.0,0.0,0.0,0.0,0.0,0.0,0.0,0.0,1.0,0.0,1.0,0.0,0.0,0.0,0.0,1.0,0.0,0.0,0.0,0.0,0.0,0.0,0.0,0.0,0.0,0.0,0.0,0.0,0.0,0.0,0.0,0.0,0.0,0.0,1.0,0.0,0.0,0.0,0.0,0.0,0.0,0.0,0.0,0.0,0.0,0.0,0.0,0.0,0.0,0.0,0.0,0.0,0.0,0.0,0.0,0.0,0.0,0.0,0.0,0.0,0.0,0.0,0.0,0.0,0.0,0.0,0.0,0.0,0.0,0.0,0.0,0.0,0.0,0.0,0.0,0.0,0.0,0.0,0.0,0.0,1.0,0.0,0.0,0.0,0.0,0.0,0.0,0.0,0.0,0.0,0.0,0.0,0.0,0.0,0.0,0.0,0.0,0.0,1.0,0.0,1.0,0.0,0.0,0.0,0.0,0.0,0.0,0.0,1.0,0.0
102298,0,0.0,0.0,0.0,1.0,1.0,112500.0,622413.0,33894.0,495000.0,0.018634,31.96712328767123,-338.0,-11642.0,-4264.0,,3.0,2.0,2.0,10.0,0.472118804101488,0.4413886491302077,0.746300213050371,,,,,,,,,,,,,,,,,,,,,,,,,,,,,,,,,,,,,,,,,,,,,1.0,0.0,1.0,0.0,-889.0,0.0,0.0,0.0,0.0,0.0,0.0,1.0,1.0,0.0,1.0,0.0,0.0,0.0,0.0,0.0,1.0,1.0,0.0,0.0,1.0,0.0,0.0,0.0,0.0,0.0,0.0,0.0,0.0,0.0,0.0,0.0,0.0,0.0,0.0,0.0,0.0,0.0,0.0,0.0,,,,,,,,,,,,,0.0,,1.0,12845.295,137677.5,137677.5,0.0,137677.5,12.0,-889.0,365243.0,-851.0,-521.0,-521.0,-512.0,15.0,0.0,0.0,134.0,14.0,12.0,6.0,-23.5,0.0,0.0,13.0,12845.295,12845.295,-686.0,-671.0,7.0,1.0,0.0,,,,,,,,,,,,,,,,,,,,,8345219265.0,184371823048.5,165560862564.0,51961800457.935,1863.0,1705.0,71125.0,70789.0,9140.0,505945.0,,,,,,,128386.0,662684.0,,,,13525272.676711932,-601751042.0,-921723201.0,-296453806.0,-1534887817.0416667,44011.0,30702.0,,,,,,,67445.05751890955,158009.7138115046,126081.18136969996,,,,,,,3713530.0,,,,,,,,,,,,,,,,436412.0,431207.0,,6423.801766002895,631840.0,625392.0,,,,,,,,,,,,,,,,,,,,,,,,,,,,,,,,,,,135379556.8199997,1935035584.650002,2184996572.73,31325214.41999999,1935035584.650002,140768.0,-9664183.0,2226118677.0,94240551.0,486135023.0,219525902.0,506755529.0,139894.0,2190.0,391.199715394496,3395079.0,1146479.0,701787.0,-2305225.0,736273.0,98177.0,1536324250.680023,1544196446.5500083,-94723511.0,-93945633.0,1732246.0,76927.0,,,,,,,,,,,,,,,,,,,,,1467113.0,14768508.0,3231746.0,8553359.0,11605449.0,1415373.0,,,,,,,,,,,,,,,,,,,,,,,,,,,,,,,,,,4272027.5,2478703.0,-9001950.5,921269.0,37582.5,3732692029.4249625,3657204381.869961,-260579702.0,-257269338.0,2526063.5,269145.0,3925333782.742456,33248975750.325912,36677554708.59014,1729021442.0175498,48073487443.26822,3987244.0,-247545471.0,103066672133.5,1053679184.5,17270054383.0,3502802878.0,18883891425.0,3671402.5,71901.5,20866.542424128027,89783333.0,-10.573363044223518,5.53256,3.3191715347849176,106.1043656653984,18.363515666489644,587.0287693057566,37500.0,0.6234898018587336,0.7818314824680298,0.0,1.0,0.0,0.0,0.0,0.0,0.0,0.0,0.0,0.0,0.0,0.0,0.0,1.0,0.0,0.0,0.0,0.0,1.0,0.0,1.0,0.0,0.0,0.0,0.0,1.0,0.0,0.0,0.0,0.0,0.0,0.0,0.0,0.0,0.0,0.0,0.0,0.0,0.0,0.0,0.0,0.0,0.0,0.0,1.0,0.0,0.0,0.0,0.0,0.0,0.0,0.0,0.0,0.0,0.0,0.0,0.0,0.0,0.0,0.0,0.0,0.0,0.0,0.0,0.0,0.0,0.0,0.0,0.0,0.0,0.0,0.0,0.0,0.0,0.0,0.0,0.0,0.0,0.0,0.0,0.0,0.0,0.0,0.0,0.0,0.0,0.0,0.0,0.0,0.0,0.0,0.0,0.0,0.0,0.0,0.0,0.0,0.0,0.0,1.0,0.0,0.0,0.0,0.0,0.0,0.0,0.0,0.0,0.0,0.0,0.0,0.0,0.0,0.0,0.0,0.0,0.0,0.0,0.0,0.0
102303,0,0.0,0.0,0.0,1.0,0.0,315000.0,1800000.0,74416.5,1800000.0,0.010643,55.55068493150685,-3868.0,-6199.0,-3224.0,,2.0,2.0,2.0,12.0,0.7287161116389232,0.5830651068144926,,,,,,,,,,,,,,,,,,,,,,,,,,,,,,,,,,,,,,,,,,,,,,1.0,0.0,1.0,0.0,-1722.0,,,,,,,1.0,1.0,0.0,1.0,0.0,0.0,0.0,1.0,1.0,0.0,0.0,0.0,0.0,1.0,0.0,0.0,0.0,0.0,0.0,0.0,0.0,0.0,0.0,0.0,0.0,0.0,0.0,0.0,0.0,0.0,0.0,0.0,0.0,,,,,,,,,,,,,0.0,,6.0,28137.1725,33727.5,256855.5,6750.0,675000.0,15.0,-864.5,365243.0,-1142.5,-129.0,35.5,-127.0,14.0,0.5,0.1043323772918867,-1.0,60.0,24.0,15.0,-17.5,0.0,0.0,140.0,18432.112500000007,18432.112500000007,-613.0,-606.0,22.0,0.0,44.0,348372.11250000005,450000.0,0.0,0.0,0.0,0.0,17830.935,22500.0,3923.775,342087.21,347699.36250000005,347699.36250000005,0.0,0.0,0.0,0.0,22.0,-22.5,0.0,0.0,8345293681.5,184373623048.5,165562662564.0,51962115457.935,,,,,,,,,,,,,128386.0,662686.0,,,,13525328.227396864,-601754910.0,-921726425.0,-296455528.0,-1534894016.0416667,44011.0,30702.0,,,,,,,67445.7862350212,158010.29687661142,,,,,,,,3713542.0,,,,,,,,,,,,,,,,436413.0,431208.0,,6423.812409002896,631842.0,625394.0,,,,,,,,,,,,,,,,,,,,,,,,,,,,,,,,,,,135721130.69249964,1939076337.150002,2190241237.23,31338007.91999999,1939413837.150002,141146.0,-9689068.0,2229583338.5,94221162.0,486486197.0,220612334.5,507475354.0,140213.5,2195.5,391.5162412826101,3402876.5,1149131.0,703312.5,-2309968.5,736273.0,98177.0,1538713795.7925231,1546499090.1825075,-95122522.5,-94342858.5,1743897.5,77033.0,1503541138.7700016,3931762500.0,127776372.39,198608719.7699997,7821039.6000000015,62853703.06499996,85133822.48999989,215770728.91499928,198415373.0849997,1443342194.7075007,1497659556.375001,1497717563.3100016,6535.0,16782.0,107.0,10140.0,483209.0,-870366.0,274881.0,850.0,1467113.0,14768508.0,3231790.0,8553419.0,11605589.0,1415379.0,,,,,,,,,,,,,,5921397865.979961,18717930000.0,198760895.325,447859400.1524977,1948107.735,256684196.49750075,309044347.1999987,636437206.597498,459065677.76999927,5706593140.860032,5884691303.879999,5884934486.625,13378.0,80816.0,44.0,70331.0,971276.5,-1698046.0,177364.0,6755.0,4272051.5,2478718.0,-9001968.0,921269.0,37582.5,3732710461.537463,3657222813.982461,-260580315.0,-257269944.0,2526085.5,269145.0,3925361919.914957,33249009477.825912,36677811564.09014,1729028192.0175498,48074162443.26822,3987259.0,-247546335.5,103067037376.5,1053678042.0,17270054254.0,3502802913.5,18883891298.0,3671416.5,71902.0,20866.64675650532,89783332.0,-69.63010455711185,5.7142857142857135,4.232932212614138,235.1422836793541,24.188184072080787,1343.6701924534525,157500.0,0.6234898018587336,0.7818314824680298,0.0,1.0,0.0,0.0,0.0,0.0,0.0,0.0,0.0,0.0,0.0,0.0,0.0,1.0,0.0,1.0,0.0,0.0,0.0,0.0,1.0,0.0,0.0,0.0,0.0,1.0,0.0,0.0,0.0,0.0,0.0,0.0,0.0,0.0,0.0,0.0,0.0,0.0,0.0,0.0,0.0,0.0,0.0,0.0,0.0,0.0,0.0,0.0,0.0,0.0,0.0,0.0,0.0,0.0,0.0,0.0,0.0,0.0,0.0,0.0,0.0,0.0,0.0,0.0,0.0,0.0,0.0,0.0,0.0,0.0,0.0,0.0,0.0,0.0,0.0,0.0,0.0,0.0,0.0,0.0,0.0,1.0,0.0,0.0,0.0,0.0,0.0,0.0,0.0,0.0,0.0,0.0,0.0,0.0,0.0,0.0,0.0,0.0,0.0,0.0,0.0,0.0,0.0,0.0,0.0,0.0,0.0,0.0,0.0,0.0,0.0,0.0,0.0,0.0,0.0,0.0,0.0,0.0,0.0,0.0
102309,0,0.0,1.0,1.0,1.0,0.0,135000.0,420588.0,32679.0,360000.0,0.01885,54.03561643835617,-2198.0,-5768.0,-3268.0,12.0,2.0,2.0,2.0,11.0,,0.5567810754084628,0.7136313997323308,,,,,,,,,,,,,,,,,,,,,,,,,,,,,,,,,,,,,,,,,,,,,0.0,0.0,0.0,0.0,0.0,0.0,0.0,0.0,0.0,0.0,4.0,1.0,1.0,1.0,1.0,1.0,1.0,0.0,0.0,0.0,0.0,0.0,0.0,0.0,1.0,0.0,0.0,0.0,0.0,0.0,0.0,0.0,0.0,0.0,0.0,0.0,0.0,0.0,0.0,0.0,0.0,0.0,0.0,1.0,0.0,,35748.0,0.0,0.0,0.0,0.0,0.0,-1366.0,-1274.0,-1302.0,-1303.0,45.0,-22.0,6.0,10160.9775,66424.5,82107.0,2981.25,73260.0,10.0,-969.0,365243.0,-724.0,-284.0,-154.0,-277.5,15.5,0.0,0.0544545454545454,19.0,62.0,12.0,7.5,-26.5,0.0,0.0,70.0,34960.05,9019.755,-605.0,-594.0,10.5,1.0,30.0,0.0,540000.0,,0.0,,,0.0,,0.0,0.0,0.0,0.0,,0.0,,,0.0,-17.5,0.0,0.0,8345326360.5,184374043636.5,165563022564.0,51962250457.935,1863.0,1705.0,71125.0,70789.0,9140.0,505949.0,,,,,,,128386.0,662688.0,,,,13525382.2630133,-601757108.0,-921729693.0,-296455528.0,-1534899784.0416667,44011.0,30702.0,,,,,,,,158010.85365768682,126081.89500109966,,,,,,,3713553.0,,,,,,,,,,,,,,,,436413.0,431208.0,1262826.0,6423.831259002895,631844.0,625396.0,,,,,,,,,45.0,34650705.24000001,,3746346491.97,1245503442.7349994,44538295.45499999,696729.5099999999,66.0,11786.0,-12187304.0,5284460.0,-6303727.0,-6798819.0,-22.0,0.0,,35748.0,0.0,0.0,0.0,0.0,0.0,-1366.0,-1274.0,-1302.0,-1303.0,136079867.42999965,1942830462.7800016,2194887479.22,31438551.05999999,1942867092.7800016,141443.0,-9717418.5,2237617096.5,94562485.5,487929438.5,221328058.5,509283827.0,140657.0,2203.0,392.73993494506544,3408978.5,1152614.0,705374.0,-2318895.5,736273.0,98177.0,1545265562.8050227,1552998700.3950074,-95417425.5,-94634724.5,1748366.5,77298.5,1516634418.5100012,3956121000.0,,199756855.0799997,,,85773880.61999992,,199186011.1799998,1456023267.9899995,1510691782.6800008,1510749789.615001,,16886.0,,,484041.0,-871610.5,274881.0,850.0,1467114.0,14768553.0,3231820.0,8553481.0,11605659.0,1415385.0,1058302496.794501,,72088294682.33961,21673072128.42012,582250914.791999,5792665.7475,689.5,94245.0,-276871370.0,21957745.5,-123767047.0,-218663164.0,-2017609.5,5921397865.979961,18718470000.0,,447859400.1524977,,,309044347.1999987,,459065677.76999927,5706593140.860032,5884691303.879999,5884934486.625,,80816.0,,,971276.5,-1698063.5,177364.0,6755.0,4272063.5,2478725.5,-9001994.5,921269.0,37582.5,3732745421.587464,3657231833.737461,-260580920.0,-257270538.0,2526096.0,269146.0,3925372080.892457,33249075902.325912,36677893671.09014,1729031173.2675498,48074235703.26822,3987269.0,-247547304.5,103067402619.5,1053677318.0,17270053970.0,3502802759.5,18883891020.5,3671432.0,71902.0,20866.701211050768,89783351.0,-40.67687471479998,3.115466666666667,4.131093362709997,223.2261764184364,12.870283668410904,695.4537117590912,67500.0,1.0,0.0,0.0,1.0,0.0,0.0,0.0,0.0,0.0,0.0,0.0,0.0,0.0,0.0,0.0,1.0,0.0,0.0,0.0,0.0,1.0,0.0,1.0,0.0,0.0,0.0,0.0,1.0,0.0,0.0,0.0,0.0,0.0,0.0,0.0,0.0,0.0,0.0,0.0,0.0,1.0,0.0,0.0,0.0,0.0,0.0,0.0,0.0,0.0,0.0,0.0,0.0,0.0,0.0,0.0,0.0,0.0,0.0,0.0,0.0,0.0,0.0,0.0,0.0,0.0,0.0,0.0,0.0,0.0,0.0,0.0,0.0,0.0,0.0,1.0,0.0,0.0,0.0,0.0,0.0,0.0,0.0,0.0,0.0,0.0,0.0,0.0,0.0,0.0,0.0,0.0,0.0,0.0,0.0,0.0,0.0,0.0,0.0,0.0,0.0,0.0,0.0,0.0,0.0,0.0,0.0,0.0,0.0,0.0,0.0,0.0,0.0,0.0,0.0,0.0,0.0,0.0,0.0,0.0,0.0,0.0,0.0
102315,0,0.0,0.0,1.0,1.0,1.0,180000.0,234000.0,12825.0,234000.0,0.018209,35.369863013698634,-1465.0,-6899.0,-5127.0,15.0,3.0,3.0,3.0,9.0,0.7157946009707215,0.3962125456967817,0.3979463219016906,0.1464,0.1068,0.9861,0.8096,0.0718,0.16,0.1379,0.3333,0.0417,0.0203,0.1194,0.1257,0.0,0.0,0.1492,0.1108,0.9861,0.8171,0.0725,0.1611,0.1379,0.3333,0.0417,0.0208,0.1304,0.131,0.0,0.0,0.1478,0.1068,0.9861,0.8121,0.0723,0.16,0.1379,0.3333,0.0417,0.0207,0.1214,0.128,0.0,0.0,0.1382,1.0,0.0,0.0,0.0,0.0,-475.0,0.0,0.0,0.0,0.0,1.0,8.0,1.0,1.0,0.0,1.0,0.0,0.0,0.0,0.0,0.0,0.0,0.0,0.0,0.0,0.0,0.0,0.0,1.0,0.0,0.0,0.0,0.0,0.0,0.0,0.0,0.0,0.0,0.0,0.0,0.0,0.0,0.0,0.0,15.0,3003.75,0.0,75838.5,0.0,0.0,0.0,0.0,0.0,-1543.0,-1048.5,-894.0,-1106.0,705.0,-26.0,20.0,37255.5,0.0,0.0,5517.0,1296000.0,60.0,-404.0,365243.0,-881.0,-401.0,-401.0,-397.0,10.5,0.5,0.1089268603806048,-1.0,36.0,24.0,8.5,-22.0,0.0,0.0,35.0,20121.3,20121.3,-660.0,-656.0,9.0,1.0,0.0,,,,,,,,,,,,,,,,,,,,,8345339185.5,184374277636.5,165563256564.0,51962430457.935,1863.0,1705.0,71125.0,70790.0,9140.0,505957.0,17804.543200002296,17866.710399999112,17318.263899998055,11293.969800000088,11231.78810000009,11179.090000000057,128387.0,662691.0,4137.178400000121,4134.848900000015,3945.475500000096,13525417.632876314,-601758573.0,-921734820.0,-296456003.0,-1534906683.0416667,44011.0,30702.0,11347.10879999918,11223.079999998974,10707.440099997297,22883.49820000968,22805.37460000964,22190.8980000082,67446.50202962216,158011.2498702325,126082.2929474216,34993.29470002792,34933.65790002835,34379.71690002876,22948.66489999592,22921.921499995493,22569.20639999572,3713562.0,8294.224800000167,8398.734800000077,8122.345300000227,9815.779700000718,9930.710400002155,10290.359599999649,16464.594299999757,16649.83089999969,16246.596999999698,828.5853000001761,813.7614000000459,759.7322000000131,3913.373500000125,3896.5388000001617,3729.172200000159,436413.0,431208.0,1262841.0,6423.849468002895,631847.0,625399.0,,16329.222999999798,154147.32319999055,154150.07179999017,154041.84109998716,77595.49319999624,77933.24960000659,78334.67340000652,51.0,34888355.730000004,10815247.035000002,3753415962.09,1247495070.7349994,44538589.75499999,696729.5099999999,66.0,11786.0,-12219336.0,5267233.5,-6319262.0,-6817340.0,-25.0,1057.5,0.0,75838.5,0.0,0.0,0.0,0.0,0.0,-1793.0,-1236.0,-989.0,-1295.0,136548662.89499968,1950456042.3600025,2203470626.22,31584352.13999999,1950568542.3600025,141860.0,-9750702.0,2243455222.5,94535514.0,488639055.0,222408706.0,510727527.5,141087.5,2206.5,394.2009920955001,3416860.5,1155334.0,706829.0,-2325790.5,736313.0,98217.0,1551309259.8150218,1558600802.6400075,-95801438.0,-95017141.0,1756124.0,77478.0,,,,,,,,,,,,,,,,,,,,,1467129.0,14769258.0,3231820.0,8553517.0,11605694.0,1415405.0,1058305500.544501,801584051.827495,72088370520.83961,21673072128.42012,582250914.791999,5792665.7475,689.5,94245.0,-276872913.0,21956697.0,-123767941.0,-218664270.0,-2017635.5,,,,,,,,,,,,,,,,,,,,,4272087.5,2478734.0,-9002016.5,921269.0,37582.5,3732765542.887463,3657251955.037461,-260581580.0,-257271194.0,2526105.0,269147.0,3925409336.392457,33249075902.325912,36677893671.09014,1729036690.2675498,48075531703.26822,3987329.0,-247547708.5,103067767862.5,1053676437.0,17270053569.0,3502802358.5,18883890623.5,3671442.5,71902.5,20866.81013791115,89783350.0,-41.41944229279628,1.3,14.035087719298245,496.4191300168228,18.24561403508772,645.3448690218697,60000.0,-0.9009688679024191,-0.433883739117558,0.0,1.0,0.0,0.0,0.0,0.0,0.0,0.0,0.0,0.0,0.0,0.0,0.0,1.0,0.0,1.0,0.0,0.0,0.0,1.0,0.0,0.0,0.0,0.0,0.0,1.0,0.0,0.0,0.0,0.0,0.0,0.0,0.0,1.0,0.0,0.0,0.0,0.0,0.0,0.0,0.0,0.0,0.0,0.0,0.0,0.0,0.0,0.0,0.0,0.0,0.0,0.0,0.0,0.0,0.0,0.0,0.0,0.0,0.0,0.0,0.0,0.0,0.0,0.0,0.0,0.0,0.0,0.0,0.0,0.0,0.0,0.0,0.0,0.0,0.0,0.0,1.0,0.0,0.0,0.0,0.0,0.0,0.0,0.0,0.0,0.0,0.0,0.0,0.0,0.0,0.0,0.0,0.0,0.0,0.0,0.0,0.0,0.0,0.0,0.0,0.0,0.0,0.0,0.0,0.0,0.0,0.0,0.0,1.0,0.0,1.0,0.0,0.0,0.0,0.0,0.0,0.0,1.0,0.0,0.0
102340,0,0.0,1.0,0.0,1.0,0.0,157500.0,345510.0,17770.5,247500.0,0.04622,51.52328767123288,,-570.0,-2121.0,,1.0,1.0,1.0,10.0,,0.7838765463642258,0.5902333386185574,0.0536,0.0293,0.9985,,,0.04,0.0345,0.3333,,,,0.0458,,,0.0546,0.0304,0.9985,,,0.0403,0.0345,0.3333,,,,0.0478,,,0.0541,0.0293,0.9985,,,0.04,0.0345,0.3333,,,,0.0467,,,0.0361,1.0,2.0,0.0,2.0,0.0,-1051.0,0.0,0.0,0.0,0.0,1.0,3.0,1.0,0.0,0.0,1.0,0.0,1.0,0.0,0.0,0.0,0.0,0.0,0.0,0.0,0.0,0.0,0.0,1.0,0.0,0.0,0.0,0.0,0.0,0.0,0.0,0.0,0.0,0.0,0.0,0.0,0.0,0.0,0.0,3.0,9922.5,,261000.0,240376.5,0.0,0.0,0.0,0.0,-268.0,867.0,-25.0,,50.0,-8.0,4.0,15400.53,163215.0,188775.0,0.0,225000.0,24.0,-521.0,365243.0,-581.0,-401.0,109.0,-397.0,13.5,1.0,0.0,-1.0,36.0,24.0,21.5,-18.5,0.0,0.0,37.0,15400.53,15400.53,-491.0,-491.0,6.0,1.0,0.0,,,,,,,,,,,,,,,,,,,,,8345356956.0,184374623146.5,165563504064.0,51962587957.935,1863.0,1705.0,71125.0,70791.0,9140.0,505960.0,17804.596800002295,17866.76449999911,17318.318499998055,11293.999100000088,11231.81740000009,11179.120400000054,128387.0,662692.0,,,,13525469.156163985,,-921736941.0,-296457054.0,-1534907253.0416667,44011.0,30702.0,11347.148799999182,11223.119999998977,10707.480399997296,22883.532700009684,22805.40910000964,22190.932500008203,,158012.03374677888,126082.8831807602,34993.628000027915,34933.99120002835,34380.05020002877,,,,3713572.0,,,,,,,16464.640099999757,16649.87759999969,16246.644799999698,,,,,,,436415.0,431210.0,,6423.895688002895,631848.0,625400.0,,16329.259099999796,154148.32169999054,154151.07029999013,154042.83959998714,,,,9.0,35186296.31999999,,3776355177.525,1253231598.3749995,44641891.75499999,696729.5099999999,67.0,11786.0,-12330234.0,5275737.0,-6375763.0,,-4.0,12559.5,,450000.0,278667.0,0.0,0.0,0.0,0.0,-959.0,867.0,-15.0,,138211491.59999958,1975537644.120002,2230324056.63,31954500.98999999,1975769394.120002,143626.0,-9836461.0,2268109125.0,95571830.0,495169519.0,223481637.0,517258316.0,142684.0,2232.0,398.2405781696304,3456741.5,1168842.0,716534.5,-2346003.5,736331.0,98232.0,1567285535.1600227,1576091271.2850096,-96379219.0,-95585237.0,1760223.0,78230.0,,,,,,,,,,,,,,,,,,,,,1467132.0,14769308.0,3231820.0,8553553.0,11605731.0,1415409.0,1058315423.044501,,72088631520.83961,21673312504.92012,582250914.791999,5792665.7475,689.5,94245.0,-276873181.0,21957564.0,-123767966.0,,-2017643.5,,,,,,,,,,,,,,,,,,,,,4272111.5,2478755.5,-9002035.0,921269.0,37582.5,3732780943.4174633,3657267355.5674615,-260582071.0,-257271685.0,2526111.0,269148.0,3925424736.922457,33249239117.325912,36678082446.09014,1729036690.2675498,48075756703.26822,3987353.0,-247548229.5,103068133105.5,1053675856.0,17270053168.0,3502802467.5,18883890226.5,3671456.0,71903.5,20866.81013791115,89783349.0,,2.193714285714285,8.86300329197265,456.6510682433909,19.44289693593315,1001.761971992216,157500.0,-0.9009688679024191,-0.433883739117558,0.0,0.0,0.0,0.0,0.0,0.0,1.0,0.0,0.0,1.0,0.0,0.0,0.0,0.0,0.0,0.0,0.0,0.0,1.0,0.0,0.0,1.0,0.0,0.0,0.0,1.0,0.0,0.0,0.0,0.0,0.0,0.0,0.0,0.0,0.0,0.0,0.0,0.0,0.0,0.0,0.0,0.0,0.0,0.0,0.0,0.0,0.0,0.0,0.0,0.0,0.0,0.0,0.0,0.0,0.0,0.0,0.0,0.0,0.0,0.0,0.0,0.0,0.0,0.0,0.0,0.0,0.0,0.0,0.0,0.0,0.0,0.0,0.0,0.0,0.0,0.0,0.0,0.0,0.0,0.0,0.0,0.0,0.0,0.0,0.0,0.0,0.0,0.0,0.0,0.0,0.0,0.0,0.0,0.0,0.0,0.0,0.0,0.0,0.0,0.0,0.0,0.0,0.0,0.0,0.0,1.0,0.0,0.0,0.0,0.0,0.0,0.0,0.0,0.0,0.0,0.0,0.0,0.0,0.0,0.0
102342,0,0.0,0.0,0.0,1.0,0.0,67500.0,572292.0,23107.5,472500.0,0.018029,59.767123287671225,,-7710.0,-4481.0,,2.0,3.0,3.0,8.0,,0.2377225077640972,0.445396241560834,0.2278,0.15,0.9911,0.8640000000000001,0.0,0.24,0.2069,0.375,0.2917,0.1791,0.1858,0.2691,0.0,0.0,0.2321,0.1556,0.9911,0.8693,0.0,0.2417,0.2069,0.375,0.2917,0.1832,0.2029,0.2804,0.0,0.0,0.23,0.15,0.9911,0.8658,0.0,0.24,0.2069,0.375,0.2917,0.1822,0.189,0.274,0.0,0.0,0.2981,1.0,4.0,3.0,4.0,1.0,0.0,0.0,0.0,0.0,0.0,1.0,3.0,1.0,0.0,0.0,1.0,0.0,0.0,0.0,0.0,0.0,0.0,0.0,0.0,0.0,1.0,0.0,0.0,0.0,0.0,0.0,0.0,0.0,0.0,0.0,0.0,0.0,0.0,0.0,0.0,0.0,0.0,0.0,0.0,1.0,0.0,0.0,0.0,0.0,0.0,0.0,0.0,0.0,-481.0,-7.0,-8.0,,16.0,-7.5,3.0,5320.8225,45000.0,45000.0,0.0,55307.25,5.0,-395.0,365243.0,182439.0,182574.0,182574.0,182577.5,9.0,0.5,0.0,1911.0,10.0,10.0,5.5,-8.5,0.0,0.0,10.0,8391.645,8391.645,-248.5,-230.0,5.5,1.0,10.0,0.0,45000.0,,0.0,,,0.0,,0.0,0.0,0.0,0.0,,0.0,,,0.0,-8.5,0.0,0.0,8345380063.5,184375195438.5,165563976564.0,51962655457.935,1863.0,1705.0,71125.0,70792.0,9140.0,505963.0,17804.824600002295,17866.994499999113,17318.550599998056,11294.149100000088,11231.96740000009,11179.276000000054,128387.0,662694.0,4137.178400000121,4134.848900000015,3945.475500000096,13525528.923287272,,-921741422.0,-296457054.0,-1534914963.0416667,44014.0,30703.0,11347.388799999182,11223.359999998976,10707.722099997298,22883.73960000968,22805.61600000964,22191.139400008204,,158012.27146928664,126083.32857700175,34994.003000027915,34934.36620002835,34380.42520002877,22948.95659999592,22922.21319999549,22569.49809999573,3713580.0,8294.403900000167,8398.917000000076,8122.528500000229,9815.965500000715,9930.899400002158,10290.562499999647,16464.909199999758,16650.151599999692,16246.925199999698,828.5853000001761,813.7614000000459,759.7322000000131,3913.373500000125,3896.5388000001617,3729.172200000159,436419.0,431214.0,,6423.913717002895,631851.0,625403.0,,16329.557199999796,154149.31279999056,154152.06139999017,154043.83069998716,77596.35719999624,77934.11540000659,78335.54270000652,16.0,35192576.06999999,10875797.865000002,3778839607.185,1253543875.8749995,44641891.75499999,696729.5099999999,67.0,11786.0,-12345439.0,5264793.0,-6382473.0,,-7.5,0.0,0.0,0.0,0.0,0.0,0.0,0.0,0.0,-481.0,-7.0,-8.0,,138258364.52249962,1976484628.620002,2231365280.13,31954500.98999999,1976517435.870002,143745.0,-9842723.0,2270483204.5,95931869.5,495532783.5,223845411.5,517621635.0,142795.0,2232.5,398.2405781696304,3466050.0,1171140.0,717801.5,-2349605.0,736331.0,98232.0,1568298455.1225235,1577053355.7825105,-96468021.0,-95672859.5,1761235.5,78336.5,1521010586.97,3979903500.0,,201466175.5799997,,,85987090.70999993,,201148334.41499972,1460137477.139999,1514981681.3699985,1515039688.3049984,,16940.0,,,487009.0,-879947.0,275730.0,851.0,1467133.0,14769324.0,3231830.0,8553563.0,11605741.0,1415412.0,1058315423.044501,801584051.827495,72088631520.83961,21673312504.92012,582250914.791999,5792665.7475,689.5,94245.0,-276873662.0,21957557.0,-123767974.0,,-2017651.0,5921397865.979961,18718515000.0,,447859400.1524977,,,309044347.1999987,,459065677.76999927,5706593140.860032,5884691303.879999,5884934486.625,,80816.0,,,971276.5,-1698072.0,177364.0,6755.0,4272121.5,2478761.0,-9002043.5,921269.0,37582.5,3732789335.0624633,3657275747.212462,-260582319.5,-257271915.0,2526116.5,269149.0,3925430057.744957,33249284117.325912,36678127446.09014,1729036690.2675498,48075812010.51822,3987358.0,-247548624.5,103068498348.5,1053858295.0,17270235742.0,3502985041.5,18884072804.0,3671465.0,71904.0,20866.81013791115,89785260.0,,8.4784,2.9211295034079843,174.58750716943885,24.76650438169425,1480.2227207853705,33750.0,-0.9009688679024191,0.4338837391175582,1.0,0.0,0.0,0.0,0.0,0.0,0.0,0.0,0.0,1.0,0.0,0.0,0.0,0.0,0.0,0.0,0.0,0.0,1.0,0.0,1.0,0.0,0.0,0.0,0.0,1.0,0.0,0.0,0.0,0.0,0.0,0.0,0.0,0.0,0.0,0.0,0.0,0.0,0.0,0.0,0.0,0.0,0.0,0.0,0.0,0.0,0.0,0.0,0.0,0.0,0.0,0.0,0.0,0.0,0.0,0.0,0.0,0.0,0.0,0.0,0.0,0.0,0.0,0.0,0.0,0.0,0.0,0.0,0.0,0.0,0.0,0.0,0.0,0.0,0.0,0.0,0.0,0.0,0.0,0.0,0.0,0.0,0.0,0.0,0.0,0.0,0.0,0.0,0.0,0.0,0.0,0.0,0.0,0.0,0.0,0.0,0.0,0.0,0.0,0.0,0.0,0.0,0.0,0.0,0.0,1.0,0.0,0.0,0.0,1.0,1.0,0.0,0.0,0.0,0.0,0.0,0.0,1.0,0.0,0.0
102344,0,0.0,0.0,0.0,1.0,0.0,117000.0,225000.0,23184.0,225000.0,0.019101,66.58356164383562,,-4238.0,-4804.0,,1.0,2.0,2.0,8.0,,0.3345386966281105,,,,,,,,,,,,,,,,,,,,,,,,,,,,,,,,,,,,,,,,,,,,,,0.0,0.0,0.0,0.0,-909.0,,,,,,,1.0,0.0,0.0,1.0,0.0,0.0,0.0,0.0,0.0,0.0,0.0,0.0,0.0,0.0,0.0,0.0,1.0,0.0,0.0,0.0,0.0,0.0,0.0,0.0,0.0,0.0,0.0,0.0,0.0,0.0,0.0,0.0,0.0,,,,,,,,,,,,,0.0,,7.0,6367.41,45000.0,45000.0,8167.5,63337.5,12.0,-514.0,365243.0,-791.5,-521.5,-461.5,-516.0,8.0,0.5,0.1089090909090909,-1.0,54.0,12.0,6.0,-23.5,0.0,0.0,51.0,4673.25,4673.25,-700.0,-699.0,6.0,1.0,0.0,,,,,,,,,,,,,,,,,,,,,8345403247.5,184375420438.5,165564201564.0,51962772457.935,,,,,,,,,,,,,128387.0,662695.0,,,,13525595.506848916,,-921746226.0,-296457963.0,-1534919201.0416667,44014.0,30703.0,,,,,,,,158012.60600798327,,,,,,,,3713588.0,,,,,,,,,,,,,,,,436419.0,431214.0,,6423.932818002895,631853.0,625405.0,,,,,,,,,,,,,,,,,,,,,,,,,,,,,,,,,,,138277543.3649996,1976595243.120002,2231484638.13,31962668.48999999,1976699418.120002,143778.0,-9845118.0,2271578933.5,95929302.0,495531056.0,223843744.0,517619923.0,142843.0,2234.0,398.3494872605395,3467959.0,1171486.0,717965.0,-2350917.5,736331.0,98232.0,1568479345.9650226,1577234246.6250095,-96505121.0,-95709517.0,1761419.0,78367.0,,,,,,,,,,,,,,,,,,,,,1467133.0,14769324.0,3231830.0,8553617.0,11605792.0,1415419.0,,,,,,,,,,,,,,,,,,,,,,,,,,,,,,,,,,4272133.5,2478767.0,-9002067.0,921269.0,37582.5,3732794008.3124633,3657280420.462462,-260583019.5,-257272614.0,2526122.5,269150.0,3925436425.154957,33249329117.325912,36678172446.09014,1729044857.7675498,48075875348.01822,3987370.0,-247549138.5,103068863591.5,1053857503.5,17270235220.5,3502984580.0,18884072288.0,3671473.0,71904.5,20866.919047002066,89785259.0,,1.9230769230769231,5.046583850931676,336.0195269292947,9.70496894409938,646.1913979409512,117000.0,-0.9009688679024191,-0.433883739117558,0.0,0.0,0.0,0.0,0.0,0.0,1.0,0.0,0.0,1.0,0.0,0.0,0.0,0.0,0.0,0.0,0.0,0.0,1.0,0.0,0.0,0.0,1.0,0.0,0.0,1.0,0.0,0.0,0.0,0.0,0.0,0.0,0.0,0.0,0.0,0.0,0.0,0.0,0.0,0.0,0.0,0.0,0.0,0.0,0.0,0.0,0.0,0.0,0.0,0.0,0.0,0.0,0.0,0.0,0.0,0.0,0.0,0.0,0.0,0.0,0.0,0.0,0.0,0.0,0.0,0.0,0.0,0.0,0.0,0.0,0.0,0.0,0.0,0.0,0.0,0.0,0.0,0.0,0.0,0.0,0.0,0.0,0.0,0.0,0.0,0.0,0.0,0.0,0.0,0.0,0.0,0.0,0.0,0.0,0.0,0.0,0.0,0.0,0.0,0.0,0.0,0.0,0.0,0.0,0.0,1.0,0.0,0.0,0.0,0.0,0.0,0.0,0.0,0.0,0.0,0.0,0.0,0.0,0.0,0.0
102346,0,0.0,1.0,1.0,1.0,1.0,202500.0,712944.0,36531.0,567000.0,0.005313,34.35616438356164,-552.0,-1107.0,-2492.0,24.0,3.0,2.0,2.0,16.0,,0.4497887901551957,0.646329897706246,,,,,,,,,,,,,,,,,,,,,,,,,,,,,,,,,,,,,,,,,,,,,2.0,0.0,1.0,0.0,-2093.0,0.0,0.0,0.0,0.0,1.0,2.0,1.0,1.0,0.0,1.0,0.0,0.0,0.0,0.0,0.0,0.0,1.0,1.0,0.0,1.0,0.0,0.0,0.0,0.0,0.0,0.0,0.0,0.0,0.0,0.0,0.0,0.0,0.0,0.0,0.0,0.0,0.0,0.0,9.0,0.0,0.0,270000.0,0.0,0.0,0.0,0.0,0.0,-917.0,-897.5,-807.0,-1849.0,455.0,-28.0,6.0,12385.71,112333.5,115962.75,10643.0175,112333.5,12.0,-1167.0,365243.0,-1000.0,-820.0,-253.5,-812.5,17.5,0.0,0.1309449610097161,40.5,36.0,12.0,8.0,-40.0,0.0,0.0,31.0,13521.42,13521.42,-1249.0,-1238.0,4.0,1.0,38.0,0.0,225000.0,,0.0,,,0.0,,0.0,0.0,0.0,0.0,,0.0,,,0.0,-20.5,0.0,0.0,8345439778.5,184376133382.5,165564768564.0,51962974957.935,1863.0,1705.0,71125.0,70793.0,9140.0,505965.0,,,,,,,128388.0,662698.0,,,,13525629.8630133,-601759125.0,-921748718.0,-296460056.0,-1534920308.0416667,44014.0,30703.0,,,,,,,,158013.05579677346,126083.97490689949,,,,,,,3713604.0,,,,,,,,,,,,,,,,436421.0,431215.0,1262865.0,6423.938131002896,631855.0,625407.0,,,,,,,,,31.0,35373287.06999999,10875797.865000002,3785864116.725,1256274688.4549994,44654246.81999999,696729.5099999999,67.0,11786.0,-12364723.0,5269030.0,-6389758.0,-6907072.0,-15.0,0.0,0.0,134730.0,0.0,0.0,0.0,0.0,0.0,-2454.0,-2016.0,-1741.0,-2110.0,138455737.71749958,1979715102.120002,2234820393.63,31993089.0075,1979715102.120002,143934.0,-9854062.5,2274135634.5,96289896.0,496259563.0,224208298.0,518348449.0,143036.0,2237.0,398.7175176783146,3468769.0,1172557.0,718772.5,-2352291.0,736331.0,98232.0,1571626976.895024,1580372743.8600106,-96758249.0,-95961235.0,1774507.0,78421.0,1529066224.9349992,3993133500.0,,201679925.5799997,,,86621643.26999994,,201819014.41499972,1467855819.0449982,1523037275.9999974,1523095282.9349976,,16958.0,,,492201.0,-885000.5,275730.0,851.0,1467142.0,14769779.0,3231868.0,8553653.0,11605823.0,1415425.0,1058315423.044501,801584051.827495,72088901520.83961,21673312504.92012,582250914.791999,5792665.7475,689.5,94245.0,-276874579.0,21956659.5,-123768781.0,-218666119.0,-2017679.0,5921397865.979961,18718740000.0,,447859400.1524977,,,309044347.1999987,,459065677.76999927,5706593140.860032,5884691303.879999,5884934486.625,,80816.0,,,971276.5,-1698092.5,177364.0,6755.0,4272145.5,2478775.0,-9002107.0,921269.0,37582.5,3732807529.732464,3657293941.8824615,-260584268.5,-257273852.0,2526126.5,269151.0,3925448810.864957,33249441450.825912,36678288408.84014,1729055500.7850494,48075987681.51822,3987382.0,-247550305.5,103069228834.5,1053856503.5,17270234400.5,3502984326.5,18884071475.5,3671490.5,71904.5,20867.049991963067,89785299.5,-16.066985645933016,3.520711111111111,5.543237250554324,190.44437019712657,19.51613697955161,670.4996102015814,67500.0,-0.9009688679024191,0.4338837391175582,0.0,0.0,0.0,0.0,0.0,0.0,1.0,0.0,0.0,0.0,0.0,0.0,0.0,1.0,0.0,0.0,0.0,0.0,1.0,0.0,1.0,0.0,0.0,0.0,0.0,1.0,0.0,0.0,0.0,0.0,0.0,0.0,0.0,0.0,0.0,0.0,0.0,0.0,1.0,0.0,0.0,0.0,0.0,0.0,0.0,0.0,0.0,0.0,0.0,0.0,0.0,0.0,0.0,1.0,0.0,0.0,0.0,0.0,0.0,0.0,0.0,0.0,0.0,0.0,0.0,0.0,0.0,0.0,0.0,0.0,0.0,0.0,0.0,0.0,0.0,0.0,0.0,0.0,0.0,0.0,0.0,0.0,0.0,0.0,0.0,0.0,0.0,0.0,0.0,0.0,0.0,0.0,0.0,0.0,0.0,0.0,0.0,0.0,0.0,0.0,0.0,0.0,0.0,0.0,0.0,0.0,0.0,0.0,0.0,0.0,0.0,0.0,0.0,0.0,0.0,0.0,0.0,0.0,0.0,0.0
102347,0,0.0,0.0,0.0,0.0,0.0,56700.0,67500.0,7087.5,67500.0,0.031329,65.24931506849315,,-16465.0,-4860.0,,2.0,2.0,2.0,12.0,,0.3143367706128072,0.7713615919194317,0.0082,,0.9712,,,0.0,0.0345,0.0417,,,,,,,0.0084,,0.9712,,,0.0,0.0345,0.0417,,,,,,,0.0083,,0.9712,,,0.0,0.0345,0.0417,,,,,,,0.0064,1.0,0.0,0.0,0.0,0.0,-876.0,0.0,0.0,0.0,0.0,0.0,0.0,1.0,0.0,0.0,1.0,1.0,0.0,0.0,0.0,0.0,0.0,0.0,0.0,0.0,1.0,0.0,0.0,0.0,0.0,0.0,0.0,0.0,0.0,0.0,0.0,0.0,0.0,0.0,0.0,0.0,0.0,0.0,0.0,1.0,0.0,,78016.5,,,0.0,0.0,0.0,-1358.0,-1298.0,-1201.0,-1204.0,45.0,-22.0,4.0,5422.095,46035.0,48683.25,0.0,47497.5,12.0,-552.0,365243.0,-522.0,-192.0,142.0,-190.0,9.5,1.0,0.0,44.0,28.0,12.0,11.5,-13.5,0.0,0.0,29.0,5422.095,5422.095,-392.0,-372.0,5.0,1.0,0.0,,,,,,,,,,,,,,,,,,,,,8345446866.0,184376200882.5,165564836064.0,51963031657.935,1863.0,1705.0,71125.0,70793.0,9140.0,505965.0,17804.832800002296,17867.002799999114,17318.55899999806,,,,128388.0,662700.0,,,,13525695.112328367,,-921753578.0,-296460932.0,-1534936773.0416667,44014.0,30703.0,11347.388799999182,11223.359999998976,10707.722099997298,22883.774100009683,22805.650500009644,22191.1739000082,,158013.37013354406,126084.7462684914,34994.04470002792,34934.40790002835,34380.46690002876,,,,3713616.0,,,,,,,,,,,,,,,,436421.0,431215.0,,6423.969460002895,631857.0,625409.0,,16329.563599999798,154150.28399999056,154153.03259999017,154044.80189998716,,,,45.0,35435162.06999999,,3788523513.225,,,696729.5099999999,67.0,11786.0,-12372817.0,5264460.0,-6395909.0,-6913208.0,-22.0,0.0,,78016.5,,,0.0,0.0,0.0,-1358.0,-1298.0,-1201.0,-1204.0,138496673.24999958,1980084586.9050016,2235202740.63,31999232.02499999,1980062300.6550016,143992.0,-9857605.0,2275779228.0,96286607.0,496621524.0,224206756.0,518710433.0,143100.5,2239.0,398.8236581740702,3469987.0,1173033.0,719109.5,-2353222.0,736331.0,98232.0,1572029824.0050237,1580834990.9700098,-96783962.0,-95986148.0,1774669.0,78471.0,,,,,,,,,,,,,,,,,,,,,1467143.0,14769824.0,3231868.0,8553681.0,11605852.0,1415429.0,1058315423.044501,,72088979537.33961,,,5792665.7475,689.5,94245.0,-276875937.0,21955361.5,-123769982.0,-218667323.0,-2017701.0,,,,,,,,,,,,,,,,,,,,,4272157.5,2478786.5,-9002120.5,921269.0,37582.5,3732812951.827463,3657299363.977461,-260584660.5,-257274224.0,2526131.5,269152.0,3925454232.959957,33249487485.825912,36678337092.09014,1729055500.7850494,48076035179.01822,3987394.0,-247550857.5,103069594077.5,1053855981.5,17270234208.5,3502984468.5,18884071285.5,3671500.0,71905.5,20867.049991963067,89785343.5,,1.1904761904761905,8.0,521.9945205479452,9.523809523809524,621.4220482713632,28350.0,-0.2225209339563146,-0.9749279121818236,0.0,0.0,0.0,0.0,0.0,0.0,1.0,0.0,0.0,1.0,0.0,0.0,0.0,0.0,0.0,0.0,0.0,0.0,1.0,0.0,1.0,0.0,0.0,0.0,0.0,1.0,0.0,0.0,0.0,0.0,0.0,0.0,0.0,0.0,0.0,0.0,0.0,0.0,0.0,0.0,0.0,0.0,0.0,0.0,0.0,0.0,0.0,0.0,0.0,0.0,0.0,0.0,0.0,0.0,0.0,0.0,0.0,0.0,0.0,0.0,0.0,0.0,0.0,0.0,0.0,0.0,0.0,0.0,0.0,0.0,0.0,0.0,0.0,0.0,0.0,0.0,0.0,0.0,0.0,0.0,0.0,0.0,0.0,0.0,0.0,0.0,0.0,0.0,0.0,0.0,0.0,0.0,0.0,0.0,0.0,0.0,0.0,0.0,0.0,0.0,0.0,0.0,0.0,0.0,0.0,1.0,0.0,0.0,0.0,0.0,1.0,0.0,0.0,0.0,0.0,0.0,0.0,0.0,0.0,0.0
102374,0,0.0,1.0,1.0,1.0,0.0,292500.0,573408.0,24421.5,495000.0,0.008625,55.06849315068493,-12619.0,-12611.0,-1.0,35.0,2.0,2.0,2.0,12.0,,0.52207924051906,0.5937175866150576,,,,,,,,,,,,,,,,,,,,,,,,,,,,,,,,,,,,,,,,,,,,,6.0,1.0,6.0,1.0,0.0,0.0,0.0,0.0,0.0,0.0,1.0,1.0,1.0,0.0,1.0,0.0,0.0,0.0,1.0,1.0,0.0,0.0,0.0,0.0,1.0,0.0,0.0,0.0,0.0,0.0,0.0,0.0,0.0,0.0,0.0,0.0,0.0,0.0,0.0,0.0,0.0,0.0,0.0,15.0,4050.0,1102.5,337500.0,0.0,0.0,0.0,0.0,0.0,-1088.0,354.0,-316.0,-628.0,650.0,-23.0,2.0,6353.19,53055.0,83434.5,0.0,106110.0,9.0,-2579.5,365243.0,181300.0,181555.0,181555.0,181558.0,14.5,0.5,0.0,750.0,18.0,18.0,9.5,-79.5,0.0,0.0,18.0,10456.38,10456.38,-2392.5,-2388.0,9.5,1.0,79.0,0.0,45000.0,,0.0,,,0.0,,0.0,0.0,0.0,0.0,,0.0,,,0.0,-43.0,0.0,0.0,8345471287.5,184376774290.5,165565331064.0,51963324157.935,1863.0,1705.0,71125.0,70793.0,9140.0,505966.0,,,,,,,128388.0,662702.0,,,,13525750.180821516,-601771744.0,-921753579.0,-296460932.0,-1534949384.0416667,44015.0,30704.0,,,,,,,,158013.89221278462,126085.339986078,,,,,,,3713628.0,,,,,,,,,,,,,,,,436427.0,431221.0,1262900.0,6423.978085002896,631859.0,625411.0,,,,,,,,,36.0,36064093.58999999,11128958.955000002,3849812605.394999,1277378531.459999,45374853.46499999,696729.5099999999,69.0,11786.0,-12546571.0,5283931.0,-6486395.0,-7015317.0,-17.5,355.5,369.0,225000.0,0.0,0.0,0.0,0.0,0.0,-1439.0,23.0,-478.0,-628.0,140075770.5899997,2004028420.9050016,2261671195.23,32347715.174999997,2004028420.9050016,145538.0,-9983565.5,2302984131.5,97113353.5,503314121.5,226164783.5,526503131.5,144574.0,2263.0,403.9259015079064,3491779.0,1187248.0,727692.5,-2381360.5,737814.0,98363.0,1589174266.9950356,1596915427.5450175,-98189440.0,-97384033.5,1795272.0,79426.5,1544411148.9750006,4059508500.0,,203010278.7599997,,,87700017.91499995,,203595803.50499985,1482552969.6599977,1538350219.1699998,1538408226.105,,17035.0,,,502798.0,-905754.0,299554.0,864.0,1467158.0,14770474.0,3231947.0,8553699.0,11605870.0,1415431.0,1058319473.044501,801585154.327495,72089317037.33961,21673312504.92012,582250914.791999,5792665.7475,689.5,94245.0,-276877025.0,21955715.5,-123770298.0,-218667951.0,-2017724.0,5921397865.979961,18718785000.0,,447859400.1524977,,,309044347.1999987,,459065677.76999927,5706593140.860032,5884691303.879999,5884934486.625,,80816.0,,,971276.5,-1698135.5,177364.0,6755.0,4272175.5,2478796.0,-9002200.0,921269.0,37582.5,3732823408.2074633,3657309820.357462,-260587053.0,-257276612.0,2526141.0,269153.0,3925460586.149957,33249540540.825912,36678420526.59014,1729055500.7850494,48076141289.01822,3987403.0,-247553437.0,103069959320.5,1054037281.5,17270415763.5,3503166023.5,18884252843.5,3671514.5,71906.0,20867.049991963067,89786093.5,-229.15099502487564,1.9603692307692309,11.977151280633867,659.5636732623034,23.47963884282292,1292.98833079655,146250.0,-0.2225209339563146,-0.9749279121818236,0.0,0.0,0.0,0.0,0.0,1.0,0.0,0.0,0.0,0.0,0.0,0.0,0.0,1.0,0.0,0.0,0.0,0.0,1.0,0.0,1.0,0.0,0.0,0.0,0.0,1.0,0.0,0.0,0.0,0.0,0.0,0.0,0.0,0.0,0.0,0.0,0.0,0.0,1.0,0.0,0.0,0.0,0.0,0.0,0.0,0.0,0.0,0.0,0.0,0.0,0.0,0.0,0.0,0.0,0.0,0.0,0.0,0.0,0.0,0.0,0.0,0.0,0.0,0.0,0.0,0.0,0.0,0.0,0.0,0.0,0.0,0.0,0.0,0.0,0.0,0.0,0.0,0.0,0.0,0.0,0.0,0.0,0.0,0.0,0.0,0.0,0.0,0.0,0.0,0.0,0.0,0.0,0.0,0.0,0.0,0.0,0.0,0.0,0.0,0.0,0.0,1.0,0.0,0.0,0.0,0.0,0.0,0.0,0.0,0.0,0.0,0.0,0.0,0.0,0.0,0.0,0.0,0.0,0.0,0.0
102380,0,0.0,1.0,0.0,1.0,2.0,162000.0,257391.0,25204.5,238500.0,0.025164,37.405479452054784,-4828.0,-6571.0,-4814.0,,4.0,2.0,2.0,10.0,,0.5960127524389244,0.8245949709919925,,,,,,,,,,,,,,,,,,,,,,,,,,,,,,,,,,,,,,,,,,,,,0.0,0.0,0.0,0.0,-1777.0,0.0,0.0,0.0,0.0,1.0,2.0,1.0,1.0,0.0,1.0,0.0,0.0,0.0,0.0,0.0,0.0,1.0,1.0,0.0,1.0,0.0,0.0,0.0,0.0,0.0,0.0,0.0,0.0,0.0,0.0,0.0,0.0,0.0,0.0,0.0,0.0,0.0,0.0,1.0,0.0,,56700.0,0.0,0.0,0.0,0.0,0.0,-1521.0,-1337.0,-1330.0,-1337.0,50.0,-24.5,2.0,12800.3175,150277.5,171942.75,6111.0,150277.5,18.0,-1644.0,365243.0,-1613.0,-1118.0,-1103.0,-1102.0,13.5,0.5,0.2018266177054386,20.5,38.0,23.0,8.5,-32.5,0.0,0.0,38.0,22249.035,22249.035,-968.0,-957.0,9.5,1.0,0.0,,,,,,,,,,,,,,,,,,,,,8345496492.0,184377031681.5,165565569564.0,51963486157.935,1863.0,1705.0,71125.0,70794.0,9140.0,505968.0,,,,,,,128390.0,662706.0,,,,13525787.58630097,-601776572.0,-921758393.0,-296462709.0,-1534955955.0416667,44015.0,30704.0,,,,,,,,158014.48822553706,126086.164581049,,,,,,,3713638.0,,,,,,,,,,,,,,,,436427.0,431221.0,,6424.003249002895,631861.0,625413.0,,,,,,,,,50.0,37108120.72499999,,3864813597.4049993,1282979231.0099995,45478309.90499999,696729.5099999999,70.0,11786.0,-12584441.0,5324813.0,-6503918.0,-7034074.0,-24.5,0.0,,56700.0,0.0,0.0,0.0,0.0,0.0,-1521.0,-1337.0,-1330.0,-1337.0,140565658.0724997,2011090338.4050016,2270030023.98,32369081.174999997,2011090338.4050016,146096.0,-10020038.0,2310653262.5,97270166.0,504937872.0,227064430.0,528127002.0,145022.0,2273.5,404.7436244267735,3526252.5,1191440.5,730654.0,-2388813.0,737868.0,98417.0,1596467458.6425364,1605251182.477518,-98541851.0,-97733996.0,1802023.5,79705.0,,,,,,,,,,,,,,,,,,,,,1467159.0,14770524.0,3231947.0,8553737.0,11605908.0,1415433.0,1058319473.044501,,72089373737.33961,21673312504.92012,582250914.791999,5792665.7475,689.5,94245.0,-276878546.0,21954378.5,-123771628.0,-218669288.0,-2017748.5,,,,,,,,,,,,,,,,,,,,,4272198.5,2478804.5,-9002232.5,921269.0,37582.5,3732845657.242463,3657332069.392461,-260588021.0,-257277569.0,2526150.5,269154.0,3925473386.467457,33249690818.325912,36678592469.34014,1729061611.7850494,48076291566.51822,3987421.0,-247555081.0,103070324563.5,1054035668.5,17270414645.5,3503164920.5,18884251741.5,3671528.0,71906.5,20867.251818580768,89786114.0,-129.0719988280964,1.588833333333333,6.427423674343867,240.42086418032,10.212104981253349,381.9886830384984,40500.0,-0.2225209339563143,0.9749279121818236,0.0,0.0,0.0,0.0,0.0,0.0,1.0,0.0,1.0,0.0,0.0,0.0,0.0,0.0,0.0,0.0,0.0,0.0,1.0,0.0,1.0,0.0,0.0,0.0,0.0,1.0,0.0,0.0,0.0,0.0,0.0,0.0,0.0,0.0,0.0,0.0,0.0,0.0,1.0,0.0,0.0,0.0,0.0,0.0,0.0,0.0,0.0,0.0,0.0,0.0,0.0,1.0,0.0,0.0,0.0,0.0,0.0,0.0,0.0,0.0,0.0,0.0,0.0,0.0,0.0,0.0,0.0,0.0,0.0,0.0,0.0,0.0,0.0,0.0,0.0,0.0,0.0,0.0,0.0,0.0,0.0,0.0,0.0,0.0,0.0,0.0,0.0,0.0,0.0,0.0,0.0,0.0,0.0,0.0,0.0,0.0,0.0,0.0,0.0,0.0,0.0,0.0,0.0,0.0,0.0,0.0,0.0,0.0,0.0,0.0,0.0,0.0,0.0,0.0,0.0,0.0,0.0,0.0,0.0,0.0
102387,0,0.0,1.0,1.0,0.0,0.0,202500.0,630000.0,32296.5,630000.0,0.028663,33.419178082191785,-302.0,-558.0,-1133.0,12.0,2.0,2.0,2.0,10.0,0.6842611825137589,0.7805349512928729,,0.0995,0.0432,0.9727,0.6668,0.0317,0.04,0.0345,0.2917,0.3333,0.0119,0.0777,0.0378,0.0154,0.0218,0.0273,0.0232,0.9672,0.608,0.0236,0.0,0.0345,0.0417,0.0833,0.0083,0.0239,0.0153,0.0,0.0,0.1004,0.0432,0.9702,0.6713,0.0319,0.04,0.0345,0.2917,0.3333,0.0121,0.0791,0.0149,0.0155,0.0223,0.0243,1.0,10.0,0.0,10.0,0.0,-1968.0,0.0,0.0,0.0,0.0,0.0,3.0,1.0,1.0,0.0,1.0,0.0,1.0,0.0,0.0,0.0,0.0,1.0,1.0,0.0,1.0,0.0,0.0,0.0,0.0,0.0,0.0,0.0,0.0,0.0,0.0,0.0,0.0,0.0,0.0,0.0,0.0,0.0,0.0,1.0,53406.0,0.0,6025500.0,,,0.0,0.0,0.0,-568.0,4973.0,-13.0,,19.0,-9.0,4.0,11250.0,122827.5,137751.75,6570.0,180000.0,10.0,-1052.0,365243.0,-1478.0,-1178.0,-1178.0,-1174.5,9.0,0.5,0.1089837373045049,-1.0,24.0,12.0,5.5,-33.5,0.0,0.0,22.0,22218.93,22218.93,-1009.5,-1007.0,6.0,1.0,0.0,,,,,,,,,,,,,,,,,,,,,8345528788.5,184377661681.5,165566199564.0,51963688657.935,1863.0,1705.0,71125.0,70794.0,9140.0,505971.0,17804.932300002296,17867.103199999114,17318.586299998056,11294.192300000088,11232.01060000009,11179.299200000054,128390.0,662708.0,4137.21010000012,4134.880800000015,3945.499100000096,13525821.00547905,-601776874.0,-921759526.0,-296464677.0,-1534956513.0416667,44015.0,30704.0,11347.428799999185,11223.399999998976,10707.722099997298,22883.80860000968,22805.68500000965,22191.208400008207,67447.18629080468,158015.26876048837,,34994.33640002792,34934.699600028354,34380.50860002876,22949.28989999592,22922.546499995493,22569.58139999572,3713648.0,8294.415800000166,8398.929100000076,8122.536800000228,9816.043200000717,9930.978500002158,10290.586399999647,16464.946999999756,16650.16649999969,16246.940499999697,828.6007000001761,813.7769000000459,759.7322000000131,3913.395300000125,3896.561100000162,3729.172200000159,436437.0,431231.0,1262912.0,6424.031912002895,631863.0,625415.0,,16329.587899999797,154151.2566999906,154154.00279999015,154045.76909998714,77597.02399999625,77934.78670000659,78336.15070000652,19.0,37161526.72499999,11161989.855000002,3872347074.4049993,,,696729.5099999999,70.0,11786.0,-12599660.0,5323388.0,-6513260.0,,-9.0,53406.0,0.0,6025500.0,,,0.0,0.0,0.0,-568.0,4973.0,-13.0,,141019931.6099997,2017727581.950002,2279312752.275,32416056.674999997,2017840081.950002,146554.0,-10058321.0,2319052882.5,97607448.0,506012911.0,227780952.0,529567681.0,145423.5,2283.5,405.7919424399485,3531661.5,1197602.0,735054.0,-2398131.0,737885.0,98417.0,1605987067.5225337,1616264415.7875154,-98847769.5,-98036504.0,1805896.5,80001.5,,,,,,,,,,,,,,,,,,,,,1467160.0,14770543.0,3231947.0,8553761.0,11605930.0,1415437.0,1058372879.044501,801585154.327495,72095399237.33961,,,5792665.7475,689.5,94245.0,-276879114.0,21959351.5,-123771641.0,,-2017757.5,,,,,,,,,,,,,,,,,,,,,4272210.5,2478810.0,-9002266.0,921269.0,37582.5,3732867876.172464,3657354288.322461,-260589030.5,-257278576.0,2526156.5,269155.0,3925484636.467457,33249813645.825912,36678730221.09014,1729068181.7850494,48076471566.51822,3987431.0,-247556133.0,103070689806.5,1054034190.5,17270413467.5,3503163742.5,18884250567.0,3671537.0,71907.0,20867.360802318075,89786113.0,-9.036727332349566,3.111111111111111,6.270029260136548,209.53922442505643,19.50675769820259,651.8998093223978,101250.0,0.6234898018587336,0.7818314824680298,0.0,0.0,0.0,0.0,0.0,0.0,1.0,0.0,0.0,0.0,0.0,0.0,0.0,1.0,0.0,0.0,0.0,0.0,1.0,0.0,1.0,0.0,0.0,0.0,0.0,1.0,0.0,0.0,0.0,0.0,0.0,0.0,0.0,1.0,0.0,0.0,0.0,0.0,0.0,0.0,0.0,0.0,0.0,0.0,0.0,0.0,0.0,0.0,0.0,0.0,0.0,0.0,0.0,0.0,0.0,0.0,0.0,0.0,1.0,0.0,0.0,0.0,0.0,0.0,0.0,0.0,0.0,0.0,0.0,0.0,0.0,0.0,0.0,0.0,0.0,0.0,0.0,0.0,0.0,0.0,0.0,0.0,0.0,0.0,0.0,0.0,0.0,0.0,0.0,0.0,0.0,0.0,0.0,0.0,0.0,0.0,0.0,0.0,0.0,0.0,0.0,0.0,0.0,0.0,0.0,0.0,0.0,0.0,1.0,0.0,1.0,0.0,0.0,0.0,0.0,0.0,0.0,0.0,1.0,0.0
102393,0,0.0,0.0,1.0,1.0,1.0,112500.0,260640.0,26838.0,225000.0,0.00702,33.16164383561644,-2502.0,-916.0,-3727.0,10.0,3.0,2.0,2.0,10.0,0.5114833253956284,0.5120977618832915,,,,,,,,,,,,,,,,,,,,,,,,,,,,,,,,,,,,,,,,,,,,,,1.0,0.0,1.0,0.0,-942.0,,,,,,,1.0,1.0,0.0,1.0,0.0,0.0,0.0,0.0,0.0,0.0,0.0,0.0,0.0,1.0,0.0,0.0,0.0,0.0,0.0,0.0,0.0,0.0,0.0,0.0,0.0,0.0,0.0,0.0,0.0,0.0,0.0,0.0,0.0,,,,,,,,,,,,,0.0,,1.0,8233.2,72936.0,80640.0,0.0,72936.0,12.0,-942.0,365243.0,-910.0,-580.0,-580.0,-575.0,17.0,0.0,0.0,46.0,13.0,12.0,6.0,-25.0,0.0,0.0,12.0,8233.2,8233.2,-756.5,-745.0,6.5,1.0,0.0,,,,,,,,,,,,,,,,,,,,,8345555626.5,184377922321.5,165566424564.0,51963801157.935,,,,,,,,,,,,,128391.0,662711.0,,,,13525854.167122886,-601779376.0,-921763253.0,-296465619.0,-1534957429.0416667,44015.0,30704.0,,,,,,,67447.69777413008,158015.78085825025,,,,,,,,3713658.0,,,,,,,,,,,,,,,,436438.0,431232.0,1262922.0,6424.038932002895,631865.0,625417.0,,,,,,,,,,,,,,,,,,,,,,,,,,,,,,,,,,,141229644.11999965,2020018492.035002,2281765966.11,32455519.424999997,2020018492.035002,146760.0,-10085286.0,2323618420.0,97954484.0,506728253.0,227766843.0,530283079.0,145641.0,2290.0,406.4526786153074,3535239.0,1199323.0,736021.0,-2404774.0,737885.0,98417.0,1607449070.2500317,1617711801.840014,-99035439.5,-98222352.0,1806668.5,80129.5,,,,,,,,,,,,,,,,,,,,,1467160.0,14770543.0,3231947.0,8553774.0,11605942.0,1415438.0,,,,,,,,,,,,,,,,,,,,,,,,,,,,,,,,,,4272222.5,2478816.0,-9002291.0,921269.0,37582.5,3732876109.372463,3657362521.522461,-260589787.0,-257279321.0,2526163.0,269156.0,3925492869.667457,33249886581.825912,36678810861.09014,1729068181.7850494,48076544502.51822,3987443.0,-247557075.0,103071055049.5,1054033280.5,17270412887.5,3503163162.5,18884249992.0,3671554.0,71907.0,20867.360802318075,89786159.0,-75.4486120290813,2.3168,4.191817572099263,139.00756134983416,9.711602951039572,322.05271813529583,37500.0,1.0,0.0,0.0,0.0,0.0,0.0,0.0,0.0,1.0,0.0,1.0,0.0,0.0,0.0,0.0,0.0,0.0,0.0,0.0,0.0,1.0,0.0,1.0,0.0,0.0,0.0,0.0,1.0,0.0,0.0,0.0,0.0,0.0,0.0,0.0,1.0,0.0,0.0,0.0,0.0,0.0,0.0,0.0,0.0,0.0,0.0,0.0,0.0,0.0,0.0,0.0,0.0,0.0,0.0,0.0,0.0,0.0,0.0,0.0,0.0,0.0,0.0,0.0,0.0,0.0,0.0,0.0,0.0,0.0,0.0,0.0,0.0,0.0,0.0,0.0,0.0,0.0,0.0,0.0,0.0,0.0,0.0,0.0,0.0,0.0,0.0,0.0,0.0,0.0,1.0,0.0,0.0,0.0,0.0,0.0,0.0,0.0,0.0,0.0,0.0,0.0,0.0,0.0,0.0,0.0,0.0,0.0,0.0,0.0,0.0,0.0,0.0,0.0,0.0,0.0,0.0,0.0,0.0,0.0,0.0,0.0,0.0
102403,0,0.0,1.0,1.0,1.0,0.0,135000.0,104256.0,11074.5,90000.0,0.019101,43.07397260273972,-1861.0,-7985.0,-4250.0,19.0,2.0,2.0,2.0,10.0,0.6169181000665416,0.5510103379190335,0.7352209993926424,0.1046,0.0802,0.9876,0.83,0.014,0.06,0.1379,0.25,0.0208,0.0483,0.0824,0.0931,0.0135,0.0404,0.0998,0.0832,0.9801,0.7387,0.0131,0.0,0.1034,0.1667,0.0,0.033,0.0826,0.0837,0.0078,0.0069,0.1057,0.0802,0.9876,0.8323,0.0141,0.06,0.1379,0.25,0.0208,0.0491,0.0838,0.0948,0.0136,0.0413,0.0794,1.0,1.0,0.0,1.0,0.0,-3311.0,0.0,0.0,0.0,0.0,0.0,2.0,1.0,1.0,0.0,1.0,0.0,0.0,0.0,0.0,0.0,0.0,0.0,0.0,0.0,1.0,0.0,0.0,0.0,0.0,0.0,0.0,0.0,0.0,0.0,0.0,0.0,0.0,0.0,0.0,0.0,0.0,0.0,0.0,3.0,,,405000.0,0.0,,0.0,0.0,0.0,-2511.0,-1633.0,-579.0,-1979.0,205.0,-35.0,1.0,17713.125,135000.0,163255.5,,135000.0,12.0,-1238.0,365243.0,-1208.0,-878.0,-878.0,-871.0,10.0,1.0,,-1.0,13.0,12.0,6.0,-35.0,0.0,0.0,13.0,17713.125,17713.125,-1055.0,-1058.0,6.0,1.0,95.0,0.0,0.0,,0.0,,,0.0,,0.0,0.0,0.0,0.0,,0.0,,,0.0,-49.0,0.0,0.0,8345566701.0,184378026577.5,165566514564.0,51963936157.935,1863.0,1705.0,71125.0,70794.0,9140.0,505973.0,17805.036900002295,17867.208899999114,17318.686099998056,11294.272500000088,11232.09080000009,11179.382400000051,128391.0,662713.0,4137.22410000012,4134.894900000016,3945.512200000096,13525897.241095489,-601781237.0,-921767503.0,-296468930.0,-1534965414.0416667,44015.0,30704.0,11347.488799999182,11223.459999998977,10707.722099997298,22883.94650000969,22805.822900009647,22191.311800008207,67448.31469223014,158016.33186858814,126086.8998020484,34994.58640002792,34934.949600028354,34380.675300028764,22949.31069999592,22922.567299995488,22569.58139999572,3713668.0,8294.464100000167,8398.978200000076,8122.569800000227,9816.125600000716,9931.06230000216,10290.668999999649,16465.040099999755,16650.26129999969,16247.024199999694,828.6142000001761,813.7905000000459,759.7400000000131,3913.435700000125,3896.6024000001617,3729.17910000016,436439.0,431233.0,1262941.0,6424.058033002895,631867.0,625419.0,,16329.667299999795,154152.24429999062,154154.99039999014,154046.74919998716,77597.85399999625,77935.61900000657,78336.88940000652,83.0,,,3908426805.495,1294700862.8699994,,696729.5099999999,70.0,11786.0,-12717327.0,5348485.0,-6574599.0,-7117237.0,-41.0,,,405000.0,0.0,,0.0,0.0,0.0,-2511.0,-1633.0,-579.0,-1632.0,141795359.0549998,2027925491.535002,2290284767.61,,2027925491.535002,147508.0,-10146669.0,2334572736.0,97910354.0,508154600.0,228466828.0,532075758.0,146402.0,2302.0,,3545537.0,1203633.0,738535.0,-2419206.0,737950.0,98424.0,1614323829.690042,1625117920.5150242,-100013477.0,-99195960.0,1831246.0,80512.0,1575648542.385,4134928500.0,,207230359.9499997,,,89600514.56999995,,208610279.3249999,1512459265.5899966,1569504895.3349984,1569562902.2699986,,17457.0,,,515299.0,-928444.0,299562.0,871.0,1467163.0,14770748.0,3232042.0,8553787.0,11605955.0,1415439.0,,,72095804237.33961,21673312504.92012,,5792665.7475,689.5,94245.0,-276881625.0,21957718.5,-123772220.0,-218671267.0,-2017792.5,5921397865.979961,18718785000.0,,447859400.1524977,,,309044347.1999987,,459065677.76999927,5706593140.860032,5884691303.879999,5884934486.625,,80816.0,,,971276.5,-1698184.5,177364.0,6755.0,4272234.5,2478822.0,-9002326.0,921269.0,37582.5,3732893822.497463,3657380234.647461,-260590842.0,-257280379.0,2526169.0,269157.0,3925510582.792457,33250021581.825912,36678974116.59014,,48076679502.51822,3987455.0,-247558313.0,103071420292.5,1054032072.5,17270412009.5,3503162284.5,18884249121.0,3671564.0,71908.0,,89786158.0,-43.20474494339143,0.7722666666666667,12.190166598943517,525.078902105726,9.414059325477448,405.500933466182,67500.0,-0.2225209339563143,0.9749279121818236,0.0,0.0,0.0,0.0,0.0,0.0,1.0,0.0,1.0,0.0,0.0,0.0,0.0,0.0,0.0,0.0,0.0,0.0,1.0,0.0,1.0,0.0,0.0,0.0,0.0,1.0,0.0,0.0,0.0,0.0,0.0,0.0,0.0,0.0,1.0,0.0,0.0,0.0,0.0,0.0,0.0,0.0,0.0,0.0,0.0,0.0,0.0,0.0,0.0,0.0,0.0,0.0,0.0,1.0,0.0,0.0,0.0,0.0,0.0,0.0,0.0,0.0,0.0,0.0,0.0,0.0,0.0,0.0,0.0,0.0,0.0,0.0,0.0,0.0,0.0,0.0,0.0,0.0,0.0,0.0,0.0,0.0,0.0,0.0,0.0,0.0,0.0,0.0,0.0,0.0,0.0,0.0,0.0,0.0,0.0,0.0,0.0,0.0,0.0,0.0,0.0,0.0,0.0,0.0,0.0,0.0,0.0,0.0,1.0,0.0,0.0,0.0,1.0,0.0,0.0,0.0,0.0,0.0,1.0,0.0
102413,0,0.0,1.0,1.0,1.0,0.0,157500.0,301896.0,23490.0,252000.0,0.008019,42.21643835616438,-2736.0,-3555.0,-4039.0,16.0,2.0,2.0,2.0,12.0,0.6040972156746302,0.6446323816299063,0.5549467685334323,0.0619,0.0519,0.9866,0.8164,0.0791,0.0,0.1379,0.1667,0.0417,0.0401,0.0504,0.055,0.0,0.0,0.063,0.0539,0.9866,0.8236,0.0799,0.0,0.1379,0.1667,0.0417,0.041,0.0551,0.0573,0.0,0.0,0.0625,0.0519,0.9866,0.8189,0.0796,0.0,0.1379,0.1667,0.0417,0.0408,0.0513,0.056,0.0,0.0,0.0433,1.0,2.0,0.0,2.0,0.0,0.0,0.0,0.0,0.0,0.0,0.0,3.0,1.0,1.0,0.0,1.0,0.0,0.0,0.0,0.0,0.0,0.0,0.0,0.0,0.0,1.0,0.0,0.0,0.0,0.0,0.0,0.0,0.0,0.0,0.0,0.0,0.0,0.0,0.0,0.0,0.0,0.0,0.0,0.0,9.0,0.0,0.0,32805.0,0.0,0.0,0.0,0.0,0.0,-642.0,-350.0,-217.0,-487.0,230.0,-13.0,3.0,16415.055,78286.5,76270.5,7830.0,196643.25,17.0,-791.0,365243.0,-1636.0,-1306.0,-1156.0,-1299.5,14.0,1.0,0.1013975162832779,-1.0,25.0,24.0,12.0,-24.0,0.0,0.0,25.0,10699.83,10699.83,-701.0,-701.0,6.0,1.0,0.0,,,,,,,,,,,,,,,,,,,,,8345590191.0,184378328473.5,165566766564.0,51964093657.935,1863.0,1705.0,71125.0,70794.0,9140.0,505976.0,17805.098800002295,17867.271399999114,17318.74909999806,11294.324400000089,11232.142700000091,11179.436300000054,128391.0,662715.0,4137.30320000012,4134.974500000016,3945.592100000096,13525939.457533846,-601783973.0,-921771542.0,-296468930.0,-1534968969.0416667,44015.0,30704.0,11347.488799999182,11223.459999998977,10707.722099997298,22884.084400009688,22805.96080000965,22191.44970000821,67448.91878944582,158016.97650096976,126087.45474881692,34994.75310002792,34935.11630002836,34380.842000028766,22949.35239999592,22922.608999995493,22569.62309999573,3713680.0,8294.504200000167,8399.019000000077,8122.61080000023,9816.176000000716,9931.113600002158,10290.724099999648,16465.095099999755,16650.31729999969,16247.081499999696,828.6142000001761,813.7905000000459,759.7400000000131,3913.435700000125,3896.6024000001617,3729.17910000016,436441.0,431235.0,1262957.0,6424.066052002896,631869.0,625421.0,,16329.710599999797,154153.2308999906,154155.97699999015,154047.73579998716,77598.67039999625,77936.43790000657,78337.71300000652,22.0,37241203.72499999,11271120.165000005,3927266983.2599993,1299642313.4549994,46176645.55499999,696729.5099999999,70.0,11786.0,-12772974.0,5367284.0,-6601114.0,-7148907.0,-10.5,0.0,0.0,32805.0,0.0,0.0,0.0,0.0,0.0,-955.0,-863.0,-378.0,-893.0,142179070.5224998,2031459660.630002,2294829254.61,32657987.51999999,2031420517.380002,147812.0,-10170950.0,2342424849.5,97890723.5,510331349.5,229185956.5,534618161.0,146812.0,2311.5,409.9191446137908,3556894.0,1206903.0,740321.0,-2430812.0,825206.0,98479.0,1618836060.195037,1629613878.52502,-100463916.0,-99644139.0,1842077.0,80787.0,,,,,,,,,,,,,,,,,,,,,1467172.0,14770978.0,3232042.0,8553812.0,11605980.0,1415442.0,1058372879.044501,801585154.327495,72095837042.33961,21673312504.92012,582250914.791999,5792665.7475,689.5,94245.0,-276882267.0,21957368.5,-123772437.0,-218671754.0,-2017805.5,,,,,,,,,,,,,,,,,,,,,4272258.5,2478834.0,-9002350.0,921269.0,37582.5,3732904522.327463,3657390934.477461,-260591543.0,-257281080.0,2526175.0,269158.0,3925526997.847457,33250099868.325912,36679050387.09014,1729076011.7850494,48076876145.76822,3987472.0,-247559104.0,103071785535.5,1054030436.5,17270410703.5,3503161128.5,18884247821.5,3671578.0,71909.0,20867.46219983436,89786157.0,-64.80887792848335,1.9168,6.704980842911878,283.0604104340524,12.852107279693485,542.5701947199916,78750.0,1.0,0.0,0.0,0.0,0.0,0.0,0.0,0.0,1.0,0.0,0.0,0.0,0.0,0.0,0.0,1.0,0.0,0.0,0.0,0.0,1.0,1.0,0.0,0.0,0.0,0.0,0.0,1.0,0.0,0.0,0.0,0.0,0.0,0.0,0.0,0.0,1.0,0.0,0.0,0.0,0.0,0.0,0.0,0.0,0.0,0.0,0.0,0.0,0.0,0.0,0.0,0.0,0.0,0.0,0.0,0.0,0.0,0.0,0.0,0.0,0.0,0.0,0.0,0.0,0.0,0.0,0.0,0.0,0.0,0.0,0.0,0.0,0.0,0.0,0.0,0.0,0.0,0.0,0.0,0.0,0.0,0.0,0.0,0.0,0.0,0.0,0.0,0.0,0.0,0.0,0.0,0.0,0.0,0.0,0.0,0.0,0.0,0.0,0.0,0.0,0.0,0.0,0.0,0.0,1.0,0.0,0.0,0.0,0.0,0.0,1.0,0.0,1.0,0.0,0.0,0.0,0.0,0.0,0.0,1.0,0.0,0.0
102414,0,0.0,1.0,1.0,1.0,0.0,180000.0,1741972.5,54198.0,1557000.0,0.035792,40.60821917808219,-5506.0,-3687.0,-5556.0,2.0,2.0,2.0,2.0,14.0,0.7317373217090681,0.5860496220759194,0.722392890081304,,,,,,,,,,,,,,,,,,,,,,,,,,,,,,,,,,,,,,,,,,,,,0.0,0.0,0.0,0.0,-3887.0,0.0,0.0,0.0,0.0,0.0,4.0,1.0,1.0,0.0,1.0,0.0,0.0,0.0,0.0,0.0,0.0,0.0,0.0,0.0,0.0,0.0,0.0,0.0,0.0,1.0,0.0,0.0,0.0,0.0,0.0,0.0,0.0,0.0,0.0,0.0,0.0,0.0,0.0,9.0,0.0,0.0,1368000.0,0.0,0.0,0.0,0.0,0.0,-1711.0,681.0,-988.0,-1072.0,464.0,-26.0,10.0,35876.115000000005,0.0,0.0,37125.0,635625.0,12.0,-390.0,365243.0,-391.0,-30.0,-30.0,-29.0,14.0,0.0,0.1089090909090909,-1.0,18.0,12.0,8.0,-9.5,0.0,0.0,50.0,30484.215000000004,30484.215000000004,-287.0,-269.0,8.5,0.0,14.0,140762.02500000002,270000.0,0.0,51204.15,0.0,51204.15,6747.6825,22500.0,13419.7425,139754.79,140762.02500000002,140762.02500000002,0.0,7.5,0.0,7.5,5.5,-7.5,0.0,0.0,8345644389.0,184380070446.0,165568323564.0,51964273657.935,1863.0,1705.0,71125.0,70794.0,9140.0,505980.0,,,,,,,128391.0,662717.0,,,,13525980.065753024,-601789479.0,-921777098.0,-296472817.0,-1534972656.0416667,44015.0,30704.0,,,,,,,67449.65052676752,158017.56255059186,126088.177141707,,,,,,,3713694.0,,,,,,,,,,,,,,,,436441.0,431235.0,1262959.0,6424.101844002896,631871.0,625423.0,,,,,,,,,57.0,37263015.22499999,11271309.165000005,3938228491.68,1304167850.9549994,46176645.55499999,696729.5099999999,70.0,11786.0,-12782645.0,5387392.0,-6607048.0,-7154403.0,-28.0,0.0,0.0,1368000.0,0.0,0.0,0.0,0.0,0.0,-1711.0,-490.0,-1063.0,-1072.0,142318835.6399998,2033768160.630002,2297338706.61,32695112.51999999,2033633160.630002,147889.0,-10173402.0,2342972714.0,97888717.0,510695061.0,229549878.0,534981879.0,146905.5,2313.0,410.0280537046999,3556891.5,1207165.0,740469.5,-2431699.5,825206.0,98479.0,1620198345.7125373,1631583664.0425203,-100494311.5,-99674186.5,1842418.0,80911.0,1580412361.05,4152861000.0,135291147.39,208295452.93499973,8314752.6000000015,64531912.31999999,89907984.29249996,228083094.81000003,209769362.415,1517057495.8874965,1574251764.9299994,1574309771.8649995,6857.0,17522.0,115.0,10550.0,518376.5,-935921.0,299568.0,877.0,1467181.0,14771442.0,3232056.0,8553830.0,11606030.0,1415452.0,1058372879.044501,801585154.327495,72097205042.33961,21673312504.92012,582250914.791999,5792665.7475,689.5,94245.0,-276883978.0,21958049.5,-123773425.0,-218672826.0,-2017831.5,5921538628.004962,18719055000.0,198760895.325,447910604.3024976,1948107.735,256735400.64750075,309051094.8824987,636459706.597498,459079097.5124993,5706732895.650032,5884832065.904999,5885075248.65,13378.0,80823.5,44.0,70338.5,971282.0,-1698192.0,177364.0,6755.0,4272270.5,2478842.0,-9002359.5,921269.0,37582.5,3732935006.5424633,3657421418.692461,-260591830.0,-257281349.0,2526183.5,269158.0,3925562873.962456,33250099868.325912,36679050387.09014,1729113136.7850494,48077511770.76822,3987484.0,-247559494.0,103072150778.5,1054030045.5,17270410673.5,3503161098.5,18884247792.5,3671592.0,71909.0,20867.571108925265,89786156.0,-135.5883146673863,9.677625,3.3211557622052474,134.86622111618132,32.14090003321156,1305.1847131294842,90000.0,1.0,0.0,0.0,0.0,0.0,0.0,0.0,0.0,1.0,0.0,0.0,0.0,1.0,0.0,0.0,0.0,0.0,1.0,0.0,0.0,0.0,0.0,1.0,0.0,0.0,0.0,0.0,1.0,0.0,0.0,0.0,0.0,0.0,0.0,0.0,1.0,0.0,0.0,0.0,0.0,0.0,0.0,0.0,0.0,0.0,0.0,0.0,0.0,0.0,0.0,0.0,0.0,0.0,0.0,0.0,0.0,0.0,0.0,0.0,0.0,0.0,0.0,0.0,0.0,0.0,0.0,0.0,0.0,0.0,0.0,0.0,0.0,0.0,0.0,0.0,0.0,0.0,0.0,0.0,0.0,0.0,0.0,0.0,0.0,1.0,0.0,0.0,0.0,0.0,0.0,0.0,0.0,0.0,0.0,0.0,0.0,0.0,0.0,0.0,0.0,0.0,0.0,0.0,0.0,0.0,0.0,0.0,0.0,0.0,0.0,0.0,0.0,0.0,0.0,0.0,0.0,0.0,0.0,0.0,0.0,0.0,0.0
102415,0,0.0,0.0,1.0,0.0,0.0,202500.0,247500.0,12037.5,247500.0,0.01885,46.99178082191781,-7350.0,-916.0,-677.0,5.0,2.0,2.0,2.0,15.0,0.5360429683630468,0.6279647878846799,0.4206109640437848,,,,,,,,,,,,,,,,,,,,,,,,,,,,,,,,,,,,,,,,,,,,,5.0,1.0,5.0,0.0,-2365.0,0.0,0.0,0.0,0.0,1.0,4.0,1.0,1.0,1.0,1.0,1.0,0.0,0.0,0.0,0.0,0.0,0.0,0.0,0.0,1.0,0.0,0.0,0.0,0.0,0.0,0.0,0.0,0.0,0.0,0.0,0.0,0.0,0.0,0.0,0.0,0.0,0.0,0.0,6.0,0.0,10530.0,211500.0,0.0,0.0,0.0,0.0,0.0,-1231.0,38.0,-215.5,-1115.0,289.0,-31.0,8.0,7184.6325,83745.0,86715.0,0.0,83745.0,15.0,-737.5,365243.0,-813.0,-573.0,-452.0,-568.0,14.5,1.0,0.0,40.0,65.0,12.0,7.0,-25.0,0.0,0.0,166.0,7736.3325,7736.3325,-1375.5,-1369.0,38.0,0.0,96.0,140856.23249999998,202500.0,0.0,0.0,0.0,0.0,8100.0,10125.0,10125.0,134385.79499999998,140856.23249999998,140856.23249999998,0.0,0.0,0.0,0.0,40.5,-48.5,0.0,0.0,8345656426.5,184380317946.0,165568571064.0,51964476157.935,1863.0,1705.0,71125.0,70795.0,9140.0,505984.0,,,,,,,128391.0,662719.0,,,,13526027.057533843,-601796829.0,-921777775.0,-296475182.0,-1534973572.0416667,44016.0,30704.0,,,,,,,67450.18656973589,158018.1905153797,126088.59775267103,,,,,,,3713709.0,,,,,,,,,,,,,,,,436446.0,431240.0,1262964.0,6424.120694002895,631873.0,625425.0,,,,,,,,,41.0,37284826.72499999,11281839.165000005,3943414944.18,1304167850.9549994,46176645.55499999,696729.5099999999,70.0,11786.0,-12797026.5,5391855.0,-6613481.5,-7163177.0,-20.0,0.0,10530.0,173047.5,0.0,0.0,0.0,0.0,0.0,-2656.0,-830.0,-769.0,-1115.0,142385871.5324998,2034489753.630002,2298080531.61,32697475.01999999,2034489753.630002,147995.0,-10180073.0,2344433249.0,97884032.0,510691627.0,229546804.0,534978460.0,147024.5,2315.0,410.1281539720795,3557115.0,1207712.0,740770.0,-2432891.0,825206.0,98479.0,1622037506.0175352,1633422322.867519,-100610290.5,-99789579.5,1847201.0,80935.0,1587942295.5825002,4163330250.0,135853422.39,209479431.23999968,8455152.600000001,65013215.62499999,90354814.15499996,229247874.63000008,210882520.7549999,1524259387.7549963,1581777239.5574994,1581835246.4924998,6886.0,17623.0,116.0,10621.0,520384.5,-938157.5,299568.0,877.0,1467187.0,14771731.0,3232152.0,8553895.0,11606196.0,1415460.0,1058372879.044501,801595684.327495,72097416542.33961,21673312504.92012,582250914.791999,5792665.7475,689.5,94245.0,-276885209.0,21958087.5,-123773640.5,-218673941.0,-2017862.5,5921679484.237462,18719257500.0,198760895.325,447910604.3024976,1948107.735,256735400.64750075,309059194.8824987,636469831.597498,459089222.5124993,5706867281.445032,5884972922.137499,5885216104.8825,13378.0,80823.5,44.0,70338.5,971322.5,-1698240.5,177364.0,6755.0,4272282.5,2478849.0,-9002384.5,921269.0,37582.5,3732942742.8749633,3657429155.024961,-260593205.5,-257282718.0,2526221.5,269158.0,3925570058.594957,33250183613.325912,36679137102.09014,1729113136.7850494,48077595515.76822,3987499.0,-247560231.5,103072516021.5,1054029232.5,17270410100.5,3503160646.5,18884247224.5,3671606.5,71910.0,20867.571108925265,89786196.0,-156.4103311567164,1.2222222222222223,16.822429906542055,790.5159390602995,20.560747663551407,966.1861477403662,101250.0,-0.9009688679024191,0.4338837391175582,0.0,0.0,0.0,0.0,0.0,0.0,1.0,0.0,0.0,0.0,0.0,0.0,0.0,1.0,0.0,0.0,0.0,0.0,1.0,0.0,1.0,0.0,0.0,0.0,0.0,1.0,0.0,0.0,0.0,0.0,0.0,0.0,0.0,1.0,0.0,0.0,0.0,0.0,0.0,0.0,0.0,0.0,0.0,0.0,0.0,0.0,0.0,0.0,0.0,0.0,0.0,0.0,0.0,0.0,0.0,0.0,0.0,0.0,0.0,1.0,0.0,0.0,0.0,0.0,0.0,0.0,0.0,0.0,0.0,0.0,0.0,0.0,0.0,0.0,0.0,0.0,0.0,0.0,0.0,0.0,0.0,0.0,0.0,0.0,0.0,0.0,0.0,0.0,0.0,0.0,0.0,0.0,0.0,0.0,0.0,0.0,0.0,0.0,0.0,0.0,0.0,0.0,0.0,0.0,0.0,0.0,0.0,0.0,0.0,0.0,0.0,0.0,0.0,0.0,0.0,0.0,0.0,0.0,0.0,0.0
102416,0,0.0,0.0,0.0,1.0,1.0,157500.0,490482.0,58338.0,441000.0,0.0196889999999999,30.14246575342466,-1374.0,-5863.0,-3596.0,,3.0,2.0,2.0,9.0,0.6306805836797681,0.3923635683663775,,0.0392,0.0051,0.9737,0.6396,0.0035,0.0,0.069,0.1667,0.2083,0.0169,0.0269,0.0294,0.0232,0.0276,0.0399,0.0053,0.9737,0.6537,0.0035,0.0,0.069,0.1667,0.2083,0.0173,0.0294,0.0306,0.0233,0.0292,0.0396,0.0051,0.9737,0.6444,0.0035,0.0,0.069,0.1667,0.2083,0.0172,0.0274,0.0299,0.0233,0.0282,0.0316,1.0,0.0,0.0,0.0,0.0,-229.0,,,,,,,1.0,1.0,0.0,1.0,0.0,0.0,0.0,0.0,0.0,0.0,0.0,0.0,0.0,1.0,0.0,0.0,0.0,0.0,0.0,0.0,0.0,0.0,0.0,0.0,0.0,0.0,0.0,0.0,0.0,0.0,0.0,0.0,0.0,,,,,,,,,,,,,0.0,,2.0,5336.1675,90564.75,93163.5,0.0,90564.75,18.0,-412.5,365243.0,-372.0,365243.0,138.0,365243.0,15.0,0.0,0.0,250.0,25.0,24.0,12.0,-8.0,0.0,0.0,27.0,6188.175,6188.175,-211.0,-220.0,8.0,1.0,0.0,,,,,,,,,,,,,,,,,,,,,8345714764.5,184380808428.0,165569012064.0,51964633657.935,,,,,,,17805.138000002295,17867.310999999114,17318.788999998054,11294.329500000087,11232.147800000092,11179.441600000056,128392.0,662722.0,4137.30670000012,4134.978000000016,3945.595600000096,13526057.1999996,-601798203.0,-921781371.0,-296475411.0,-1534979435.0416667,44016.0,30704.0,11347.488799999182,11223.459999998977,10707.722099997298,22884.153400009687,22806.029800009648,22191.518700008208,67450.81725031957,158018.58287894807,,34994.91980002792,34935.283000028365,34381.00870002877,22949.56069999592,22922.817299995488,22569.83139999572,3713718.0,8294.521100000167,8399.036200000077,8122.628100000229,9816.202900000717,9931.14100000216,10290.753499999648,16465.124499999754,16650.34719999969,16247.112099999697,828.6374000001761,813.8138000000458,759.7633000000129,3913.463300000125,3896.630600000162,3729.20830000016,436446.0,431240.0,,6424.140383002896,631875.0,625427.0,,16329.742199999797,154154.2045999906,154156.95069999015,154048.70949998716,77599.30999999624,77937.08230000659,78338.36670000652,,,,,,,,,,,,,,,,,,,,,,,,,,,142425199.3949998,2035200969.630002,2298895326.36,32697475.01999999,2035200969.630002,148121.0,-10184666.0,2345711599.5,97880222.0,511236913.5,229544689.0,535523753.5,147096.0,2316.0,410.1281539720795,3557699.0,1208441.0,741196.0,-2435030.0,825209.0,98479.0,1622917070.7300358,1634294833.8300192,-100750183.0,-99928653.0,1850453.0,80992.0,,,,,,,,,,,,,,,,,,,,,1467187.0,14771731.0,3232152.0,8553920.0,11606223.0,1415462.0,,,,,,,,,,,,,,,,,,,,,,,,,,,,,,,,,,4272306.5,2478861.0,-9002392.5,921269.0,37582.5,3732948931.049964,3657435343.1999607,-260593416.5,-257282938.0,2526229.5,269159.0,3925575394.762456,33250274178.075912,36679230265.59014,1729113136.7850494,48077686080.51822,3987517.0,-247560644.0,103072881264.5,1054028860.5,17270775343.5,3503160784.5,18884612467.5,3671621.5,71910.0,20867.571108925265,89786446.0,-45.58353026722414,3.1141714285714284,2.6997840172786183,81.37814728246398,8.407590249922864,253.425501177127,52500.0,-0.2225209339563146,-0.9749279121818236,0.0,0.0,0.0,0.0,0.0,0.0,1.0,0.0,1.0,0.0,0.0,0.0,0.0,0.0,0.0,0.0,0.0,0.0,1.0,0.0,1.0,0.0,0.0,0.0,0.0,1.0,0.0,0.0,0.0,0.0,0.0,0.0,0.0,0.0,0.0,0.0,0.0,0.0,0.0,0.0,0.0,0.0,0.0,0.0,1.0,0.0,0.0,0.0,0.0,0.0,0.0,0.0,0.0,0.0,0.0,0.0,0.0,0.0,0.0,0.0,0.0,0.0,0.0,0.0,0.0,0.0,0.0,0.0,0.0,0.0,0.0,0.0,0.0,0.0,0.0,0.0,0.0,0.0,0.0,0.0,0.0,0.0,0.0,0.0,0.0,0.0,0.0,0.0,0.0,0.0,1.0,0.0,0.0,0.0,0.0,0.0,0.0,0.0,0.0,0.0,0.0,0.0,0.0,0.0,0.0,0.0,0.0,0.0,1.0,0.0,1.0,0.0,0.0,0.0,0.0,0.0,0.0,0.0,1.0,0.0
102439,0,0.0,0.0,0.0,1.0,0.0,45000.0,539100.0,23877.0,450000.0,0.0105,53.15068493150685,-838.0,-5909.0,-2949.0,,2.0,3.0,3.0,11.0,,0.5235467729831833,0.7001838506835805,,,,,,,,,,,,,,,,,,,,,,,,,,,,,,,,,,,,,,,,,,,,,2.0,0.0,2.0,0.0,-1051.0,0.0,0.0,0.0,0.0,1.0,1.0,1.0,1.0,0.0,1.0,0.0,0.0,0.0,0.0,0.0,0.0,0.0,0.0,0.0,1.0,0.0,0.0,0.0,0.0,0.0,0.0,0.0,0.0,0.0,0.0,0.0,0.0,0.0,0.0,0.0,0.0,0.0,0.0,1.0,0.0,,103500.0,0.0,0.0,0.0,0.0,0.0,-575.0,-29.0,-27.0,-29.0,19.0,-9.0,3.0,7197.345,0.0,0.0,0.0,66217.5,12.0,-390.0,365243.0,-1020.0,-690.0,-690.0,-682.0,13.0,0.0,0.0,-1.0,13.0,12.0,5.0,-28.0,0.0,0.0,12.0,7197.345,7197.345,-858.0,-855.0,6.5,1.0,0.0,,,,,,,,,,,,,,,,,,,,,8345738641.5,184381347528.0,165569462064.0,51964678657.935,1863.0,1705.0,71125.0,70796.0,9140.0,505985.0,,,,,,,128392.0,662724.0,,,,13526110.350684533,-601799041.0,-921784320.0,-296476462.0,-1534985344.0416667,44016.0,30704.0,,,,,,,,158019.10642572105,126089.29793652176,,,,,,,3713729.0,,,,,,,,,,,,,,,,436448.0,431242.0,,6424.150883002895,631878.0,625430.0,,,,,,,,,19.0,37352340.40499999,,3980003426.729999,1312266414.3749998,47011492.61999998,696729.5099999999,71.0,11786.0,-12931282.0,5429758.0,-6683152.0,-7238663.0,-9.0,0.0,,103500.0,0.0,0.0,0.0,0.0,0.0,-575.0,-29.0,-27.0,-29.0,143953222.2749998,2056127773.455002,2323055855.61,32888962.84499999,2056127773.455002,149733.0,-10266823.0,2368539287.0,100013558.0,517222383.0,231705370.0,540778636.0,148605.0,2339.0,412.7752910474134,3606124.0,1222279.0,749287.0,-2460811.0,825283.0,98540.0,1634962410.6075366,1646829591.4575195,-101400000.5,-100570726.0,1856095.5,81808.5,,,,,,,,,,,,,,,,,,,,,1467188.0,14771750.0,3232152.0,8553933.0,11606235.0,1415465.0,1058372879.044501,,72097520042.33961,21673312504.92012,582250914.791999,5792665.7475,689.5,94245.0,-276885784.0,21958058.5,-123773667.5,-218673970.0,-2017871.5,,,,,,,,,,,,,,,,,,,,,4272318.5,2478866.0,-9002420.5,921269.0,37582.5,3732956128.3949633,3657442540.544961,-260594274.5,-257283793.0,2526236.0,269160.0,3925582592.107456,33250274178.075912,36679230265.59014,1729113136.7850494,48077752298.01822,3987529.0,-247561034.0,103073246507.5,1054027840.5,17270774653.5,3503160094.5,18884611785.5,3671634.5,71910.0,20867.571108925265,89786445.0,-15.766494845360825,11.98,1.8846588767433088,100.17091016115124,22.578213343384853,1200.047503730592,22500.0,-0.2225209339563143,0.9749279121818236,0.0,1.0,0.0,0.0,0.0,0.0,0.0,0.0,0.0,0.0,0.0,0.0,0.0,1.0,0.0,0.0,0.0,0.0,1.0,0.0,1.0,0.0,0.0,0.0,0.0,1.0,0.0,0.0,0.0,0.0,0.0,0.0,0.0,0.0,0.0,0.0,0.0,0.0,0.0,0.0,0.0,0.0,0.0,0.0,0.0,0.0,0.0,0.0,0.0,0.0,0.0,0.0,0.0,0.0,0.0,0.0,0.0,0.0,0.0,0.0,0.0,0.0,0.0,0.0,0.0,0.0,0.0,0.0,0.0,0.0,0.0,0.0,0.0,0.0,0.0,0.0,0.0,0.0,0.0,0.0,0.0,1.0,0.0,0.0,0.0,0.0,0.0,0.0,0.0,0.0,0.0,0.0,0.0,0.0,0.0,0.0,0.0,0.0,0.0,0.0,0.0,0.0,0.0,0.0,0.0,0.0,0.0,0.0,0.0,0.0,0.0,0.0,0.0,0.0,0.0,0.0,0.0,0.0,0.0,0.0
102441,0,0.0,1.0,0.0,1.0,0.0,225000.0,162000.0,17577.0,162000.0,0.032561,38.32876712328768,-2076.0,-8095.0,-5462.0,,2.0,1.0,1.0,14.0,0.3286979750204061,0.6785637263083949,,0.4433,0.2956,0.9831,,,0.48,0.4138,0.3333,,,,0.4322,,0.0237,0.4517,0.3068,0.9831,,,0.4834,0.4138,0.3333,,,,0.4503,,0.0251,0.4476,0.2956,0.9831,,,0.48,0.4138,0.3333,,,,0.4399,,0.0242,0.3451,1.0,0.0,0.0,0.0,0.0,-3670.0,0.0,0.0,0.0,0.0,0.0,0.0,1.0,1.0,1.0,1.0,0.0,0.0,0.0,0.0,0.0,0.0,0.0,0.0,0.0,0.0,0.0,1.0,0.0,0.0,0.0,0.0,0.0,0.0,0.0,0.0,0.0,0.0,0.0,0.0,0.0,0.0,0.0,0.0,1.0,12109.5,,315000.0,208467.0,,0.0,0.0,0.0,-479.0,618.0,-24.0,,16.0,-7.5,0.0,,,,,,,,,,,,,,,,,0.0,,,,,,0.0,,,,,,,0.0,,,,,,,,,,,,,,,,,,,,,8345756218.5,184381509528.0,165569624064.0,51964903657.935,1863.0,1705.0,71125.0,70796.0,9140.0,505985.0,17805.581300002294,17867.75859999911,17319.240699998056,11294.625100000088,11232.443400000093,11179.748400000057,128392.0,662726.0,,,,13526148.679451656,-601801117.0,-921789782.0,-296480132.0,-1534993439.0416667,44016.0,30704.0,11347.968799999182,11223.939999998976,10708.205499997295,22884.56720000969,22806.44360000965,22191.932500008206,67451.1459482946,158019.78498944733,,34995.25310002792,34935.61630002836,34381.342000028766,,,,3713743.0,,,,,,,16465.556699999754,16650.787099999692,16247.562399999695,,,,3913.487000000125,3896.6548000001617,3729.2334000001592,436448.0,431242.0,,6424.183444002895,631879.0,625431.0,,16330.087299999796,154155.1876999906,154157.93379999016,154049.69259998715,,,,16.0,37364449.90499999,,3981834440.729999,1312474881.3749998,,696729.5099999999,71.0,11786.0,-12936923.0,5427808.0,-6685729.0,,-7.5,12109.5,,315000.0,208467.0,,0.0,0.0,0.0,-479.0,618.0,-24.0,,,,,,,,,,,,,,,,,,,,,,,,,,,,,,,,,,,,,,,,,,,,,,,,,1467189.0,14771766.0,3232152.0,8553933.0,11606235.0,1415465.0,1058384988.544501,,72097835042.33961,21673520971.92012,,5792665.7475,689.5,94245.0,-276886263.0,21958676.5,-123773691.5,,-2017879.0,,,,,,,,,,,,,,,,,,,,,,,,,,,,,,,,,,,,,,,,,,,,,,,,-54.16297355253753,0.72,12.800819252432154,490.6396201137695,9.216589861751151,353.260526481914,112500.0,-0.2225209339563146,-0.9749279121818236,0.0,0.0,0.0,0.0,0.0,0.0,1.0,0.0,0.0,0.0,0.0,0.0,0.0,1.0,0.0,0.0,0.0,0.0,1.0,0.0,1.0,0.0,0.0,0.0,0.0,1.0,0.0,0.0,0.0,0.0,0.0,0.0,0.0,0.0,0.0,0.0,0.0,0.0,0.0,0.0,0.0,0.0,0.0,0.0,0.0,0.0,0.0,0.0,0.0,0.0,0.0,0.0,0.0,0.0,0.0,0.0,0.0,0.0,0.0,0.0,0.0,0.0,0.0,0.0,0.0,0.0,0.0,0.0,0.0,1.0,0.0,0.0,0.0,0.0,0.0,0.0,0.0,0.0,0.0,0.0,0.0,0.0,0.0,0.0,0.0,0.0,0.0,0.0,0.0,0.0,0.0,0.0,0.0,0.0,0.0,0.0,0.0,0.0,0.0,0.0,0.0,0.0,0.0,0.0,0.0,0.0,0.0,0.0,0.0,0.0,1.0,0.0,0.0,0.0,0.0,0.0,0.0,1.0,0.0,0.0
102443,0,0.0,0.0,0.0,1.0,0.0,202500.0,225000.0,23625.0,225000.0,0.0116569999999999,28.53972602739726,-1497.0,-1995.0,-997.0,,2.0,1.0,1.0,18.0,0.7415709311962907,0.6114289010762586,0.5814837058057234,,,,,,,,,,,,,,,,,,,,,,,,,,,,,,,,,,,,,,,,,,,,,0.0,0.0,0.0,0.0,-244.0,0.0,0.0,0.0,0.0,1.0,0.0,1.0,1.0,0.0,1.0,0.0,0.0,1.0,1.0,0.0,1.0,1.0,0.0,0.0,0.0,0.0,1.0,0.0,0.0,0.0,0.0,0.0,0.0,0.0,0.0,0.0,0.0,0.0,0.0,0.0,0.0,0.0,0.0,3.0,5850.0,,180000.0,57352.5,0.0,0.0,0.0,0.0,-415.0,372.0,-26.0,-656.0,59.0,-9.0,1.0,16447.095,150412.5,161662.5,0.0,150412.5,12.0,-244.0,365243.0,-214.0,-154.0,116.0,-151.0,11.0,1.0,0.0,10.0,4.0,12.0,10.5,-6.5,0.0,0.0,3.0,16447.095,16447.095,-189.0,-184.0,2.0,1.0,0.0,,,,,,,,,,,,,,,,,,,,,8345779843.5,184381734528.0,165569849064.0,51965106157.935,1863.0,1705.0,71125.0,70797.0,9140.0,505985.0,,,,,,,128392.0,662728.0,,,,13526177.219177682,-601802614.0,-921790779.0,-296480376.0,-1534995434.0416667,44016.0,30704.0,,,,,,,67451.88751922577,158020.39641834845,126089.87942022756,,,,,,,3713761.0,,,,,,,,,,,,,,,,436448.0,431242.0,,6424.195101002895,631880.0,625432.0,,,,,,,,,14.0,37371676.90499999,,3986122061.43,1313233322.4,47011492.61999998,696729.5099999999,71.0,11786.0,-12957187.0,5428058.0,-6693848.0,-7251848.0,-6.5,0.0,,0.0,0.0,0.0,0.0,0.0,0.0,-937.0,-664.0,-652.0,-656.0,144131920.9199998,2057840919.4050016,2325201433.56,32890758.34499999,2057840919.4050016,149851.0,-10282707.0,2371825341.0,100000207.0,517578373.0,232061630.0,541134719.0,148768.0,2344.0,412.8795490303135,3612020.0,1224198.0,750235.0,-2465574.0,825316.0,98541.0,1638122431.1850376,1649694358.3050206,-101587438.0,-100756963.0,1859985.0,81935.0,,,,,,,,,,,,,,,,,,,,,1467192.0,14771825.0,3232152.0,8553937.0,11606238.0,1415466.0,1058390838.544501,,72098015042.33961,21673578324.42012,582250914.791999,5792665.7475,689.5,94245.0,-276886678.0,21959048.5,-123773717.5,-218674626.0,-2017888.0,,,,,,,,,,,,,,,,,,,,,4272330.5,2478876.5,-9002427.0,921269.0,37582.5,3732972575.4899626,3657458987.639961,-260594463.5,-257283977.0,2526238.0,269161.0,3925599039.202457,33250424590.575912,36679391928.09014,1729113136.7850494,48077902710.51822,3987541.0,-247561278.0,103073611750.5,1054027626.5,17270774499.5,3503160210.5,18884611634.5,3671645.5,71911.0,20867.571108925265,89786455.0,-52.45320149755208,1.1111111111111112,8.571428571428571,244.62622309197656,9.523809523809524,271.8069145466406,101250.0,-0.9009688679024191,0.4338837391175582,0.0,0.0,0.0,0.0,0.0,0.0,1.0,0.0,0.0,0.0,0.0,0.0,0.0,1.0,0.0,1.0,0.0,0.0,0.0,0.0,1.0,0.0,0.0,0.0,0.0,1.0,0.0,0.0,0.0,0.0,0.0,0.0,0.0,0.0,0.0,0.0,0.0,0.0,0.0,0.0,1.0,0.0,0.0,0.0,0.0,0.0,0.0,0.0,0.0,0.0,0.0,0.0,0.0,1.0,0.0,0.0,0.0,0.0,0.0,0.0,0.0,0.0,0.0,0.0,0.0,0.0,0.0,0.0,0.0,0.0,0.0,0.0,0.0,0.0,0.0,0.0,0.0,0.0,0.0,0.0,0.0,0.0,0.0,0.0,0.0,0.0,0.0,0.0,0.0,0.0,0.0,0.0,0.0,0.0,0.0,0.0,0.0,0.0,0.0,0.0,0.0,0.0,0.0,0.0,0.0,0.0,0.0,0.0,0.0,0.0,0.0,0.0,0.0,0.0,0.0,0.0,0.0,0.0,0.0,0.0
102444,0,0.0,1.0,0.0,0.0,0.0,135000.0,90000.0,9693.0,90000.0,0.04622,41.49041095890411,-4236.0,-5239.0,-4569.0,,2.0,1.0,1.0,12.0,0.1549665080614638,0.711068715018821,0.178760465484575,,,,,,,,,,,,,,,,,,,,,,,,,,,,,,,,,,,,,,,,,,,,,4.0,0.0,4.0,0.0,-2542.0,0.0,0.0,0.0,0.0,3.0,7.0,1.0,1.0,0.0,1.0,1.0,0.0,0.0,0.0,0.0,0.0,0.0,0.0,0.0,0.0,0.0,1.0,0.0,0.0,0.0,0.0,0.0,0.0,0.0,0.0,0.0,0.0,0.0,0.0,0.0,0.0,0.0,0.0,2.0,2700.0,,47088.0,3251.25,,0.0,0.0,0.0,-766.5,310.5,-434.0,-1181.0,51.0,-23.0,8.0,10427.895,44977.5,42727.5,2250.0,92160.0,12.0,-554.5,365243.0,-636.0,-276.0,-216.0,-270.0,14.0,0.0,0.0545090545090545,-1.0,34.0,18.0,7.0,-18.0,0.0,0.0,63.0,10529.145,10529.145,-316.0,-315.0,10.0,0.0,16.0,218355.9075,225000.0,0.0,3945.1275,0.0,393.21,11157.7725,11700.0,306.2925,215402.9625,218355.9075,218355.9075,0.0,3.0,0.0,1.0,6.5,-9.5,0.0,0.0,8345789536.5,184381824528.0,165569939064.0,51965241157.935,1863.0,1705.0,71125.0,70800.0,9140.0,505992.0,,,,,,,128392.0,662730.0,,,,13526218.70958864,-601806850.0,-921795348.0,-296482918.0,-1535000673.0416667,44016.0,30704.0,,,,,,,67452.04248573385,158021.10748706348,126090.05818069304,,,,,,,3713773.0,,,,,,,,,,,,,,,,436452.0,431246.0,,6424.241321002895,631881.0,625433.0,,,,,,,,,25.5,37380226.90499999,,3986461487.43,1313476212.15,,696729.5099999999,71.0,11786.0,-12959113.0,5428495.5,-6694718.0,-7253029.0,-12.25,2700.0,,80676.0,0.0,,0.0,0.0,0.0,-1489.0,-1154.0,-864.0,-1181.0,144158162.3549998,2058090579.4050016,2325458518.56,32893008.34499999,2058090579.4050016,149875.0,-10285137.5,2372372957.5,99998739.5,517941873.0,232425250.0,541498233.5,148829.0,2344.5,412.9340580848225,3612043.5,1224473.0,750402.5,-2465874.0,825316.0,98541.0,1638528670.3950374,1650100597.51502,-101598634.0,-100768011.0,1860432.0,81946.0,1602939936.3525,4206442500.0,136650147.39,210679207.4024997,8483232.600000001,65388186.78749998,91136926.30499992,230573915.73000008,212117554.19249988,1538659475.482496,1596717628.852499,1596775635.7874992,6927.0,17737.0,117.0,10693.0,522777.5,-942243.5,299568.0,877.0,1467194.0,14771876.0,3232168.0,8553971.0,11606301.0,1415474.0,1058393538.544501,,72098062130.33961,21673581575.67012,,5792665.7475,689.5,94245.0,-276887444.5,21959359.0,-123774151.5,-218675807.0,-2017911.0,5921897840.144961,18719482500.0,198760895.325,447914549.4299976,1948107.735,256735793.8575008,309070352.65499866,636481531.597498,459089528.8049993,5707082684.407532,5885191278.044999,5885434460.79,13378.0,80826.5,44.0,70339.5,971329.0,-1698250.0,177364.0,6755.0,4272348.5,2478883.5,-9002445.0,921269.0,37582.5,3732983104.6349626,3657469516.7849607,-260594779.5,-257284292.0,2526248.0,269161.0,3925609467.097457,33250469568.075912,36679434655.59014,1729115386.7850494,48077994870.51822,3987553.0,-247561832.5,103073976993.5,1054026990.5,17270774223.5,3503159994.5,18884611364.5,3671659.5,71911.0,20867.62561797977,89786454.0,-102.09587955625992,0.6666666666666666,13.927576601671309,577.8608768649597,9.285051067780872,385.2405845766398,67500.0,-0.9009688679024191,0.4338837391175582,0.0,0.0,0.0,0.0,0.0,0.0,1.0,0.0,1.0,0.0,0.0,0.0,0.0,0.0,0.0,1.0,0.0,0.0,0.0,0.0,1.0,0.0,0.0,0.0,0.0,1.0,0.0,0.0,0.0,0.0,0.0,0.0,0.0,0.0,0.0,0.0,0.0,0.0,0.0,0.0,0.0,0.0,0.0,0.0,1.0,0.0,0.0,0.0,0.0,0.0,0.0,0.0,0.0,0.0,0.0,0.0,0.0,0.0,0.0,0.0,0.0,0.0,0.0,0.0,0.0,0.0,0.0,0.0,0.0,0.0,0.0,0.0,0.0,0.0,0.0,0.0,0.0,0.0,0.0,0.0,0.0,0.0,0.0,0.0,0.0,0.0,0.0,0.0,0.0,0.0,1.0,0.0,0.0,0.0,0.0,0.0,0.0,0.0,0.0,0.0,0.0,0.0,0.0,0.0,0.0,0.0,0.0,0.0,0.0,0.0,0.0,0.0,0.0,0.0,0.0,0.0,0.0,0.0,0.0,0.0
102445,0,0.0,1.0,1.0,0.0,0.0,81000.0,161595.0,17095.5,139500.0,0.002134,28.12328767123288,-1284.0,-1435.0,-2890.0,12.0,2.0,3.0,3.0,8.0,,0.4326407768638117,0.2866524828090694,,,,,,,,,,,,,,,,,,,,,,,,,,,,,,,,,,,,,,,,,,,,,0.0,0.0,0.0,0.0,-873.0,0.0,0.0,0.0,0.0,1.0,3.0,1.0,1.0,0.0,1.0,0.0,0.0,0.0,0.0,0.0,0.0,0.0,0.0,0.0,1.0,0.0,0.0,0.0,0.0,0.0,0.0,0.0,0.0,0.0,0.0,0.0,0.0,0.0,0.0,0.0,0.0,0.0,0.0,3.0,5739.75,0.0,225000.0,0.0,0.0,0.0,0.0,0.0,-577.0,94.0,-199.0,-336.5,61.0,-11.0,3.0,16276.41,102825.0,113683.5,0.0,149287.5,12.0,-318.0,365243.0,-559.5,182366.0,-229.5,182367.0,7.0,0.5,0.0,200.0,23.0,12.0,6.0,-18.0,0.0,0.0,24.0,10611.225,10611.225,-536.5,-526.0,6.0,1.0,0.0,,,,,,,,,,,,,,,,,,,,,8345806632.0,184381986123.0,165570078564.0,51965322157.935,1863.0,1705.0,71125.0,70801.0,9140.0,505995.0,,,,,,,128392.0,662732.0,,,,13526246.832876312,-601808134.0,-921798238.0,-296483791.0,-1535002108.0416667,44016.0,30704.0,,,,,,,,158021.54012784033,126090.34483317586,,,,,,,3713781.0,,,,,,,,,,,,,,,,436452.0,431246.0,1262976.0,6424.243455002896,631884.0,625436.0,,,,,,,,,20.0,37385966.65499999,11421061.245000005,3986999237.43,1313736755.4,47011492.61999998,696729.5099999999,71.0,11786.0,-12960372.0,5429861.0,-6694942.0,-7253476.0,-9.5,0.0,0.0,225000.0,0.0,0.0,0.0,0.0,0.0,-1002.0,94.0,-199.0,-221.0,144201674.5874998,2058546609.4050016,2325972585.06,32895258.34499999,2058448734.4050016,149916.0,-10290004.0,2373468438.5,99994995.0,518122792.5,232423574.0,541679157.5,148899.0,2345.5,412.9885671393316,3614260.0,1224823.0,750581.0,-2466818.0,825316.0,98541.0,1638969714.6525354,1650536320.185019,-101626816.5,-100795807.5,1860817.0,81981.5,,,,,,,,,,,,,,,,,,,,,1467197.0,14771937.0,3232168.0,8553994.0,11606325.0,1415477.0,1058399278.294501,801595684.327495,72098287130.33961,21673581575.67012,582250914.791999,5792665.7475,689.5,94245.0,-276888021.5,21959453.0,-123774350.5,-218676143.5,-2017922.0,,,,,,,,,,,,,,,,,,,,,4272360.5,2478889.5,-9002463.0,921269.0,37582.5,3732993715.8599625,3657480128.009961,-260595316.0,-257284818.0,2526254.0,269162.0,3925625743.507456,33250572393.075912,36679548339.09014,1729115386.7850494,48078144158.01822,3987565.0,-247562150.5,103074342236.5,1054026431.0,17270956589.5,3503159765.0,18884793731.5,3671666.5,71911.5,20867.62561797977,89786654.0,-45.656113005358016,1.995,4.738088970781785,133.25063913719185,9.45248749670966,265.8350250786977,40500.0,-0.9009688679024191,-0.433883739117558,0.0,0.0,0.0,0.0,0.0,0.0,1.0,0.0,0.0,0.0,0.0,0.0,0.0,1.0,0.0,0.0,0.0,0.0,1.0,0.0,1.0,0.0,0.0,0.0,0.0,0.0,0.0,0.0,0.0,1.0,0.0,0.0,0.0,0.0,1.0,0.0,0.0,0.0,0.0,0.0,0.0,0.0,0.0,0.0,0.0,0.0,0.0,0.0,0.0,0.0,0.0,0.0,0.0,0.0,0.0,0.0,0.0,0.0,0.0,0.0,0.0,0.0,0.0,0.0,0.0,0.0,0.0,0.0,0.0,0.0,0.0,0.0,0.0,0.0,0.0,0.0,0.0,0.0,0.0,0.0,0.0,0.0,0.0,0.0,0.0,0.0,0.0,0.0,0.0,1.0,0.0,0.0,0.0,0.0,0.0,0.0,0.0,0.0,0.0,0.0,0.0,0.0,0.0,0.0,0.0,0.0,0.0,0.0,0.0,0.0,0.0,0.0,0.0,0.0,0.0,0.0,0.0,0.0,0.0,0.0
102448,0,0.0,0.0,1.0,0.0,1.0,121500.0,531706.5,23548.5,459000.0,0.006233,39.54794520547946,-3186.0,-1978.0,-5151.0,65.0,2.0,2.0,2.0,17.0,0.6959934906267089,0.4075605097039309,0.3185955240537633,0.0165,,0.9692,,,0.0,0.1034,0.0417,,0.0174,,0.0177,,0.0077,0.0168,,0.9692,,,0.0,0.1034,0.0417,,0.0178,,0.0184,,0.0082,0.0167,,0.9692,,,0.0,0.1034,0.0417,,0.0177,,0.018,,0.0079,0.0156,1.0,2.0,1.0,2.0,0.0,0.0,0.0,0.0,0.0,0.0,0.0,0.0,1.0,1.0,0.0,1.0,0.0,0.0,0.0,0.0,0.0,0.0,0.0,0.0,0.0,1.0,0.0,0.0,0.0,0.0,0.0,0.0,0.0,0.0,0.0,0.0,0.0,0.0,0.0,0.0,0.0,0.0,0.0,0.0,3.0,12150.0,0.0,133640.505,0.0,0.0,0.0,0.0,0.0,-714.0,-349.0,-651.0,-657.0,64.0,-12.5,5.0,11339.1,113323.5,112086.0,2785.5,113323.5,10.0,-1288.0,365243.0,-1623.0,-1293.0,-1293.0,-1289.0,14.0,0.0,0.1000262515039924,72.0,26.0,11.0,5.5,-48.5,0.0,0.0,23.0,11339.1,11339.1,-1498.0,-1473.0,4.0,1.0,0.0,,,,,,,,,,,,,,,,,,,,,8345830180.5,184382517829.5,165570537564.0,51965443657.935,1863.0,1705.0,71125.0,70801.0,9140.0,505995.0,17805.597800002295,17867.77529999911,17319.257499998057,,,,128393.0,662734.0,,,,13526286.380821517,-601811320.0,-921803389.0,-296483791.0,-1535004086.0416667,44017.0,30704.0,11347.968799999182,11223.939999998976,10708.205499997295,22884.67060000969,22806.54700000965,22192.035900008206,67452.73847922447,158021.94768835005,126090.66342869987,34995.29480002792,34935.658000028365,34381.38370002877,,,,3713798.0,8294.538500000168,8399.053900000077,8122.64590000023,,,,16465.574399999754,16650.805099999692,16247.580799999698,,,,3913.494700000125,3896.6627000001617,3729.24160000016,436454.0,431248.0,1263041.0,6424.249688002896,631886.0,625438.0,,16330.102899999798,154156.1568999906,154158.90299999015,154050.66179998714,,,,24.0,37403856.40499999,11424418.065000003,3987864706.9499993,1313952633.9,47030203.16999998,696729.5099999999,71.0,11786.0,-12968249.0,5427597.0,-6698443.0,-7257122.5,-11.5,12150.0,15297.615,169695.0,0.0,0.0,0.0,0.0,0.0,-1028.0,-663.0,-661.0,-663.0,144330415.6499998,2060284590.4050016,2327826454.56,32930308.84499999,2060284590.4050016,150168.0,-10309297.0,2377303490.0,99981310.0,518660651.0,232415934.0,542217068.0,149074.0,2349.0,413.5933182548544,3615129.0,1228126.0,752654.0,-2471841.0,825341.0,98541.0,1640917838.7000306,1652129611.4250193,-101789386.0,-100957699.0,1862526.0,82148.0,,,,,,,,,,,,,,,,,,,,,1467200.0,14772001.0,3232168.0,8554020.0,11606348.0,1415482.0,1058411428.294501,801595684.327495,72098420770.84462,21673581575.67012,582250914.791999,5792665.7475,689.5,94245.0,-276888735.5,21959104.0,-123775001.5,-218676800.5,-2017934.5,,,,,,,,,,,,,,,,,,,,,4272371.5,2478895.0,-9002511.5,921269.0,37582.5,3733005054.959962,3657491467.109961,-260596814.0,-257286291.0,2526258.0,269163.0,3925637082.607456,33250685716.575912,36679660425.09014,1729118172.2850494,48078257481.51822,3987575.0,-247563438.5,103074707479.5,1054024808.0,17270955296.5,3503158472.0,18884792442.5,3671680.5,71911.5,20867.725644231283,89786726.0,-80.56044336681677,4.376185185185185,5.1595643034588194,204.0501663573372,22.5792088668068,892.9613150475511,60750.0,1.0,0.0,0.0,0.0,0.0,0.0,0.0,0.0,1.0,0.0,1.0,0.0,0.0,0.0,0.0,0.0,0.0,1.0,0.0,0.0,0.0,0.0,0.0,0.0,1.0,0.0,0.0,1.0,0.0,0.0,0.0,0.0,0.0,0.0,0.0,1.0,0.0,0.0,0.0,0.0,0.0,0.0,0.0,0.0,0.0,0.0,0.0,0.0,0.0,0.0,0.0,0.0,0.0,0.0,0.0,0.0,0.0,0.0,0.0,0.0,0.0,0.0,0.0,0.0,0.0,0.0,0.0,0.0,0.0,0.0,0.0,0.0,0.0,0.0,0.0,0.0,0.0,0.0,1.0,0.0,0.0,0.0,0.0,0.0,0.0,0.0,0.0,0.0,0.0,0.0,0.0,0.0,0.0,0.0,0.0,0.0,0.0,0.0,0.0,0.0,0.0,0.0,0.0,0.0,0.0,0.0,0.0,0.0,0.0,0.0,0.0,0.0,1.0,0.0,0.0,0.0,0.0,0.0,0.0,0.0,1.0,0.0
102449,0,0.0,0.0,0.0,1.0,0.0,135000.0,577741.5,21910.5,477000.0,0.008575,49.87397260273973,-7330.0,-5630.0,-1754.0,,2.0,2.0,2.0,12.0,,0.3442803484192301,0.5154953751603267,0.0412,,0.9737,0.6396,0.0035,0.0,0.069,0.1667,0.0417,0.0209,0.0336,0.032,0.0,0.0,0.042,,0.9737,0.6537,0.0035,0.0,0.069,0.1667,0.0417,0.0213,0.0367,0.0334,0.0,0.0,0.0416,,0.9737,0.6444,0.0035,0.0,0.069,0.1667,0.0417,0.0212,0.0342,0.0326,0.0,0.0,0.0252,1.0,0.0,0.0,0.0,0.0,-2170.0,0.0,0.0,0.0,0.0,0.0,4.0,1.0,1.0,0.0,1.0,0.0,0.0,0.0,0.0,0.0,0.0,0.0,0.0,0.0,1.0,0.0,0.0,0.0,0.0,0.0,0.0,0.0,0.0,0.0,0.0,0.0,0.0,0.0,0.0,0.0,0.0,0.0,0.0,5.0,42822.0,0.0,112500.0,0.0,0.0,0.0,0.0,0.0,-1810.0,-1446.0,-1698.0,-1907.5,272.0,-33.5,8.0,10375.155,31223.25,28764.0,3145.5,180000.0,15.0,-1416.5,365243.0,-1386.5,-891.5,-426.5,-1083.0,10.5,0.0,0.1059574199254532,14.0,61.0,24.0,17.0,-41.0,0.0,0.0,66.0,12687.48,12687.48,-1195.0,-1195.0,7.0,1.0,0.0,,,,,,,,,,,,,,,,,,,,,8345852091.0,184383095571.0,165571014564.0,51965578657.935,1863.0,1705.0,71125.0,70801.0,9140.0,505999.0,17805.639000002295,17867.816899999114,17319.29949999806,,,,128393.0,662736.0,4137.31020000012,4134.981500000015,3945.599100000096,13526336.25479412,-601818650.0,-921805143.0,-296485961.0,-1535009716.0416667,44017.0,30704.0,11347.968799999182,11223.939999998976,10708.205499997295,22884.73960000968,22806.61600000965,22192.10490000821,,158022.29196869847,126091.17892407504,34995.46150002792,34935.824700028366,34381.55040002877,22949.60239999592,22922.858999995493,22569.87309999573,3713810.0,8294.559400000167,8399.075100000076,8122.667200000229,9816.236500000718,9931.17520000216,10290.790199999648,16465.60639999975,16650.83769999969,16247.614199999698,828.6374000001761,813.8138000000458,759.7633000000129,3913.494700000125,3896.6627000001617,3729.24160000016,436454.0,431248.0,,6424.258263002896,631888.0,625440.0,,16330.128099999798,154157.1305999906,154159.87669999016,154051.63549998714,77599.94959999624,77937.72670000659,78339.02040000651,60.0,37446678.40499999,11439715.680000003,3989474401.9499993,1314609757.65,47030203.16999998,696729.5099999999,71.0,11786.0,-12974948.0,5423494.0,-6703749.0,-7262970.0,-29.5,42822.0,0.0,45000.0,0.0,0.0,0.0,0.0,0.0,-2548.0,-2183.0,-2113.0,-2117.0,144379543.8599998,2061125482.9050016,2328736795.56,32936244.34499999,2061125482.9050016,150246.0,-10317610.0,2378763567.5,100157175.5,518837804.5,232593671.0,542212655.0,149151.5,2350.0,413.8035360015239,3617487.0,1229055.0,753183.0,-2473831.0,825341.0,98541.0,1641942364.0275314,1653096927.4875202,-101851310.5,-101019177.5,1862995.5,82199.5,,,,,,,,,,,,,,,,,,,,,1467205.0,14772273.0,3232168.0,8554081.0,11606414.0,1415490.0,1058454250.294501,801595684.327495,72098533270.84462,21673581575.67012,582250914.791999,5792665.7475,689.5,94245.0,-276890545.5,21957658.0,-123776699.5,-218678708.0,-2017968.0,,,,,,,,,,,,,,,,,,,,,4272395.5,2478912.0,-9002552.5,921269.0,37582.5,3733017742.439962,3657504154.589961,-260598009.0,-257287486.0,2526265.0,269164.0,3925647457.762456,33250716939.825912,36679689189.09014,1729121317.7850494,48078437481.51822,3987590.0,-247564855.0,103075072722.5,1054023421.5,17270954405.0,3503158045.5,18884791359.5,3671691.0,71911.5,20867.831601651204,89786740.0,-146.9704460558119,4.279566666666667,6.161429451632778,307.29496366444687,26.36824810022592,1315.0892833329117,67500.0,-0.9009688679024191,-0.433883739117558,0.0,0.0,0.0,0.0,0.0,0.0,1.0,0.0,0.0,0.0,0.0,0.0,0.0,1.0,0.0,0.0,0.0,0.0,1.0,0.0,1.0,0.0,0.0,0.0,0.0,1.0,0.0,0.0,0.0,0.0,0.0,0.0,0.0,0.0,0.0,0.0,0.0,0.0,0.0,0.0,0.0,0.0,0.0,0.0,1.0,0.0,0.0,0.0,0.0,0.0,0.0,0.0,0.0,0.0,0.0,0.0,0.0,0.0,0.0,0.0,0.0,0.0,0.0,0.0,0.0,0.0,0.0,0.0,0.0,0.0,0.0,0.0,0.0,0.0,0.0,0.0,0.0,0.0,0.0,0.0,0.0,0.0,0.0,0.0,0.0,0.0,0.0,0.0,0.0,0.0,0.0,0.0,0.0,0.0,0.0,0.0,0.0,0.0,0.0,1.0,0.0,0.0,0.0,0.0,0.0,0.0,0.0,0.0,1.0,0.0,1.0,0.0,0.0,0.0,0.0,0.0,0.0,0.0,0.0,0.0
102450,1,0.0,1.0,0.0,0.0,0.0,337500.0,675000.0,53329.5,675000.0,0.018029,33.22191780821917,-781.0,-463.0,-1930.0,,2.0,3.0,3.0,14.0,0.4943612402763271,0.3366841111568137,,,,,,,,,,,,,,,,,,,,,,,,,,,,,,,,,,,,,,,,,,,,,,0.0,0.0,0.0,0.0,-233.0,0.0,0.0,0.0,0.0,0.0,3.0,1.0,1.0,1.0,1.0,1.0,0.0,0.0,0.0,0.0,0.0,0.0,0.0,0.0,1.0,0.0,0.0,0.0,0.0,0.0,0.0,0.0,0.0,0.0,0.0,0.0,0.0,0.0,0.0,0.0,0.0,0.0,0.0,3.0,21613.5,,135000.0,573966.0,,0.0,0.0,0.0,-131.0,50.0,-52.0,-105.5,19.0,-3.0,1.0,10419.525,68310.0,63810.0,4500.0,68310.0,8.0,-233.0,365243.0,-196.0,-16.0,14.0,-14.0,14.0,0.0,0.0717451191759492,24.0,8.0,8.0,5.0,-4.5,0.0,0.0,7.0,10419.525,10419.525,-117.0,-106.0,4.0,1.0,0.0,,,,,,,,,,,,,,,,,,,,,8345905420.5,184383770571.0,165571689564.0,51965916157.935,1863.0,1705.0,71125.0,70801.0,9140.0,506002.0,,,,,,,128393.0,662738.0,,,,13526369.476711929,-601819431.0,-921807073.0,-296486194.0,-1535010179.0416667,44017.0,30704.0,,,,,,,67453.23284046477,158022.62865280962,,,,,,,,3713824.0,,,,,,,,,,,,,,,,436454.0,431248.0,,6424.276292002895,631891.0,625443.0,,,,,,,,,5.0,37468291.90499999,,3990692564.46,1315840847.4,,696729.5099999999,71.0,11786.0,-12977908.0,5423472.0,-6705985.0,-7264375.0,-2.0,21613.5,,135000.0,0.0,,0.0,0.0,0.0,-315.0,-72.0,-126.0,-131.0,144428745.9149998,2062138738.9050016,2329875048.06,32943889.84499999,2062138738.9050016,150318.0,-10322335.0,2379858402.0,100336427.0,519382927.0,232775341.0,542573045.0,149203.0,2351.0,413.9842213819269,3617616.0,1230121.0,754112.0,-2475037.5,825342.0,98542.0,1643276579.94003,1655124238.8900185,-101886531.0,-101054067.0,1863179.0,82278.0,,,,,,,,,,,,,,,,,,,,,1467208.0,14772292.0,3232168.0,8554089.0,11606421.0,1415491.0,1058475863.794501,,72098668270.84462,21674155541.67012,,5792665.7475,689.5,94245.0,-276890676.5,21957708.0,-123776751.5,-218678813.5,-2017971.0,,,,,,,,,,,,,,,,,,,,,4272403.5,2478917.0,-9002557.0,921269.0,37582.5,3733028161.9649625,3657514574.114961,-260598126.0,-257287592.0,2526269.0,269165.0,3925657877.287456,33250785249.825912,36679752999.09014,1729125817.7850494,48078505791.51822,3987598.0,-247565088.0,103075437965.5,1054023225.5,17270954389.0,3503158059.5,18884791345.5,3671705.0,71911.5,20867.90334677038,89786764.0,-23.508576612238173,2.0,6.328579866677918,210.2475601735244,12.657159733355837,420.4951203470488,168750.0,-0.2225209339563146,-0.9749279121818236,0.0,0.0,0.0,0.0,0.0,0.0,1.0,0.0,0.0,0.0,0.0,0.0,0.0,1.0,0.0,0.0,0.0,0.0,1.0,0.0,1.0,0.0,0.0,0.0,0.0,0.0,0.0,0.0,0.0,1.0,0.0,0.0,0.0,1.0,0.0,0.0,0.0,0.0,0.0,0.0,0.0,0.0,0.0,0.0,0.0,0.0,0.0,0.0,0.0,0.0,0.0,0.0,0.0,1.0,0.0,0.0,0.0,0.0,0.0,0.0,0.0,0.0,0.0,0.0,0.0,0.0,0.0,0.0,0.0,0.0,0.0,0.0,0.0,0.0,0.0,0.0,0.0,0.0,0.0,0.0,0.0,0.0,0.0,0.0,0.0,0.0,0.0,0.0,0.0,0.0,0.0,0.0,0.0,0.0,0.0,0.0,0.0,0.0,0.0,0.0,0.0,0.0,0.0,0.0,0.0,0.0,0.0,0.0,0.0,0.0,0.0,0.0,0.0,0.0,0.0,0.0,0.0,0.0,0.0,0.0
102456,0,0.0,0.0,0.0,1.0,1.0,135000.0,135000.0,14175.0,135000.0,0.010276,32.684931506849324,-2946.0,-5869.0,-1155.0,,3.0,2.0,2.0,11.0,0.8035946775063888,0.3538896562119398,,0.067,0.0644,0.9831,,,0.0,0.1724,0.1667,,0.0561,,0.0685,,0.0,0.0683,0.0668,0.9831,,,0.0,0.1724,0.1667,,0.0574,,0.0714,,0.0,0.0677,0.0644,0.9831,,,0.0,0.1724,0.1667,,0.0571,,0.0697,,0.0,0.0539,1.0,0.0,0.0,0.0,0.0,-181.0,0.0,0.0,0.0,0.0,0.0,1.0,1.0,1.0,1.0,1.0,0.0,0.0,0.0,0.0,0.0,0.0,0.0,0.0,0.0,1.0,0.0,0.0,0.0,0.0,0.0,0.0,0.0,0.0,0.0,0.0,0.0,0.0,0.0,0.0,0.0,0.0,0.0,0.0,3.0,,,96228.0,0.0,0.0,0.0,0.0,0.0,-1456.0,-1060.0,-14.0,-1402.5,163.0,-27.0,6.0,21006.54,78750.0,171177.75,17406.0,174042.0,11.0,-738.5,365243.0,-151.0,-121.0,899.0,-116.0,16.5,0.0,0.098801595711791,-1.0,15.0,10.0,5.0,-49.0,0.0,0.0,13.0,19513.08,19513.08,-1514.0,-1501.0,4.0,1.0,42.0,0.0,450000.0,,0.0,,,0.0,,0.0,0.0,0.0,0.0,,0.0,,,0.0,-21.5,0.0,0.0,8345919595.5,184383905571.0,165571824564.0,51966051157.935,1863.0,1705.0,71125.0,70801.0,9140.0,506003.0,17805.706000002294,17867.884599999114,17319.367799998057,11294.689500000088,11232.50780000009,11179.815200000055,128394.0,662741.0,,,,13526402.161643434,-601822377.0,-921808228.0,-296486375.0,-1535016048.0416667,44017.0,30704.0,11347.968799999182,11223.939999998976,10708.205499997295,22884.91200000968,22806.78840000965,22192.2773000082,67454.03643514226,158022.98254246585,,34995.628200027924,34935.99140002836,34381.71710002877,,,,3713835.0,8294.615500000167,8399.132200000076,8122.72460000023,,,,16465.674899999754,16650.90739999969,16247.6855999997,,,,3913.494700000125,3896.6627000001617,3729.24160000016,436454.0,431248.0,,6424.286568002895,631893.0,625445.0,,16330.1819999998,154158.11369999062,154160.85979999017,154052.61859998718,,,,48.0,,,4007453436.4499993,1323843272.0099998,47031069.05999998,696729.5099999999,72.0,11786.0,-12999446.0,5483402.0,-6708973.0,-7271346.5,-23.5,,,96228.0,0.0,0.0,0.0,0.0,0.0,-1456.0,-1060.0,-14.0,-1714.0,144599753.33999982,2064528459.5850024,2332421242.56,32970296.02499999,2064528459.5850024,150538.0,-10334263.5,2383145589.0,100328226.0,519742563.0,232770979.0,542932721.0,149461.5,2354.0,414.43634307866654,3625845.5,1231669.0,754888.0,-2478475.0,825342.0,98542.0,1644315124.8150284,1656175244.7600162,-101986626.0,-101152989.0,1863990.0,82398.0,1604295231.84,4212045000.0,,210894441.2099997,,,91197382.27499992,,212132371.54499987,1539987340.8599956,1598068718.279999,1598126725.2149992,,17804.0,,,522815.0,-942662.5,299568.0,877.0,1467211.0,14772455.0,3232210.0,8554104.0,11606434.0,1415497.0,,,72098764498.84462,21674155541.67012,582250914.791999,5792665.7475,689.5,94245.0,-276892132.5,21956648.0,-123776765.5,-218680216.0,-2017998.0,5921897840.144961,18719932500.0,,447914549.4299976,,,309070352.65499866,,459089528.8049993,5707082684.407532,5885191278.044999,5885434460.79,,80826.5,,,971329.0,-1698271.5,177364.0,6755.0,4272413.5,2478922.0,-9002606.0,921269.0,37582.5,3733047675.044962,3657534087.194961,-260599640.0,-257289093.0,2526273.0,269166.0,3925678883.827457,33250863999.825912,36679924176.84014,1729143223.7850494,48078679833.51822,3987609.0,-247565826.5,103075803208.5,1054023074.5,17270954268.0,3503158958.5,18884791229.5,3671721.5,71911.5,20868.002148366093,89786763.0,-90.13327745180216,1.0,9.523809523809524,311.28506196999354,9.523809523809524,311.28506196999354,45000.0,-0.9009688679024191,0.4338837391175582,0.0,0.0,0.0,0.0,0.0,0.0,1.0,0.0,0.0,0.0,0.0,0.0,0.0,1.0,0.0,1.0,0.0,0.0,0.0,0.0,1.0,0.0,0.0,0.0,0.0,1.0,0.0,0.0,0.0,0.0,1.0,0.0,0.0,0.0,0.0,0.0,0.0,0.0,0.0,0.0,0.0,0.0,0.0,0.0,0.0,0.0,0.0,0.0,0.0,0.0,0.0,0.0,0.0,1.0,0.0,0.0,0.0,0.0,0.0,0.0,0.0,0.0,0.0,0.0,0.0,0.0,0.0,0.0,0.0,0.0,0.0,0.0,0.0,0.0,0.0,0.0,0.0,0.0,0.0,0.0,0.0,0.0,0.0,0.0,0.0,0.0,0.0,0.0,0.0,0.0,0.0,0.0,0.0,0.0,0.0,0.0,0.0,0.0,0.0,0.0,0.0,0.0,0.0,0.0,0.0,0.0,0.0,0.0,0.0,0.0,1.0,0.0,0.0,0.0,0.0,0.0,0.0,0.0,1.0,0.0
102458,0,0.0,0.0,0.0,0.0,1.0,180000.0,630000.0,32166.0,630000.0,0.035792,39.71506849315068,-3741.0,-3612.0,-3854.0,,3.0,2.0,2.0,12.0,0.7405328277825329,0.6447275556114415,0.0785361445733672,,,,,,,,,,,,,,,,,,,,,,,,,,,,,,,,,,,,,,,,,,,,,0.0,0.0,0.0,0.0,-48.0,0.0,0.0,0.0,0.0,1.0,3.0,1.0,1.0,1.0,1.0,0.0,0.0,0.0,0.0,0.0,0.0,1.0,1.0,0.0,1.0,0.0,0.0,0.0,0.0,0.0,0.0,0.0,0.0,0.0,0.0,0.0,0.0,0.0,0.0,0.0,0.0,0.0,0.0,11.0,19800.0,0.0,360000.0,81643.5,0.0,0.0,0.0,0.0,-890.0,112.0,-29.0,-496.5,319.0,-18.0,6.0,8724.915,33700.5,21325.5,9000.0,68746.5,8.0,-623.0,365243.0,-1977.0,-1767.0,-1767.0,-1761.5,11.0,0.0,0.1330431112986695,7.0,19.0,10.0,4.0,-62.0,0.0,0.0,16.0,8821.53,8821.53,-1891.5,-1872.0,4.5,1.0,0.0,,,,,,,,,,,,,,,,,,,,,8345951761.5,184384535571.0,165572454564.0,51966231157.935,1863.0,1705.0,71125.0,70802.0,9140.0,506006.0,,,,,,,128395.0,662744.0,,,,13526441.876711927,-601826118.0,-921812082.0,-296486423.0,-1535019660.0416667,44017.0,30704.0,,,,,,,67454.77696797004,158023.62727002145,126091.25746021964,,,,,,,3713847.0,,,,,,,,,,,,,,,,436454.0,431248.0,,6424.322360002896,631895.0,625447.0,,,,,,,,,30.0,37677996.40499999,11439715.680000003,4017383668.62,1331669127.5099998,47031069.05999998,696729.5099999999,72.0,11786.0,-13012271.0,5485846.0,-6712390.0,-7276706.0,-14.5,33655.5,0.0,450000.0,68769.0,0.0,0.0,0.0,0.0,-1321.0,-198.0,-180.0,-766.0,144695672.95499986,2065416113.8350024,2333755449.81,33008546.02499999,2065416113.8350024,150585.0,-10345558.5,2385154175.5,100687944.5,520468684.5,233497401.5,543658885.0,149694.5,2355.0,415.0287477051397,3646660.5,1232261.0,755220.0,-2479967.0,825345.0,98545.0,1645441056.0000296,1657308840.345017,-102031355.5,-101197352.5,1864372.5,82444.5,,,,,,,,,,,,,,,,,,,,,1467222.0,14772774.0,3232210.0,8554123.0,11606450.0,1415503.0,1058495663.794501,801595684.327495,72099124498.84462,21674237185.17012,582250914.791999,5792665.7475,689.5,94245.0,-276893022.5,21956760.0,-123776794.5,-218680712.5,-2018016.0,,,,,,,,,,,,,,,,,,,,,4272423.5,2478926.0,-9002668.0,921269.0,37582.5,3733056496.5749626,3657542908.724961,-260601531.5,-257290965.0,2526277.5,269167.0,3925687608.742456,33250897700.325912,36679945502.34014,1729152223.7850494,48078748580.01822,3987617.0,-247566449.5,103076168451.5,1054021097.5,17270952501.0,3503157191.5,18884789468.0,3671732.5,71911.5,20868.13519147739,89786770.0,-94.19598509933778,3.5,5.595970900951315,222.2443676169596,19.5858981533296,777.8552866593586,60000.0,-0.9009688679024191,-0.433883739117558,0.0,0.0,0.0,0.0,0.0,0.0,1.0,0.0,0.0,0.0,0.0,0.0,0.0,1.0,0.0,1.0,0.0,0.0,0.0,0.0,1.0,0.0,0.0,0.0,0.0,1.0,0.0,0.0,0.0,0.0,0.0,0.0,0.0,0.0,0.0,0.0,0.0,0.0,0.0,0.0,0.0,0.0,0.0,0.0,0.0,0.0,0.0,0.0,0.0,0.0,0.0,0.0,0.0,0.0,0.0,0.0,0.0,0.0,0.0,0.0,0.0,0.0,0.0,0.0,0.0,0.0,0.0,0.0,0.0,0.0,0.0,0.0,0.0,0.0,0.0,0.0,0.0,0.0,0.0,0.0,0.0,0.0,0.0,0.0,0.0,0.0,0.0,0.0,0.0,0.0,0.0,1.0,0.0,0.0,0.0,0.0,0.0,0.0,0.0,0.0,0.0,0.0,0.0,0.0,0.0,0.0,0.0,0.0,0.0,0.0,0.0,0.0,0.0,0.0,0.0,0.0,0.0,0.0,0.0,0.0
102459,0,0.0,0.0,0.0,1.0,1.0,112500.0,750816.0,24349.5,594000.0,0.0196889999999999,38.624657534246566,-5292.0,-3090.0,-4665.0,,3.0,2.0,2.0,12.0,0.5439299129479648,0.4269762143159233,0.5370699579791587,0.2825,0.0818,0.9821,,,0.08,0.0345,0.3333,,0.0934,,0.0974,,0.0054,0.2878,0.0849,0.9821,,,0.0806,0.0345,0.3333,,0.0955,,0.1015,,0.0057,0.2852,0.0818,0.9821,,,0.08,0.0345,0.3333,,0.095,,0.0992,,0.0055,0.1025,1.0,1.0,0.0,1.0,0.0,-716.0,0.0,0.0,0.0,0.0,1.0,2.0,1.0,1.0,0.0,1.0,0.0,0.0,0.0,0.0,0.0,0.0,0.0,0.0,0.0,1.0,0.0,0.0,0.0,0.0,0.0,0.0,0.0,0.0,0.0,0.0,0.0,0.0,0.0,0.0,0.0,0.0,0.0,0.0,10.0,23274.0,0.0,70744.07250000001,0.0,0.0,0.0,0.0,0.0,-703.5,997.5,-18.0,-407.0,288.0,-15.0,14.0,16335.315,108000.0,135000.0,,247500.0,24.0,-567.0,365243.0,-686.0,-156.0,184.0,-129.0,14.0,0.0,,0.0,39.0,30.0,18.0,-20.0,0.0,0.0,119.0,5400.0,5400.0,-1275.0,-1275.0,22.0,0.0,109.0,0.0,90000.0,0.0,0.0,0.0,0.0,0.0,291.735,58.23,0.0,0.0,0.0,0.0,0.0,0.0,0.0,59.0,-42.0,0.0,0.0,8345976111.0,184385286387.0,165573048564.0,51966343657.935,1863.0,1705.0,71125.0,70803.0,9140.0,506008.0,17805.988500002295,17868.169799999112,17319.655599998056,11294.771300000088,11232.58960000009,11179.900100000055,128396.0,662747.0,,,,13526480.50136946,-601831410.0,-921816747.0,-296487139.0,-1535022750.0416667,44017.0,30704.0,11348.048799999182,11224.019999998976,10708.286099997296,22884.94650000969,22806.822900009647,22192.311800008207,67455.320897883,158024.05424623576,126091.7945301776,34995.96150002792,34936.324700028366,34382.05040002877,,,,3713859.0,8294.708900000167,8399.227200000076,8122.820100000229,,,,16465.77229999975,16651.00659999969,16247.7870999997,,,,3913.500100000125,3896.668200000162,3729.247300000159,436455.0,431249.0,,6424.342049002896,631897.0,625449.0,,16330.2844999998,154159.0957999906,154161.84189999016,154053.60069998718,,,,23.5,37782785.65499999,11439715.680000003,4019664918.015,1332861050.699999,47035298.11499998,696729.5099999999,72.0,11786.0,-13019390.5,5489197.5,-6713442.0,-7278474.0,-11.25,26419.5,0.0,82988.145,0.0,0.0,0.0,0.0,0.0,-1071.0,-241.0,-246.0,-887.0,144779540.12999988,2066599514.8350024,2335166627.31,,2066599514.8350024,150732.0,-10353735.5,2385702040.0,100685602.0,520467177.0,233861437.0,543657394.0,149828.5,2355.0,,3646674.0,1232803.0,755564.0,-2480986.0,825345.0,98545.0,1646035376.0850296,1657903160.430017,-102148946.0,-101314007.0,1866812.0,82467.0,1607986665.18,4226193000.0,136961997.39,211196933.3249997,8483232.600000001,65594062.70999998,91432597.7249999,230873081.535,212356984.27499983,1543483562.714996,1601721690.434999,1601779697.3699992,6957.0,17844.0,117.0,10770.0,525695.0,-946026.0,299573.0,882.0,1467232.0,14773062.0,3232319.0,8554162.0,11606569.0,1415517.0,1058518937.794501,801595684.327495,72099195242.91711,21674237185.17012,582250914.791999,5792665.7475,689.5,94245.0,-276893726.0,21957757.5,-123776812.5,-218681119.5,-2018031.0,5921897840.144961,18720022500.0,198760895.325,447914549.4299976,1948107.735,256735793.8575008,309070352.65499866,636481823.3324982,459089587.0349993,5707082684.407532,5885191278.044999,5885434460.79,13378.0,80826.5,44.0,70339.5,971388.0,-1698313.5,177364.0,6755.0,4272453.5,2478944.0,-9002688.0,921269.0,37582.5,3733061896.5749626,3657548308.724961,-260602806.5,-257292240.0,2526299.5,269167.0,3925703944.057456,33251005700.325912,36680080502.34014,,48078996080.01822,3987641.0,-247567016.5,103076533694.5,1054020411.5,17270952345.0,3503157375.5,18884789339.0,3671746.5,71911.5,,89786770.0,-137.01092353525323,6.67392,4.620218074293106,178.45434085310742,30.834965810386247,1190.9899945063707,37500.0,1.0,0.0,0.0,1.0,0.0,0.0,0.0,0.0,0.0,0.0,1.0,0.0,0.0,0.0,0.0,0.0,0.0,0.0,0.0,0.0,1.0,0.0,1.0,0.0,0.0,0.0,0.0,1.0,0.0,0.0,0.0,0.0,0.0,0.0,0.0,0.0,0.0,0.0,0.0,0.0,1.0,0.0,0.0,0.0,0.0,0.0,0.0,0.0,0.0,0.0,0.0,0.0,0.0,0.0,0.0,0.0,0.0,0.0,0.0,0.0,0.0,0.0,0.0,0.0,1.0,0.0,0.0,0.0,0.0,0.0,0.0,0.0,0.0,0.0,0.0,0.0,0.0,0.0,0.0,0.0,0.0,0.0,0.0,0.0,0.0,0.0,0.0,0.0,0.0,0.0,0.0,0.0,0.0,0.0,0.0,0.0,0.0,0.0,0.0,0.0,0.0,0.0,0.0,0.0,0.0,0.0,0.0,0.0,0.0,0.0,0.0,0.0,1.0,0.0,0.0,0.0,0.0,0.0,0.0,0.0,1.0,0.0
102465,0,0.0,0.0,1.0,1.0,1.0,225000.0,922365.0,33259.5,778500.0,0.00823,43.509589041095886,-7567.0,-610.0,-5545.0,5.0,3.0,2.0,2.0,13.0,0.5016049754536496,0.6153699999307374,0.5989262182569273,0.1216,0.0233,0.9975,0.966,0.0067,0.12,0.1034,0.375,0.4167,0.0037,0.0975,0.1112,0.0077,0.0144,0.1239,0.0242,0.9975,0.9673,0.0068,0.1208,0.1034,0.375,0.4167,0.0038,0.1065,0.1159,0.0078,0.0152,0.1228,0.0233,0.9975,0.9665,0.0068,0.12,0.1034,0.375,0.4167,0.0038,0.0992,0.1132,0.0078,0.0147,0.0906,1.0,2.0,0.0,2.0,0.0,-3169.0,0.0,0.0,0.0,0.0,1.0,4.0,1.0,1.0,0.0,1.0,0.0,1.0,0.0,0.0,0.0,0.0,0.0,0.0,0.0,1.0,0.0,0.0,0.0,0.0,0.0,0.0,0.0,0.0,0.0,0.0,0.0,0.0,0.0,0.0,0.0,0.0,0.0,0.0,6.0,0.0,41377.5,1147500.0,0.0,0.0,0.0,0.0,0.0,-1243.5,430.5,-399.5,-1205.0,293.0,-24.0,14.0,42786.315,292500.0,326754.0,0.0,1244250.0,60.0,-365.0,365243.0,-1286.0,-941.0,124.0,-935.0,16.0,0.0,0.0,-1.0,85.0,45.0,32.0,-49.0,0.0,0.0,221.0,9000.0,9000.0,-1351.0,-1349.0,37.0,0.0,96.0,183140.4825,180000.0,2362.5,3825.0,0.0,0.0,9000.0,9000.0,9000.0,176382.7425,183140.4825,183140.4825,1.0,1.0,0.0,0.0,54.5,-48.5,0.0,0.0,8346009370.5,184386208752.0,165573827064.0,51966568657.935,1863.0,1705.0,71125.0,70804.0,9140.0,506012.0,17806.110100002294,17868.292599999113,17319.779499998054,11294.794600000088,11232.612900000093,11179.924300000055,128397.0,662750.0,4137.31690000012,4134.988300000015,3945.605900000096,13526524.010958502,-601838977.0,-921822292.0,-296490308.0,-1535023360.0416667,44017.0,30704.0,11348.168799999185,11224.139999998975,10708.406899997295,22885.04990000969,22806.926300009647,22192.415200008207,67455.82250285844,158024.66961623568,126092.39345639586,34996.33650002792,34936.699700028366,34382.42540002877,22950.01909999592,22923.27569999549,22570.289799995728,3713872.0,8294.712600000166,8399.231000000076,8122.823900000229,9816.334000000716,9931.27440000216,10290.896699999648,16465.883499999753,16651.11979999969,16247.9029999997,828.6451000001761,813.8216000000458,759.771100000013,3913.514500000125,3896.6829000001617,3729.26250000016,436457.0,431251.0,1263046.0,6424.350279002895,631899.0,625451.0,,16330.3750999998,154160.0932999906,154162.83939999016,154054.59819998714,77600.91559999624,77938.69320000659,78339.98770000652,41.0,37800355.90499999,11496746.430000003,4028440952.835,1334096300.699999,47080268.50499998,696729.5099999999,72.0,11786.0,-13047145.0,5478804.0,-6733058.5,-7296605.5,-20.0,0.0,41377.5,1170000.0,0.0,0.0,0.0,0.0,0.0,-2031.0,-205.0,-1693.0,-1693.0,145293364.6649999,2078133271.3350024,2347651512.81,33073589.02499999,2078133271.3350024,151312.0,-10373947.0,2390267158.5,101039111.5,522285953.5,234225285.5,545476238.5,150346.0,2360.0,415.9645257186282,3647224.5,1236991.0,758246.0,-2485481.0,825349.0,98549.0,1651804385.220027,1664526468.0150144,-102384964.0,-101547649.0,1875609.0,82640.0,1622067839.6175015,4246713000.0,137837472.39,212365583.99999967,8483232.600000001,65886520.49999998,92210833.61999986,232803839.34,214284840.83999985,1557098900.7974956,1615793696.6175003,1615851703.5525005,7016.0,18025.0,117.0,10892.0,530728.0,-950198.5,299573.0,882.0,1467238.0,14773355.0,3232415.0,8554247.0,11606790.0,1415531.0,1058518937.794501,801637061.827495,72100342742.91711,21674237185.17012,582250914.791999,5792665.7475,689.5,94245.0,-276894969.5,21958188.0,-123777212.0,-218682324.5,-2018055.0,5922080980.627461,18720202500.0,198763257.825,447918374.4299976,1948107.735,256735793.8575008,309079352.65499866,636490823.3324982,459098587.0349993,5707259067.150032,5885374418.527499,5885617601.2725,13379.0,80827.5,44.0,70339.5,971442.5,-1698362.0,177364.0,6755.0,4272498.5,2478976.0,-9002737.0,921269.0,37582.5,3733070896.5749626,3657557308.724961,-260604157.5,-257293589.0,2526336.5,269167.0,3925746730.372456,33251298200.325912,36680407256.34014,1729152223.7850494,48080240330.01822,3987701.0,-247567381.5,103076898937.5,1054019125.5,17270951404.0,3503157499.5,18884788404.0,3671762.5,71911.5,20868.13519147739,89786769.0,-173.9156854102386,4.0994,6.764984440535788,294.34169287712007,27.732377215532413,1206.6243357804665,75000.0,-0.9009688679024191,0.4338837391175582,0.0,0.0,0.0,0.0,0.0,0.0,1.0,0.0,0.0,0.0,1.0,0.0,0.0,0.0,0.0,0.0,0.0,0.0,1.0,0.0,1.0,0.0,0.0,0.0,0.0,1.0,0.0,0.0,0.0,0.0,0.0,0.0,0.0,0.0,0.0,0.0,0.0,0.0,0.0,0.0,1.0,0.0,0.0,0.0,0.0,0.0,0.0,0.0,0.0,0.0,0.0,0.0,0.0,0.0,0.0,0.0,0.0,0.0,0.0,0.0,0.0,0.0,0.0,0.0,0.0,0.0,0.0,0.0,0.0,0.0,0.0,0.0,0.0,0.0,0.0,0.0,0.0,0.0,0.0,0.0,0.0,1.0,0.0,0.0,0.0,0.0,0.0,0.0,0.0,0.0,0.0,0.0,0.0,0.0,0.0,0.0,0.0,0.0,0.0,0.0,0.0,0.0,0.0,0.0,0.0,0.0,0.0,0.0,1.0,0.0,1.0,0.0,0.0,0.0,0.0,0.0,0.0,0.0,1.0,0.0
102470,1,0.0,0.0,0.0,0.0,1.0,76500.0,163512.0,13045.5,135000.0,0.018634,29.556164383561644,-1490.0,-1567.0,-1317.0,,3.0,2.0,2.0,19.0,0.1149562977598606,0.1784033546601782,0.4848514754962666,,,,,,,,,,,,,,,,,,,,,,,,,,,,,,,,,,,,,,,,,,,,,0.0,0.0,0.0,0.0,-1265.0,0.0,0.0,0.0,0.0,0.0,1.0,1.0,1.0,1.0,1.0,1.0,0.0,0.0,0.0,0.0,0.0,1.0,1.0,0.0,0.0,0.0,0.0,0.0,0.0,1.0,0.0,0.0,0.0,0.0,0.0,0.0,0.0,0.0,0.0,0.0,0.0,0.0,0.0,3.0,0.0,,40743.0,0.0,4303.2375,0.0,0.0,0.0,-970.0,30865.0,-30.0,-964.0,81.0,-16.0,2.0,3685.7475,41908.5,44471.25,0.0,41908.5,5.0,-248.0,182516.0,-193.0,365243.0,182647.5,365243.0,15.0,0.5,0.0,15.0,8.0,10.0,6.5,-4.5,0.0,0.0,20.0,2830.59,2830.59,-100.5,-97.5,5.5,0.0,8.0,508.8825,22500.0,0.0,0.0,0.0,1293.3,248.2425,2895.84,1125.0,400.995,440.55,440.55,0.0,0.0,0.0,1.0,1.5,-4.5,0.0,0.0,8346022416.0,184386372264.0,165573962064.0,51966645157.935,1863.0,1705.0,71125.0,70804.0,9140.0,506013.0,,,,,,,128398.0,662753.0,,,,13526553.567122884,-601840467.0,-921823609.0,-296491573.0,-1535024927.0416667,44017.0,30704.0,,,,,,,67455.93745915621,158024.84801959034,126092.87830787136,,,,,,,3713891.0,,,,,,,,,,,,,,,,436457.0,431251.0,,6424.368913002895,631901.0,625453.0,,,,,,,,,32.0,38245072.90499999,,4045584402.405,1334283467.8499994,47088977.35499998,696729.5099999999,74.0,11786.0,-13097629.0,5497887.0,-6766884.0,-7335921.0,-15.5,0.0,,40743.0,0.0,0.0,0.0,0.0,0.0,-1265.0,-897.0,-963.0,-964.0,145906098.02999994,2090528352.135002,2361319783.11,33175104.52499999,2090528352.135002,151708.0,-10392151.0,2396657893.5,101391918.0,524285738.5,235134586.5,547476555.5,150612.5,2366.0,417.1312902315937,3647999.5,1240615.0,760957.5,-2489596.5,825350.0,98550.0,1662400635.5250213,1675249239.9600086,-102646108.5,-101806674.0,1881399.0,82839.0,1632222281.3175015,4263801750.0,139254972.39,213997992.7949997,8483232.600000001,66101429.29499998,92729516.17499986,234457645.86000013,215894024.14500007,1566890070.2549956,1625935184.6400006,1625993191.5750008,7077.0,18112.0,117.0,10918.0,533373.5,-953275.5,299574.0,883.0,1467241.0,14773436.0,3232423.0,8554255.0,11606810.0,1415533.0,1058518937.794501,,72100383485.91711,21674237185.17012,582255218.0294988,5792665.7475,689.5,94245.0,-276895939.5,21989053.0,-123777242.0,-218683288.5,-2018071.0,5922081489.509962,18720225000.0,198763257.825,447918374.4299976,1948107.735,256737087.1575008,309079600.89749867,636493719.1724981,459099712.0349993,5707259468.145032,5885374859.077499,5885618041.8225,13379.0,80827.5,44.0,70340.5,971444.0,-1698366.5,177364.0,6755.0,4272508.5,2478982.5,-9002741.5,921269.0,37582.5,3733073727.1649632,3657560139.314961,-260604258.0,-257293686.5,2526342.0,269167.0,3925750416.119956,33251340108.825912,36680451727.59014,1729152223.7850494,48080282238.51822,3987706.0,-247567629.5,103077081453.5,1054018932.5,17271316647.0,3503340147.0,18885153647.0,3671777.5,71912.0,20868.13519147739,89786784.0,-50.41249536522061,2.1374117647058823,5.864091065884787,173.320039503466,12.533977233528804,370.4562914939965,25500.0,-0.2225209339563146,-0.9749279121818236,0.0,0.0,0.0,0.0,0.0,0.0,1.0,0.0,0.0,0.0,0.0,0.0,0.0,1.0,0.0,0.0,0.0,0.0,1.0,0.0,1.0,0.0,0.0,0.0,0.0,0.0,0.0,0.0,0.0,1.0,0.0,0.0,0.0,0.0,0.0,0.0,0.0,0.0,0.0,0.0,0.0,0.0,0.0,0.0,1.0,0.0,0.0,0.0,0.0,0.0,0.0,0.0,0.0,1.0,0.0,0.0,0.0,0.0,0.0,0.0,0.0,0.0,0.0,0.0,0.0,0.0,0.0,0.0,0.0,0.0,0.0,0.0,0.0,0.0,0.0,0.0,0.0,0.0,0.0,0.0,0.0,0.0,0.0,0.0,0.0,0.0,0.0,0.0,0.0,0.0,0.0,0.0,0.0,0.0,0.0,0.0,0.0,0.0,0.0,0.0,0.0,0.0,0.0,0.0,0.0,0.0,0.0,0.0,0.0,0.0,0.0,0.0,0.0,0.0,0.0,0.0,0.0,0.0,0.0,0.0
102471,0,0.0,0.0,0.0,1.0,3.0,81000.0,675000.0,37822.5,675000.0,0.0228,32.9013698630137,-364.0,-5795.0,-333.0,,5.0,2.0,2.0,16.0,0.4744303388682272,0.6374722758075607,,0.0722,0.0645,0.9811,0.7416,0.0069,0.0,0.1379,0.1667,0.2083,0.0,0.0588,0.0607,0.0,0.0174,0.0735,0.067,0.9811,0.7517,0.0069999999999999,0.0,0.1379,0.1667,0.2083,0.0,0.0643,0.0632,0.0,0.0184,0.0729,0.0645,0.9811,0.7451,0.0069999999999999,0.0,0.1379,0.1667,0.2083,0.0,0.0599,0.0618,0.0,0.0178,0.0515,1.0,3.0,0.0,3.0,0.0,-528.0,,,,,,,1.0,1.0,0.0,1.0,0.0,1.0,0.0,0.0,0.0,1.0,1.0,0.0,0.0,1.0,0.0,0.0,0.0,0.0,0.0,0.0,0.0,0.0,0.0,0.0,0.0,0.0,0.0,0.0,0.0,0.0,0.0,0.0,0.0,,,,,,,,,,,,,0.0,,5.0,16875.0,103455.0,103455.0,0.0,315000.0,10.0,-375.0,365243.0,-498.0,-348.0,-228.0,-349.0,9.0,0.0,0.0,-1.0,20.0,12.0,6.5,-33.5,0.0,0.0,18.0,33041.745,33041.745,-1054.5,-1033.0,5.0,1.0,10.0,0.0,337500.0,,0.0,,,0.0,,0.0,0.0,0.0,0.0,,0.0,,,0.0,-7.5,0.0,0.0,8346060238.5,184387047264.0,165574637064.0,51966726157.935,,,,,,,17806.182300002292,17868.365499999112,17319.852999998053,11294.859100000089,11232.677400000091,11179.991300000054,128401.0,662758.0,4137.32380000012,4134.995300000015,3945.612900000096,13526586.468492748,-601840831.0,-921823942.0,-296492101.0,-1535030722.0416667,44017.0,30704.0,11348.168799999185,11224.139999998975,10708.406899997295,22885.187800009688,22807.06420000965,22192.55310000821,67456.41188949508,158025.48549186616,,34996.503200027924,34936.86640002836,34382.59210002877,22950.22739999592,22923.483999995493,22570.49809999573,3713907.0,8294.712600000166,8399.231000000076,8122.823900000229,9816.392800000718,9931.33430000216,10290.960999999648,16465.944199999754,16651.18159999969,16247.9661999997,828.6451000001761,813.8216000000458,759.771100000013,3913.531900000126,3896.7007000001618,3729.28090000016,436460.0,431254.0,,6424.391713002896,631903.0,625455.0,,16330.4265999998,154161.0743999906,154163.82049999016,154055.57929998718,77601.65719999622,77939.43830000659,78340.73940000651,,,,,,,,,,,,,,,,,,,,,,,,,,,145952162.09999993,2090969307.135002,2361781528.11,33175104.52499999,2090969307.135002,151730.0,-10394497.0,2397388274.0,101391336.0,524468012.0,235316980.0,547657881.0,150652.0,2366.0,417.1312902315937,3648123.0,1240758.0,761041.5,-2489835.0,825350.0,98550.0,1662651091.1025212,1675499695.537508,-102653597.5,-101813971.0,1881504.5,82849.5,1632247507.3050015,4265759250.0,,214020980.59499967,,,92733021.67499986,,215899376.26500008,1566913281.659996,1625958678.3750005,1626016685.310001,,18127.0,,,533383.0,-953332.5,299574.0,883.0,1467241.0,14773436.0,3232433.0,8554275.0,11606828.0,1415538.0,,,,,,,,,,,,,,5922081489.509962,18720562500.0,,447918374.4299976,,,309079600.89749867,,459099712.0349993,5707259468.145032,5885374859.077499,5885618041.8225,,80827.5,,,971444.0,-1698374.0,177364.0,6755.0,4272520.5,2478989.0,-9002775.0,921269.0,37582.5,3733106768.909962,3657593181.059961,-260605312.5,-257294719.5,2526347.0,269168.0,3925767291.119956,33251443563.825912,36680555182.59014,1729152223.7850494,48080597238.51822,3987716.0,-247568004.5,103077446696.5,1054018434.5,17271316299.0,3503339919.0,18885153298.0,3671786.5,71912.0,20868.13519147739,89786783.0,-11.063369139811806,8.333333333333334,2.1415823914336705,70.46099435267656,17.846519928613922,587.1749529389714,16200.0,0.6234898018587336,0.7818314824680298,0.0,0.0,0.0,0.0,0.0,0.0,1.0,0.0,1.0,0.0,0.0,0.0,0.0,0.0,0.0,1.0,0.0,0.0,0.0,0.0,1.0,0.0,0.0,0.0,0.0,1.0,0.0,0.0,0.0,0.0,0.0,0.0,0.0,1.0,0.0,0.0,0.0,0.0,0.0,0.0,0.0,0.0,0.0,0.0,0.0,0.0,0.0,0.0,0.0,0.0,0.0,0.0,0.0,0.0,0.0,0.0,0.0,0.0,0.0,0.0,0.0,0.0,0.0,0.0,0.0,0.0,0.0,0.0,0.0,0.0,0.0,0.0,0.0,0.0,0.0,0.0,0.0,0.0,0.0,0.0,0.0,0.0,0.0,0.0,0.0,0.0,0.0,0.0,0.0,0.0,0.0,0.0,0.0,0.0,0.0,0.0,0.0,0.0,0.0,1.0,0.0,0.0,0.0,0.0,0.0,0.0,0.0,0.0,1.0,0.0,1.0,0.0,0.0,0.0,0.0,0.0,0.0,0.0,1.0,0.0
102475,0,0.0,1.0,1.0,1.0,0.0,175500.0,248760.0,29650.5,225000.0,0.005002,39.61369863013699,-2770.0,-4209.0,-4158.0,0.0,2.0,3.0,3.0,11.0,,0.7706597318699878,0.4241303111942548,,,,,,,,,,,,,,,,,,,,,,,,,,,,,,,,,,,,,,,,,,,,,0.0,0.0,0.0,0.0,-2269.0,0.0,0.0,0.0,0.0,0.0,0.0,1.0,1.0,1.0,1.0,0.0,1.0,0.0,0.0,0.0,1.0,1.0,1.0,0.0,1.0,0.0,0.0,0.0,0.0,0.0,0.0,0.0,0.0,0.0,0.0,0.0,0.0,0.0,0.0,0.0,0.0,0.0,0.0,8.0,0.0,0.0,92569.05,0.0,0.0,0.0,0.0,0.0,-859.5,-466.5,-465.5,-725.5,308.0,-24.5,2.0,7997.58,61740.0,54990.0,9135.0,61740.0,8.0,-2535.5,365243.0,-2771.0,-2531.0,-2501.0,-2522.0,13.5,1.0,0.1596008059736873,68.5,12.0,9.0,2.5,-88.5,0.0,0.0,11.0,7249.545,7249.545,-2681.0,-2681.0,6.0,1.0,0.0,,,,,,,,,,,,,,,,,,,,,8346089889.0,184387296024.0,165574862064.0,51966901657.935,1863.0,1705.0,71125.0,70804.0,9140.0,506013.0,,,,,,,128401.0,662760.0,,,,13526626.082191378,-601843601.0,-921828100.0,-296494370.0,-1535034931.0416667,44017.0,30704.0,,,,,,,,158026.25615159803,126093.30243818257,,,,,,,3713918.0,,,,,,,,,,,,,,,,436460.0,431254.0,1263046.0,6424.396715002896,631906.0,625458.0,,,,,,,,,28.5,38245072.90499999,11622933.495000005,4047066503.505,1334348807.8499994,47111477.35499998,696729.5099999999,74.0,11786.0,-13108610.0,5521175.5,-6774955.5,-7341272.5,-13.75,0.0,0.0,85045.5,0.0,0.0,0.0,0.0,0.0,-2538.0,-712.0,-757.0,-757.0,146065658.51249993,2092517401.635002,2363294369.61,33253323.52499999,2092517401.635002,151856.0,-10409891.0,2401405947.0,102474979.0,525919626.0,236403743.0,548744910.0,150828.5,2368.0,418.4102531096132,3651796.5,1242410.5,761861.5,-2494604.5,825370.0,98570.0,1664167705.8750193,1676871360.8100064,-102803643.0,-101962275.0,1882487.0,82961.0,,,,,,,,,,,,,,,,,,,,,1467249.0,14773744.0,3232433.0,8554287.0,11606839.0,1415540.0,1058518937.794501,801637061.827495,72100476054.96713,21674237185.17012,582255218.0294988,5792665.7475,689.5,94245.0,-276896799.0,21988586.5,-123777707.5,-218684014.0,-2018095.5,,,,,,,,,,,,,,,,,,,,,4272529.5,2478991.5,-9002863.5,921269.0,37582.5,3733114018.4549623,3657600430.604961,-260607993.5,-257297400.5,2526353.0,269169.0,3925775288.699957,33251505303.825912,36680610172.59014,1729161358.7850494,48080658978.51822,3987724.0,-247570540.0,103077811939.5,1054015663.5,17271313768.0,3503337418.0,18885150776.0,3671800.0,71913.0,20868.29479228337,89786851.5,-69.92530603776194,1.4174358974358974,5.9189558354833816,234.4717326719293,8.389740476551829,332.348650823186,87750.0,0.6234898018587336,0.7818314824680298,0.0,0.0,0.0,0.0,0.0,0.0,1.0,0.0,0.0,0.0,0.0,0.0,0.0,1.0,0.0,0.0,0.0,1.0,0.0,0.0,1.0,0.0,0.0,0.0,0.0,1.0,0.0,0.0,0.0,0.0,0.0,0.0,0.0,0.0,1.0,0.0,0.0,0.0,0.0,0.0,0.0,0.0,0.0,0.0,0.0,0.0,0.0,0.0,0.0,0.0,0.0,0.0,0.0,1.0,0.0,0.0,0.0,0.0,0.0,0.0,0.0,0.0,0.0,0.0,0.0,0.0,0.0,0.0,0.0,0.0,0.0,0.0,0.0,0.0,0.0,0.0,0.0,0.0,0.0,0.0,0.0,0.0,0.0,0.0,0.0,0.0,0.0,0.0,0.0,0.0,0.0,0.0,0.0,0.0,0.0,0.0,0.0,0.0,0.0,0.0,0.0,0.0,0.0,0.0,0.0,0.0,0.0,0.0,0.0,0.0,0.0,0.0,0.0,0.0,0.0,0.0,0.0,0.0,0.0,0.0
102476,0,0.0,0.0,0.0,1.0,0.0,202500.0,848745.0,43465.5,675000.0,0.018634,47.42465753424658,-1926.0,-475.0,-844.0,,2.0,2.0,2.0,15.0,,0.5340733531234478,0.3825018041447388,,,,,,,,,,,,,,,,,,,,,,,,,,,,,,,,,,,,,,,,,,,,,0.0,0.0,0.0,0.0,-281.0,0.0,0.0,0.0,0.0,1.0,2.0,1.0,1.0,0.0,1.0,0.0,0.0,0.0,0.0,0.0,0.0,1.0,1.0,0.0,0.0,0.0,1.0,0.0,0.0,0.0,0.0,0.0,0.0,0.0,0.0,0.0,0.0,0.0,0.0,0.0,0.0,0.0,0.0,5.0,8448.75,,288000.0,0.0,0.0,0.0,0.0,0.0,-1026.0,798.0,-148.0,-632.0,168.0,-17.0,3.0,8817.1425,135000.0,135000.0,0.0,135832.5,9.0,-307.0,182499.0,-343.0,182588.5,182633.5,182592.5,12.0,0.0,0.0,-1.0,16.0,18.0,10.5,-9.5,0.0,0.0,43.0,10884.285,9450.0,-159.0,-159.0,11.0,0.0,10.0,15458.175,135000.0,15750.0,13854.6675,0.0,6103.1475,2074.8825,17550.0,10415.655,13627.3725,13887.675,13887.675,1.0,2.0,0.0,2.0,2.5,-5.5,0.0,0.0,8346133354.5,184388144769.0,165575537064.0,51967104157.935,1863.0,1705.0,71125.0,70805.0,9140.0,506015.0,,,,,,,128401.0,662762.0,,,,13526673.506848913,-601845527.0,-921828944.0,-296494651.0,-1535035406.0416667,44017.0,30704.0,,,,,,,,158026.79022495114,126093.68493998668,,,,,,,3713933.0,,,,,,,,,,,,,,,,436460.0,431254.0,,6424.415349002896,631908.0,625460.0,,,,,,,,,34.0,38534454.40499999,,4049954270.505,1334577717.9449997,47111477.35499998,696729.5099999999,74.0,11786.0,-13114681.0,5521240.0,-6777033.0,-7343846.0,-16.5,0.0,,270000.0,0.0,0.0,0.0,0.0,0.0,-1028.0,798.0,-214.0,-632.0,146083542.5699999,2092686196.635002,2363479927.11,33256536.52499999,2092753696.635002,151879.0,-10412116.0,2401771067.5,102474393.0,526102181.5,236586388.5,548927473.5,150862.0,2368.0,418.4609448246778,3651983.0,1242610.0,761983.5,-2495183.0,825370.0,98570.0,1664453022.255021,1677124024.3350074,-102822137.0,-101980620.0,1882720.0,82986.0,1632560276.0250018,4268875500.0,139394472.39,214214151.86999968,8483232.600000001,66173588.36999999,92748644.05499986,234544162.9500001,215981666.23500007,1567211647.409996,1626263215.6050007,1626321222.540001,7082.5,18150.0,117.0,10950.0,533397.0,-953452.5,299574.0,883.0,1467254.0,14773912.0,3232443.0,8554303.0,11606882.0,1415543.0,1058527386.544501,,72100764054.96713,21674237185.17012,582255218.0294988,5792665.7475,689.5,94245.0,-276897825.0,21989384.5,-123777855.5,-218684646.0,-2018112.5,5922096947.684961,18720697500.0,198779007.825,447932229.0974976,1948107.735,256743190.3050008,309081675.77999866,636511269.1724981,459110127.68999934,5707273095.517532,5885388746.7525,5885631929.4975,13380.0,80829.5,44.0,70342.5,971446.5,-1698379.5,177364.0,6755.0,4272547.5,2479002.0,-9002873.0,921269.0,37582.5,3733124902.7399626,3657609880.604961,-260608152.5,-257297559.5,2526364.0,269169.0,3925784105.842456,33251640303.825912,36680745172.59014,1729161358.7850494,48080794811.01822,3987733.0,-247570847.0,103077994438.5,1054015320.5,17271496356.5,3503520051.5,18885333368.5,3671812.0,71913.0,20868.29479228337,89786850.5,-40.61178509532061,4.191333333333334,4.658867377575318,220.9451898789829,19.52686613521068,926.0549391794436,101250.0,0.6234898018587336,0.7818314824680298,0.0,0.0,0.0,0.0,0.0,0.0,1.0,0.0,0.0,0.0,0.0,0.0,0.0,1.0,0.0,0.0,0.0,0.0,1.0,1.0,0.0,0.0,0.0,0.0,0.0,1.0,0.0,0.0,0.0,0.0,0.0,0.0,0.0,0.0,0.0,0.0,0.0,0.0,0.0,0.0,0.0,0.0,0.0,0.0,1.0,0.0,0.0,0.0,0.0,0.0,0.0,0.0,0.0,0.0,0.0,0.0,0.0,0.0,0.0,0.0,0.0,0.0,0.0,0.0,0.0,0.0,0.0,0.0,0.0,0.0,0.0,0.0,0.0,0.0,0.0,0.0,0.0,0.0,0.0,0.0,0.0,0.0,0.0,0.0,0.0,0.0,0.0,0.0,0.0,0.0,0.0,0.0,0.0,0.0,0.0,0.0,0.0,0.0,0.0,1.0,0.0,0.0,0.0,0.0,0.0,0.0,0.0,0.0,0.0,0.0,0.0,0.0,0.0,0.0,0.0,0.0,0.0,0.0,0.0,0.0
102506,0,0.0,1.0,1.0,1.0,1.0,270000.0,225000.0,27994.5,225000.0,0.072508,29.92054794520548,-509.0,-5670.0,-572.0,18.0,3.0,1.0,1.0,17.0,0.5977675160454287,0.1470939965112147,0.6092756673894402,0.1402,0.0564,0.9901,0.8640000000000001,0.0007,0.16,0.069,0.6667,0.7083,0.0,0.1126,0.147,0.0077,0.0017,0.1429,0.0585,0.9901,0.8693,0.0008,0.1611,0.069,0.6667,0.7083,0.0,0.123,0.1532,0.0078,0.0018,0.1416,0.0564,0.9901,0.8658,0.0007,0.16,0.069,0.6667,0.7083,0.0,0.1146,0.1496,0.0078,0.0017,0.1164,1.0,0.0,0.0,0.0,0.0,-400.0,0.0,0.0,0.0,0.0,1.0,1.0,1.0,1.0,1.0,1.0,0.0,0.0,0.0,0.0,0.0,0.0,0.0,0.0,0.0,0.0,0.0,0.0,0.0,0.0,1.0,0.0,0.0,0.0,0.0,0.0,0.0,0.0,0.0,0.0,0.0,0.0,0.0,0.0,3.0,18130.5,9445.5,125455.5,136455.75,0.0,0.0,0.0,0.0,-1588.0,-803.0,-811.0,-1061.5,148.0,-24.0,6.0,19304.775,83025.0,76972.5,6052.5,123522.75,9.0,-400.0,365243.0,-1025.0,-815.0,-785.0,-806.0,14.5,0.5,0.0544545454545454,-1.0,17.0,12.0,4.0,-10.0,0.0,0.0,16.0,25547.04,25547.04,-269.0,-265.0,4.5,1.0,0.0,,,,,,,,,,,,,,,,,,,,,8346161349.0,184388369769.0,165575762064.0,51967374157.935,1863.0,1705.0,71125.0,70806.0,9140.0,506016.0,17806.322500002294,17868.507099999108,17319.995899998048,11294.915500000088,11232.733800000093,11180.049800000052,128402.0,662765.0,4137.324500000121,4134.996000000016,3945.613700000096,13526703.427396858,-601846036.0,-921829516.0,-296495051.0,-1535041076.0416667,44017.0,30704.0,11348.328799999184,11224.299999998975,10708.567999997296,22885.256800009687,22807.133200009648,22192.622100008208,67457.00965701112,158026.9373189477,126094.29421565408,34997.16990002793,34937.53310002836,34383.25880002877,22950.93569999592,22924.192299995488,22571.20639999572,3713950.0,8294.712600000166,8399.231000000076,8122.823900000229,9816.50540000072,9931.44890000216,10291.083999999648,16466.091199999755,16651.33119999969,16248.1193999997,828.6528000001761,813.8294000000458,759.778900000013,3913.533600000125,3896.7024000001616,3729.28270000016,436460.0,431254.0,1263064.0,6424.487857002896,631909.0,625461.0,,16330.5429999998,154162.0644999906,154164.81059999016,154056.56939998714,77602.52119999622,77940.30410000659,78341.60870000652,53.0,38809793.92499999,12328007.040000005,4097633357.250001,1345045082.7149994,47354502.14999998,696729.5099999999,79.0,11786.0,-13260551.0,5681970.0,-6858391.0,-7425186.0,-26.0,36261.0,9445.5,125455.5,272911.5,0.0,0.0,0.0,0.0,-1588.0,-803.0,-811.0,-1292.0,147632450.89499974,2112814032.2100024,2385732030.885,33515495.32499999,2112814032.2100024,153510.0,-10508081.0,2429708941.5,103868444.0,533906390.0,238565838.0,557466333.5,152606.5,2387.5,422.2201983435529,3679053.5,1256370.0,771245.0,-2517249.0,825378.0,98575.0,1682513380.6200087,1695433669.5149956,-103585245.0,-102743686.0,1891893.5,83820.5,,,,,,,,,,,,,,,,,,,,,1467257.0,14774060.0,3232443.0,8554320.0,11606898.0,1415549.0,1058545517.044501,801646507.327495,72100889510.46713,21674373640.92012,582255218.0294988,5792665.7475,689.5,94245.0,-276899413.0,21988581.5,-123778666.5,-218685707.5,-2018136.5,,,,,,,,,,,,,,,,,,,,,4272559.5,2479006.0,-9002883.0,921269.0,37582.5,3733150449.7799625,3657635427.644961,-260608421.5,-257297824.5,2526368.5,269170.0,3925803410.617456,33251723328.825912,36680822145.09014,1729167411.2850494,48080918333.76822,3987742.0,-247571247.0,103078359681.5,1054014295.5,17271495541.5,3503519266.5,18885332562.5,3671826.5,71913.5,20868.349246828817,89786849.5,-17.01172053841223,0.8333333333333334,9.644751647645071,288.57625409296395,8.037293039704227,240.48021174413665,90000.0,1.0,0.0,0.0,0.0,0.0,0.0,0.0,0.0,1.0,0.0,1.0,0.0,0.0,0.0,0.0,0.0,0.0,0.0,0.0,0.0,1.0,0.0,1.0,0.0,0.0,0.0,0.0,1.0,0.0,0.0,0.0,0.0,0.0,0.0,0.0,0.0,1.0,0.0,0.0,0.0,0.0,0.0,0.0,0.0,0.0,0.0,0.0,0.0,0.0,0.0,0.0,0.0,0.0,0.0,0.0,1.0,0.0,0.0,0.0,0.0,0.0,0.0,0.0,0.0,0.0,0.0,0.0,0.0,0.0,0.0,0.0,0.0,0.0,0.0,0.0,0.0,0.0,0.0,0.0,0.0,0.0,0.0,0.0,0.0,0.0,0.0,0.0,0.0,0.0,0.0,0.0,0.0,0.0,0.0,0.0,0.0,0.0,0.0,0.0,0.0,0.0,0.0,0.0,0.0,0.0,0.0,0.0,0.0,0.0,0.0,1.0,0.0,1.0,0.0,0.0,0.0,0.0,0.0,0.0,1.0,0.0,0.0
102509,0,0.0,1.0,1.0,1.0,0.0,360000.0,2013840.0,62640.0,1800000.0,0.04622,57.67397260273973,-384.0,-2883.0,-1798.0,5.0,2.0,1.0,1.0,17.0,,0.5912281614145831,0.3893387918468769,,,,,,,,,,,,,,,,,,,,,,,,,,,,,,,,,,,,,,,,,,,,,0.0,0.0,0.0,0.0,-645.0,0.0,0.0,0.0,0.0,1.0,0.0,1.0,1.0,0.0,1.0,0.0,1.0,0.0,1.0,1.0,0.0,0.0,0.0,0.0,0.0,0.0,0.0,0.0,0.0,1.0,0.0,0.0,0.0,0.0,0.0,0.0,0.0,0.0,0.0,0.0,0.0,0.0,0.0,8.0,0.0,0.0,315000.0,0.0,0.0,0.0,0.0,0.0,-1408.5,-815.5,-505.0,-847.5,403.0,-26.0,1.0,9986.76,123005.7,98401.5,24604.2,123005.7,12.0,-645.0,365243.0,-606.0,-276.0,-276.0,-269.0,13.0,0.0,0.2178452750194059,21.0,13.0,12.0,6.0,-15.0,0.0,0.0,14.0,9986.76,9986.76,-428.0,-411.0,7.5,1.0,0.0,,,,,,,,,,,,,,,,,,,,,8346223989.0,184390383609.0,165577562064.0,51967734157.935,1863.0,1705.0,71125.0,70807.0,9140.0,506016.0,,,,,,,128402.0,662767.0,,,,13526761.10136946,-601846420.0,-921831314.0,-296495696.0,-1535043959.0416667,44017.0,30704.0,,,,,,,,158027.5285471091,126094.68355444592,,,,,,,3713967.0,,,,,,,,,,,,,,,,436460.0,431254.0,1263069.0,6424.534077002895,631910.0,625462.0,,,,,,,,,47.0,38827924.42499999,12328007.040000005,4103989718.805,1345719114.584999,47532260.56499998,696729.5099999999,79.0,11786.0,-13285868.0,5675153.5,-6870794.0,-7436506.0,-23.0,0.0,0.0,450000.0,0.0,0.0,0.0,0.0,0.0,-1807.0,-1231.0,-716.0,-979.0,147683580.29999968,2113371067.4100025,2386297199.385,33548829.52499999,2113371067.4100025,153578.0,-10512454.0,2430987292.0,103864986.0,534269397.0,238564135.0,557829356.0,152686.0,2389.0,422.751102792322,3680056.0,1257362.0,771900.0,-2517986.0,825378.0,98575.0,1683057423.105008,1695958860.6899948,-103605831.0,-102763922.0,1892264.0,83863.5,,,,,,,,,,,,,,,,,,,,,1467265.0,14774463.0,3232443.0,8554333.0,11606912.0,1415550.0,1058545517.044501,801646507.327495,72101204510.46713,21674373640.92012,582255218.0294988,5792665.7475,689.5,94245.0,-276900821.5,21987766.0,-123779171.5,-218686555.0,-2018162.5,,,,,,,,,,,,,,,,,,,,,4272571.5,2479012.0,-9002898.0,921269.0,37582.5,3733160436.5399632,3657645414.404961,-260608849.5,-257298235.5,2526376.0,269171.0,3925813397.377456,33251846334.52592,36680920546.59014,1729192015.4850495,48081041339.468216,3987754.0,-247571892.0,103078724924.5,1054013689.5,17271495265.5,3503518990.5,18885332293.5,3671839.5,71913.5,20868.56709210384,89786870.5,-6.658116003990308,5.593999999999999,5.747126436781608,331.45961265942367,32.14942528735632,1854.185073216816,180000.0,-0.2225209339563143,0.9749279121818236,0.0,0.0,0.0,0.0,0.0,0.0,1.0,0.0,1.0,0.0,0.0,0.0,0.0,0.0,0.0,1.0,0.0,0.0,0.0,0.0,1.0,0.0,0.0,0.0,0.0,1.0,0.0,0.0,0.0,0.0,0.0,0.0,0.0,0.0,0.0,0.0,0.0,0.0,0.0,0.0,1.0,0.0,0.0,0.0,0.0,0.0,0.0,0.0,0.0,0.0,0.0,0.0,0.0,1.0,0.0,0.0,0.0,0.0,0.0,0.0,0.0,0.0,0.0,0.0,0.0,0.0,0.0,0.0,0.0,0.0,0.0,0.0,0.0,0.0,0.0,0.0,0.0,0.0,0.0,0.0,0.0,0.0,0.0,0.0,0.0,0.0,0.0,0.0,0.0,0.0,0.0,0.0,0.0,0.0,0.0,0.0,0.0,0.0,0.0,0.0,0.0,0.0,0.0,0.0,0.0,0.0,0.0,0.0,0.0,0.0,0.0,0.0,0.0,0.0,0.0,0.0,0.0,0.0,0.0,0.0
102519,0,0.0,0.0,0.0,0.0,0.0,108000.0,104256.0,8064.0,90000.0,0.0105,56.24109589041096,,-5518.0,-3097.0,,1.0,3.0,3.0,9.0,,0.7411612989296863,0.5226973172821112,,,,,,,,,,,,,,,,,,,,,,,,,,,,,,,,,,,,,,,,,,,,,5.0,0.0,5.0,0.0,-385.0,0.0,0.0,0.0,0.0,0.0,2.0,1.0,0.0,0.0,1.0,0.0,0.0,0.0,0.0,0.0,0.0,0.0,0.0,0.0,1.0,0.0,0.0,0.0,0.0,0.0,0.0,0.0,0.0,0.0,0.0,0.0,0.0,0.0,0.0,0.0,0.0,0.0,0.0,3.0,0.0,,85500.0,0.0,0.0,0.0,0.0,0.0,-1651.0,-827.0,-1177.0,-1180.0,165.0,-27.0,3.0,7192.215,90000.0,90000.0,0.0,90000.0,12.0,-165.0,365243.0,-243.5,365243.0,146.5,365243.0,11.0,0.5,0.0,90.0,17.0,16.0,10.0,-6.0,0.0,0.0,17.0,7192.215,7192.215,-151.0,-135.0,5.0,1.0,0.0,,,,,,,,,,,,,,,,,,,,,8346232053.0,184390487865.0,165577652064.0,51967842157.935,1863.0,1705.0,71125.0,70807.0,9140.0,506018.0,,,,,,,128402.0,662768.0,,,,13526817.342465352,,-921834411.0,-296496081.0,-1535049477.0416667,44017.0,30704.0,,,,,,,,158028.26970840804,126095.2062517632,,,,,,,3713976.0,,,,,,,,,,,,,,,,436465.0,431259.0,,6424.544577002896,631913.0,625465.0,,,,,,,,,55.0,38960354.92499999,,4115053070.55,1346844827.8799994,47552690.51999998,696734.0099999999,79.0,11949.0,-13333481.0,5654788.0,-6891643.0,-7462622.0,-27.0,0.0,,85500.0,0.0,0.0,0.0,0.0,0.0,-1651.0,-827.0,-1177.0,-1180.0,148188619.03499967,2119648843.3500023,2393195375.385,33823749.465,2119648843.3500023,154054.0,-10542527.0,2439570502.5,104204186.0,536624585.5,238547074.0,560550642.5,153109.0,2400.0,425.1062465359275,3687189.0,1263672.0,775239.0,-2529727.0,900259.0,98641.0,1688665595.8050098,1701278646.0749972,-103887924.0,-103043576.0,1895028.0,84165.0,,,,,,,,,,,,,,,,,,,,,1467268.0,14774628.0,3232443.0,8554350.0,11606929.0,1415553.0,1058545517.044501,,72101290010.46713,21674373640.92012,582255218.0294988,5792665.7475,689.5,94245.0,-276902472.5,21986939.0,-123780348.5,-218687735.0,-2018189.5,,,,,,,,,,,,,,,,,,,,,4272587.5,2479022.0,-9002904.0,921269.0,37582.5,3733167628.7549634,3657652606.619961,-260609000.5,-257298370.5,2526381.0,269172.0,3925820589.592456,33251936334.52592,36681010546.59014,1729192015.4850495,48081131339.468216,3987766.0,-247572057.0,103079090167.5,1054013446.0,17271860508.5,3503519137.0,18885697536.5,3671850.5,71914.0,20868.56709210384,89786960.5,,0.9653333333333334,13.392857142857142,753.2289628180039,12.928571428571429,727.1170254403131,108000.0,-0.9009688679024191,0.4338837391175582,0.0,0.0,0.0,0.0,0.0,0.0,1.0,0.0,0.0,1.0,0.0,0.0,0.0,0.0,0.0,0.0,0.0,0.0,1.0,0.0,0.0,0.0,0.0,1.0,0.0,1.0,0.0,0.0,0.0,0.0,0.0,0.0,0.0,0.0,0.0,0.0,0.0,0.0,0.0,0.0,0.0,0.0,0.0,0.0,0.0,0.0,0.0,0.0,0.0,0.0,0.0,0.0,0.0,0.0,0.0,0.0,0.0,0.0,0.0,0.0,0.0,0.0,0.0,0.0,0.0,0.0,0.0,0.0,0.0,0.0,0.0,0.0,0.0,0.0,0.0,0.0,0.0,0.0,0.0,0.0,0.0,0.0,0.0,0.0,0.0,0.0,0.0,0.0,0.0,0.0,0.0,0.0,0.0,0.0,0.0,0.0,0.0,0.0,0.0,0.0,0.0,0.0,0.0,0.0,0.0,1.0,0.0,0.0,0.0,0.0,0.0,0.0,0.0,0.0,0.0,0.0,0.0,0.0,0.0,0.0
102522,0,0.0,1.0,0.0,0.0,0.0,288000.0,260640.0,31059.0,225000.0,0.02461,33.51780821917808,-4308.0,-1355.0,-4691.0,,2.0,2.0,2.0,14.0,0.7689697678975334,0.6071707071877025,0.1974745115685422,0.2278,0.1767,0.9896,0.8572,0.1127,0.24,0.2069,0.3333,0.375,0.1284,0.1849,0.2368,0.0039,0.0161,0.2321,0.1833,0.9896,0.8628,0.1138,0.2417,0.2069,0.3333,0.375,0.1313,0.202,0.2467,0.0039,0.0171,0.23,0.1767,0.9896,0.8591,0.1134,0.24,0.2069,0.3333,0.375,0.1306,0.1881,0.241,0.0039,0.0165,0.2514,1.0,0.0,0.0,0.0,0.0,-677.0,0.0,0.0,0.0,0.0,1.0,3.0,1.0,1.0,0.0,1.0,0.0,0.0,0.0,0.0,0.0,0.0,0.0,0.0,0.0,1.0,0.0,0.0,0.0,0.0,0.0,0.0,0.0,0.0,0.0,0.0,0.0,0.0,0.0,0.0,0.0,0.0,0.0,0.0,10.0,7884.0,4.5,189000.0,15469.2675,0.0,0.0,0.0,0.0,-639.0,54.5,-24.5,-667.0,303.0,-16.0,5.0,21920.2425,90625.5,178555.5,27031.5,215995.5,9.0,-677.0,365243.0,-2276.0,-1964.0,-316.0,-1015.0,13.0,0.0,0.1593436601242758,30.0,15.0,6.0,3.0,-73.0,0.0,0.0,63.0,9000.0,9000.0,-2289.0,-2271.0,18.0,0.0,88.0,0.0,180000.0,0.0,0.0,0.0,0.0,0.0,0.0,0.0,0.0,0.0,0.0,0.0,0.0,0.0,0.0,25.0,-47.5,0.0,0.0,8346263112.0,184390748505.0,165577877064.0,51968130157.935,1863.0,1705.0,71125.0,70808.0,9140.0,506021.0,17806.550300002295,17868.737099999107,17320.227999998053,11295.092200000088,11232.91050000009,11180.233100000054,128402.0,662770.0,4137.437200000119,4135.109400000015,3945.727500000096,13526850.860273572,-601850728.0,-921839102.0,-296496758.0,-1535050832.0416667,44017.0,30704.0,11348.568799999182,11224.539999998977,10708.809699997297,22885.46370000969,22807.34010000965,22192.82900000821,67457.77862677902,158028.87687911524,126095.4037262748,34997.503200027924,34937.86640002836,34383.59210002877,22951.31069999592,22924.567299995488,22571.58139999572,3713990.0,8294.841000000166,8399.361600000077,8122.955200000229,9816.69030000072,9931.63700000216,10291.285999999647,16466.327999999754,16651.572199999693,16248.3660999997,828.6567000001761,813.8333000000458,759.782800000013,3913.549700000125,3896.7189000001617,3729.29980000016,436465.0,431259.0,,6424.569187002896,631915.0,625467.0,,16330.7943999998,154163.0540999906,154165.80019999016,154057.55899998714,77603.37839999622,77941.16320000659,78342.47150000652,21.5,38990212.42499999,12349845.225000003,4116188267.28,1347293469.3074994,47552690.51999998,696734.0099999999,79.0,11949.0,-13342573.5,5649905.0,-6894249.5,-7468015.0,-10.25,7636.5,0.0,104970.825,0.0,0.0,0.0,0.0,0.0,-1015.0,-486.0,-14.0,-2804.0,148314954.7349997,2121525122.8500023,2395486698.885,33875823.465,2121525122.8500023,154226.0,-10550238.0,2441579339.0,104196964.0,537532016.0,238908629.0,561459061.0,153238.0,2402.0,425.46873338019935,3689840.0,1263986.0,775423.0,-2530878.0,900259.0,98641.0,1689442430.4450097,1702020803.2199972,-103982351.0,-103137543.0,1895749.0,84206.0,1639646451.202496,4309623000.0,140467272.39,215646722.14499968,8483232.600000001,66537858.64499999,93244619.96999983,235944725.30999988,217343592.17999983,1573988729.1299956,1633330088.4599948,1633388095.394995,7132.0,18251.0,117.0,11002.0,539060.0,-963359.0,358097.0,894.0,1467278.0,14774931.0,3232531.0,8554365.0,11606992.0,1415558.0,1058553401.044501,801646511.827495,72101479010.46713,21674389110.18762,582255218.0294988,5792665.7475,689.5,94245.0,-276903111.5,21986993.5,-123780373.0,-218688402.0,-2018205.5,5922096947.684961,18720877500.0,198779007.825,447932229.0974976,1948107.735,256743190.3050008,309081675.77999866,636511269.1724981,459110127.68999934,5707273095.517532,5885388746.7525,5885631929.4975,13380.0,80829.5,44.0,70342.5,971471.5,-1698427.0,177364.0,6755.0,4272593.5,2479025.0,-9002977.0,921269.0,37582.5,3733176628.7549634,3657661606.619961,-260611289.5,-257300641.5,2526399.0,269172.0,3925842509.834956,33252026960.02592,36681189102.09014,1729219046.9850495,48081347334.968216,3987775.0,-247572734.0,103079455410.5,1054011170.0,17271858544.5,3503518821.0,18885696521.5,3671863.5,71914.0,20868.726435763965,89786990.5,-128.52869053457582,0.905,9.27267458707621,310.79972848846666,8.39177050130397,281.2737542820623,144000.0,-0.9009688679024191,0.4338837391175582,0.0,0.0,0.0,0.0,0.0,0.0,1.0,0.0,1.0,0.0,0.0,0.0,0.0,0.0,0.0,1.0,0.0,0.0,0.0,0.0,1.0,0.0,0.0,0.0,0.0,1.0,0.0,0.0,0.0,0.0,0.0,0.0,0.0,0.0,0.0,0.0,1.0,0.0,0.0,0.0,0.0,0.0,0.0,0.0,0.0,0.0,0.0,0.0,0.0,0.0,0.0,0.0,0.0,0.0,0.0,0.0,0.0,0.0,0.0,0.0,0.0,0.0,0.0,0.0,0.0,0.0,0.0,0.0,0.0,0.0,0.0,0.0,0.0,0.0,0.0,0.0,0.0,0.0,0.0,0.0,0.0,0.0,0.0,0.0,0.0,0.0,0.0,0.0,0.0,0.0,0.0,0.0,0.0,0.0,0.0,0.0,0.0,0.0,0.0,0.0,0.0,1.0,0.0,0.0,0.0,0.0,0.0,1.0,0.0,0.0,1.0,0.0,0.0,0.0,0.0,0.0,0.0,1.0,0.0,0.0
102545,0,0.0,1.0,1.0,1.0,1.0,157500.0,442062.0,22698.0,369000.0,0.014464,49.33424657534246,-4522.0,-4032.0,-1554.0,23.0,3.0,2.0,2.0,6.0,0.4688353756241704,0.6693285132510364,0.6446794549585961,0.0825,0.0508,0.9881,0.8368,0.1532,0.08,0.069,0.375,0.4167,0.0464,0.0672,0.0948,0.0,0.0,0.084,0.0527,0.9881,0.8432,0.1546,0.0806,0.069,0.375,0.4167,0.0475,0.0735,0.0987,0.0,0.0,0.0833,0.0508,0.9881,0.8390000000000001,0.1542,0.08,0.069,0.375,0.4167,0.0472,0.0684,0.0965,0.0,0.0,0.1583,1.0,0.0,0.0,0.0,0.0,-2433.0,0.0,0.0,0.0,0.0,0.0,3.0,1.0,1.0,0.0,1.0,0.0,0.0,0.0,0.0,0.0,0.0,0.0,0.0,0.0,1.0,0.0,0.0,0.0,0.0,0.0,0.0,0.0,0.0,0.0,0.0,0.0,0.0,0.0,0.0,0.0,0.0,0.0,0.0,10.0,0.0,,154377.0,0.0,0.0,0.0,0.0,0.0,-1911.0,-1202.0,-1137.0,-1626.0,585.0,-32.0,8.0,8766.45,116055.0,112500.0,6450.75,202500.0,24.0,-1244.5,365243.0,-1390.0,-379.0,-349.0,-374.0,5.5,1.0,0.1077415723017511,-1.0,118.0,24.0,12.0,-29.0,0.0,0.0,217.0,4500.0,4500.0,-1020.0,-1000.0,18.0,1.0,80.0,88456.5,90000.0,0.0,0.0,0.0,0.0,4500.0,4500.0,4500.0,83024.97750000001,88456.5,88456.5,0.0,0.0,0.0,0.0,39.5,-40.5,0.0,0.0,8346285810.0,184391190567.0,165578246064.0,51968287657.935,1863.0,1705.0,71125.0,70808.0,9140.0,506024.0,17806.632800002295,17868.82039999911,17320.311999998048,11295.143000000093,11232.961300000094,11180.285800000054,128403.0,662773.0,4137.590400000119,4135.263600000016,3945.8821000000953,13526900.194520148,-601855250.0,-921840656.0,-296499191.0,-1535054864.0416667,44017.0,30704.0,11348.648799999182,11224.619999998977,10708.890299997296,22885.532700009688,22807.40910000965,22192.89800000821,67458.24746215464,158029.5462076285,126096.04840572974,34997.878200027924,34938.24140002836,34383.96710002877,22951.72739999592,22924.983999995493,22571.99809999573,3713996.0,8294.887400000165,8399.408800000077,8123.002700000229,9816.757500000718,9931.70540000216,10291.359499999648,16466.42279999975,16651.668699999693,16248.4647999997,828.6567000001761,813.8333000000458,759.782800000013,3913.549700000125,3896.7189000001617,3729.29980000016,436465.0,431259.0,1263092.0,6424.583651002896,631917.0,625469.0,,16330.952699999798,154164.0421999906,154166.78829999015,154058.54709998716,77604.21519999624,77942.0022000066,78343.31470000652,63.0,39285081.35999999,,4152083263.290001,1364386748.265,47705126.17499998,696734.0099999999,82.0,11949.0,-13496566.5,5755359.5,-6984586.5,-7553726.0,-31.0,0.0,,171000.0,0.0,0.0,0.0,0.0,0.0,-2121.0,-1535.0,-1137.0,-1626.0,149405572.48499978,2138332822.8750024,2414007339.885,34179930.98999999,2138332822.8750024,155540.0,-10641651.5,2462026022.0,105224085.0,541131160.0,240326965.0,564692124.0,154221.0,2417.0,429.7130904591259,3705788.5,1274610.0,782179.5,-2555237.0,900313.0,98665.0,1703311076.4750128,1715585548.1849954,-104843409.0,-103992776.0,1904430.0,84853.0,1645749668.5424902,4345128000.0,140848872.39,216104577.52499968,8496597.600000001,66597892.24499999,93637146.14999984,236615946.52499992,218011797.26999983,1579697675.9099965,1639426741.357489,1639486638.2924893,7169.0,18297.0,119.0,11009.0,543859.5,-973024.0,454412.0,900.0,1467288.0,14775516.0,3232611.0,8554483.0,11607209.0,1415566.0,1058553401.044501,,72101633387.46713,21674389110.18762,582255218.0294988,5792665.7475,689.5,94245.0,-276905022.5,21985791.5,-123781510.0,-218690028.0,-2018237.5,5922185404.184961,18720967500.0,198779007.825,447932229.0974976,1948107.735,256743190.3050008,309086175.77999866,636515769.1724981,459114627.68999934,5707356120.495032,5885477203.2525,5885720385.9975,13380.0,80829.5,44.0,70342.5,971511.0,-1698467.5,177364.0,6755.0,4272617.5,2479037.0,-9003006.0,921269.0,37582.5,3733181128.7549634,3657666106.619961,-260612309.5,-257301641.5,2526417.0,269173.0,3925851276.284957,33252143015.02592,36681301602.09014,1729225497.7350495,48081549834.968216,3987799.0,-247573978.5,103079820653.5,1054009780.0,17271858165.5,3503518472.0,18885696147.5,3671869.0,71915.0,20868.834177336263,89786989.5,-91.66046537457656,2.8067428571428565,6.9389373513084855,342.32724626030665,19.475812846946862,960.8245532464992,52500.0,-0.2225209339563143,0.9749279121818236,0.0,0.0,0.0,0.0,0.0,0.0,1.0,0.0,1.0,0.0,0.0,0.0,0.0,0.0,0.0,0.0,0.0,0.0,1.0,0.0,1.0,0.0,0.0,0.0,0.0,1.0,0.0,0.0,0.0,0.0,0.0,0.0,0.0,0.0,1.0,0.0,0.0,0.0,0.0,0.0,0.0,0.0,0.0,0.0,0.0,0.0,0.0,0.0,0.0,0.0,0.0,0.0,0.0,0.0,0.0,0.0,0.0,0.0,0.0,0.0,0.0,0.0,0.0,0.0,0.0,0.0,0.0,0.0,1.0,0.0,0.0,0.0,0.0,0.0,0.0,0.0,0.0,0.0,0.0,0.0,0.0,0.0,0.0,0.0,0.0,0.0,0.0,0.0,0.0,0.0,0.0,0.0,0.0,0.0,0.0,0.0,0.0,0.0,0.0,0.0,0.0,0.0,0.0,0.0,0.0,0.0,1.0,0.0,0.0,0.0,1.0,0.0,0.0,0.0,0.0,0.0,0.0,1.0,0.0,0.0
102549,0,0.0,0.0,0.0,0.0,0.0,90000.0,118512.0,8752.5,90000.0,0.030755,27.07397260273973,-643.0,-2508.0,-2515.0,,1.0,2.0,2.0,15.0,0.4696257171914578,0.7197808949294613,0.3791004853998145,,,,,,,,,,,,,,,,,,,,,,,,,,,,,,,,,,,,,,,,,,,,,0.0,0.0,0.0,0.0,-456.0,0.0,0.0,0.0,0.0,2.0,3.0,1.0,1.0,0.0,1.0,0.0,1.0,0.0,0.0,0.0,1.0,1.0,0.0,0.0,1.0,0.0,0.0,0.0,0.0,0.0,0.0,0.0,0.0,0.0,0.0,0.0,0.0,0.0,0.0,0.0,0.0,0.0,0.0,1.0,27058.5,,989775.0,940855.5,0.0,0.0,0.0,0.0,-166.0,1660.0,-13.0,,6.0,-2.5,5.0,4234.252500000001,0.0,0.0,5715.0,51075.0,5.0,-456.0,365243.0,-484.0,-214.0,-214.0,-209.0,13.0,1.0,0.1009153257365718,-1.0,11.0,10.0,5.0,-12.0,0.0,0.0,10.0,6218.505,6218.505,-351.0,-349.0,5.5,1.0,0.0,,,,,,,,,,,,,,,,,,,,,8346294562.5,184391309079.0,165578336064.0,51968377657.935,1863.0,1705.0,71125.0,70810.0,9140.0,506027.0,,,,,,,128403.0,662774.0,,,,13526927.26849275,-601855893.0,-921843171.0,-296499647.0,-1535057372.0416667,44017.0,30704.0,,,,,,,67458.71708787183,158030.26598852346,126096.42750621516,,,,,,,3714011.0,,,,,,,,,,,,,,,,436465.0,431259.0,,6424.614406002896,631919.0,625471.0,,,,,,,,,6.0,39562861.85999999,,4157818659.540001,1366669449.765,47705126.17499998,696734.0099999999,82.0,11949.0,-13525218.0,5773875.0,-6998054.0,,-2.5,27058.5,,989775.0,940855.5,0.0,0.0,0.0,0.0,-166.0,1660.0,-13.0,,149649117.43499967,2142144220.8150024,2418053546.385,34211184.929999985,2142121720.8150024,155820.0,-10669457.0,2468235153.0,105933144.0,542942481.0,241410480.0,566138133.0,154545.0,2424.0,430.2990595446177,3710562.0,1277775.0,784028.0,-2563584.0,900313.0,98665.0,1705933770.0525205,1718136900.1575036,-105304442.0,-104451565.0,1916679.5,85024.5,,,,,,,,,,,,,,,,,,,,,1467289.0,14775522.0,3232611.0,8554494.0,11607219.0,1415571.0,1058580459.544501,,72102623162.46713,21675329965.68762,582255218.0294988,5792665.7475,689.5,94245.0,-276905188.5,21987451.5,-123781523.0,,-2018240.0,,,,,,,,,,,,,,,,,,,,,4272627.5,2479042.0,-9003018.0,921269.0,37582.5,3733187347.259964,3657672325.124962,-260612660.5,-257301990.5,2526422.5,269174.0,3925855510.537456,33252143015.02592,36681301602.09014,1729231212.7350495,48081600909.968216,3987804.0,-247574434.5,103080185896.5,1054009296.0,17271857951.5,3503518258.0,18885695938.5,3671882.0,71916.0,20868.935092662003,89786988.5,-23.749747014774336,1.3168,10.282776349614396,278.39560516956016,13.540359897172234,366.5913328872769,90000.0,-0.2225209339563146,-0.9749279121818236,0.0,0.0,0.0,0.0,0.0,0.0,1.0,0.0,0.0,0.0,0.0,0.0,0.0,1.0,0.0,0.0,1.0,0.0,0.0,0.0,0.0,0.0,1.0,0.0,0.0,0.0,0.0,0.0,0.0,1.0,0.0,0.0,0.0,1.0,0.0,0.0,0.0,0.0,0.0,0.0,0.0,0.0,0.0,0.0,0.0,0.0,0.0,0.0,0.0,0.0,0.0,0.0,0.0,0.0,0.0,0.0,0.0,0.0,0.0,0.0,0.0,0.0,0.0,0.0,0.0,0.0,0.0,0.0,0.0,0.0,0.0,0.0,0.0,0.0,0.0,0.0,0.0,0.0,0.0,0.0,0.0,0.0,0.0,0.0,0.0,0.0,0.0,1.0,0.0,0.0,0.0,0.0,0.0,0.0,0.0,0.0,0.0,0.0,0.0,0.0,0.0,0.0,0.0,0.0,0.0,0.0,0.0,0.0,0.0,0.0,0.0,0.0,0.0,0.0,0.0,0.0,0.0,0.0,0.0,0.0
102562,0,0.0,0.0,0.0,1.0,0.0,157500.0,539100.0,26064.0,450000.0,0.009334,44.89041095890411,-7273.0,-8296.0,-5085.0,,2.0,2.0,2.0,12.0,0.9035448370520164,0.6010151485582824,0.5884877883422673,,0.1043,0.9796,0.7212,0.0161,0.0,0.2759,0.1667,0.2083,0.0396,0.1,0.114,0.0,0.0,,0.1082,0.9796,0.7321,0.0162,0.0,0.2759,0.1667,0.2083,0.0405,0.1093,0.1188,0.0,0.0,,0.1043,0.9796,0.7249,0.0162,0.0,0.2759,0.1667,0.2083,0.0402,0.1018,0.1161,0.0,0.0,0.0985,1.0,1.0,0.0,1.0,0.0,-2214.0,0.0,0.0,0.0,0.0,0.0,0.0,1.0,1.0,0.0,1.0,0.0,0.0,0.0,0.0,0.0,0.0,0.0,0.0,0.0,1.0,0.0,0.0,0.0,0.0,0.0,0.0,0.0,0.0,0.0,0.0,0.0,0.0,0.0,0.0,0.0,0.0,0.0,0.0,6.0,12705.75,0.0,206532.0,0.0,0.0,0.0,0.0,0.0,-1584.5,-767.5,-891.0,-1374.0,310.0,-30.0,4.0,5035.05,58081.5,58081.5,0.0,58081.5,11.0,-523.0,365243.0,-491.0,-191.0,-161.0,-188.0,14.0,0.0,0.0,28.0,25.0,12.0,6.0,-60.0,0.0,0.0,24.0,2195.01,2195.01,-1850.0,-1868.0,6.5,1.0,16.0,0.0,225000.0,,0.0,,,0.0,,0.0,0.0,0.0,0.0,,0.0,,,0.0,-9.5,0.0,0.0,8346320626.5,184391848179.0,165578786064.0,51968535157.935,1863.0,1705.0,71125.0,70810.0,9140.0,506027.0,,,,11295.24730000009,11233.065600000093,11180.394000000057,128403.0,662776.0,4137.606500000119,4135.279800000016,3945.8983000000953,13526972.15890371,-601863166.0,-921848256.0,-296501861.0,-1535065668.0416667,44017.0,30704.0,11348.648799999182,11224.619999998977,10708.890299997296,22885.80860000969,22807.68500000965,22193.17390000821,67459.62063270889,158030.867003672,126097.01599400348,34998.04490002793,34938.40810002836,34384.13380002877,22951.93569999592,22925.192299995488,22572.20639999572,3714023.0,8294.927000000165,8399.449000000077,8123.043200000229,9816.85750000072,9931.80720000216,10291.468799999648,16466.536799999754,16651.784799999692,16248.583599999702,828.6567000001761,813.8333000000458,759.782800000013,3913.549700000125,3896.7189000001617,3729.29980000016,436466.0,431260.0,,6424.623740002896,631921.0,625473.0,,16331.051199999798,154165.02179999062,154167.76789999017,154059.52669998715,77604.93639999624,77942.7271000066,78344.04680000653,52.5,39725926.24499999,12518097.885000004,4180409422.9650006,1373705790.1649995,47781489.05999997,696734.0099999999,82.0,11949.0,-13620411.5,5784342.5,-7049570.0,-7626536.0,-25.75,0.0,0.0,225000.0,0.0,0.0,0.0,0.0,0.0,-2472.0,-1377.0,-1374.0,-1374.0,150535548.89999974,2153961706.8150024,2431349201.385,34382166.929999985,2153961706.8150024,156521.0,-10713963.0,2479918773.0,107357494.0,546203293.0,243584486.0,569400525.0,155228.0,2433.0,431.71301468397394,3729639.0,1284358.0,788363.0,-2574632.0,900931.0,98692.0,1722601007.7750237,1735877014.5600097,-105805914.0,-104949525.5,1925133.5,85376.5,1655248365.4049895,4382860500.0,,222727698.49499968,,,94141211.7599998,,225253472.89500007,1588783688.6399968,1648905043.679987,1648964940.6149874,,18732.0,,,549239.0,-983865.0,454425.0,913.0,1467295.0,14775832.0,3232627.0,8554519.0,11607243.0,1415575.0,1058593165.294501,801646511.827495,72102829694.46713,21675329965.68762,582255218.0294988,5792665.7475,689.5,94245.0,-276906773.0,21986684.0,-123782414.0,-218691402.0,-2018270.0,5922185404.184961,18721192500.0,,447932229.0974976,,,309086175.77999866,,459114627.68999934,5707356120.495032,5885477203.2525,5885720385.9975,,80829.5,,,971511.0,-1698477.0,177364.0,6755.0,4272639.5,2479048.0,-9003078.0,921269.0,37582.5,3733189542.2699633,3657674520.1349616,-260614510.5,-257303858.5,2526429.0,269175.0,3925860545.587456,33252201096.52592,36681359683.59014,1729231212.7350495,48081658991.468216,3987815.0,-247574957.5,103080551139.5,1054008805.0,17271857760.5,3503518097.0,18885695750.5,3671896.0,71916.0,20868.935092662003,89787016.5,-162.01678364357642,3.4228571428571435,6.042817679558011,271.2645689850905,20.683701657458567,928.4998675546808,78750.0,-0.2225209339563146,-0.9749279121818236,0.0,0.0,0.0,0.0,0.0,0.0,1.0,0.0,0.0,0.0,0.0,0.0,0.0,1.0,0.0,1.0,0.0,0.0,0.0,1.0,0.0,0.0,0.0,0.0,0.0,1.0,0.0,0.0,0.0,0.0,0.0,0.0,0.0,0.0,0.0,0.0,1.0,0.0,0.0,0.0,0.0,0.0,0.0,0.0,0.0,0.0,0.0,0.0,0.0,0.0,0.0,0.0,1.0,0.0,0.0,0.0,0.0,0.0,0.0,0.0,0.0,0.0,0.0,0.0,0.0,0.0,0.0,0.0,0.0,0.0,0.0,0.0,0.0,0.0,0.0,0.0,0.0,0.0,0.0,0.0,0.0,0.0,0.0,0.0,0.0,0.0,0.0,0.0,0.0,0.0,0.0,0.0,0.0,0.0,0.0,0.0,0.0,0.0,0.0,0.0,0.0,0.0,0.0,0.0,0.0,0.0,0.0,0.0,1.0,0.0,1.0,0.0,0.0,0.0,0.0,0.0,0.0,1.0,0.0,0.0
102563,0,0.0,0.0,0.0,1.0,0.0,157500.0,495000.0,25272.0,495000.0,0.072508,44.30684931506849,-4289.0,-10328.0,-4518.0,,1.0,1.0,1.0,14.0,0.6988270100127333,0.5814907258604329,0.633031641417419,0.1113,0.0636,0.9752,,,0.12,0.1034,0.3333,,,,0.089,,0.0,0.1134,0.066,0.9752,,,0.1208,0.1034,0.3333,,,,0.092,,0.0,0.1124,0.0636,0.9752,,,0.12,0.1034,0.3333,,,,0.0906,,0.0,0.0695,1.0,0.0,0.0,0.0,0.0,-40.0,0.0,0.0,0.0,0.0,0.0,0.0,1.0,1.0,1.0,1.0,1.0,0.0,0.0,0.0,0.0,0.0,0.0,0.0,0.0,1.0,0.0,0.0,0.0,0.0,0.0,0.0,0.0,0.0,0.0,0.0,0.0,0.0,0.0,0.0,0.0,0.0,0.0,0.0,5.0,19750.5,0.0,483750.0,0.0,0.0,0.0,0.0,0.0,-908.0,542.0,-531.0,-628.5,172.0,-19.0,1.0,7494.57,68895.0,67464.0,6889.5,68895.0,10.0,-896.0,365243.0,-862.0,-742.0,-592.0,-734.0,17.0,0.0,0.1009137675856794,150.0,9.0,10.0,6.0,-28.0,0.0,0.0,5.0,7494.57,7494.57,-836.0,-802.0,3.0,1.0,0.0,,,,,,,,,,,,,,,,,,,,,8346345898.5,184392343179.0,165579281064.0,51968692657.935,1863.0,1705.0,71125.0,70810.0,9140.0,506027.0,17806.744100002295,17868.932799999107,17320.42539999805,11295.31090000009,11233.129200000092,11180.460000000056,128403.0,662777.0,,,,13527016.465753024,-601867455.0,-921852774.0,-296501901.0,-1535075996.0416667,44017.0,30704.0,11348.768799999183,11224.739999998978,10709.011099997297,22885.91200000969,22807.78840000965,22193.27730000821,67460.3194597189,158031.44849439786,126097.6490256449,34998.378200027924,34938.74140002836,34384.46710002877,,,,3714037.0,,,,,,,16466.625799999754,16651.87539999969,16248.675599999702,,,,3913.549700000125,3896.7189000001617,3729.29980000016,436466.0,431260.0,,6424.696248002895,631922.0,625474.0,,16331.120699999798,154165.99699999054,154168.74309999013,154060.50189998714,,,,30.0,39758382.49499999,12541416.885000004,4182855954.165001,1373705790.1649995,47781489.05999997,696734.0099999999,82.0,11949.0,-13625712.0,5789088.0,-7052434.0,-7629744.0,-14.5,19750.5,0.0,432000.0,0.0,0.0,0.0,0.0,0.0,-1285.0,542.0,-720.0,-724.0,150549148.52999967,2154092998.8150024,2431470044.385,34399676.429999985,2154092998.8150024,156548.0,-10717335.0,2480649259.0,107356632.0,546202551.0,243583894.0,569399791.0,155271.0,2433.0,432.2209362972373,3729830.0,1284547.0,788464.0,-2575553.0,900959.0,98692.0,1722684065.2650237,1735957925.2350097,-105831795.0,-104974876.0,1925226.0,85392.0,,,,,,,,,,,,,,,,,,,,,1467300.0,14776004.0,3232627.0,8554528.0,11607248.0,1415576.0,1058612915.794501,801646511.827495,72103313444.46713,21675329965.68762,582255218.0294988,5792665.7475,689.5,94245.0,-276907681.0,21987226.0,-123782945.0,-218692030.5,-2018289.0,,,,,,,,,,,,,,,,,,,,,4272649.5,2479054.0,-9003106.0,921269.0,37582.5,3733197036.8399634,3657682014.704962,-260615346.5,-257304660.5,2526432.0,269176.0,3925868040.157456,33252269991.52592,36681427147.59014,1729238102.2350495,48081727886.468216,3987825.0,-247575853.5,103080916382.5,1054007943.0,17271857018.5,3503517505.0,18885695016.5,3671913.0,71916.0,20869.03600642959,89787166.5,-96.80218896858769,3.1428571428571432,6.232193732193732,276.128868594622,19.586894586894587,867.8335870116691,157500.0,-0.2225209339563146,-0.9749279121818236,0.0,0.0,0.0,0.0,0.0,0.0,1.0,0.0,0.0,0.0,0.0,0.0,0.0,1.0,0.0,0.0,0.0,0.0,1.0,0.0,0.0,1.0,0.0,0.0,0.0,0.0,1.0,0.0,0.0,0.0,1.0,0.0,0.0,0.0,0.0,0.0,0.0,0.0,0.0,0.0,0.0,0.0,0.0,0.0,0.0,0.0,0.0,0.0,0.0,0.0,0.0,0.0,0.0,1.0,0.0,0.0,0.0,0.0,0.0,0.0,0.0,0.0,0.0,0.0,0.0,0.0,0.0,0.0,0.0,0.0,0.0,0.0,0.0,0.0,0.0,0.0,0.0,0.0,0.0,0.0,0.0,0.0,0.0,0.0,0.0,0.0,0.0,0.0,0.0,0.0,0.0,0.0,0.0,0.0,0.0,0.0,0.0,0.0,0.0,0.0,0.0,0.0,0.0,0.0,0.0,0.0,0.0,0.0,0.0,0.0,1.0,0.0,0.0,0.0,0.0,0.0,0.0,0.0,1.0,0.0
102568,0,0.0,1.0,1.0,1.0,0.0,112500.0,334152.0,17190.0,270000.0,0.020713,49.273972602739725,-2209.0,-9250.0,-1541.0,15.0,1.0,3.0,3.0,6.0,,0.5815120124234876,0.3392876999089139,0.0619,0.0629,0.9771,0.6872,0.0268,0.0,0.1379,0.1667,0.2083,0.0407,0.0504,0.0546,0.0,0.0,0.063,0.0653,0.9772,0.6994,0.0271,0.0,0.1379,0.1667,0.2083,0.0417,0.0551,0.0569,0.0,0.0,0.0625,0.0629,0.9771,0.6914,0.027,0.0,0.1379,0.1667,0.2083,0.0415,0.0513,0.0556,0.0,0.0,0.043,1.0,0.0,0.0,0.0,0.0,-626.0,0.0,0.0,0.0,0.0,2.0,3.0,1.0,1.0,0.0,1.0,0.0,1.0,0.0,0.0,0.0,0.0,0.0,0.0,0.0,1.0,0.0,0.0,0.0,0.0,0.0,0.0,0.0,0.0,0.0,0.0,0.0,0.0,0.0,0.0,0.0,0.0,0.0,0.0,4.0,0.0,6147.945,82122.75,0.0,0.0,0.0,0.0,0.0,-678.0,-275.5,-57.0,-421.0,101.0,-12.0,15.0,15561.72,0.0,0.0,0.0,270000.0,30.0,-626.0,365243.0,-292.0,365243.0,148.0,365243.0,5.0,0.0,0.0,-1.0,56.0,36.0,16.5,-19.5,0.0,0.0,63.0,15406.515,6821.775,-541.0,-542.0,10.0,1.0,40.0,0.0,0.0,,0.0,,,0.0,,0.0,0.0,0.0,0.0,,0.0,,,0.0,-12.5,0.0,0.0,8346363088.5,184392677331.0,165579551064.0,51968805157.935,1863.0,1705.0,71125.0,70812.0,9140.0,506030.0,17806.806000002296,17868.995299999107,17320.48839999805,11295.37380000009,11233.192100000091,11180.525300000056,128403.0,662778.0,4137.633300000119,4135.306800000015,3945.925400000095,13527065.739725629,-601869664.0,-921854315.0,-296502527.0,-1535085246.0416667,44017.0,30704.0,11348.768799999183,11224.739999998978,10709.011099997297,22886.049900009693,22807.926300009647,22193.415200008207,,158032.0300064103,126097.98831334485,34998.54490002793,34938.90810002836,34384.63380002877,22952.143999995908,22925.40059999549,22572.414699995723,3714043.0,8294.967700000165,8399.490500000076,8123.08490000023,9816.90790000072,9931.85850000216,10291.523899999647,16466.680399999754,16651.93099999969,16248.732499999702,828.6567000001761,813.8333000000458,759.782800000013,3913.549700000125,3896.7189000001617,3729.29980000016,436466.0,431260.0,1263107.0,6424.716961002896,631925.0,625477.0,,16331.163699999795,154166.97409999053,154169.72019999012,154061.47909998713,77605.62359999624,77943.41850000659,78344.74620000651,23.0,39883394.74499999,12630695.400000004,4195946005.7400007,1380591036.2249994,48349709.00999997,696734.0099999999,82.0,11949.0,-13664736.0,5868506.5,-7070055.0,-7651971.0,-11.0,0.0,6147.945,105745.5,0.0,0.0,0.0,0.0,0.0,-746.0,-421.0,-106.0,-421.0,150937939.14749968,2157807670.6950026,2436811319.385,34470500.30999999,2158370170.6950026,156978.0,-10751887.0,2488318881.0,108427179.0,548740142.0,245028220.0,571206546.0,155725.0,2441.0,433.5187033530371,3738728.0,1288516.0,790915.0,-2582815.5,900959.0,98692.0,1726047757.5300288,1739189971.1700149,-106051378.0,-105192266.0,1927353.0,85604.0,1655602642.6649897,4394943000.0,,222795938.6999997,,,94157190.62999982,,225289135.39500007,1589124189.5099962,1649253791.6099868,1649313688.544987,,18745.0,,,549267.0,-985162.5,454425.0,913.0,1467304.0,14776105.0,3232667.0,8554584.0,11607311.0,1415591.0,1058612915.794501,801652659.772495,72103395567.21713,21675329965.68762,582255218.0294988,5792665.7475,689.5,94245.0,-276908359.0,21986950.5,-123783002.0,-218692451.5,-2018301.0,5922185404.184961,18721192500.0,,447932229.0974976,,,309086175.77999866,,459114627.68999934,5707356120.495032,5885477203.2525,5885720385.9975,,80829.5,,,971511.0,-1698489.5,177364.0,6755.0,4272685.5,2479070.5,-9003125.5,921269.0,37582.5,3733212443.3549633,3657688836.479962,-260615887.5,-257305202.5,2526442.0,269177.0,3925883601.877456,33252269991.52592,36681427147.59014,1729238102.2350495,48081997886.468216,3987855.0,-247576479.5,103081281625.5,1054007651.0,17272222261.5,3503517653.0,18886060259.5,3671918.0,71916.0,20869.03600642959,89787165.5,-44.83097025298861,2.97024,6.544502617801047,322.47364268808724,19.43874345549738,957.824112457864,112500.0,-0.9009688679024191,-0.433883739117558,0.0,0.0,0.0,0.0,0.0,0.0,1.0,0.0,0.0,0.0,0.0,0.0,0.0,1.0,0.0,0.0,0.0,0.0,1.0,0.0,0.0,0.0,1.0,0.0,0.0,1.0,0.0,0.0,0.0,0.0,0.0,0.0,0.0,0.0,0.0,0.0,0.0,0.0,1.0,0.0,0.0,0.0,0.0,0.0,0.0,0.0,0.0,0.0,0.0,0.0,0.0,0.0,0.0,0.0,0.0,0.0,0.0,0.0,0.0,1.0,0.0,0.0,0.0,0.0,0.0,0.0,0.0,0.0,0.0,0.0,0.0,0.0,0.0,0.0,0.0,0.0,0.0,0.0,0.0,0.0,0.0,0.0,0.0,0.0,0.0,0.0,0.0,0.0,0.0,0.0,0.0,0.0,0.0,0.0,0.0,0.0,0.0,0.0,0.0,0.0,0.0,0.0,0.0,0.0,0.0,0.0,0.0,0.0,1.0,0.0,1.0,0.0,0.0,0.0,0.0,0.0,0.0,1.0,0.0,0.0
102582,0,0.0,1.0,1.0,0.0,0.0,90000.0,225000.0,14377.5,225000.0,0.030755,27.0,-1702.0,-4297.0,-2519.0,10.0,2.0,2.0,2.0,11.0,0.273220123224565,0.4292033979701184,,,,,,,,,,,,,,,,,,,,,,,,,,,,,,,,,,,,,,,,,,,,,,0.0,0.0,0.0,0.0,-1138.0,0.0,0.0,0.0,0.0,0.0,0.0,1.0,1.0,1.0,1.0,0.0,0.0,0.0,0.0,0.0,0.0,0.0,0.0,0.0,1.0,0.0,0.0,0.0,0.0,0.0,0.0,0.0,0.0,0.0,0.0,0.0,0.0,0.0,0.0,0.0,0.0,0.0,0.0,1.0,6259.5,,145215.0,,,0.0,0.0,0.0,-1206.0,,-1030.0,,40.0,-19.5,5.0,17210.34,26568.0,26014.5,1329.75,177808.5,12.0,-411.0,365243.0,-795.0,-465.0,-465.0,-457.0,11.0,0.0,0.0505063345317582,0.0,32.0,12.0,8.5,-17.5,0.0,0.0,31.0,17340.84,17340.84,-558.0,-525.0,5.0,1.0,0.0,,,,,,,,,,,,,,,,,,,,,8346377466.0,184392902331.0,165579776064.0,51968895157.935,1863.0,1705.0,71125.0,70812.0,9140.0,506030.0,,,,,,,128403.0,662780.0,,,,13527092.739725629,-601871366.0,-921856834.0,-296503665.0,-1535089543.0416667,44017.0,30704.0,,,,,,,67460.59267984213,158032.45920980824,,,,,,,,3714054.0,,,,,,,,,,,,,,,,436466.0,431260.0,1263117.0,6424.747716002896,631927.0,625479.0,,,,,,,,,40.0,39932664.38999999,,4202157079.575001,,,696734.0099999999,82.0,11949.0,-13712900.0,,-7100334.0,,-19.5,6259.5,,145215.0,,,0.0,0.0,0.0,-1206.0,,-1030.0,,151522071.61499983,2167638835.0950027,2447836734.2850003,34566354.80999999,2167638835.0950027,157770.0,-10788820.0,2501467375.0,109133251.0,552742123.0,246118384.0,575208711.0,156400.0,2454.0,435.2734925084951,3747394.0,1296031.0,796214.5,-2590286.0,901022.0,98755.0,1734871750.8750224,1748965043.3850086,-106276183.0,-105412220.0,1930261.0,86070.0,,,,,,,,,,,,,,,,,,,,,1467305.0,14776145.0,3232667.0,8554616.0,11607342.0,1415596.0,1058619175.294501,,72103540782.21713,,,5792665.7475,689.5,94245.0,-276909565.0,,-123784032.0,,-2018320.5,,,,,,,,,,,,,,,,,,,,,4272697.5,2479079.0,-9003143.0,921269.0,37582.5,3733229784.194964,3657706177.3199615,-260616445.5,-257305727.5,2526447.0,269178.0,3925900812.217456,33252296559.52592,36681453162.09014,1729239431.9850495,48082175694.968216,3987867.0,-247576890.5,103081646868.5,1054006856.0,17272221796.5,3503517188.0,18886059802.5,3671929.0,71916.0,20869.086512764123,89787165.5,-63.03703703703704,2.5,6.259780907668231,169.01408450704224,15.64945226917058,422.5352112676056,45000.0,-0.2225209339563146,-0.9749279121818236,0.0,0.0,0.0,0.0,0.0,0.0,1.0,0.0,0.0,0.0,0.0,0.0,0.0,1.0,0.0,1.0,0.0,0.0,0.0,0.0,1.0,0.0,0.0,0.0,0.0,1.0,0.0,0.0,0.0,0.0,0.0,0.0,0.0,0.0,0.0,0.0,0.0,0.0,1.0,0.0,0.0,0.0,0.0,0.0,0.0,0.0,0.0,0.0,0.0,0.0,0.0,0.0,0.0,0.0,0.0,0.0,0.0,0.0,0.0,0.0,0.0,0.0,0.0,0.0,0.0,0.0,0.0,0.0,0.0,0.0,0.0,0.0,0.0,0.0,0.0,0.0,0.0,0.0,0.0,0.0,0.0,0.0,0.0,0.0,0.0,0.0,0.0,0.0,0.0,0.0,1.0,0.0,0.0,0.0,0.0,0.0,0.0,0.0,0.0,0.0,0.0,0.0,0.0,0.0,0.0,0.0,0.0,0.0,0.0,0.0,0.0,0.0,0.0,0.0,0.0,0.0,0.0,0.0,0.0,0.0
102592,0,0.0,0.0,1.0,1.0,0.0,202500.0,260640.0,27369.0,225000.0,0.031329,29.74794520547945,-177.0,-6119.0,-3515.0,8.0,2.0,2.0,2.0,13.0,0.4381920573041631,0.5845103441468734,0.7324033228040929,0.0825,0.0326,0.9906,0.8708,0.0206,0.08,0.069,0.375,0.4167,0.0358,0.0672,0.0849,0.0,0.0,0.084,0.0339,0.9906,0.8759,0.0208,0.0806,0.069,0.375,0.4167,0.0366,0.0735,0.0885,0.0,0.0,0.0833,0.0326,0.9906,0.8725,0.0207,0.08,0.069,0.375,0.4167,0.0364,0.0684,0.0864,0.0,0.0,0.078,1.0,1.0,0.0,1.0,0.0,-856.0,0.0,0.0,0.0,0.0,0.0,3.0,1.0,1.0,0.0,1.0,0.0,0.0,0.0,0.0,0.0,0.0,0.0,0.0,0.0,1.0,0.0,0.0,0.0,0.0,0.0,0.0,0.0,0.0,0.0,0.0,0.0,0.0,0.0,0.0,0.0,0.0,0.0,0.0,2.0,41233.5,0.0,640067.85,59554.125,0.0,0.0,0.0,0.0,-1741.0,-1087.5,-16.5,-2281.0,115.0,-28.0,3.0,6979.86,45000.0,45000.0,0.0,75726.0,5.0,-499.0,182401.5,-611.5,-354.0,182344.5,-279.5,11.0,0.0,0.0,-1.0,11.0,10.0,5.0,-23.0,0.0,0.0,43.0,2250.0,2250.0,-333.0,-333.0,12.0,0.0,16.0,0.0,45000.0,0.0,5222.2725,0.0,6392.475,113.085,3144.87,597.69,0.0,0.0,0.0,0.0,1.0,0.0,1.5,5.5,-8.5,0.0,0.0,8346404835.0,184393162971.0,165580001064.0,51969097657.935,1863.0,1705.0,71125.0,70812.0,9140.0,506033.0,17806.888500002296,17869.07859999911,17320.572399998047,11295.40640000009,11233.224700000092,11180.559200000056,128403.0,662782.0,4137.653900000119,4135.327500000015,3945.946200000096,13527122.487670835,-601871543.0,-921860349.0,-296504521.0,-1535095662.0416667,44017.0,30704.0,11348.848799999185,11224.819999998976,10709.091699997296,22886.118900009693,22807.99530000965,22193.484200008206,67461.03087189942,158033.0437201524,126098.72071666762,34998.91990002793,34939.28310002836,34385.00880002877,22952.56069999592,22925.817299995488,22572.83139999572,3714067.0,8295.003500000164,8399.526900000077,8123.121500000229,9816.975100000718,9931.92690000216,10291.597399999648,16466.765299999755,16652.01739999969,16248.820999999702,828.6567000001761,813.8333000000458,759.782800000013,3913.549700000125,3896.7189000001617,3729.29980000016,436467.0,431261.0,1263125.0,6424.779045002895,631929.0,625481.0,,16331.241699999797,154167.96469999055,154170.7107999901,154062.46969998712,77606.49439999624,77944.29100000659,78345.62210000651,57.5,40050586.88999999,12752291.205000006,4229270743.2750006,1388172741.3449993,48503870.59499997,696734.0099999999,84.0,11949.0,-13760864.0,5907586.5,-7117129.5,-7706855.0,-28.25,41233.5,0.0,155135.7,0.0,0.0,0.0,0.0,0.0,-2462.0,-2250.0,-16.0,-2281.0,152126535.10499978,2178651221.145004,2460064183.7850003,34637391.359999985,2178704447.145004,158443.0,-10825136.0,2509318288.5,109108590.0,555281166.0,247567496.0,577748014.0,156889.0,2463.0,436.82467189345925,3750851.0,1301503.0,799516.0,-2600700.0,901076.0,98788.0,1742454860.8950207,1756316316.6900058,-106519249.0,-105654079.0,1934058.0,86337.0,1658752672.544989,4422460500.0,142063422.39,223731029.9249996,8496597.600000001,73009644.66000001,94567192.96499984,244617493.92750087,225905438.2275,1592084847.3749964,1652353819.604987,1652413716.5399866,7239.0,18903.0,119.0,11545.0,549718.5,-986915.0,454433.0,913.0,1467307.0,14776260.0,3232683.0,8554627.0,11607385.0,1415599.0,1058660408.794501,801652659.772495,72104180850.06712,21675389519.81262,582255218.0294988,5792665.7475,689.5,94245.0,-276911306.0,21985863.0,-123784048.5,-218694732.5,-2018348.5,5922185404.184961,18721237500.0,198779007.825,447937451.3699976,1948107.735,256749582.7800008,309086288.86499864,636518914.0424981,459115225.37999934,5707356120.495032,5885477203.2525,5885720385.9975,13380.0,80830.5,44.0,70344.0,971516.5,-1698498.0,177364.0,6755.0,4272707.5,2479084.0,-9003166.0,921269.0,37582.5,3733232034.194964,3657708427.3199615,-260616778.5,-257306060.5,2526459.0,269178.0,3925907792.077457,33252341559.52592,36681498162.09014,1729239431.9850495,48082251420.968216,3987872.0,-247577389.5,103081829270.0,1054006244.5,17272221442.5,3503699532.5,18886059523.0,3671940.0,71916.0,20869.086512764123,89787164.5,-5.949990790200772,1.2871111111111109,7.398881946728049,220.1015347330772,9.523183163433082,283.2951309275518,101250.0,-0.2225209339563146,-0.9749279121818236,0.0,1.0,0.0,0.0,0.0,0.0,0.0,0.0,0.0,0.0,0.0,0.0,0.0,1.0,0.0,1.0,0.0,0.0,0.0,0.0,1.0,0.0,0.0,0.0,0.0,1.0,0.0,0.0,0.0,0.0,0.0,0.0,0.0,0.0,0.0,0.0,0.0,0.0,0.0,0.0,0.0,0.0,0.0,0.0,0.0,1.0,0.0,0.0,0.0,0.0,0.0,0.0,0.0,1.0,0.0,0.0,0.0,0.0,0.0,0.0,0.0,0.0,0.0,0.0,0.0,0.0,0.0,0.0,0.0,0.0,0.0,0.0,0.0,0.0,0.0,0.0,0.0,0.0,0.0,0.0,0.0,0.0,0.0,0.0,0.0,0.0,0.0,0.0,0.0,0.0,0.0,0.0,0.0,0.0,0.0,0.0,0.0,0.0,0.0,0.0,0.0,0.0,0.0,0.0,0.0,0.0,0.0,0.0,1.0,0.0,1.0,0.0,0.0,0.0,1.0,0.0,0.0,0.0,0.0,0.0
102597,0,0.0,0.0,1.0,0.0,0.0,85500.0,149256.0,17842.5,135000.0,0.028663,29.156164383561645,-1486.0,-1013.0,-923.0,9.0,2.0,2.0,2.0,9.0,0.222690657347502,0.5654241736090353,0.190705947811054,0.1247,0.1203,0.9861,0.8096,0.0511,0.0,0.2069,0.1667,0.2083,0.1543,0.1009,0.0922,0.0039,0.0053,0.1271,0.1248,0.9861,0.8171,0.0515,0.0,0.2069,0.1667,0.2083,0.1578,0.1102,0.0961,0.0039,0.0056,0.126,0.1203,0.9861,0.8121,0.0514,0.0,0.2069,0.1667,0.2083,0.157,0.1026,0.0939,0.0039,0.0054,0.0737,1.0,0.0,0.0,0.0,0.0,-487.0,0.0,0.0,0.0,0.0,2.0,0.0,1.0,1.0,0.0,1.0,0.0,0.0,0.0,0.0,0.0,0.0,0.0,0.0,0.0,1.0,0.0,0.0,0.0,0.0,0.0,0.0,0.0,0.0,0.0,0.0,0.0,0.0,0.0,0.0,0.0,0.0,0.0,0.0,3.0,2625.0075,0.0,65268.0,0.0,0.0,0.0,0.0,0.0,-270.0,-27.0,-26.0,-122.0,25.0,-5.0,5.0,3012.12,24130.125,26519.625,0.0,24130.125,10.0,-289.0,365243.0,-141.0,-66.0,78.0,-61.5,17.0,0.0,0.0,50.0,24.0,12.0,6.0,-7.0,0.0,0.0,20.0,9979.515,9979.515,-230.5,-219.0,5.0,1.0,0.0,,,,,,,,,,,,,,,,,,,,,8346422677.5,184393312227.0,165580136064.0,51969183157.935,1863.0,1705.0,71125.0,70814.0,9140.0,506033.0,17807.013200002293,17869.20459999911,17320.69949999805,11295.526700000091,11233.345000000096,11180.684000000056,128403.0,662784.0,4137.705000000118,4135.378900000015,3945.997700000096,13527151.64383522,-601873029.0,-921861272.0,-296505008.0,-1535096675.0416667,44017.0,30704.0,11348.848799999185,11224.819999998976,10709.091699997296,22886.32580000969,22808.202200009648,22193.691100008207,67461.25356255678,158033.609144326,126098.91142261543,34999.08660002793,34939.449800028364,34385.175500028774,22952.768999995908,22926.02559999549,22573.039699995723,3714076.0,8295.157800000165,8399.683900000076,8123.279300000229,9817.076000000718,9932.02950000216,10291.707599999649,16466.857499999755,16652.11129999969,16248.917099999702,828.660600000176,813.837200000046,759.7867000000131,3913.555000000125,3896.7243000001617,3729.30540000016,436467.0,431261.0,1263134.0,6424.807708002895,631931.0,625483.0,,16331.315399999798,154168.95079999053,154171.69689999011,154063.45579998713,77607.30399999622,77945.10310000659,78346.43920000651,9.0,40092708.39749999,12754048.500000006,4236692683.0950007,1389651007.7249994,48648219.83999997,696734.0099999999,84.0,11949.0,-13794296.0,5910956.0,-7130929.0,-7723285.5,-4.0,0.0,0.0,65268.0,0.0,0.0,0.0,0.0,0.0,-404.0,-190.0,-186.0,-217.0,152298082.0799998,2180852064.270004,2462581205.9100003,34657384.859999985,2180852064.270004,158598.0,-10839334.0,2513335715.5,109648668.5,556188583.5,248294620.0,578655487.0,157098.0,2467.0,437.1439092851873,3757305.0,1302684.0,800309.0,-2602722.5,901076.0,98788.0,1744939681.5825214,1758749848.177505,-106583615.0,-105717690.0,1934791.0,86422.5,,,,,,,,,,,,,,,,,,,,,1467310.0,14776285.0,3232683.0,8554651.0,11607405.0,1415604.0,1058663033.802001,801652659.772495,72104246118.06712,21675389519.81262,582255218.0294988,5792665.7475,689.5,94245.0,-276911576.0,21985836.0,-123784074.5,-218694854.5,-2018353.5,,,,,,,,,,,,,,,,,,,,,4272719.5,2479090.0,-9003173.0,921269.0,37582.5,3733242013.7099633,3657718406.834962,-260617009.0,-257306279.5,2526464.0,269179.0,3925910804.197456,33252365689.65092,36681524681.71514,1729239431.9850495,48082275551.093216,3987882.0,-247577678.5,103082194513.0,1054006103.5,17272221376.5,3503699610.5,18886059461.5,3671957.0,71916.0,20869.086512764123,89787214.5,-50.96692351061829,1.7456842105263155,4.791929382093317,139.71428077873173,8.365195460277427,243.8970139404723,42750.0,-0.2225209339563143,0.9749279121818236,0.0,0.0,0.0,0.0,0.0,0.0,1.0,0.0,0.0,0.0,0.0,0.0,0.0,1.0,0.0,0.0,0.0,0.0,1.0,0.0,1.0,0.0,0.0,0.0,0.0,1.0,0.0,0.0,0.0,0.0,0.0,0.0,0.0,1.0,0.0,0.0,0.0,0.0,0.0,0.0,0.0,0.0,0.0,0.0,0.0,0.0,0.0,0.0,0.0,0.0,0.0,0.0,0.0,0.0,0.0,0.0,0.0,0.0,0.0,0.0,0.0,0.0,0.0,0.0,0.0,0.0,0.0,0.0,0.0,0.0,0.0,0.0,0.0,0.0,0.0,0.0,0.0,0.0,0.0,0.0,0.0,0.0,0.0,0.0,0.0,0.0,0.0,0.0,0.0,0.0,1.0,0.0,0.0,0.0,0.0,0.0,0.0,0.0,0.0,0.0,0.0,0.0,0.0,0.0,0.0,0.0,0.0,0.0,1.0,0.0,1.0,0.0,0.0,0.0,0.0,0.0,0.0,0.0,1.0,0.0
102605,0,0.0,1.0,1.0,0.0,2.0,157500.0,238500.0,12177.0,238500.0,0.006233,45.78356164383562,-866.0,-650.0,-258.0,8.0,4.0,2.0,2.0,12.0,,0.67185004255588,0.5424451438613613,,,,,,,,,,,,,,,,,,,,,,,,,,,,,,,,,,,,,,,,,,,,,1.0,0.0,1.0,0.0,-2741.0,0.0,0.0,0.0,0.0,0.0,4.0,1.0,1.0,0.0,1.0,1.0,0.0,0.0,0.0,0.0,0.0,1.0,1.0,0.0,1.0,0.0,0.0,0.0,0.0,0.0,0.0,0.0,0.0,0.0,0.0,0.0,0.0,0.0,0.0,0.0,0.0,0.0,0.0,13.0,0.0,346.5,270000.0,0.0,0.0,0.0,0.0,0.0,-1246.0,433.0,-601.0,-1121.0,604.0,-27.0,3.0,8305.065,0.0,0.0,0.0,54864.0,8.0,-543.0,365243.0,-2709.0,-2529.0,-2499.0,-2523.0,13.0,1.0,0.0,-1.0,8.0,7.0,3.5,-86.5,0.0,0.0,7.0,8305.065,8305.065,-2634.0,-2619.0,4.0,1.0,0.0,,,,,,,,,,,,,,,,,,,,,8346434854.5,184393550727.0,165580374564.0,51969340657.935,1863.0,1705.0,71125.0,70814.0,9140.0,506037.0,,,,,,,128405.0,662788.0,,,,13527197.427396862,-601873895.0,-921861530.0,-296507749.0,-1535097325.0416667,44017.0,30704.0,,,,,,,,158034.28099436854,126099.4538677593,,,,,,,3714088.0,,,,,,,,,,,,,,,,436468.0,431262.0,1263142.0,6424.813941002895,631933.0,625485.0,,,,,,,,,41.0,40200818.26499999,12754395.000000006,4253386520.3400006,1396122318.2249994,48648219.83999997,696734.0099999999,84.0,11949.0,-13835305.0,5904901.0,-7154769.0,-7744352.5,-20.0,0.0,346.5,270000.0,0.0,0.0,0.0,0.0,0.0,-2401.0,57.0,-1233.0,-1241.0,152741248.4699998,2189666446.605004,2472190708.4100003,34782330.194999985,2189666446.605004,159168.0,-10861432.0,2518630223.0,109817507.0,557823275.0,249018422.0,580290250.0,157548.0,2473.0,438.3032947418216,3765597.0,1304900.5,801683.0,-2606056.5,901076.0,98788.0,1747775979.1350243,1761520268.6550078,-106717095.0,-105849440.0,1938108.0,86568.0,,,,,,,,,,,,,,,,,,,,,1467323.0,14776889.0,3232683.0,8554659.0,11607412.0,1415607.0,1058663033.802001,801653006.272495,72104516118.06712,21675389519.81262,582255218.0294988,5792665.7475,689.5,94245.0,-276912822.0,21986269.0,-123784675.5,-218695975.5,-2018380.5,,,,,,,,,,,,,,,,,,,,,4272726.5,2479093.5,-9003259.5,921269.0,37582.5,3733250318.7749634,3657726711.899962,-260619643.0,-257308898.5,2526468.0,269180.0,3925919109.262456,33252365689.65092,36681524681.71514,1729239431.9850495,48082330415.093216,3987890.0,-247578221.5,103082559756.0,1054003394.5,17272218847.5,3503697111.5,18886056938.5,3671970.0,71917.0,20869.086512764123,89787213.5,-18.915085871581592,1.5142857142857142,12.93422025129342,592.1746701900394,19.58610495195861,896.7216434306309,39375.0,-0.2225209339563143,0.9749279121818236,0.0,0.0,0.0,0.0,0.0,0.0,1.0,0.0,0.0,0.0,0.0,0.0,0.0,1.0,0.0,0.0,0.0,0.0,1.0,0.0,1.0,0.0,0.0,0.0,0.0,1.0,0.0,0.0,0.0,0.0,0.0,0.0,0.0,0.0,0.0,0.0,0.0,0.0,0.0,0.0,0.0,0.0,0.0,0.0,0.0,0.0,1.0,0.0,0.0,0.0,0.0,0.0,0.0,0.0,0.0,0.0,0.0,0.0,0.0,0.0,0.0,0.0,0.0,0.0,0.0,0.0,0.0,0.0,0.0,0.0,0.0,0.0,0.0,0.0,0.0,0.0,0.0,0.0,0.0,0.0,0.0,0.0,0.0,0.0,0.0,0.0,0.0,0.0,0.0,0.0,0.0,0.0,0.0,0.0,0.0,0.0,0.0,0.0,0.0,0.0,1.0,0.0,0.0,0.0,0.0,0.0,0.0,0.0,0.0,0.0,0.0,0.0,0.0,0.0,0.0,0.0,0.0,0.0,0.0,0.0
102614,0,0.0,1.0,1.0,1.0,0.0,112500.0,225000.0,14508.0,225000.0,0.028663,37.00547945205479,-5860.0,-6827.0,-4926.0,10.0,1.0,2.0,2.0,9.0,,0.6671032334378726,0.6313545365850379,0.0165,0.0148,0.9826,0.762,0.002,0.0,0.0803,0.0417,0.0417,0.0158,0.0134,0.0133,0.0,0.0051,0.0084,0.0,0.9801,0.7387,0.0015,0.0,0.1034,0.0417,0.0417,0.0082,0.0073,0.0077,0.0,0.0039,0.0187,0.0,0.9811,0.7451,0.0022,0.0,0.1034,0.0417,0.0417,0.0109,0.0154,0.0153,0.0,0.0057,0.0066,1.0,0.0,0.0,0.0,0.0,-1630.0,0.0,0.0,0.0,0.0,0.0,3.0,1.0,1.0,0.0,1.0,1.0,0.0,0.0,0.0,0.0,0.0,0.0,0.0,0.0,1.0,0.0,0.0,0.0,0.0,0.0,0.0,0.0,0.0,0.0,0.0,0.0,0.0,0.0,0.0,0.0,0.0,0.0,0.0,5.0,0.0,0.0,73980.0,58788.0,0.0,0.0,0.0,0.0,-871.0,-445.5,-112.0,-779.0,218.0,-23.5,3.0,3375.0,29740.5,26491.5,9000.0,32854.5,6.0,-2552.0,365243.0,-1599.0,-1449.0,-1449.0,-1444.0,15.0,0.0,0.2715555060275722,50.0,16.0,7.0,3.5,-65.5,0.0,0.0,15.0,5410.17,2881.485,-2316.0,-2311.0,4.0,1.0,91.0,0.0,0.0,,0.0,,,0.0,,0.0,0.0,0.0,0.0,,0.0,,,0.0,-49.0,0.0,0.0,8346449362.5,184393775727.0,165580599564.0,51969453157.935,1863.0,1705.0,71125.0,70814.0,9140.0,506040.0,17807.0297000023,17869.22329999911,17320.707899998048,11295.541500000092,11233.345000000096,11180.684000000056,128405.0,662789.0,4137.707000000119,4135.381100000015,3945.9992000000952,13527234.432876311,-601879755.0,-921866456.0,-296509379.0,-1535104152.0416667,44017.0,30704.0,11348.848799999185,11224.819999998976,10709.091699997296,22886.40610000969,22808.305600009648,22193.794500008207,,158034.948097602,126100.08522229588,34999.12830002793,34939.491500028365,34385.217200028776,22952.81069999592,22926.067299995488,22573.08139999572,3714097.0,8295.173600000164,8399.694800000076,8123.28750000023,9817.089400000716,9932.04490000216,10291.714899999646,16466.87079999975,16652.12659999969,16248.924799999702,828.660600000176,813.837200000046,759.7867000000131,3913.560100000125,3896.730000000162,3729.30930000016,436468.0,431262.0,1263152.0,6424.842604002895,631935.0,625487.0,,16331.321999999798,154169.93339999055,154172.67799999012,154064.43589998712,77608.06599999624,77945.84820000659,78347.17790000651,29.0,40340191.00499998,12779829.765000004,4267038924.0900006,1403874574.6949997,48861915.65999997,696734.0099999999,84.0,11949.0,-13883421.0,5934356.0,-7177373.0,-7771191.0,-14.0,0.0,0.0,73980.0,0.0,0.0,0.0,0.0,0.0,-1938.0,-779.0,-773.0,-779.0,152983875.05999982,2192401141.605004,2475385424.9100003,34889475.194999985,2192419125.855004,159462.0,-10892160.0,2523741156.0,110164970.0,559637081.0,249738013.0,582470178.0,157861.0,2474.0,439.54864095635895,3767093.0,1307215.0,803006.0,-2612018.0,901076.0,98788.0,1749973990.8600175,1763703917.4600012,-107227635.0,-106365915.0,1955409.0,86710.0,1674444756.05999,4465615500.0,,225935110.3049996,,,95490140.71499974,,227641716.765,1607253213.5999966,1667966075.0549874,1668025971.989988,,19102.0,,,555939.0,-998062.0,462475.0,915.0,1467328.0,14777107.0,3232774.0,8554675.0,11607427.0,1415610.0,1058663033.802001,801653006.272495,72104590098.06712,21675448307.81262,582255218.0294988,5792665.7475,689.5,94245.0,-276913693.0,21985823.5,-123784787.5,-218696754.5,-2018404.0,5922185404.184961,18721237500.0,,447937451.3699976,,,309086288.86499864,,459115225.37999934,5707356120.495032,5885477203.2525,5885720385.9975,,80830.5,,,971516.5,-1698547.0,177364.0,6755.0,4272733.5,2479097.0,-9003325.0,921269.0,37582.5,3733255728.944964,3657729593.3849616,-260621959.0,-257311209.5,2526472.0,269181.0,3925922484.262456,33252395430.15092,36681551173.21514,1729248431.9850495,48082363269.593216,3987896.0,-247580773.5,103082924999.0,1054001795.5,17272217398.5,3503695662.5,18886055494.5,3671985.0,71917.0,20869.35806827015,89787263.5,-158.3549270748501,2.0,7.754342431761787,286.9531595227574,15.508684863523571,573.9063190455148,112500.0,-0.2225209339563143,0.9749279121818236,0.0,0.0,0.0,0.0,0.0,0.0,1.0,0.0,0.0,0.0,0.0,0.0,0.0,1.0,0.0,0.0,0.0,0.0,1.0,0.0,0.0,0.0,1.0,0.0,0.0,1.0,0.0,0.0,0.0,0.0,0.0,0.0,0.0,0.0,0.0,0.0,0.0,0.0,1.0,0.0,0.0,0.0,0.0,0.0,0.0,0.0,0.0,0.0,0.0,0.0,0.0,0.0,0.0,0.0,0.0,0.0,0.0,0.0,0.0,0.0,0.0,0.0,0.0,0.0,0.0,0.0,0.0,0.0,0.0,0.0,0.0,0.0,0.0,0.0,1.0,0.0,0.0,0.0,0.0,0.0,0.0,0.0,0.0,0.0,0.0,0.0,0.0,0.0,0.0,0.0,0.0,0.0,0.0,0.0,0.0,0.0,0.0,0.0,0.0,0.0,0.0,0.0,0.0,0.0,0.0,0.0,0.0,0.0,1.0,0.0,1.0,0.0,0.0,0.0,0.0,0.0,0.0,0.0,1.0,0.0
102617,0,0.0,0.0,1.0,0.0,1.0,180000.0,90000.0,7110.0,90000.0,0.035792,37.65753424657535,-2259.0,-5333.0,-2302.0,14.0,3.0,2.0,2.0,11.0,,0.6641489642998615,0.2009260877159708,,,,,,,,,,,,,,,,,,,,,,,,,,,,,,,,,,,,,,,,,,,,,2.0,0.0,2.0,0.0,-1049.0,0.0,0.0,0.0,0.0,1.0,6.0,1.0,1.0,1.0,1.0,0.0,0.0,0.0,0.0,0.0,0.0,0.0,0.0,0.0,1.0,0.0,0.0,0.0,0.0,0.0,0.0,0.0,0.0,0.0,0.0,0.0,0.0,0.0,0.0,0.0,0.0,0.0,0.0,24.0,0.0,0.0,66894.75,0.0,0.0,0.0,0.0,0.0,-718.0,-269.0,-270.5,-645.5,629.0,-13.0,25.0,3225.24,45000.0,48370.5,0.0,57074.625,12.0,-411.0,365243.0,-534.0,-450.0,-150.0,-442.0,15.0,0.0,0.0,30.0,69.0,24.0,11.0,-29.0,0.0,0.0,92.0,3039.84,2893.3875,-572.0,-557.0,6.0,1.0,9.0,447372.405,450000.0,0.0,18851.085,0.0,12791.385,22848.795,23309.0775,23248.665,437740.47,447372.405,447372.405,0.0,6.0,0.0,6.0,4.0,-6.0,0.0,0.0,8346456472.5,184393865727.0,165580689564.0,51969633157.935,1863.0,1705.0,71125.0,70815.0,9140.0,506046.0,,,,,,,128406.0,662792.0,,,,13527272.09041056,-601882014.0,-921868758.0,-296510428.0,-1535109485.0416667,44017.0,30704.0,,,,,,,,158035.6122465663,126100.2861483836,,,,,,,3714108.0,,,,,,,,,,,,,,,,436470.0,431264.0,1263166.0,6424.878396002896,631937.0,625489.0,,,,,,,,,24.0,40365193.00499998,12779829.765000004,4275243224.8200006,1405499340.1949997,49491915.65999997,696734.0099999999,84.0,11949.0,-13920507.0,6011249.0,-7200844.5,-7795279.5,-11.5,0.0,0.0,66289.5,0.0,0.0,0.0,0.0,0.0,-948.0,-574.0,-573.0,-924.0,153229187.51999986,2196313437.105004,2479699705.4100003,34924912.694999985,2194958127.105004,159644.0,-10916118.0,2527755777.0,110150204.0,560720959.0,250460195.0,583920513.0,158274.0,2478.0,440.2572861304269,3774993.0,1308430.0,803655.0,-2616432.0,901080.0,98788.0,1751590944.5175178,1765311589.0125017,-107474926.5,-106611273.0,1961106.5,86787.5,1680765292.34999,4480015500.0,143909322.39,226581239.6549996,8934042.600000001,73576509.39000005,95846667.11999972,246922490.7900002,228076478.37,1613355232.7699964,1674284386.4099874,1674344283.3449874,7354.0,19152.0,121.0,11677.0,558697.0,-1004708.0,462478.0,917.0,1467352.0,14777736.0,3232783.0,8554744.0,11607519.0,1415635.0,1058663033.802001,801653006.272495,72104656992.81712,21675448307.81262,582255218.0294988,5792665.7475,689.5,94245.0,-276914411.0,21985554.5,-123785058.0,-218697400.0,-2018417.0,5922632776.589962,18721687500.0,198779007.825,447956302.4549976,1948107.735,256762374.1650008,309109137.65999866,636542223.1199981,459138474.0449993,5707793860.965033,5885924575.657499,5886167758.4025,13380.0,80836.5,44.0,70350.0,971520.5,-1698553.0,177364.0,6755.0,4272757.5,2479108.0,-9003354.0,921269.0,37582.5,3733258768.784964,3657732486.772462,-260622531.0,-257311766.5,2526478.0,269182.0,3925925709.502456,33252440430.15092,36681599543.71514,1729248431.9850495,48082420344.218216,3987908.0,-247581184.5,103083290242.0,1054001261.5,17272216948.5,3503695512.5,18886055052.5,3672000.0,71917.0,20869.35806827015,89787293.5,-59.98799563477628,0.5,25.31645569620253,953.3552973816544,12.658227848101266,476.6776486908272,60000.0,0.6234898018587334,-0.7818314824680299,0.0,0.0,0.0,0.0,0.0,0.0,1.0,0.0,1.0,0.0,0.0,0.0,0.0,0.0,0.0,0.0,0.0,0.0,1.0,0.0,1.0,0.0,0.0,0.0,0.0,1.0,0.0,0.0,0.0,0.0,0.0,0.0,0.0,0.0,0.0,0.0,0.0,0.0,0.0,0.0,0.0,0.0,0.0,0.0,1.0,0.0,0.0,0.0,0.0,0.0,0.0,0.0,0.0,0.0,0.0,0.0,0.0,0.0,0.0,0.0,0.0,0.0,0.0,0.0,0.0,0.0,0.0,0.0,0.0,0.0,0.0,0.0,0.0,0.0,0.0,0.0,0.0,0.0,0.0,0.0,0.0,0.0,0.0,0.0,0.0,0.0,0.0,0.0,0.0,0.0,1.0,0.0,0.0,0.0,0.0,0.0,0.0,0.0,0.0,0.0,0.0,0.0,0.0,0.0,0.0,0.0,0.0,0.0,0.0,0.0,0.0,0.0,0.0,0.0,0.0,0.0,0.0,0.0,0.0,0.0
102634,0,0.0,0.0,1.0,1.0,1.0,211500.0,341280.0,21937.5,270000.0,0.006207,39.18082191780822,-1327.0,-396.0,-556.0,4.0,2.0,2.0,2.0,12.0,0.3697427316412749,0.4055661913834919,0.3123653692278984,0.1644,,0.999,0.9796,0.0247,0.12,0.1034,0.375,0.2292,0.0,0.1332,0.129,0.0039,0.0053,0.1492,,0.999,0.9804,0.0,0.1208,0.1034,0.375,0.0417,0.0,0.1286,0.1324,0.0,0.0,0.166,,0.999,0.9799,0.0248,0.12,0.1034,0.375,0.2292,0.0,0.1355,0.1313,0.0039,0.0055,0.1029,1.0,0.0,0.0,0.0,0.0,-156.0,0.0,0.0,0.0,0.0,0.0,4.0,1.0,1.0,0.0,1.0,0.0,1.0,0.0,0.0,0.0,0.0,0.0,0.0,0.0,1.0,0.0,0.0,0.0,0.0,0.0,0.0,0.0,0.0,0.0,0.0,0.0,0.0,0.0,0.0,0.0,0.0,0.0,0.0,9.0,0.0,0.0,180000.0,0.0,0.0,0.0,0.0,0.0,-1512.0,-764.0,-732.0,-1065.0,467.0,-27.0,11.0,12708.134999999998,23121.0,47182.5,5017.5,58455.0,9.0,-1016.0,365243.0,-1338.5,-1125.5,-788.0,-968.5,11.0,0.0,0.2073462487405116,-1.0,62.0,12.0,6.0,-41.5,0.0,0.0,93.0,9545.04,9545.04,-1148.0,-1148.0,6.0,1.0,45.0,0.0,450000.0,0.0,0.0,0.0,0.0,0.0,0.0,0.0,0.0,0.0,0.0,0.0,0.0,0.0,0.0,12.0,-23.0,0.0,0.0,8346478410.0,184394207007.0,165580959564.0,51969844657.935,1863.0,1705.0,71125.0,70815.0,9140.0,506050.0,17807.1941000023,17869.389299999108,17320.857099998047,,,,128407.0,662794.0,4137.731700000119,4135.405900000015,3945.9992000000952,13527311.271232478,-601883341.0,-921869314.0,-296510584.0,-1535109881.0416667,44017.0,30704.0,11348.968799999184,11224.939999998976,10709.212499997297,22886.50950000969,22808.409000009648,22193.897900008207,67461.62330528843,158036.0178127577,126100.59851375283,34999.50330002793,34939.866500028365,34385.592200028776,22953.03989999592,22926.296499995493,22573.12309999573,3714120.0,8295.173600000164,8399.694800000076,8123.28750000023,9817.222600000718,9932.18040000216,10291.843499999646,16466.999799999754,16652.25789999969,16249.057199999705,828.6645000001762,813.8411000000459,759.7867000000131,3913.565400000125,3896.7355000001626,3729.30930000016,436470.0,431264.0,1263170.0,6424.884603002895,631939.0,625491.0,,16331.424899999798,154170.93239999056,154173.67699999013,154065.43489998713,77609.04559999624,77946.82810000659,78348.15830000651,50.0,41104490.35499998,13996706.850000003,4303996599.690001,1410560713.4849994,49840526.92499997,696734.0099999999,84.0,11949.0,-14038102.0,6050203.0,-7260464.0,-7857783.0,-24.5,0.0,0.0,180000.0,0.0,0.0,0.0,0.0,0.0,-1809.0,-963.0,-882.0,-1328.0,154357909.82999986,2210803898.355004,2495916209.1600003,35433786.194999985,2210803898.355004,160941.0,-11016162.0,2548752658.5,111547233.0,565422041.0,253342148.0,589353793.5,159803.0,2497.5,445.8552334508978,3798664.0,1318687.0,808636.0,-2644022.0,901309.0,98810.0,1758421894.7250123,1771884973.0349965,-108262957.0,-107393288.0,1971577.0,87397.0,1690451914.63499,4511380500.0,144305772.39,227201412.1499996,8934042.600000001,73780841.61000004,96451056.94499968,248011304.7600002,229068871.02,1622679037.4249964,1683956665.6199868,1684016562.554987,7373.0,19244.0,121.0,11750.0,562472.0,-1009767.0,462506.0,917.0,1467361.0,14778203.0,3232828.0,8554806.0,11607612.0,1415646.0,1058663033.802001,801653006.272495,72104836992.81712,21675448307.81262,582255218.0294988,5792665.7475,689.5,94245.0,-276915923.0,21984790.5,-123785790.0,-218698465.0,-2018444.0,5922632776.589962,18722137500.0,198779007.825,447956302.4549976,1948107.735,256762374.1650008,309109137.65999866,636542223.1199981,459138474.0449993,5707793860.965033,5885924575.657499,5886167758.4025,13380.0,80836.5,44.0,70350.0,971532.5,-1698576.0,177364.0,6755.0,4272769.5,2479114.0,-9003395.5,921269.0,37582.5,3733268313.824964,3657742031.812462,-260623679.0,-257312914.5,2526484.0,269183.0,3925938417.637456,33252463551.15092,36681646726.21514,1729253449.4850495,48082478799.218216,3987917.0,-247582200.5,103083655485.0,1053999923.0,17272215823.0,3503694724.5,18886054084.0,3672011.0,71917.0,20869.565414518893,89787292.5,-33.86861058667226,1.6136170212765957,9.64102564102564,377.7433087460485,15.556923076923075,609.5330326659641,105750.0,-0.2225209339563146,-0.9749279121818236,0.0,0.0,0.0,0.0,0.0,0.0,1.0,0.0,0.0,0.0,0.0,0.0,0.0,1.0,0.0,1.0,0.0,0.0,0.0,0.0,0.0,1.0,0.0,0.0,0.0,1.0,0.0,0.0,0.0,0.0,0.0,0.0,0.0,1.0,0.0,0.0,0.0,0.0,0.0,0.0,0.0,0.0,0.0,0.0,0.0,0.0,0.0,0.0,0.0,0.0,0.0,0.0,0.0,0.0,0.0,0.0,0.0,0.0,0.0,0.0,0.0,0.0,0.0,0.0,0.0,0.0,0.0,0.0,0.0,0.0,0.0,0.0,0.0,0.0,0.0,0.0,0.0,0.0,1.0,0.0,0.0,0.0,0.0,0.0,0.0,0.0,0.0,0.0,0.0,0.0,0.0,0.0,0.0,0.0,0.0,0.0,0.0,0.0,0.0,0.0,0.0,0.0,0.0,0.0,0.0,0.0,0.0,1.0,0.0,0.0,1.0,0.0,0.0,0.0,0.0,0.0,0.0,1.0,0.0,0.0
102652,0,0.0,0.0,0.0,1.0,0.0,202500.0,360000.0,28570.5,360000.0,0.022625,44.94794520547945,-3585.0,-2268.0,-4356.0,,2.0,2.0,2.0,14.0,0.7503379607078764,0.7298467949404077,0.4848514754962666,0.1278,0.0492,0.9851,0.7959999999999999,0.0559,0.08,0.0345,0.625,0.6667,0.0791,0.1042,0.1241,0.0154,0.0148,0.1303,0.0511,0.9851,0.804,0.0564,0.0806,0.0345,0.625,0.6667,0.0809,0.1139,0.1293,0.0156,0.0157,0.1291,0.0492,0.9851,0.7987,0.0562,0.08,0.0345,0.625,0.6667,0.0804,0.106,0.1263,0.0155,0.0151,0.0976,1.0,0.0,0.0,0.0,0.0,-851.0,0.0,0.0,0.0,0.0,1.0,2.0,1.0,1.0,0.0,1.0,0.0,0.0,0.0,0.0,0.0,0.0,0.0,0.0,0.0,1.0,0.0,0.0,0.0,0.0,0.0,0.0,0.0,0.0,0.0,0.0,0.0,0.0,0.0,0.0,0.0,0.0,0.0,0.0,12.0,0.0,0.0,50949.0,0.0,0.0,0.0,0.0,0.0,-1940.5,-1683.0,-863.5,-1707.5,774.0,-33.0,16.0,11250.0,339750.0,268449.75,0.0,450000.0,0.0,-851.0,365243.0,-1848.5,181348.5,-1158.5,181353.5,11.0,1.0,0.0,0.0,41.0,36.0,16.0,-21.0,0.0,0.0,52.0,14225.22,13925.88,-717.0,-716.0,9.0,1.0,0.0,,,,,,,,,,,,,,,,,,,,,8346506980.5,184394567007.0,165581319564.0,51970047157.935,1863.0,1705.0,71125.0,70816.0,9140.0,506052.0,17807.3219000023,17869.51839999911,17320.98739999805,11295.590700000092,11233.394200000092,11180.735100000056,128407.0,662796.0,4137.787600000119,4135.462100000015,3946.055600000095,13527356.219177686,-601886926.0,-921873670.0,-296511435.0,-1535112149.0416667,44017.0,30704.0,11349.048799999184,11225.019999998976,10709.293099997296,22886.544000009693,22808.443500009653,22193.93240000821,67462.37364324913,158036.74765955267,126101.08336522832,35000.12830002793,34940.491500028365,34386.217200028776,22953.70659999592,22926.96319999549,22573.789799995728,3714134.0,8295.252700000165,8399.775200000076,8123.368400000229,9817.326800000716,9932.28640000216,10291.957399999646,16467.123899999755,16652.38419999969,16249.186499999703,828.6799000001762,813.8566000000459,759.802300000013,3913.580200000125,3896.750600000162,3729.32500000016,436470.0,431264.0,,6424.907228002896,631941.0,625493.0,,16331.522499999795,154171.91749999055,154174.66209999012,154066.41999998712,77609.84159999625,77947.62680000659,78348.96230000652,64.0,41586473.15999998,14063329.890000004,4343228845.560002,1423650914.2349994,50008223.92499997,696734.0099999999,85.0,11949.0,-14187841.0,6088791.0,-7335508.0,-7955626.0,-32.0,0.0,0.0,40882.5,0.0,0.0,0.0,0.0,0.0,-1967.0,-1683.0,-887.0,-1732.0,156324153.14999968,2240039609.6400027,2527121392.3350005,35665268.80499999,2240039609.6400027,162421.0,-11128028.5,2568473214.5,111840988.0,567560328.0,254024566.0,591858965.0,161276.5,2528.5,448.5320569854808,3807854.0,1329585.0,814748.0,-2669713.0,901341.0,98828.0,1776423998.8350196,1789205235.7050009,-109086821.0,-108210443.5,1979159.0,88112.5,,,,,,,,,,,,,,,,,,,,,1467373.0,14778977.0,3232828.0,8554847.0,11607664.0,1415662.0,1058663033.802001,801653006.272495,72104887941.81712,21675448307.81262,582255218.0294988,5792665.7475,689.5,94245.0,-276917863.5,21983107.5,-123786653.5,-218700172.5,-2018477.0,,,,,,,,,,,,,,,,,,,,,4272805.5,2479130.0,-9003416.5,921269.0,37582.5,3733282539.0449634,3657755957.6924615,-260624396.0,-257313630.5,2526493.0,269184.0,3925949667.637456,33252803301.15092,36681915175.96514,1729253449.4850495,48082928799.218216,3987917.0,-247583051.5,103084020728.0,1053998074.5,17272397171.5,3503693566.0,18886235437.5,3672022.0,71918.0,20869.565414518893,89787292.5,-79.75892965988054,1.7777777777777777,7.0877303512364165,318.578915458588,12.600409513309186,566.3625163708232,101250.0,0.6234898018587336,0.7818314824680298,0.0,0.0,0.0,0.0,0.0,0.0,1.0,0.0,0.0,0.0,0.0,0.0,0.0,1.0,0.0,0.0,0.0,0.0,1.0,0.0,1.0,0.0,0.0,0.0,0.0,1.0,0.0,0.0,0.0,0.0,0.0,0.0,0.0,0.0,0.0,0.0,0.0,0.0,0.0,0.0,0.0,0.0,0.0,1.0,0.0,0.0,0.0,0.0,0.0,0.0,0.0,0.0,0.0,0.0,0.0,0.0,0.0,0.0,0.0,0.0,0.0,0.0,0.0,0.0,0.0,0.0,0.0,0.0,0.0,0.0,0.0,0.0,0.0,0.0,0.0,0.0,0.0,0.0,0.0,0.0,0.0,0.0,0.0,0.0,0.0,0.0,0.0,0.0,0.0,0.0,1.0,0.0,0.0,0.0,0.0,0.0,0.0,0.0,0.0,0.0,0.0,0.0,0.0,0.0,0.0,0.0,0.0,0.0,1.0,0.0,1.0,0.0,0.0,0.0,0.0,0.0,0.0,1.0,0.0,0.0
102655,0,0.0,0.0,1.0,0.0,0.0,315000.0,1451047.5,59881.5,1354500.0,0.072508,33.51506849315069,-3354.0,-2249.0,-4602.0,4.0,2.0,1.0,1.0,14.0,0.8080153434711459,0.7005076018901577,0.5100895276257282,0.243,0.0783,0.9965,0.9524,0.1159,0.3,0.1207,0.6771,0.7188,0.0,0.1879,0.2226,0.0473,0.0409,0.1712,0.0519,0.9965,0.9543,0.1014,0.3222,0.1379,0.5417,0.5833,0.0,0.1423,0.1763,0.0311,0.031,0.2306,0.0819999999999999,0.9965,0.953,0.1102,0.32,0.1379,0.6042,0.6458,0.0,0.1791,0.2106,0.0466,0.0401,0.1765,1.0,0.0,0.0,0.0,0.0,-638.0,0.0,0.0,0.0,0.0,0.0,0.0,1.0,1.0,1.0,1.0,1.0,0.0,0.0,0.0,0.0,0.0,0.0,0.0,0.0,0.0,0.0,0.0,0.0,0.0,1.0,0.0,0.0,0.0,0.0,0.0,0.0,0.0,0.0,0.0,0.0,0.0,0.0,0.0,15.0,4666.815,0.0,122845.5,0.0,0.0,0.0,0.0,0.0,-930.0,-688.5,-686.0,-965.0,589.0,-21.0,2.0,10179.45,207000.0,224761.5,0.0,207000.0,24.0,-637.5,365243.0,-606.0,365243.0,84.0,365243.0,13.5,0.0,0.0,85.0,20.0,24.0,14.5,-11.5,0.0,0.0,20.0,10983.87,10983.87,-322.0,-321.0,10.5,1.0,0.0,,,,,,,,,,,,,,,,,,,,,8346566862.0,184396018054.5,165582674064.0,51970362157.935,1863.0,1705.0,71125.0,70816.0,9140.0,506052.0,17807.564900002293,17869.74899999911,17321.15859999805,11295.66900000009,11233.476200000096,11180.787000000057,128407.0,662798.0,4137.903500000119,4135.572300000015,3946.157000000095,13527389.734246178,-601890280.0,-921878272.0,-296512073.0,-1535114398.0416667,44017.0,30704.0,11349.348799999185,11225.339999998978,10709.615299997296,22886.664700009693,22808.58140000965,22194.07030000821,67463.1816585926,158037.44816715454,126101.59345475596,35000.80540002793,34941.09570002837,34386.75890002878,22954.42539999592,22927.608999995493,22574.37309999573,3714148.0,8295.252700000165,8399.775200000076,8123.368400000229,9817.514700000718,9932.46550000216,10292.099699999646,16467.346499999756,16652.59479999969,16249.362799999702,828.7272000001761,813.9032000000459,759.8334000000132,3913.621100000125,3896.790700000163,3729.35600000016,436470.0,431264.0,1263174.0,6424.979736002895,631942.0,625494.0,,16331.698999999797,154172.91399999056,154175.65859999013,154067.41649998713,77610.79399999624,77948.57980000657,78349.91660000653,31.0,41692122.13499998,14063329.890000004,4353352415.910003,1425977934.5249994,50447513.96999997,696734.0099999999,85.0,11949.0,-14216297.0,6110057.0,-7348543.0,-7971795.5,-15.0,0.0,0.0,137737.35,0.0,0.0,0.0,0.0,0.0,-1674.0,-1122.0,-908.0,-1493.0,156587891.35499972,2245664159.010002,2533087289.8350005,35704476.675,2245664159.010002,162744.0,-11143911.5,2570847294.0,111833049.0,568285184.0,254019822.0,592583848.0,161541.0,2530.0,448.9915333648523,3817035.5,1331921.0,816267.0,-2672749.5,901550.0,98828.0,1777551023.1600204,1790510077.35,-109197623.0,-108320649.0,1980077.5,88271.5,,,,,,,,,,,,,,,,,,,,,1467388.0,14779566.0,3232828.0,8554867.0,11607684.0,1415664.0,1058667700.6170008,801653006.272495,72105010787.31712,21675448307.81262,582255218.0294988,5792665.7475,689.5,94245.0,-276918793.5,21982419.0,-123787339.5,-218701137.5,-2018498.0,,,,,,,,,,,,,,,,,,,,,4272829.5,2479144.5,-9003428.0,921269.0,37582.5,3733293522.9149632,3657766941.562462,-260624718.0,-257313951.5,2526503.5,269185.0,3925959847.087456,33253010301.15092,36682139937.46514,1729253449.4850495,48083135799.218216,3987941.0,-247583689.0,103084385971.0,1053997468.5,17272762414.5,3503693650.0,18886600680.5,3672035.5,71918.0,20869.565414518893,89787377.5,-100.07438894792772,4.6065,5.260389268805892,176.3023066446643,24.23198316675434,812.1365755586462,157500.0,-0.2225209339563143,0.9749279121818236,0.0,1.0,0.0,0.0,0.0,0.0,0.0,0.0,1.0,0.0,0.0,0.0,0.0,0.0,0.0,0.0,0.0,0.0,1.0,0.0,1.0,0.0,0.0,0.0,0.0,1.0,0.0,0.0,0.0,0.0,0.0,0.0,0.0,0.0,0.0,0.0,0.0,0.0,1.0,0.0,0.0,0.0,0.0,0.0,0.0,0.0,0.0,0.0,0.0,0.0,0.0,0.0,1.0,0.0,0.0,0.0,0.0,0.0,0.0,0.0,0.0,0.0,0.0,0.0,0.0,0.0,0.0,0.0,0.0,0.0,0.0,0.0,0.0,0.0,0.0,0.0,0.0,0.0,0.0,0.0,0.0,0.0,0.0,0.0,0.0,0.0,0.0,0.0,0.0,0.0,0.0,0.0,0.0,0.0,0.0,0.0,0.0,0.0,0.0,0.0,0.0,0.0,0.0,0.0,0.0,0.0,0.0,0.0,1.0,0.0,1.0,0.0,0.0,0.0,0.0,0.0,0.0,1.0,0.0,0.0
102671,0,0.0,0.0,0.0,1.0,0.0,153000.0,454500.0,19386.0,454500.0,0.018209,62.44657534246576,,-5863.0,-2706.0,,2.0,3.0,3.0,7.0,,0.1620287401543473,,0.1485,0.0749,0.9851,0.7959999999999999,,0.16,0.1379,0.3333,0.0417,0.0909,0.121,0.1542,0.0,0.0,0.1513,0.0777,0.9851,0.804,,0.1611,0.1379,0.3333,0.0417,0.093,0.1322,0.1606,0.0,0.0,0.1499,0.0749,0.9851,0.7987,,0.16,0.1379,0.3333,0.0417,0.0925,0.1231,0.157,0.0,0.0,0.1213,1.0,0.0,0.0,0.0,0.0,-567.0,,,,,,,1.0,0.0,0.0,1.0,0.0,0.0,0.0,0.0,0.0,0.0,0.0,0.0,0.0,1.0,0.0,0.0,0.0,0.0,0.0,0.0,0.0,0.0,0.0,0.0,0.0,0.0,0.0,0.0,0.0,0.0,0.0,0.0,0.0,,,,,,,,,,,,,0.0,,1.0,6200.55,112500.0,101250.0,11250.0,112500.0,24.0,-567.0,365243.0,-536.0,365243.0,154.0,365243.0,8.0,0.0,0.1089090909090909,16.0,17.0,24.0,15.0,-10.0,0.0,0.0,18.0,6200.55,6200.55,-292.5,-281.0,9.5,1.0,0.0,,,,,,,,,,,,,,,,,,,,,8346586248.0,184396472554.5,165583128564.0,51970515157.935,,,,,,,17807.713400002296,17869.89889999911,17321.30989999805,11295.74390000009,11233.551100000092,11180.864700000056,128407.0,662800.0,,,,13527452.18082152,,-921880978.0,-296512640.0,-1535120261.0416667,44017.0,30704.0,11349.508799999185,11225.499999998978,10709.776399997296,22886.80260000969,22808.71930000966,22194.20820000821,,158037.6101958947,,35001.13870002793,34941.429000028365,34387.092200028776,22954.46709999592,22927.65069999549,22574.414799995728,3714155.0,8295.343600000164,8399.867700000077,8123.461400000229,9817.635700000716,9932.58860000216,10292.231899999646,16467.500699999757,16652.75179999969,16249.523399999702,828.7272000001761,813.9032000000459,759.8334000000132,3913.621100000125,3896.790700000163,3729.35600000016,436470.0,431264.0,,6424.997945002896,631945.0,625497.0,,16331.820299999796,154173.89909999055,154176.64369999012,154068.40159998712,77611.58999999624,77949.37850000657,78350.72060000652,,,,,,,,,,,,,,,,,,,,,,,,,,,157124607.0749997,2254371132.510002,2543184259.3350005,35871111.675,2254371132.510002,163347.0,-11175053.0,2581804378.0,112171783.0,570457373.0,254370202.0,594756195.0,162128.0,2536.0,451.95277289155183,3825673.0,1336547.0,818856.0,-2680590.0,901572.0,98836.0,1783412900.68502,1796267094.255,-109621359.0,-108739964.0,1987768.5,88579.0,,,,,,,,,,,,,,,,,,,,,1467388.0,14779566.0,3232828.0,8554884.0,11607702.0,1415665.0,,,,,,,,,,,,,,,,,,,,,,,,,,,,,,,,,,4272853.5,2479159.5,-9003438.0,921269.0,37582.5,3733299723.4649634,3657773142.1124616,-260625010.5,-257314232.5,2526513.0,269186.0,3925966047.637456,33253122801.15092,36682241187.46514,1729264699.4850495,48083248299.218216,3987965.0,-247584256.0,103084751214.0,1053996932.5,17273127657.5,3503693804.0,18886965923.5,3672043.5,71918.0,20869.6743236098,89787393.5,,2.9705882352941178,7.892293407613742,492.84669490339735,23.444753946146704,1464.0445936836215,76500.0,1.0,0.0,0.0,0.0,0.0,0.0,0.0,0.0,1.0,0.0,0.0,1.0,0.0,0.0,0.0,0.0,0.0,1.0,0.0,0.0,0.0,0.0,1.0,0.0,0.0,0.0,0.0,1.0,0.0,0.0,0.0,0.0,0.0,0.0,0.0,0.0,0.0,0.0,0.0,0.0,0.0,0.0,0.0,0.0,0.0,0.0,0.0,0.0,0.0,0.0,0.0,0.0,0.0,0.0,0.0,0.0,0.0,0.0,0.0,0.0,0.0,0.0,0.0,0.0,0.0,0.0,0.0,0.0,0.0,0.0,0.0,0.0,0.0,0.0,0.0,0.0,0.0,0.0,0.0,0.0,0.0,0.0,0.0,0.0,0.0,0.0,0.0,0.0,0.0,0.0,0.0,0.0,0.0,0.0,0.0,0.0,0.0,0.0,0.0,0.0,0.0,0.0,0.0,0.0,0.0,0.0,0.0,1.0,0.0,0.0,1.0,0.0,1.0,0.0,0.0,0.0,0.0,0.0,0.0,1.0,0.0,0.0
102694,0,0.0,0.0,0.0,1.0,0.0,135000.0,539100.0,27652.5,450000.0,0.025164,61.3013698630137,,-4433.0,-4433.0,,2.0,2.0,2.0,13.0,,0.1512429506205085,0.2807895743848605,0.0144,0.0485,0.9781,0.7008,0.0019,0.0,0.069,0.0417,0.0833,0.0144,0.0118,0.0117,0.0,0.0,0.0147,0.0503,0.9782,0.7125,0.002,0.0,0.069,0.0417,0.0833,0.0147,0.0129,0.0122,0.0,0.0,0.0146,0.0485,0.9781,0.7048,0.002,0.0,0.069,0.0417,0.0833,0.0147,0.012,0.0119,0.0,0.0,0.0105,1.0,0.0,0.0,0.0,0.0,-1530.0,0.0,0.0,0.0,0.0,1.0,2.0,1.0,0.0,0.0,1.0,0.0,0.0,0.0,0.0,0.0,0.0,0.0,0.0,0.0,1.0,0.0,0.0,0.0,0.0,0.0,0.0,0.0,0.0,0.0,0.0,0.0,0.0,0.0,0.0,0.0,0.0,0.0,0.0,6.0,7641.0,18213.21,208350.0,0.0,0.0,0.0,0.0,0.0,-758.5,511.0,-150.0,-599.0,197.0,-16.0,6.0,22354.605,121095.0,119535.75,12109.5,285547.5,36.0,-546.5,365243.0,-1499.0,-1229.0,-1229.0,-1221.0,12.5,0.0,0.1013817502547265,-1.0,11.0,10.0,5.0,-45.0,0.0,0.0,10.0,13107.195,13107.195,-1376.0,-1364.0,5.5,1.0,0.0,,,,,,,,,,,,,,,,,,,,,8346613900.5,184397011654.5,165583578564.0,51970650157.935,1863.0,1705.0,71125.0,70817.0,9140.0,506054.0,17807.727800002296,17869.913499999107,17321.32459999805,11295.792400000091,11233.599600000096,11180.915000000055,128407.0,662802.0,4137.905400000119,4135.574300000016,3946.159000000095,13527513.482191382,,-921885411.0,-296514170.0,-1535124694.0416667,44017.0,30704.0,11349.508799999185,11225.499999998978,10709.776399997296,22886.871600009694,22808.78830000965,22194.27720000821,,158037.76143884528,126101.87424433032,35001.18040002793,34941.47070002837,34387.13390002878,22954.55039999592,22927.733999995493,22574.49809999573,3714168.0,8295.358000000164,8399.882400000077,8123.476100000229,9817.647500000718,9932.60060000216,10292.244799999646,16467.512399999756,16652.76369999969,16249.5355999997,828.7272000001761,813.9032000000459,759.8334000000132,3913.621100000125,3896.790700000163,3729.35600000016,436470.0,431264.0,,6425.023109002896,631947.0,625499.0,,16331.830799999798,154174.87719999056,154177.62179999013,154069.37979998713,77612.29079999625,77950.08330000659,78351.43310000651,25.5,42066824.08499999,18608263.740000013,4452292595.700004,1442902655.3849998,50596988.26499997,696734.0099999999,86.0,11949.0,-14460405.0,6195889.5,-7476445.5,-8115954.0,-12.25,15954.525,18213.21,175500.0,0.0,0.0,0.0,0.0,0.0,-1086.0,-356.0,-170.0,-660.0,158115035.38499975,2265581888.865002,2556787340.8350005,36208626.03,2265581888.865002,164323.0,-11250671.5,2600426825.0,112483322.0,574438471.0,256169327.0,599104625.0,163331.5,2553.0,456.25079295038086,3868492.5,1347943.0,825659.0,-2698704.0,901643.0,98896.0,1796534318.677506,1808481711.7124872,-110535468.0,-109645918.5,2005661.0,89228.5,,,,,,,,,,,,,,,,,,,,,1467394.0,14779763.0,3232828.0,8554895.0,11607712.0,1415671.0,1058675341.6170008,801671219.4824951,72105219137.31712,21675448307.81262,582255218.0294988,5792665.7475,689.5,94245.0,-276919552.0,21982930.0,-123787489.5,-218701736.5,-2018514.0,,,,,,,,,,,,,,,,,,,,,4272863.5,2479164.5,-9003483.0,921269.0,37582.5,3733312830.659964,3657786249.3074617,-260626386.5,-257315596.5,2526518.5,269187.0,3925988402.242456,33253243896.15092,36682360723.21514,1729276808.9850495,48083533846.718216,3988001.0,-247584802.5,103085116457.0,1053995433.5,17273126428.5,3503692575.0,18886964702.5,3672056.0,71918.0,20869.775705360047,89787392.5,,3.993333333333333,4.8820179007323015,299.2743850106445,19.49552481692433,1195.1023774758407,67500.0,-0.2225209339563143,0.9749279121818236,0.0,0.0,0.0,0.0,0.0,0.0,1.0,0.0,0.0,1.0,0.0,0.0,0.0,0.0,0.0,0.0,0.0,0.0,1.0,0.0,1.0,0.0,0.0,0.0,0.0,1.0,0.0,0.0,0.0,0.0,0.0,0.0,0.0,0.0,0.0,0.0,0.0,0.0,0.0,0.0,0.0,0.0,0.0,0.0,0.0,0.0,0.0,0.0,0.0,0.0,0.0,0.0,0.0,0.0,0.0,0.0,0.0,0.0,0.0,0.0,0.0,0.0,0.0,0.0,0.0,0.0,0.0,0.0,0.0,0.0,0.0,0.0,0.0,0.0,0.0,0.0,0.0,0.0,0.0,0.0,0.0,0.0,0.0,0.0,0.0,0.0,0.0,0.0,0.0,0.0,0.0,0.0,0.0,0.0,0.0,0.0,0.0,0.0,0.0,0.0,0.0,0.0,0.0,0.0,0.0,1.0,0.0,0.0,1.0,0.0,1.0,0.0,0.0,0.0,0.0,0.0,0.0,0.0,1.0,0.0
102701,0,0.0,0.0,0.0,1.0,0.0,112500.0,239476.5,22095.0,193500.0,0.019101,22.463013698630142,-245.0,-3054.0,-874.0,,1.0,2.0,2.0,12.0,,0.6871068831929256,0.746300213050371,,,,,,,,,,,,,,,,,,,,,,,,,,,,,,,,,,,,,,,,,,,,,0.0,0.0,0.0,0.0,-304.0,0.0,0.0,0.0,0.0,0.0,0.0,1.0,1.0,0.0,1.0,0.0,0.0,0.0,0.0,0.0,1.0,1.0,1.0,0.0,1.0,0.0,0.0,0.0,0.0,0.0,0.0,0.0,0.0,0.0,0.0,0.0,0.0,0.0,0.0,0.0,0.0,0.0,0.0,1.0,,0.0,105750.0,0.0,0.0,0.0,0.0,0.0,-1060.0,-756.0,-752.0,-756.0,35.0,-17.0,1.0,8698.68,78291.0,71541.0,6750.0,78291.0,12.0,-304.0,365243.0,-269.0,365243.0,61.0,365243.0,15.0,0.0,0.093897940202113,50.0,9.0,12.0,8.0,-6.0,0.0,0.0,9.0,8829.18,8829.18,-155.0,-149.0,5.0,1.0,0.0,,,,,,,,,,,,,,,,,,,,,8346635995.5,184397251131.0,165583772064.0,51970762657.935,1863.0,1705.0,71125.0,70817.0,9140.0,506054.0,,,,,,,128407.0,662803.0,,,,13527535.94520508,-601890525.0,-921886285.0,-296514474.0,-1535127748.0416667,44017.0,30704.0,,,,,,,,158038.4485457285,126102.6205445434,,,,,,,3714180.0,,,,,,,,,,,,,,,,436470.0,431264.0,,6425.042210002895,631949.0,625501.0,,,,,,,,,35.0,,18608296.99500001,4460826705.615004,1445858820.8099997,50679461.11499997,696734.0099999999,86.0,11949.0,-14516447.0,6263418.0,-7506218.0,-8151141.0,-17.0,,0.0,105750.0,0.0,0.0,0.0,0.0,0.0,-1060.0,-756.0,-752.0,-756.0,158337641.42999974,2268658957.0050025,2560066022.8350005,36305312.67,2268658957.0050025,164584.0,-11277042.0,2605905439.0,112829885.0,575884418.0,256520570.0,600550730.0,163704.0,2556.0,457.95168304152,3872801.0,1349953.0,826756.0,-2705221.0,901660.0,98909.0,1798526439.8550048,1810531986.8399875,-110729065.0,-109838145.0,2006964.0,89423.0,,,,,,,,,,,,,,,,,,,,,1467395.0,14779798.0,3232828.0,8554904.0,11607721.0,1415672.0,,801671219.4824951,72105324887.31712,21675448307.81262,582255218.0294988,5792665.7475,689.5,94245.0,-276920612.0,21982174.0,-123788241.5,-218702492.5,-2018531.0,,,,,,,,,,,,,,,,,,,,,4272875.5,2479172.5,-9003489.0,921269.0,37582.5,3733321659.8399634,3657795078.4874616,-260626541.5,-257315745.5,2526523.5,269188.0,3925997100.922456,33253322187.15092,36682432264.21514,1729283558.9850495,48083612137.718216,3988013.0,-247585106.5,103085481700.0,1053995164.5,17273491671.5,3503692636.0,18887329945.5,3672071.0,71918.0,20869.86960330025,89787442.5,-10.906817904622514,2.12868,5.091649694501019,114.37379683620232,10.838492871690429,243.4652138492872,112500.0,-0.2225209339563143,0.9749279121818236,0.0,0.0,0.0,0.0,0.0,0.0,1.0,0.0,0.0,0.0,0.0,0.0,0.0,1.0,0.0,0.0,0.0,0.0,1.0,0.0,0.0,0.0,1.0,0.0,0.0,1.0,0.0,0.0,0.0,0.0,0.0,0.0,0.0,0.0,0.0,0.0,0.0,0.0,0.0,0.0,0.0,1.0,0.0,0.0,0.0,0.0,0.0,0.0,0.0,0.0,0.0,0.0,0.0,0.0,0.0,0.0,0.0,0.0,0.0,0.0,0.0,0.0,0.0,0.0,0.0,0.0,0.0,0.0,0.0,0.0,0.0,0.0,0.0,0.0,0.0,0.0,0.0,0.0,0.0,0.0,0.0,1.0,0.0,0.0,0.0,0.0,0.0,0.0,0.0,0.0,0.0,0.0,0.0,0.0,0.0,0.0,0.0,0.0,0.0,0.0,0.0,0.0,0.0,0.0,0.0,0.0,0.0,0.0,0.0,0.0,0.0,0.0,0.0,0.0,0.0,0.0,0.0,0.0,0.0,0.0
102703,0,0.0,0.0,0.0,1.0,0.0,112500.0,553581.0,31041.0,472500.0,0.031329,50.67671232876712,-1245.0,-904.0,-2040.0,,2.0,2.0,2.0,10.0,0.7174281600806582,0.6840003818264704,0.7076993447402619,0.0732,0.0511,0.996,0.9456,0.0255,0.08,0.069,0.3333,0.375,0.0922,0.0597,0.0765,0.0,0.0,0.0746,0.0531,0.996,0.9477,0.0257,0.0806,0.069,0.3333,0.375,0.0943,0.0652,0.0797,0.0,0.0,0.0739,0.0511,0.996,0.9463,0.0256,0.08,0.069,0.3333,0.375,0.0938,0.0607,0.0778,0.0,0.0,0.073,1.0,1.0,1.0,1.0,1.0,-862.0,0.0,0.0,0.0,0.0,0.0,0.0,1.0,1.0,0.0,1.0,0.0,0.0,0.0,0.0,0.0,0.0,0.0,0.0,0.0,1.0,0.0,0.0,0.0,0.0,0.0,0.0,0.0,0.0,0.0,0.0,0.0,0.0,0.0,0.0,0.0,0.0,0.0,0.0,2.0,,0.0,90000.0,0.0,0.0,0.0,0.0,0.0,-1611.5,-516.0,-948.0,-1853.0,107.0,-26.0,3.0,21443.805,102375.0,102375.0,0.0,278437.5,15.0,-324.0,365243.0,-561.5,182341.0,-141.5,182342.0,12.0,0.5,0.0,-1.0,21.0,12.0,10.0,-18.0,0.0,0.0,20.0,30609.1575,30609.1575,-433.0,-426.5,5.5,1.0,0.0,,,,,,,,,,,,,,,,,,,,,8346667036.5,184397804712.0,165584244564.0,51970875157.935,1863.0,1705.0,71125.0,70817.0,9140.0,506054.0,17807.801000002295,17869.98739999911,17321.39919999805,11295.843500000094,11233.650700000097,11180.968100000056,128407.0,662805.0,4137.930900000119,4135.599900000016,3946.1847000000953,13527586.62191741,-601891770.0,-921888325.0,-296515336.0,-1535128652.0416667,44018.0,30705.0,11349.588799999185,11225.579999998978,10709.856999997295,22886.940600009693,22808.85730000965,22194.34620000821,67463.89908675267,158039.13254611028,126103.32824388811,35001.51370002793,34941.804000028365,34387.467200028776,22954.92539999592,22928.108999995493,22574.87309999573,3714190.0,8295.450200000163,8399.976200000077,8123.57040000023,9817.707200000716,9932.66130000216,10292.309999999645,16467.588899999755,16652.84149999969,16249.6152999997,828.7272000001761,813.9032000000459,759.8334000000132,3913.621100000125,3896.790700000163,3729.35600000016,436471.0,431265.0,,6425.073539002896,631951.0,625503.0,,16331.903799999798,154175.87319999054,154178.61779999017,154070.37579998717,77613.23639999625,77951.02960000659,78352.38080000652,53.5,,18613764.49500001,4463781572.115004,1446708830.3099997,50679461.11499997,696734.0099999999,86.0,11949.0,-14522552.0,6275801.5,-7507757.5,-8153522.0,-26.25,,0.0,180000.0,0.0,0.0,0.0,0.0,0.0,-2172.0,-1807.0,-1853.0,-1853.0,158389852.02749974,2269484113.0050025,2560933213.3350005,36305312.67,2269432925.5050025,164632.0,-11279980.0,2606818546.5,112828200.5,576248883.5,256520250.5,600915212.5,163753.0,2557.0,457.95168304152,3874329.0,1350635.0,827202.0,-2705779.0,901660.0,98909.0,1798966367.032505,1810971914.017488,-110745249.5,-109853375.5,2007188.5,89455.5,,,,,,,,,,,,,,,,,,,,,1467397.0,14779905.0,3232828.0,8554925.0,11607741.0,1415675.0,,801671219.4824951,72105414887.31712,21675448307.81262,582255218.0294988,5792665.7475,689.5,94245.0,-276922223.5,21981658.0,-123789189.5,-218704345.5,-2018557.0,,,,,,,,,,,,,,,,,,,,,4272887.5,2479182.5,-9003507.0,921269.0,37582.5,3733352268.997463,3657825687.644962,-260626974.5,-257316172.0,2526529.0,269189.0,3926018544.727456,33253424562.15092,36682534639.21514,1729283558.9850495,48083890575.218216,3988028.0,-247585430.5,103085846943.0,1053994603.0,17273674012.5,3503692494.5,18887512287.5,3672083.0,71918.5,20869.86960330025,89787441.5,-24.567497432016,4.920719999999999,3.624238909828936,183.66451264412555,17.83386488837344,903.7616406582016,56250.0,-0.2225209339563146,-0.9749279121818236,0.0,0.0,0.0,0.0,0.0,0.0,1.0,0.0,0.0,0.0,0.0,0.0,0.0,1.0,0.0,1.0,0.0,0.0,0.0,0.0,1.0,0.0,0.0,0.0,0.0,1.0,0.0,0.0,0.0,0.0,0.0,0.0,0.0,0.0,0.0,0.0,0.0,0.0,0.0,0.0,1.0,0.0,0.0,0.0,0.0,0.0,0.0,0.0,0.0,0.0,0.0,0.0,0.0,0.0,0.0,0.0,0.0,0.0,0.0,0.0,0.0,0.0,0.0,0.0,0.0,0.0,0.0,0.0,0.0,0.0,0.0,0.0,0.0,0.0,0.0,0.0,0.0,0.0,0.0,0.0,0.0,0.0,0.0,0.0,0.0,0.0,0.0,1.0,0.0,0.0,0.0,0.0,0.0,0.0,0.0,0.0,0.0,0.0,0.0,0.0,0.0,0.0,0.0,0.0,0.0,0.0,0.0,0.0,1.0,0.0,1.0,0.0,0.0,0.0,0.0,0.0,0.0,0.0,1.0,0.0
102704,0,0.0,0.0,0.0,1.0,0.0,90000.0,292500.0,15997.5,292500.0,0.028663,59.15616438356165,,-4234.0,-5048.0,,2.0,2.0,2.0,12.0,,0.7012136374705649,0.6161216908872079,,,,,,,,,,,,,,,,,,,,,,,,,,,,,,,,,,,,,,,,,,,,,0.0,0.0,0.0,0.0,-1732.0,0.0,0.0,0.0,0.0,1.0,0.0,1.0,0.0,0.0,1.0,0.0,0.0,0.0,0.0,0.0,0.0,0.0,0.0,0.0,1.0,0.0,0.0,0.0,0.0,0.0,0.0,0.0,0.0,0.0,0.0,0.0,0.0,0.0,0.0,0.0,0.0,0.0,0.0,7.0,1602.0,0.0,135000.0,0.0,0.0,0.0,0.0,0.0,-965.0,209.0,-171.0,-925.0,254.0,-21.0,2.0,7361.6175,68443.875,71842.5,1236.375,68443.875,11.0,-983.0,365243.0,-951.0,181907.5,-651.0,181912.5,16.5,0.5,0.0274131031352413,95.0,18.0,10.0,7.0,-48.5,0.0,0.0,19.0,5933.52,5933.52,-1456.0,-1458.0,5.0,1.0,0.0,,,,,,,,,,,,,,,,,,,,,8346683034.0,184398097212.0,165584537064.0,51970965157.935,1863.0,1705.0,71125.0,70818.0,9140.0,506054.0,,,,,,,128407.0,662807.0,,,,13527645.778081791,,-921893373.0,-296517068.0,-1535132886.0416667,44018.0,30705.0,,,,,,,,158039.8337597478,126103.944365579,,,,,,,3714202.0,,,,,,,,,,,,,,,,436471.0,431265.0,,6425.102202002896,631953.0,625505.0,,,,,,,,,32.0,42180928.10999999,18613764.49500001,4464609360.615004,1447010046.8099997,50679461.11499997,696734.0099999999,86.0,11949.0,-14526031.0,6275092.5,-7509071.0,-8154757.0,-15.5,1602.0,0.0,0.0,0.0,0.0,0.0,0.0,0.0,-1759.0,-235.0,-925.0,-925.0,158406296.26499975,2269596440.8800025,2561053574.8350005,36306549.045,2269596440.8800025,164655.0,-11281404.0,2607549032.5,112826732.0,576613132.0,256519412.0,601279467.0,163790.0,2558.0,457.9790961446553,3874499.0,1350862.0,827338.0,-2706166.5,901660.0,98909.0,1799153093.790005,1811158640.774988,-110757714.0,-109865452.0,2007286.0,89476.0,,,,,,,,,,,,,,,,,,,,,1467404.0,14780159.0,3232828.0,8554943.0,11607760.0,1415677.0,1058676943.6170008,801671219.4824951,72105549887.31712,21675448307.81262,582255218.0294988,5792665.7475,689.5,94245.0,-276923188.5,21981867.0,-123789360.5,-218705270.5,-2018578.0,,,,,,,,,,,,,,,,,,,,,4272897.5,2479189.5,-9003555.5,921269.0,37582.5,3733358202.517463,3657831621.164962,-260628430.5,-257317630.0,2526534.0,269190.0,3926025906.344957,33253493006.02592,36682606481.71514,1729284795.3600495,48083959019.093216,3988039.0,-247586413.5,103086212186.0,1053993652.0,17273855920.0,3503691843.5,18887694200.0,3672099.5,71919.0,20869.897016403396,89787536.5,,3.25,5.625879043600564,332.80542550526945,18.28410689170183,1081.6176328921258,45000.0,-0.9009688679024191,0.4338837391175582,0.0,0.0,0.0,0.0,0.0,0.0,1.0,0.0,0.0,1.0,0.0,0.0,0.0,0.0,0.0,0.0,0.0,0.0,1.0,0.0,1.0,0.0,0.0,0.0,0.0,1.0,0.0,0.0,0.0,0.0,0.0,0.0,0.0,0.0,0.0,0.0,0.0,0.0,0.0,0.0,0.0,0.0,0.0,0.0,0.0,0.0,0.0,0.0,0.0,0.0,0.0,0.0,0.0,0.0,0.0,0.0,0.0,0.0,0.0,0.0,0.0,0.0,0.0,0.0,0.0,0.0,0.0,0.0,0.0,0.0,0.0,0.0,0.0,0.0,0.0,0.0,0.0,0.0,0.0,0.0,0.0,0.0,0.0,0.0,0.0,0.0,0.0,0.0,0.0,0.0,0.0,0.0,0.0,0.0,0.0,0.0,0.0,0.0,0.0,0.0,0.0,0.0,0.0,0.0,0.0,1.0,0.0,0.0,0.0,0.0,0.0,0.0,0.0,0.0,0.0,0.0,0.0,0.0,0.0,0.0
102713,0,0.0,0.0,1.0,1.0,3.0,63000.0,99504.0,10575.0,90000.0,0.072508,38.72602739726028,,-5653.0,-5717.0,65.0,5.0,1.0,1.0,10.0,,0.6694543386664703,0.7801436381572275,0.2794,0.1771,0.9801,0.728,,0.48,0.2069,0.4583,0.5,0.0,0.2278,0.3041,,0.2645,0.2847,0.1838,0.9801,0.7387,,0.4834,0.2069,0.4583,0.5,0.0,0.2489,0.3169,,0.28,0.2821,0.1771,0.9801,0.7316,,0.48,0.2069,0.4583,0.5,0.0,0.2317,0.3096,,0.27,0.2967,1.0,0.0,0.0,0.0,0.0,-1.0,0.0,0.0,0.0,0.0,0.0,3.0,1.0,0.0,0.0,1.0,0.0,1.0,0.0,0.0,0.0,0.0,0.0,0.0,0.0,1.0,0.0,0.0,0.0,0.0,0.0,0.0,0.0,0.0,0.0,0.0,0.0,0.0,0.0,0.0,0.0,0.0,0.0,0.0,7.0,0.0,0.0,227785.5,0.0,0.0,0.0,0.0,0.0,-1359.0,-1120.0,-1059.0,-1062.0,293.0,-20.0,2.0,7899.12,71140.5,75723.75,0.0,71140.5,12.0,-565.0,365243.0,-532.0,-232.0,-202.0,-226.5,11.0,0.5,0.0,47.0,25.0,12.0,6.0,-13.0,0.0,0.0,23.0,9671.535,9671.535,-427.0,-405.0,6.0,2.0,0.0,,,,,,,,,,,,,,,,,,,,,8346693609.0,184398196716.0,165584627064.0,51971028157.935,1863.0,1705.0,71125.0,70818.0,9140.0,506057.0,17808.080400002294,17870.269499999107,17321.68389999805,11296.020600000093,11233.827800000096,11181.151900000055,128410.0,662812.0,,,,13527684.50410919,,-921899090.0,-296517069.0,-1535138539.0416667,44018.0,30705.0,11350.068799999182,11226.059999998975,10710.340399997294,22887.14750000969,22809.06420000966,22194.55310000822,,158040.50321408644,126104.72450921717,35001.97200002793,34942.262300028364,34387.925500028774,22955.42539999592,22928.608999995493,22575.37309999573,3714212.0,8295.450200000163,8399.976200000077,8123.57040000023,9817.935000000718,9932.89300000216,10292.558899999643,16467.892999999756,16653.15109999969,16249.9321999997,,,,3913.885600000125,3897.060700000163,3729.636000000159,436471.0,431265.0,1263239.0,6425.174710002895,631954.0,625506.0,,16332.2004999998,154176.85329999056,154179.59789999013,154071.35589998713,77613.96439999626,77951.76120000659,78353.11950000652,45.0,42212405.60999999,18628432.69500001,4485101580.810002,1449538497.4049995,51485378.98499997,696734.0099999999,86.0,11949.0,-14595969.0,6319294.0,-7544140.0,-8191544.0,-22.0,0.0,0.0,227785.5,0.0,0.0,0.0,0.0,0.0,-1363.0,-1120.0,-1072.0,-1120.0,159175347.36749983,2279711818.5750017,2573243318.925,36364941.9,2279711818.5750017,165315.0,-11346100.5,2619231194.5,113143453.5,579132202.5,257949707.5,604166816.5,164455.5,2571.5,459.1591024928438,3886135.0,1356743.0,830888.0,-2720085.0,901671.0,98920.0,1806658115.7600048,1817797784.624988,-111373328.0,-110479142.0,2014338.0,89864.0,,,,,,,,,,,,,,,,,,,,,1467411.0,14780452.0,3232828.0,8554968.0,11607783.0,1415679.0,1058676943.6170008,801671219.4824951,72105777672.81712,21675448307.81262,582255218.0294988,5792665.7475,689.5,94245.0,-276924547.5,21980747.0,-123790419.5,-218706332.5,-2018598.0,,,,,,,,,,,,,,,,,,,,,4272909.5,2479195.5,-9003568.5,921269.0,37582.5,3733367874.052463,3657841292.6999617,-260628857.5,-257318035.0,2526540.0,269192.0,3926033805.464956,33253564146.52592,36682682205.46514,1729284795.3600495,48084030159.593216,3988051.0,-247586978.5,103086577429.0,1053993120.0,17273855688.0,3503691641.5,18887693973.5,3672110.5,71919.5,20869.897016403396,89787583.5,,1.5794285714285714,5.957446808510637,230.70824832410372,9.40936170212766,364.38719906732734,12600.0,-0.2225209339563146,-0.9749279121818236,0.0,0.0,0.0,0.0,0.0,0.0,1.0,0.0,0.0,1.0,0.0,0.0,0.0,0.0,0.0,0.0,0.0,0.0,1.0,0.0,1.0,0.0,0.0,0.0,0.0,1.0,0.0,0.0,0.0,0.0,0.0,0.0,0.0,0.0,0.0,0.0,0.0,0.0,0.0,0.0,0.0,0.0,0.0,0.0,0.0,0.0,0.0,0.0,0.0,0.0,0.0,0.0,0.0,0.0,0.0,0.0,0.0,0.0,0.0,0.0,0.0,0.0,0.0,0.0,0.0,0.0,0.0,0.0,0.0,0.0,0.0,0.0,0.0,0.0,0.0,0.0,0.0,0.0,0.0,0.0,0.0,0.0,0.0,0.0,0.0,0.0,0.0,0.0,0.0,0.0,0.0,0.0,0.0,0.0,0.0,0.0,0.0,0.0,0.0,0.0,0.0,0.0,0.0,0.0,0.0,1.0,0.0,0.0,1.0,0.0,1.0,0.0,0.0,0.0,0.0,0.0,0.0,1.0,0.0,0.0
102720,0,0.0,0.0,0.0,1.0,1.0,157500.0,254799.0,16411.5,193500.0,0.0105,51.06849315068493,-1245.0,-7964.0,-1945.0,,3.0,3.0,3.0,9.0,,0.5432948730488254,0.2340151665320674,0.0186,0.0,0.9806,0.7348,,0.0,0.1034,0.0417,0.0417,0.0,0.0151,0.0169,0.0,0.0,0.0189,0.0,0.9806,0.7452,,0.0,0.1034,0.0417,0.0417,0.0,0.0165,0.0176,0.0,0.0,0.0187,0.0,0.9806,0.7383,,0.0,0.1034,0.0417,0.0417,0.0,0.0154,0.0172,0.0,0.0,0.0133,1.0,0.0,0.0,0.0,0.0,-304.0,0.0,0.0,0.0,0.0,0.0,1.0,1.0,1.0,0.0,1.0,0.0,0.0,0.0,0.0,0.0,0.0,1.0,1.0,0.0,1.0,0.0,0.0,0.0,0.0,0.0,0.0,0.0,0.0,0.0,0.0,0.0,0.0,0.0,0.0,0.0,0.0,0.0,0.0,10.0,0.0,0.0,178402.5,104845.5,0.0,0.0,0.0,0.0,-566.0,498.0,-371.5,-528.5,271.0,-14.0,1.0,4968.315,61533.0,49225.5,12307.5,61533.0,12.0,-304.0,365243.0,-258.0,-168.0,72.0,-163.0,10.0,0.0,0.2178341111864586,-1.0,6.0,12.0,10.0,-7.5,0.0,0.0,4.0,4968.315,4968.315,-269.5,-213.0,2.5,1.0,0.0,,,,,,,,,,,,,,,,,,,,,8346710020.5,184398451515.0,165584820564.0,51971185657.935,1863.0,1705.0,71125.0,70818.0,9140.0,506058.0,17808.099000002294,17870.288199999108,17321.70279999805,11296.020600000093,11233.827800000096,11181.151900000055,128411.0,662815.0,,,,13527735.57260234,-601893015.0,-921901035.0,-296517373.0,-1535146503.0416667,44018.0,30705.0,11350.068799999182,11226.059999998975,10710.340399997294,22887.25090000969,22809.16760000966,22194.65650000822,,158041.04650895952,126104.95852438368,35002.01370002793,34942.304000028365,34387.967200028776,22955.46709999592,22928.65069999549,22575.414799995728,3714221.0,8295.450200000163,8399.976200000077,8123.57040000023,9817.95010000072,9932.90840000216,10292.575399999643,16467.909899999755,16653.16829999969,16249.9497999997,828.7272000001761,813.9032000000459,759.8334000000132,3913.885600000125,3897.060700000163,3729.636000000159,436471.0,431265.0,,6425.185210002896,631957.0,625509.0,,16332.2137999998,154177.83389999054,154180.57849999017,154072.33649998714,77614.69919999626,77952.49950000657,78353.86470000652,19.0,42288217.10999999,18631492.69500001,4492568605.095001,1452722154.8849998,51755065.73999997,696734.0099999999,86.0,11949.0,-14628771.0,6403937.0,-7563807.5,-8209742.0,-9.0,0.0,0.0,131805.0,0.0,0.0,0.0,0.0,0.0,-1191.0,31.0,-546.0,-546.0,159683517.26999986,2286860894.3250017,2580911611.425,36659223.9,2286860894.3250017,165794.0,-11387534.0,2627449162.0,113848373.0,580938563.0,258298311.0,605973295.0,164881.0,2579.0,462.3164683941652,3889870.0,1360902.0,833440.0,-2728184.5,901708.0,98925.0,1811777589.1575077,1822778741.677489,-111608133.0,-110711182.0,2016153.0,90102.5,,,,,,,,,,,,,,,,,,,,,1467421.0,14780723.0,3232828.0,8554974.0,11607787.0,1415680.0,1058676943.6170008,801671219.4824951,72105956075.31712,21675553153.31262,582255218.0294988,5792665.7475,689.5,94245.0,-276925113.5,21981245.0,-123790791.0,-218706861.0,-2018612.0,,,,,,,,,,,,,,,,,,,,,4272921.5,2479205.5,-9003576.0,921269.0,37582.5,3733372842.367463,3657846261.0149617,-260629127.0,-257318248.0,2526542.5,269193.0,3926038773.779956,33253625679.52592,36682731430.96514,1729297102.8600495,48084091692.593216,3988063.0,-247587282.5,103086942672.0,1053992862.0,17273855520.0,3503691713.5,18887693810.5,3672120.5,71919.5,20870.114850514576,89787582.5,-24.379023605150213,1.6177714285714286,9.596928982725528,490.1007020219283,15.525637510282426,792.870912853875,52500.0,0.6234898018587336,0.7818314824680298,0.0,0.0,0.0,0.0,0.0,0.0,1.0,0.0,0.0,0.0,0.0,0.0,0.0,1.0,0.0,0.0,0.0,0.0,1.0,0.0,1.0,0.0,0.0,0.0,0.0,1.0,0.0,0.0,0.0,0.0,0.0,0.0,0.0,0.0,0.0,0.0,0.0,0.0,0.0,0.0,0.0,1.0,0.0,0.0,0.0,0.0,0.0,0.0,0.0,0.0,0.0,0.0,0.0,0.0,0.0,0.0,0.0,0.0,0.0,0.0,0.0,0.0,0.0,0.0,0.0,0.0,0.0,0.0,0.0,0.0,0.0,0.0,0.0,0.0,0.0,0.0,1.0,0.0,0.0,0.0,0.0,0.0,0.0,0.0,0.0,0.0,0.0,0.0,0.0,0.0,0.0,0.0,0.0,0.0,0.0,0.0,0.0,0.0,0.0,0.0,0.0,0.0,0.0,0.0,0.0,0.0,0.0,0.0,1.0,0.0,1.0,0.0,0.0,0.0,0.0,0.0,0.0,0.0,1.0,0.0
102731,0,0.0,0.0,1.0,1.0,2.0,180000.0,509400.0,40374.0,450000.0,0.04622,32.58356164383561,-96.0,-5924.0,-2736.0,13.0,4.0,1.0,1.0,10.0,0.7692381946801915,0.5492081481361005,0.5154953751603267,,,,,,,,,,,,,,,,,,,,,,,,,,,,,,,,,,,,,,,,,,,,,0.0,0.0,0.0,0.0,-666.0,0.0,0.0,0.0,0.0,1.0,0.0,1.0,1.0,0.0,1.0,0.0,0.0,0.0,0.0,0.0,0.0,0.0,0.0,0.0,1.0,0.0,0.0,0.0,0.0,0.0,0.0,0.0,0.0,0.0,0.0,0.0,0.0,0.0,0.0,0.0,0.0,0.0,0.0,9.0,5251.5,0.0,75550.5,0.0,2250.0,0.0,0.0,0.0,-1122.0,-97.0,-330.0,-987.5,334.0,-21.0,2.0,11222.955,125131.5,133260.75,0.0,125131.5,6.0,-209.0,365243.0,182532.0,365243.0,182697.0,365243.0,15.0,0.5,0.0,120.0,6.0,12.0,9.5,-4.5,0.0,0.0,8.0,16128.765,16128.765,-115.0,-104.0,3.5,3.0,6.0,0.0,4500.0,,0.0,,,0.0,,0.0,0.0,0.0,0.0,,0.0,,,0.0,-4.5,0.0,0.0,8346750394.5,184398960915.0,165585270564.0,51971365657.935,1863.0,1705.0,71125.0,70819.0,9140.0,506058.0,,,,,,,128413.0,662819.0,,,,13527768.156163985,-601893111.0,-921903771.0,-296518039.0,-1535152427.0416667,44018.0,30705.0,,,,,,,67464.66832494736,158041.59571710767,126105.47401975884,,,,,,,3714231.0,,,,,,,,,,,,,,,,436471.0,431265.0,1263252.0,6425.231430002897,631958.0,625510.0,,,,,,,,,37.0,42406949.29499999,18631492.69500001,4511369347.695003,1459370690.3249998,51866460.67499997,696734.0099999999,86.0,11949.0,-14676971.0,6423654.0,-7587778.0,-8235399.5,-18.0,9922.5,0.0,85810.5,0.0,106894.935,0.0,0.0,0.0,-1604.0,-301.0,-898.0,-1163.0,160308533.33999985,2295944742.8250017,2590477238.925,36863631.9,2295944742.8250017,166208.0,-11424410.5,2636761919.5,114366815.5,582559832.5,259191232.5,607595337.5,165322.5,2588.0,463.8422296619103,3914886.0,1365456.0,835410.5,-2743459.0,901772.0,98989.0,1818954660.667512,1830212660.5874944,-111985707.0,-111086178.5,2019598.5,90423.5,1722431430.8999884,4650423750.0,,231035223.3299996,,,98256154.85999966,,233453035.53,1653373950.2099972,1715876445.914986,1715938862.8499866,,19398.0,,,577342.0,-1040163.5,495582.0,929.0,1467430.0,14781057.0,3232834.0,8554980.0,11607795.0,1415682.0,1058682195.1170008,801671219.4824951,72106031625.81712,21675553153.31262,582257468.0294988,5792665.7475,689.5,94245.0,-276926235.5,21981148.0,-123791121.0,-218707848.5,-2018633.0,5922632776.589962,18722142000.0,,447956302.4549976,,,309109137.65999866,,459138474.0449993,5707793860.965033,5885924575.657499,5886167758.4025,,80836.5,,,971532.5,-1698580.5,177364.0,6755.0,4272933.5,2479215.0,-9003580.5,921269.0,37582.5,3733388971.132464,3657862389.7799616,-260629242.0,-257318352.0,2526546.0,269196.0,3926049996.734956,33253750811.02592,36682864691.71514,1729297102.8600495,48084216824.093216,3988069.0,-247587491.5,103087307915.0,1054175394.0,17274220763.0,3503874410.5,18888059053.5,3672135.5,71920.0,20870.114850514576,89787702.5,-2.9462709156646767,2.83,4.458314757021847,145.2677737130433,12.617030762371824,411.1077996079126,45000.0,-0.9009688679024191,-0.433883739117558,0.0,0.0,0.0,1.0,0.0,0.0,0.0,0.0,1.0,0.0,0.0,0.0,0.0,0.0,0.0,1.0,0.0,0.0,0.0,0.0,1.0,0.0,0.0,0.0,0.0,1.0,0.0,0.0,0.0,0.0,0.0,0.0,0.0,0.0,0.0,0.0,0.0,0.0,1.0,0.0,0.0,0.0,0.0,0.0,0.0,0.0,0.0,0.0,0.0,0.0,0.0,0.0,0.0,1.0,0.0,0.0,0.0,0.0,0.0,0.0,0.0,0.0,0.0,0.0,0.0,0.0,0.0,0.0,0.0,0.0,0.0,0.0,0.0,0.0,0.0,0.0,0.0,0.0,0.0,0.0,0.0,0.0,0.0,0.0,0.0,0.0,0.0,0.0,0.0,0.0,0.0,0.0,0.0,0.0,0.0,0.0,0.0,0.0,0.0,0.0,0.0,0.0,0.0,0.0,0.0,0.0,0.0,0.0,0.0,0.0,0.0,0.0,0.0,0.0,0.0,0.0,0.0,0.0,0.0,0.0
102733,0,0.0,0.0,0.0,1.0,0.0,121500.0,162000.0,14854.5,162000.0,0.011703,26.26027397260274,-1339.0,-3191.0,-2205.0,,1.0,2.0,2.0,16.0,0.3901640428779179,0.5715876339151235,0.4525335592581747,0.1134,0.1042,0.9776,0.6940000000000001,,0.0,0.2069,0.1667,0.2083,0.119,,0.0898,,0.0,0.1155,0.1081,0.9777,0.706,,0.0,0.2069,0.1667,0.2083,0.1217,,0.0935,,0.0,0.1145,0.1042,0.9776,0.6981,,0.0,0.2069,0.1667,0.2083,0.1211,,0.0914,,0.0,0.0773,1.0,1.0,0.0,1.0,0.0,-870.0,0.0,0.0,0.0,0.0,0.0,0.0,1.0,1.0,1.0,1.0,1.0,1.0,0.0,0.0,0.0,0.0,0.0,0.0,0.0,1.0,0.0,0.0,0.0,0.0,0.0,0.0,0.0,0.0,0.0,0.0,0.0,0.0,0.0,0.0,0.0,0.0,0.0,0.0,1.0,,0.0,123030.0,0.0,0.0,0.0,0.0,0.0,-404.0,-97.0,-97.0,-97.0,14.0,-6.5,8.0,19584.315,191250.0,191250.0,28716.75,225000.0,6.0,-833.0,182202.0,-899.5,182196.5,182196.5,182201.5,14.5,0.0,0.1089123444518676,415.0,7.0,6.0,3.0,-31.0,0.0,0.0,61.0,7238.25,7238.25,-465.0,-462.0,25.0,0.0,28.0,155403.1575,157500.0,0.0,0.0,0.0,0.0,7863.9525,9000.0,9000.0,151450.26750000002,155762.37,155762.37,0.0,0.0,0.0,0.0,12.5,-15.5,0.0,0.0,8346765249.0,184399122915.0,165585432564.0,51971487157.935,1863.0,1705.0,71125.0,70819.0,9140.0,506058.0,17808.212400002292,17870.402699999107,17321.81829999805,11296.124800000092,11233.932000000095,11181.260000000057,128413.0,662820.0,,,,13527794.416437956,-601894450.0,-921905976.0,-296518909.0,-1535155618.0416667,44018.0,30705.0,11350.068799999182,11226.059999998975,10710.340399997294,22887.45780000969,22809.374500009657,22194.863400008217,67465.05848899024,158042.1673047416,126105.92655331812,35002.18040002793,34942.47070002837,34388.13390002878,22955.67539999592,22928.858999995493,22575.62309999573,3714247.0,8295.569200000164,8400.097300000078,8123.692100000227,,,,16467.999699999757,16653.25969999969,16250.0432999997,,,,3913.885600000125,3897.060700000163,3729.636000000159,436472.0,431266.0,,6425.243133002897,631960.0,625512.0,,16332.2910999998,154178.81149999055,154181.55609999015,154073.31419998713,77615.39319999628,77953.19760000658,78354.57070000653,14.0,,18631492.69500001,4511795031.3600025,1459390841.3249998,51866460.67499997,696734.0099999999,86.0,11949.0,-14681161.0,6423557.0,-7589943.0,-8237439.0,-6.5,,0.0,123030.0,0.0,0.0,0.0,0.0,0.0,-404.0,-97.0,-97.0,-97.0,160457911.96499988,2297905851.8250017,2592504531.675,36908823.15,2298056484.8250017,166322.0,-11430014.5,2638405093.5,114547067.5,583654383.5,259556905.5,608689904.5,165445.0,2591.0,464.0055981785881,3916164.0,1366051.0,835895.0,-2743798.0,901776.0,98993.0,1820562677.055011,1832109471.809993,-112008859.0,-111108846.0,2020437.0,90541.0,1725201987.7049885,4653411750.0,147185772.39,231065625.77999955,9470424.6,74196466.69500005,98401562.84249967,252717733.12499967,233618185.53,1656067355.3924973,1718652525.007486,1718714941.9424863,7508.0,19406.0,124.0,11774.0,577558.5,-1040368.5,495582.0,929.0,1467431.0,14781071.0,3232862.0,8554987.0,11607856.0,1415690.0,,801671219.4824951,72106154655.81712,21675553153.31262,582257468.0294988,5792665.7475,689.5,94245.0,-276926639.5,21981051.0,-123791218.0,-218707945.5,-2018639.5,5922788179.747461,18722299500.0,198779007.825,447956302.4549976,1948107.735,256762374.1650008,309117001.61249864,636551223.1199981,459147474.0449993,5707945311.2325325,5886080338.027499,5886323520.7725,13380.0,80836.5,44.0,70350.0,971545.0,-1698596.0,177364.0,6755.0,4272939.5,2479218.0,-9003611.5,921269.0,37582.5,3733396209.382464,3657869628.0299616,-260629707.0,-257318814.0,2526571.0,269196.0,3926069581.049956,33253942061.02592,36683055941.71514,1729325819.6100495,48084441824.093216,3988075.0,-247588324.5,103087490117.0,1054174494.5,17274402959.5,3504056607.0,18888241255.0,3672150.0,71920.0,20870.223762859023,89788117.5,-50.98956703182056,1.3333333333333333,8.179339594062405,214.79169865503604,10.905786125416538,286.388931540048,121500.0,1.0,0.0,0.0,0.0,0.0,0.0,0.0,0.0,1.0,0.0,0.0,0.0,0.0,0.0,0.0,1.0,0.0,1.0,0.0,0.0,0.0,0.0,0.0,0.0,1.0,0.0,0.0,1.0,0.0,0.0,0.0,0.0,0.0,0.0,0.0,0.0,0.0,0.0,0.0,0.0,0.0,0.0,0.0,0.0,0.0,0.0,0.0,0.0,0.0,0.0,0.0,0.0,0.0,0.0,0.0,1.0,0.0,0.0,0.0,0.0,0.0,0.0,0.0,0.0,0.0,0.0,0.0,0.0,0.0,0.0,0.0,0.0,0.0,0.0,0.0,0.0,0.0,0.0,0.0,0.0,0.0,0.0,0.0,0.0,0.0,0.0,0.0,0.0,0.0,0.0,0.0,0.0,0.0,0.0,0.0,0.0,0.0,0.0,0.0,0.0,0.0,0.0,0.0,0.0,0.0,0.0,0.0,0.0,0.0,0.0,1.0,0.0,1.0,0.0,0.0,0.0,0.0,0.0,0.0,1.0,0.0,0.0
102749,0,0.0,1.0,1.0,0.0,0.0,135000.0,537471.0,56569.5,495000.0,0.007305,54.6109589041096,-4280.0,-5061.0,-3193.0,1.0,2.0,3.0,3.0,12.0,,0.5497548968878996,0.7981372313187245,,,,,,,,,,,,,,,,,,,,,,,,,,,,,,,,,,,,,,,,,,,,,5.0,0.0,5.0,0.0,-1681.0,0.0,0.0,0.0,0.0,0.0,2.0,1.0,1.0,0.0,1.0,0.0,0.0,0.0,0.0,0.0,0.0,1.0,1.0,0.0,1.0,0.0,0.0,0.0,0.0,0.0,0.0,0.0,0.0,0.0,0.0,0.0,0.0,0.0,0.0,0.0,0.0,0.0,0.0,1.0,0.0,,450000.0,0.0,0.0,0.0,0.0,0.0,-2134.0,-1410.0,-402.0,-1410.0,71.0,-35.0,9.0,23215.185,45000.0,45000.0,10813.5,216243.0,10.0,-546.0,365243.0,-920.5,-515.5,-350.5,-511.5,8.0,0.0,0.0510740511415752,-1.0,41.0,16.0,10.0,-35.0,0.0,0.0,59.0,7962.75,7962.75,-495.0,-486.0,8.0,1.0,17.0,0.0,225000.0,0.0,0.0,0.0,0.0,0.0,125.055,125.055,0.0,0.0,0.0,0.0,0.0,0.0,0.0,2.0,-9.0,0.0,0.0,8346821818.5,184399660386.0,165585927564.0,51971622157.935,1863.0,1705.0,71125.0,70819.0,9140.0,506060.0,,,,,,,128413.0,662822.0,,,,13527849.02739686,-601898730.0,-921909169.0,-296520590.0,-1535160679.0416667,44018.0,30705.0,,,,,,,,158042.7170596385,126106.72469054944,,,,,,,3714259.0,,,,,,,,,,,,,,,,436477.0,431271.0,1263253.0,6425.250438002897,631963.0,625515.0,,,,,,,,,71.0,42756591.41999999,,4536305887.14,1468654376.985,51936359.80499996,696734.0099999999,86.0,11949.0,-14746743.0,6444694.0,-7623700.0,-8278615.0,-35.0,0.0,,450000.0,0.0,0.0,0.0,0.0,0.0,-2134.0,-1410.0,-402.0,-1410.0,162092004.43500003,2319943153.1400023,2615998300.425,37286227.215,2319943153.1400023,167350.0,-11526271.0,2657939760.0,115583787.0,590002751.5,262263223.5,614309871.0,166673.0,2613.5,467.8380426981541,3940634.0,1374341.0,841216.0,-2759298.0,902882.0,98997.0,1834682404.9050035,1846845594.764987,-112655184.0,-111749358.0,2033201.0,91117.0,1742929643.6999884,4695358500.0,148018722.39,232462314.31499955,9628811.1,74601818.73000005,99375006.37499969,254187103.45500043,235063850.94,1673031298.2299974,1736363948.354987,1736428255.2899866,7556.0,19501.0,126.0,11819.0,582302.0,-1047530.0,495600.0,947.0,1467432.0,14781142.0,3232879.0,8555028.0,11607915.0,1415699.0,1058682195.1170008,,72106604655.81712,21675553153.31262,582257468.0294988,5792665.7475,689.5,94245.0,-276928773.5,21979641.0,-123791620.0,-218709355.5,-2018674.5,5922788179.747461,18722524500.0,198779007.825,447956302.4549976,1948107.735,256762374.1650008,309117001.61249864,636551348.174998,459147599.0999993,5707945311.2325325,5886080338.027499,5886323520.7725,13380.0,80836.5,44.0,70350.0,971547.0,-1698605.0,177364.0,6755.0,4272955.5,2479228.0,-9003646.5,921269.0,37582.5,3733404172.132464,3657877590.7799616,-260630202.0,-257319300.0,2526579.0,269197.0,3926092796.234956,33253987061.02592,36683100941.71514,1729336633.1100495,48084658067.093216,3988085.0,-247588870.5,103087855360.0,1054173574.0,17274402444.0,3504056256.5,18888240743.5,3672158.0,71920.0,20870.27483691017,89788116.5,-78.37254803592032,3.9812666666666665,2.3864449924429243,130.32604940921863,9.5010739002466,518.8627563112751,67500.0,-0.2225209339563143,0.9749279121818236,0.0,0.0,0.0,0.0,0.0,0.0,1.0,0.0,0.0,0.0,0.0,0.0,0.0,1.0,0.0,0.0,0.0,0.0,1.0,0.0,1.0,0.0,0.0,0.0,0.0,1.0,0.0,0.0,0.0,0.0,0.0,0.0,0.0,0.0,0.0,0.0,0.0,0.0,1.0,0.0,0.0,0.0,0.0,0.0,0.0,0.0,0.0,0.0,0.0,0.0,0.0,0.0,0.0,1.0,0.0,0.0,0.0,0.0,0.0,0.0,0.0,0.0,0.0,0.0,0.0,0.0,0.0,0.0,0.0,0.0,0.0,0.0,0.0,0.0,0.0,0.0,0.0,0.0,0.0,0.0,0.0,0.0,0.0,0.0,0.0,0.0,0.0,0.0,0.0,0.0,0.0,0.0,0.0,0.0,0.0,0.0,0.0,0.0,0.0,0.0,0.0,0.0,0.0,0.0,0.0,0.0,0.0,0.0,0.0,0.0,0.0,0.0,0.0,0.0,0.0,0.0,0.0,0.0,0.0,0.0
102755,0,0.0,0.0,0.0,1.0,0.0,112500.0,165915.0,13239.0,126000.0,0.011703,57.94520547945206,,-3576.0,-3576.0,,1.0,2.0,2.0,15.0,,0.685671190086988,0.4507472818545589,0.0082,,0.9682,,,,0.0345,0.0417,,0.048,,0.008,,0.0232,0.0084,,0.9682,,,,0.0345,0.0417,,0.0491,,0.0083,,0.0246,0.0083,,0.9682,,,,0.0345,0.0417,,0.0489,,0.0082,,0.0237,0.0113,1.0,0.0,0.0,0.0,0.0,-873.0,0.0,0.0,0.0,0.0,0.0,0.0,1.0,0.0,0.0,1.0,0.0,0.0,0.0,0.0,0.0,0.0,0.0,0.0,0.0,1.0,0.0,0.0,0.0,0.0,0.0,0.0,0.0,0.0,0.0,0.0,0.0,0.0,0.0,0.0,0.0,0.0,0.0,0.0,6.0,12150.0,0.0,382500.0,96218.55,0.0,0.0,0.0,0.0,-1504.5,-343.0,-327.5,-605.5,283.0,-26.0,21.0,9000.0,90000.0,104850.0,,112500.0,18.0,-666.0,365243.0,-532.0,182500.0,698.0,182501.5,10.0,1.0,,-1.0,30.0,36.0,29.5,-14.5,0.0,0.0,30.0,26126.865,26126.865,-452.0,-438.0,8.0,1.0,0.0,,,,,,,,,,,,,,,,,,,,,8346835057.5,184399826301.0,165586053564.0,51971734657.935,1863.0,1705.0,71125.0,70819.0,9140.0,506060.0,17808.220600002292,17870.41099999911,17321.826699998048,,,,128413.0,662823.0,,,,13527906.97260234,,-921912745.0,-296521463.0,-1535164255.0416667,44018.0,30705.0,,,,22887.492300009697,22809.40900000966,22194.897900008214,,158043.4027308286,126107.17543783128,35002.22210002793,34942.51240002837,34388.17560002878,,,,3714274.0,8295.617200000164,8400.146200000077,8123.74120000023,,,,16468.00769999976,16653.26789999969,16250.0515999997,,,,3913.908800000125,3897.084400000163,3729.6606000001593,436477.0,431271.0,,6425.262141002897,631965.0,625517.0,,16332.3023999998,154179.77969999055,154182.52429999015,154074.28239998713,,,,50.0,42974067.41999999,18631987.69500001,4544266980.240003,1471899175.11,52031521.48499997,696734.0099999999,86.0,11949.0,-14789404.0,6488933.0,-7646032.5,-8301858.5,-24.5,0.0,0.0,450000.0,0.0,0.0,0.0,0.0,0.0,-2203.0,-343.0,-338.0,-343.0,162518026.05000004,2325359618.6400023,2622635534.925,,2325697118.6400023,167825.0,-11553525.0,2664879141.5,116297475.5,591451521.5,262983289.5,615758934.0,167266.0,2618.5,,3943356.0,1376715.0,842602.0,-2765200.5,905759.0,99003.0,1837226027.137504,1849378184.7974868,-112800612.5,-111893474.5,2034114.5,91277.5,,,,,,,,,,,,,,,,,,,,,1467438.0,14781425.0,3232879.0,8555058.0,11607945.0,1415720.0,1058694345.1170008,801671219.4824951,72106987155.81712,21675649371.862617,582257468.0294988,5792665.7475,689.5,94245.0,-276930278.0,21979298.0,-123791947.5,-218709961.0,-2018700.5,,,,,,,,,,,,,,,,,,,,,4272991.5,2479257.5,-9003661.0,921269.0,37582.5,3733430298.997463,3657903717.644962,-260630654.0,-257319738.0,2526587.0,269198.0,3926101796.234956,33254077061.02592,36683205791.71514,,48084770567.093216,3988103.0,-247589536.5,103088220603.0,1054173042.0,17274584944.0,3504056954.5,18888423245.0,3672168.0,71921.0,,89788115.5,,1.4748,8.49762066621346,492.3963755901773,12.532290958531611,726.1861747203934,112500.0,0.6234898018587336,0.7818314824680298,0.0,0.0,0.0,0.0,0.0,0.0,1.0,0.0,0.0,1.0,0.0,0.0,0.0,0.0,0.0,0.0,0.0,0.0,1.0,0.0,0.0,0.0,0.0,1.0,0.0,1.0,0.0,0.0,0.0,0.0,0.0,0.0,0.0,0.0,0.0,0.0,0.0,0.0,0.0,0.0,0.0,0.0,0.0,0.0,0.0,0.0,0.0,0.0,0.0,0.0,0.0,0.0,0.0,0.0,0.0,0.0,0.0,0.0,0.0,0.0,0.0,0.0,0.0,0.0,0.0,0.0,0.0,0.0,0.0,0.0,0.0,0.0,0.0,0.0,0.0,0.0,0.0,0.0,0.0,0.0,0.0,0.0,0.0,0.0,0.0,0.0,0.0,0.0,0.0,0.0,0.0,0.0,0.0,0.0,0.0,0.0,0.0,0.0,0.0,0.0,0.0,0.0,0.0,0.0,0.0,1.0,0.0,0.0,0.0,0.0,1.0,0.0,0.0,1.0,0.0,0.0,0.0,0.0,0.0,0.0
102763,0,0.0,1.0,1.0,1.0,2.0,387000.0,218938.5,26113.5,189000.0,0.0035409999999999,29.04383561643836,-1714.0,-5459.0,-3220.0,1.0,4.0,1.0,1.0,13.0,0.2991815406116581,0.6118029026677672,0.656158373001177,0.0679,0.0656,0.9911,0.8776,0.0341,0.0264,0.1224,0.2404,0.2821,0.0304,0.0441,0.0749,0.0077,0.0092,0.0294,0.0,0.9871,0.8301,0.0172,0.0,0.069,0.1667,0.2083,0.009,0.0321,0.0328,0.0039,0.0,0.0375,0.0369,0.9911,0.8792,0.0343,0.0,0.069,0.1667,0.2083,0.0164,0.0449,0.0452,0.0078,0.0,0.1988,1.0,2.0,0.0,2.0,0.0,-402.0,0.0,0.0,0.0,0.0,2.0,1.0,1.0,1.0,0.0,1.0,0.0,1.0,0.0,0.0,0.0,0.0,0.0,0.0,0.0,1.0,0.0,0.0,0.0,0.0,0.0,0.0,0.0,0.0,0.0,0.0,0.0,0.0,0.0,0.0,0.0,0.0,0.0,0.0,4.0,47936.25,0.0,1317656.25,577089.0,,0.0,0.0,0.0,-808.0,-288.0,-361.0,-647.0,114.0,-14.0,3.0,86724.225,0.0,0.0,,900000.0,12.0,-401.0,365243.0,-368.0,-278.0,-38.0,-275.0,11.0,1.0,,-1.0,5.0,12.0,10.0,-11.0,0.0,0.0,5.0,86724.225,360000.0,-346.0,-338.0,2.0,3.0,0.0,,,,,,,,,,,,,,,,,,,,,8346861171.0,184400045239.5,165586242564.0,51972121657.935,1863.0,1705.0,71125.0,70821.0,9140.0,506061.0,17808.28850000229,17870.448499999107,17321.856099998047,11296.190400000092,11233.968900000094,11181.260000000057,128415.0,662827.0,4137.9650000001175,4135.634200000016,3946.201900000095,13527936.016437955,-601900444.0,-921915965.0,-296521865.0,-1535169714.0416667,44018.0,30705.0,11350.095199999185,11226.059999998975,10710.340399997294,22887.614700009697,22809.478000009654,22194.966900008218,67465.35767053085,158044.01453373124,126107.8315962043,35002.46250002793,34942.67910002837,34388.34230002878,22955.95749999592,22929.067299995488,22575.83139999572,3714287.0,8295.647600000164,8400.162600000078,8123.75020000023,9817.994200000718,9932.953300002162,10292.607499999644,16468.082599999758,16653.31309999969,16250.0843999997,828.7349000001761,813.9110000000459,759.8373000000131,3913.918000000125,3897.084400000163,3729.6606000001593,436479.0,431273.0,1263254.0,6425.265682002897,631966.0,625518.0,,16332.5011999998,154180.7707999906,154183.51539999017,154075.26949998713,77616.27079999627,77954.07680000657,78355.40080000654,27.0,43173273.41999999,18687992.62500001,4565818712.970002,1481978974.8149998,,696734.0099999999,86.0,11949.0,-14838469.0,6512317.0,-7671531.0,-8328001.0,-13.0,0.0,157.5,1960312.5,577089.0,,0.0,0.0,0.0,-960.0,-288.0,-642.0,-652.0,163196668.17000005,2334876774.3900023,2632849049.925,,2335776774.3900023,168383.0,-11581284.0,2673096281.0,116645390.0,594361251.0,264439061.0,618668758.0,167784.0,2623.0,,3959847.0,1380625.0,845446.0,-2770242.0,905759.0,99003.0,1844682922.350005,1857108575.609988,-112940889.0,-112031239.0,2035833.0,91532.0,,,,,,,,,,,,,,,,,,,,,1467442.0,14781539.0,3232879.0,8555063.0,11607950.0,1415723.0,1058742281.3670008,801671219.4824951,72108304812.06712,21676226460.862617,,5792665.7475,689.5,94245.0,-276931086.0,21979010.0,-123792308.5,-218710608.0,-2018714.5,,,,,,,,,,,,,,,,,,,,,4273003.5,2479267.5,-9003672.0,921269.0,37582.5,3733517023.222463,3658263717.644962,-260631000.0,-257320076.0,2526589.0,269201.0,3926188520.459956,33254077061.02592,36683205791.71514,,48085670567.093216,3988115.0,-247589937.5,103088585846.0,1054172674.0,17274584666.0,3504056916.5,18888422970.0,3672179.0,71922.0,,89788114.5,-59.014243939251,0.5657325581395349,14.819920730656555,430.4273415498361,8.384111666379459,243.5067610281881,96750.0,0.6234898018587336,0.7818314824680298,0.0,0.0,0.0,0.0,0.0,0.0,1.0,0.0,0.0,0.0,0.0,0.0,0.0,1.0,0.0,1.0,0.0,0.0,0.0,0.0,1.0,0.0,0.0,0.0,0.0,0.0,0.0,0.0,0.0,1.0,0.0,0.0,0.0,0.0,0.0,0.0,1.0,0.0,0.0,0.0,0.0,0.0,0.0,0.0,0.0,0.0,0.0,0.0,0.0,0.0,0.0,0.0,0.0,0.0,0.0,0.0,0.0,0.0,0.0,0.0,0.0,0.0,0.0,0.0,0.0,0.0,0.0,0.0,0.0,0.0,0.0,0.0,0.0,0.0,1.0,0.0,0.0,0.0,0.0,0.0,0.0,0.0,0.0,0.0,0.0,0.0,0.0,0.0,0.0,0.0,0.0,0.0,0.0,0.0,0.0,0.0,0.0,0.0,0.0,0.0,0.0,0.0,0.0,0.0,0.0,0.0,1.0,0.0,0.0,0.0,1.0,0.0,0.0,0.0,0.0,0.0,0.0,1.0,0.0,0.0
102770,0,0.0,1.0,1.0,0.0,2.0,45000.0,225000.0,11619.0,225000.0,0.010966,34.364383561643834,-811.0,-608.0,-2715.0,13.0,4.0,2.0,2.0,16.0,0.4359345522552923,0.6286848460146053,0.6430255641096323,,,,,,,,,,,,,,,,,,,,,,,,,,,,,,,,,,,,,,,,,,,,,2.0,1.0,2.0,1.0,-482.0,0.0,0.0,0.0,0.0,0.0,2.0,1.0,1.0,1.0,1.0,0.0,0.0,0.0,0.0,0.0,0.0,1.0,1.0,0.0,1.0,0.0,0.0,0.0,0.0,0.0,0.0,0.0,0.0,0.0,0.0,0.0,0.0,0.0,0.0,0.0,0.0,0.0,0.0,8.0,0.0,,109991.25,0.0,0.0,0.0,0.0,0.0,-1073.0,285.0,-644.5,-1291.5,356.0,-27.0,2.0,4902.705,86240.25,95960.25,0.0,86240.25,25.0,-677.0,365243.0,-641.5,-401.5,78.5,-396.0,14.0,0.0,0.0,40.0,22.0,36.0,26.0,-18.5,0.0,0.0,18.0,6058.755,6058.755,-592.5,-586.0,5.0,1.0,0.0,,,,,,,,,,,,,,,,,,,,,8346872790.0,184400270239.5,165586467564.0,51972166657.935,1863.0,1705.0,71125.0,70821.0,9140.0,506063.0,,,,,,,128417.0,662831.0,,,,13527970.38082152,-601901255.0,-921918680.0,-296522347.0,-1535170322.0416667,44019.0,30706.0,,,,,,,67465.79360508309,158044.64321857726,126108.4746217684,,,,,,,3714303.0,,,,,,,,,,,,,,,,436481.0,431275.0,1263267.0,6425.276648002897,631968.0,625520.0,,,,,,,,,35.5,43226596.21499999,,4575368239.020002,1482625954.125,52031521.48499997,696734.0099999999,86.0,11949.0,-14875774.0,6528413.0,-7688950.0,-8350503.0,-17.25,0.0,,125482.5,0.0,0.0,0.0,0.0,0.0,-2423.0,-21.0,-799.0,-1755.0,163399695.6375001,2338061161.1400023,2636256983.175,37475211.465,2338061161.1400023,168634.0,-11599793.0,2678757547.5,116628023.0,594713660.0,264428759.0,619386501.0,167993.5,2630.0,470.3451428861789,3961532.0,1383276.0,847062.0,-2776399.5,905759.0,99003.0,1848969941.242509,1861263202.387491,-113297934.5,-112386035.5,2043455.0,91739.5,,,,,,,,,,,,,,,,,,,,,1467450.0,14781895.0,3232879.0,8555085.0,11607968.0,1415725.0,1058742281.3670008,,72108414803.31712,21676226460.862617,582257468.0294988,5792665.7475,689.5,94245.0,-276932159.0,21979295.0,-123792953.0,-218711899.5,-2018741.5,,,,,,,,,,,,,,,,,,,,,4273039.5,2479293.5,-9003690.5,921269.0,37582.5,3733523081.9774632,3658269776.399962,-260631592.5,-257320662.0,2526594.0,269202.0,3926193423.164956,33254163301.27592,36683301751.96514,1729336633.1100495,48085756807.343216,3988140.0,-247590614.5,103088951089.0,1054172032.5,17274584264.5,3504056995.0,18888422574.0,3672193.0,71922.0,20870.27483691017,89788154.5,-23.60001594514869,5.0,3.872966692486445,133.09211294207526,19.364833462432227,665.4605647103764,11250.0,-0.2225209339563143,0.9749279121818236,0.0,0.0,0.0,0.0,0.0,0.0,1.0,0.0,0.0,0.0,0.0,0.0,0.0,1.0,0.0,0.0,0.0,0.0,1.0,0.0,1.0,0.0,0.0,0.0,0.0,1.0,0.0,0.0,0.0,0.0,0.0,0.0,0.0,0.0,0.0,0.0,0.0,0.0,0.0,0.0,0.0,0.0,0.0,0.0,0.0,1.0,0.0,0.0,0.0,0.0,0.0,0.0,0.0,0.0,0.0,0.0,0.0,0.0,0.0,0.0,0.0,0.0,0.0,0.0,0.0,0.0,0.0,0.0,0.0,0.0,0.0,0.0,0.0,0.0,0.0,0.0,0.0,0.0,0.0,0.0,0.0,1.0,0.0,0.0,0.0,0.0,0.0,0.0,0.0,0.0,0.0,0.0,0.0,0.0,0.0,0.0,0.0,0.0,0.0,0.0,0.0,0.0,0.0,0.0,0.0,0.0,0.0,0.0,0.0,0.0,0.0,0.0,0.0,0.0,0.0,0.0,0.0,0.0,0.0,0.0
102772,0,0.0,0.0,0.0,1.0,0.0,247500.0,502497.0,39829.5,454500.0,0.010643,42.232876712328775,-1393.0,-849.0,-3474.0,,2.0,2.0,2.0,12.0,0.6659151389731786,0.30640821268493,0.4311917977993083,,,,,,,,,,,,,,,,,,,,,,,,,,,,,,,,,,,,,,,,,,,,,3.0,0.0,3.0,0.0,-1041.0,0.0,0.0,0.0,0.0,1.0,7.0,1.0,1.0,0.0,1.0,1.0,1.0,0.0,0.0,0.0,0.0,1.0,1.0,0.0,1.0,0.0,0.0,0.0,0.0,0.0,0.0,0.0,0.0,0.0,0.0,0.0,0.0,0.0,0.0,0.0,0.0,0.0,0.0,8.0,0.0,,128250.0,0.0,0.0,0.0,0.0,0.0,-1015.5,180.5,-14.0,-1030.0,352.0,-23.0,14.0,16169.9625,178560.0,175482.0,17856.0,296910.0,18.0,-545.5,365243.0,-1011.0,-741.0,-93.0,-732.0,14.0,0.0,0.1054541905142197,-1.0,80.0,24.0,12.5,-29.5,0.0,0.0,93.0,11466.495,11466.495,-501.0,-483.0,8.0,1.0,8.0,138518.3025,144000.0,0.0,13151.25,0.0,5908.5,6411.8025,9236.34,9000.0,131681.475,136748.115,136748.115,0.0,1.0,0.0,0.5,2.5,-4.5,0.0,0.0,8346912619.5,184400772736.5,165586922064.0,51972414157.935,1863.0,1705.0,71125.0,70822.0,9140.0,506070.0,,,,,,,128417.0,662833.0,,,,13528012.613698233,-601902648.0,-921922154.0,-296523388.0,-1535171171.0416667,44019.0,30706.0,,,,,,,67466.45952022207,158044.94962678995,126108.9058135662,,,,,,,3714315.0,,,,,,,,,,,,,,,,436484.0,431278.0,,6425.287291002896,631970.0,625522.0,,,,,,,,,33.5,43281061.96499999,,4578682775.895002,1484523246.465,52040233.25999997,696734.0099999999,86.0,11949.0,-14889911.5,6526980.5,-7693240.0,-8358213.0,-16.25,0.0,,39753.0,0.0,0.0,0.0,0.0,0.0,-2747.0,-2442.0,-14.0,-2550.0,163548902.85750008,2340569746.8900023,2638772422.425,37596810.465,2340569746.8900023,168780.0,-11610137.0,2681131385.0,116619267.0,594710827.0,264426301.0,619383685.0,168168.0,2632.0,471.5798616437352,3967666.0,1384477.0,847823.0,-2779474.0,905759.0,99003.0,1850508535.455007,1862801680.8599892,-113388903.0,-112476290.0,2043979.0,91805.0,1754052488.4824874,4750992000.0,149207172.39,234375157.9799996,9628811.1,75325577.67000005,100176425.18999968,255989540.7450004,236823516.67500004,1683697817.789997,1747463440.5674863,1747527747.5024867,7587.0,19640.5,126.0,11927.5,587335.0,-1053058.5,495600.0,947.0,1467458.0,14782247.0,3232887.0,8555165.0,11608061.0,1415739.0,1058742281.3670008,,72108543053.31712,21676226460.862617,582257468.0294988,5792665.7475,689.5,94245.0,-276933174.5,21979475.5,-123792967.0,-218712929.5,-2018764.5,5922926698.049962,18722668500.0,198779007.825,447969453.7049976,1948107.735,256768282.6650008,309123413.41499865,636560584.5149982,459156599.0999993,5708076992.707533,5886217086.142499,5886460268.8875,13380.0,80837.5,44.0,70350.5,971549.5,-1698609.5,177364.0,6755.0,4273063.5,2479306.0,-9003720.0,921269.0,37582.5,3733534548.472463,3658281242.894962,-260632093.5,-257321145.0,2526602.0,269203.0,3926209593.127456,33254341861.27592,36683477233.96514,1729354489.1100495,48086053717.343216,3988158.0,-247591160.0,103089316332.0,1054171021.5,17274583523.5,3504056902.0,18888421842.0,3672207.0,71922.0,20870.38029110068,89788153.5,-32.983782030489785,2.030290909090909,6.213987120099424,262.43455193515786,12.61620155914586,532.818485025297,123750.0,-0.9009688679024191,0.4338837391175582,0.0,0.0,0.0,0.0,0.0,0.0,1.0,0.0,1.0,0.0,0.0,0.0,0.0,0.0,0.0,0.0,0.0,0.0,1.0,0.0,1.0,0.0,0.0,0.0,0.0,1.0,0.0,0.0,0.0,0.0,0.0,0.0,0.0,0.0,0.0,0.0,0.0,0.0,1.0,0.0,0.0,0.0,0.0,0.0,0.0,0.0,0.0,0.0,0.0,0.0,0.0,0.0,0.0,0.0,0.0,0.0,0.0,0.0,0.0,0.0,0.0,0.0,0.0,0.0,0.0,0.0,0.0,0.0,0.0,1.0,0.0,0.0,0.0,0.0,0.0,0.0,0.0,0.0,0.0,0.0,0.0,0.0,0.0,0.0,0.0,0.0,0.0,0.0,0.0,0.0,0.0,0.0,0.0,0.0,0.0,0.0,0.0,0.0,0.0,0.0,0.0,0.0,0.0,0.0,0.0,0.0,0.0,0.0,0.0,0.0,0.0,0.0,0.0,0.0,0.0,0.0,0.0,0.0,0.0,0.0
102799,0,0.0,0.0,0.0,1.0,0.0,54000.0,418743.0,25749.0,342000.0,0.010032,45.39452054794521,-949.0,-904.0,-94.0,,2.0,2.0,2.0,6.0,,0.3248929283802761,0.3622772470384314,0.033,0.0,,,,0.0,0.069,0.125,,0.0071,,0.0254,,0.0,0.0336,0.0,,,,0.0,0.069,0.125,,0.0072,,0.0265,,0.0,0.0333,0.0,,,,0.0,0.069,0.125,,0.0072,,0.0259,,0.0,0.02,1.0,0.0,0.0,0.0,0.0,-587.0,0.0,0.0,0.0,0.0,0.0,3.0,1.0,1.0,0.0,1.0,0.0,0.0,0.0,0.0,0.0,0.0,1.0,1.0,0.0,1.0,0.0,0.0,0.0,0.0,0.0,0.0,0.0,0.0,0.0,0.0,0.0,0.0,0.0,0.0,0.0,0.0,0.0,0.0,2.0,0.0,,152023.5,63744.75,0.0,0.0,0.0,0.0,-389.0,361.5,-74.0,-31.0,27.0,-6.0,3.0,34917.9525,389254.5,373446.0,38929.5,556877.25,24.0,-430.0,365243.0,-476.5,182495.0,213.5,182496.5,4.0,0.5,0.1028134904848967,-1.0,25.0,36.0,23.0,-11.0,0.0,0.0,25.0,31692.15,31692.15,-319.0,-310.0,7.0,1.0,0.0,,,,,,,,,,,,,,,,,,,,,8346938368.5,184401191479.5,165587264064.0,51972468157.935,1863.0,1705.0,71125.0,70822.0,9140.0,506073.0,17808.32150000229,17870.481799999106,17321.889699998046,11296.190400000092,11233.968900000094,11181.260000000057,128417.0,662835.0,,,,13528058.008218778,-601903597.0,-921922248.0,-296523975.0,-1535172075.0416667,44019.0,30706.0,11350.095199999185,11226.059999998975,10710.340399997294,22887.683700009697,22809.547000009657,22195.035900008217,,158045.27451971837,126109.26809081325,35002.58750002793,34942.80410002837,34388.46730002878,,,,3714321.0,8295.654700000165,8400.169800000078,8123.75740000023,,,,16468.107999999756,16653.33899999969,16250.1108999997,,,,3913.918000000125,3897.084400000163,3729.6606000001593,436484.0,431278.0,,6425.2973230028965,631972.0,625524.0,,16332.5211999998,,,,,,,13.5,43328199.86999999,,4615544410.425001,1498849422.3,52345911.41999997,696734.0099999999,90.0,11949.0,-15036035.5,6642220.0,-7764665.5,-8440270.0,-6.25,0.0,,135000.0,127489.5,0.0,0.0,0.0,0.0,-553.0,754.0,-137.0,-31.0,164997825.43500012,2360046213.2700024,2661755888.925,37978863.345,2360408463.2700024,170473.0,-11702045.0,2702493137.5,117654697.0,601788286.5,268043768.0,627559328.5,169875.0,2648.5,476.238169946943,4000877.0,1397412.0,855010.0,-2799314.0,939538.0,99019.0,1862569987.6049988,1874456935.424981,-114352380.0,-113431142.0,2066648.0,92442.0,,,,,,,,,,,,,,,,,,,,,1467460.0,14782274.0,3232887.0,8555190.0,11608086.0,1415742.0,1058742281.3670008,,72108695076.81712,21676290205.612617,582257468.0294988,5792665.7475,689.5,94245.0,-276933563.5,21979837.0,-123793041.0,-218712960.5,-2018770.5,,,,,,,,,,,,,,,,,,,,,4273099.5,2479329.0,-9003731.0,921269.0,37582.5,3733566240.622463,3658312935.044962,-260632412.5,-257321455.0,2526609.0,269204.0,3926244511.079956,33254731115.77592,36683850679.96514,1729393418.6100495,48086610594.593216,3988182.0,-247591590.0,103089681575.0,1054170545.0,17274766018.5,3504057115.5,18888604338.5,3672211.0,71922.5,20870.483104591167,89788152.5,-20.9056068561772,7.7545,2.097168822090178,95.19997318688264,16.262495630898286,738.2281920776812,27000.0,-0.9009688679024191,-0.433883739117558,0.0,0.0,0.0,0.0,0.0,0.0,1.0,0.0,0.0,0.0,0.0,0.0,0.0,1.0,0.0,0.0,0.0,1.0,0.0,0.0,1.0,0.0,0.0,0.0,0.0,1.0,0.0,0.0,0.0,0.0,0.0,0.0,0.0,0.0,0.0,0.0,0.0,0.0,0.0,0.0,0.0,0.0,0.0,0.0,0.0,0.0,0.0,0.0,0.0,0.0,0.0,0.0,0.0,0.0,0.0,0.0,0.0,0.0,0.0,0.0,0.0,0.0,0.0,0.0,0.0,0.0,0.0,0.0,0.0,0.0,0.0,0.0,0.0,0.0,0.0,0.0,0.0,0.0,0.0,0.0,0.0,0.0,0.0,0.0,0.0,0.0,0.0,1.0,0.0,0.0,0.0,0.0,0.0,0.0,0.0,0.0,0.0,0.0,0.0,0.0,0.0,0.0,0.0,0.0,0.0,0.0,0.0,0.0,0.0,0.0,1.0,0.0,0.0,0.0,0.0,0.0,0.0,0.0,1.0,0.0
102838,0,0.0,0.0,0.0,1.0,1.0,148500.0,111384.0,8748.0,90000.0,0.007305,37.64657534246575,-5521.0,-850.0,-4378.0,,2.0,3.0,3.0,9.0,,0.5935039800840594,0.6722428897082422,,,,,,,,,,,,,,,,,,,,,,,,,,,,,,,,,,,,,,,,,,,,,2.0,0.0,2.0,0.0,-395.0,0.0,0.0,0.0,0.0,1.0,0.0,1.0,1.0,1.0,1.0,1.0,0.0,0.0,0.0,0.0,0.0,0.0,0.0,0.0,1.0,0.0,0.0,0.0,0.0,0.0,0.0,0.0,0.0,0.0,0.0,0.0,0.0,0.0,0.0,0.0,0.0,0.0,0.0,10.0,0.0,0.0,218250.0,0.0,0.0,0.0,0.0,0.0,-1444.5,-598.5,-834.5,-1061.5,464.0,-23.0,1.0,6781.905,69615.0,69615.0,0.0,69615.0,12.0,-395.0,365243.0,-357.0,-27.0,-27.0,-18.0,13.0,0.0,0.0,117.0,12.0,12.0,6.5,-7.5,0.0,0.0,12.0,6781.905,6781.905,-204.0,-192.0,6.5,1.0,0.0,,,,,,,,,,,,,,,,,,,,,8346947116.5,184401302863.5,165587354064.0,51972616657.935,1863.0,1705.0,71125.0,70823.0,9140.0,506073.0,,,,,,,128418.0,662837.0,,,,13528095.65479412,-601909118.0,-921926626.0,-296524370.0,-1535172925.0416667,44019.0,30706.0,,,,,,,,158045.86802369842,126109.94033370297,,,,,,,3714330.0,,,,,,,,,,,,,,,,436486.0,431280.0,,6425.304628002897,631975.0,625527.0,,,,,,,,,48.0,44127350.27999998,19143496.440000024,4725340384.365004,1553413235.805,53190120.14999996,709752.5099999999,90.0,11997.0,-15287274.5,6676316.0,-7899772.0,-8589988.5,-23.5,0.0,0.0,270000.0,0.0,0.0,0.0,0.0,0.0,-1641.0,-1081.0,-881.0,-1563.0,166772723.85000023,2382634503.0000024,2686492900.8450003,38580014.655,2382634503.0000024,172041.0,-11822047.0,2733718075.0,119029520.0,608480197.0,270916809.0,634618021.0,171731.0,2671.0,483.64656508616633,4076077.0,1410826.0,863774.0,-2826051.5,939607.0,99034.0,1883245037.1074944,1894837054.342477,-115178650.0,-114247991.5,2075104.5,93312.5,,,,,,,,,,,,,,,,,,,,,1467470.0,14782738.0,3232887.0,8555202.0,11608098.0,1415743.0,1058742281.3670008,801671219.4824951,72108913326.81712,21676290205.612617,582257468.0294988,5792665.7475,689.5,94245.0,-276935008.0,21979238.5,-123793875.5,-218714022.0,-2018793.5,,,,,,,,,,,,,,,,,,,,,4273111.5,2479335.5,-9003738.5,921269.0,37582.5,3733573022.527464,3658319716.9499617,-260632616.5,-257321647.0,2526615.5,269205.0,3926251292.984956,33254800730.77592,36683920294.96514,1729393418.6100495,48086680209.593216,3988194.0,-247591985.0,103090046818.0,1054170188.0,17274765991.5,3504057088.5,18888604320.5,3672224.0,71922.5,20870.483104591167,89788269.5,-146.6534458918565,0.7500606060606061,16.97530864197531,639.0622357517335,12.732510288065846,479.3354078583912,74250.0,-0.9009688679024191,0.4338837391175582,0.0,1.0,0.0,0.0,0.0,0.0,0.0,0.0,0.0,0.0,0.0,0.0,0.0,1.0,0.0,1.0,0.0,0.0,0.0,0.0,0.0,1.0,0.0,0.0,0.0,1.0,0.0,0.0,0.0,0.0,0.0,0.0,0.0,0.0,0.0,0.0,0.0,0.0,0.0,0.0,0.0,1.0,0.0,0.0,0.0,0.0,0.0,0.0,0.0,0.0,0.0,0.0,0.0,0.0,0.0,0.0,0.0,0.0,0.0,0.0,0.0,0.0,0.0,0.0,0.0,0.0,0.0,0.0,0.0,0.0,0.0,0.0,0.0,0.0,0.0,0.0,0.0,0.0,1.0,0.0,0.0,0.0,0.0,0.0,0.0,0.0,0.0,0.0,0.0,0.0,0.0,0.0,0.0,0.0,0.0,0.0,0.0,0.0,0.0,0.0,0.0,0.0,0.0,0.0,0.0,0.0,0.0,0.0,0.0,0.0,0.0,0.0,0.0,0.0,0.0,0.0,0.0,0.0,0.0,0.0
102854,0,0.0,0.0,0.0,0.0,0.0,57150.0,136260.0,8334.0,112500.0,0.01885,61.7013698630137,,-10773.0,-4560.0,,2.0,2.0,2.0,13.0,,0.6778239839135141,0.3944954053123993,,,,,,,,,,,,,,,,,,,,,,,,,,,,,,,,,,,,,,,,,,,,,0.0,0.0,0.0,0.0,-1519.0,0.0,0.0,0.0,0.0,1.0,0.0,1.0,0.0,0.0,1.0,0.0,0.0,0.0,0.0,0.0,0.0,0.0,0.0,0.0,1.0,0.0,0.0,0.0,0.0,0.0,0.0,0.0,0.0,0.0,0.0,0.0,0.0,0.0,0.0,0.0,0.0,0.0,0.0,8.0,0.0,,202500.0,28613.25,0.0,0.0,0.0,0.0,-1311.0,110.0,-144.0,-1286.5,326.0,-25.0,4.0,7788.375,71707.5,69727.5,1980.0,71707.5,11.0,-1843.0,365243.0,-1812.0,-1512.0,-1512.0,-1507.0,10.5,0.0,0.0273515981735159,180.0,52.0,12.0,5.0,-59.5,0.0,0.0,55.0,8274.24,6488.505,-1937.0,-1926.0,6.0,1.0,0.0,,,,,,,,,,,,,,,,,,,,,8346955450.5,184401439123.5,165587466564.0,51972673807.935,1863.0,1705.0,71125.0,70824.0,9140.0,506073.0,,,,,,,128418.0,662839.0,,,,13528157.356163984,,-921931186.0,-296525889.0,-1535183698.0416667,44019.0,30706.0,,,,,,,,158046.54584768234,126110.33482910828,,,,,,,3714343.0,,,,,,,,,,,,,,,,436486.0,431280.0,,6425.323478002897,631977.0,625529.0,,,,,,,,,43.5,44238656.51999997,,4748541165.810002,1565449272.6750002,53712335.69999996,709752.5099999999,91.0,11997.0,-15382223.5,6711437.0,-7956592.0,-8646015.5,-21.25,0.0,,225000.0,0.0,0.0,0.0,0.0,0.0,-1428.0,-859.0,-749.0,-1482.0,167738496.9075002,2397058527.7350025,2703275886.3300004,38713846.905,2397058527.7350025,172966.0,-11882309.0,2749602786.5,119349409.5,612831190.5,272354796.5,639700699.5,172569.0,2687.5,485.8540713698864,4087087.0,1419332.0,869284.5,-2839791.5,939735.0,99135.0,1894760315.6399984,1905722779.454981,-115762220.0,-114824041.0,2085306.0,93847.0,,,,,,,,,,,,,,,,,,,,,1467478.0,14783064.0,3232887.0,8555254.0,11608153.0,1415747.0,1058742281.3670008,,72109115826.81712,21676318818.862617,582257468.0294988,5792665.7475,689.5,94245.0,-276936319.0,21979348.5,-123794019.5,-218715308.5,-2018818.5,,,,,,,,,,,,,,,,,,,,,4273123.5,2479340.5,-9003798.0,921269.0,37582.5,3733581296.767463,3658326205.454962,-260634553.5,-257323573.0,2526621.5,269206.0,3926259081.359956,33254872438.27592,36683990022.46514,1729395398.6100495,48086751917.093216,3988205.0,-247593828.0,103090412061.0,1054168376.0,17274764479.5,3504055576.5,18888602813.5,3672234.5,71922.5,20870.510456189342,89788449.5,,2.384251968503937,6.857451403887688,423.1141453889168,16.34989200863931,1008.810734045386,28575.0,-0.2225209339563146,-0.9749279121818236,0.0,0.0,0.0,0.0,0.0,0.0,1.0,0.0,0.0,1.0,0.0,0.0,0.0,0.0,0.0,0.0,0.0,0.0,1.0,0.0,1.0,0.0,0.0,0.0,0.0,1.0,0.0,0.0,0.0,0.0,0.0,0.0,0.0,0.0,0.0,0.0,0.0,0.0,0.0,0.0,0.0,0.0,0.0,0.0,0.0,0.0,0.0,0.0,0.0,0.0,0.0,0.0,0.0,0.0,0.0,0.0,0.0,0.0,0.0,0.0,0.0,0.0,0.0,0.0,0.0,0.0,0.0,0.0,0.0,0.0,0.0,0.0,0.0,0.0,0.0,0.0,0.0,0.0,0.0,0.0,0.0,0.0,0.0,0.0,0.0,0.0,0.0,0.0,0.0,0.0,0.0,0.0,0.0,0.0,0.0,0.0,0.0,0.0,0.0,0.0,0.0,0.0,0.0,0.0,0.0,1.0,0.0,0.0,0.0,0.0,0.0,0.0,0.0,0.0,0.0,0.0,0.0,0.0,0.0,0.0
102862,0,0.0,0.0,0.0,1.0,0.0,157500.0,323194.5,25663.5,279000.0,0.022625,42.24383561643835,-4827.0,-7581.0,-4418.0,,2.0,2.0,2.0,13.0,0.4273256099308256,0.5834106068339507,0.3170317785834444,,,,,,,,,,,,,,,,,,,,,,,,,,,,,,,,,,,,,,,,,,,,,0.0,0.0,0.0,0.0,-1659.0,0.0,0.0,0.0,0.0,0.0,5.0,1.0,1.0,0.0,1.0,0.0,0.0,0.0,0.0,0.0,0.0,1.0,1.0,0.0,1.0,0.0,0.0,0.0,0.0,0.0,0.0,0.0,0.0,0.0,0.0,0.0,0.0,0.0,0.0,0.0,0.0,0.0,0.0,12.0,0.0,15853.185,56250.0,0.0,0.0,0.0,0.0,0.0,-236.0,-98.0,-9.0,-223.5,194.0,-11.5,14.0,12303.3825,157500.0,215878.5,2250.0,191250.0,22.0,-1249.5,365243.0,-1549.0,-1114.0,-949.0,-1107.5,13.0,0.5,0.0501007870591088,-1.0,139.0,24.0,11.0,-59.0,0.0,0.0,207.0,10975.41,10648.575,-1278.0,-1259.0,11.0,1.0,25.0,218060.235,225000.0,4500.0,4500.0,0.0,0.0,11237.625,13500.0,13500.0,211678.155,216960.885,216960.885,1.0,1.0,0.0,0.0,12.0,-13.0,0.0,0.0,8346981114.0,184401762318.0,165587745564.0,51972831307.935,1863.0,1705.0,71125.0,70824.0,9140.0,506078.0,,,,,,,128418.0,662841.0,,,,13528199.5999996,-601913945.0,-921935604.0,-296527548.0,-1535191279.0416667,44019.0,30706.0,,,,,,,67466.886845832,158047.12925828918,126110.65186088684,,,,,,,3714356.0,,,,,,,,,,,,,,,,436486.0,431280.0,,6425.346103002897,631979.0,625531.0,,,,,,,,,8.5,44319373.01999997,19271975.715000022,4758931047.330003,1568028320.91,53868358.21499996,709752.5099999999,91.0,11997.0,-15422312.0,6762239.0,-7973400.5,-8665587.5,-3.75,0.0,15853.185,71068.5,66663.0,0.0,0.0,0.0,0.0,-570.0,-505.0,-8.0,-230.0,168284087.77500015,2406388076.6850023,2713163160.3300004,38890026.855,2406320576.6850023,173577.0,-11929415.0,2759098341.5,119315239.0,613168780.5,272697306.5,640038521.5,173220.0,2693.0,487.9749331822203,4092781.5,1424465.0,872397.0,-2853467.0,939756.0,99156.0,1902507963.93,1914839879.5349824,-116143011.0,-115201506.0,2088568.0,94152.0,1814534362.304988,4884930000.0,154298922.39,240656909.0399996,9703691.1,76440672.9,103343880.37499966,262935469.75500172,243453824.0550004,1741601397.149997,1807651181.8799863,1807715488.8149865,7827.0,20101.0,127.0,12147.0,598781.0,-1074681.0,495640.0,963.0,1467490.0,14783258.0,3232912.0,8555393.0,11608360.0,1415761.0,1058742281.3670008,801687072.667495,72109172076.81712,21676318818.862617,582257468.0294988,5792665.7475,689.5,94245.0,-276936555.0,21979250.5,-123794028.5,-218715532.0,-2018830.0,5923144758.284962,18722893500.0,198783507.825,447973953.7049976,1948107.735,256768282.6650008,309134651.03999865,636574084.5149982,459170099.0999993,5708288670.862533,5886434047.027499,5886677229.7725,13381.0,80838.5,44.0,70350.5,971561.5,-1698622.5,177364.0,6755.0,4273147.5,2479351.5,-9003857.0,921269.0,37582.5,3733592272.177463,3658336854.0299616,-260635831.5,-257324832.0,2526632.5,269207.0,3926271384.742456,33255029938.27592,36684205900.96514,1729397648.6100495,48086943167.093216,3988227.0,-247595077.5,103090777304.0,1054166827.0,17274763365.5,3504054627.5,18888601706.0,3672247.5,71923.0,20870.5605569764,89788448.5,-114.2651922952202,2.0520285714285715,6.137120813606874,259.2555228082312,12.593547255830266,531.999740103142,78750.0,-0.9009688679024191,-0.433883739117558,0.0,0.0,0.0,0.0,0.0,0.0,1.0,0.0,0.0,0.0,0.0,0.0,0.0,1.0,0.0,0.0,0.0,0.0,1.0,1.0,0.0,0.0,0.0,0.0,0.0,1.0,0.0,0.0,0.0,0.0,0.0,0.0,0.0,0.0,0.0,0.0,0.0,0.0,1.0,0.0,0.0,0.0,0.0,0.0,0.0,0.0,0.0,0.0,0.0,0.0,0.0,0.0,0.0,1.0,0.0,0.0,0.0,0.0,0.0,0.0,0.0,0.0,0.0,0.0,0.0,0.0,0.0,0.0,0.0,0.0,0.0,0.0,0.0,0.0,0.0,0.0,0.0,0.0,0.0,0.0,0.0,0.0,0.0,0.0,0.0,0.0,0.0,0.0,0.0,0.0,0.0,0.0,0.0,0.0,0.0,0.0,0.0,0.0,0.0,0.0,0.0,0.0,0.0,0.0,0.0,0.0,0.0,0.0,0.0,0.0,0.0,0.0,0.0,0.0,0.0,0.0,0.0,0.0,0.0,0.0
102863,0,0.0,0.0,0.0,0.0,0.0,202500.0,622575.0,23598.0,463500.0,0.020713,50.98630136986301,-4647.0,-9764.0,-2153.0,,2.0,3.0,2.0,12.0,,0.5694872649671822,0.6971469077844458,0.0227,0.0501,0.9737,0.6396,0.0053,0.0,0.1034,0.1667,0.2083,0.0349,0.0185,0.0495,0.0,0.0,0.0231,0.052,0.9737,0.6537,0.0053,0.0,0.1034,0.1667,0.2083,0.0357,0.0202,0.0516,0.0,0.0,0.0229,0.0501,0.9737,0.6444,0.0053,0.0,0.1034,0.1667,0.2083,0.0355,0.0188,0.0504,0.0,0.0,0.0389,1.0,0.0,0.0,0.0,0.0,-1970.0,0.0,0.0,0.0,0.0,0.0,3.0,1.0,1.0,0.0,1.0,0.0,0.0,0.0,0.0,0.0,0.0,0.0,0.0,0.0,1.0,0.0,0.0,0.0,0.0,0.0,0.0,0.0,0.0,0.0,0.0,0.0,0.0,0.0,0.0,0.0,0.0,0.0,0.0,2.0,0.0,,693000.0,98986.5,0.0,0.0,0.0,0.0,-1463.0,130.5,-406.0,-685.0,97.0,-24.0,2.0,7210.8,60171.75,65232.0,6018.75,60171.75,11.0,-1756.0,365243.0,-1725.0,-1515.0,-1425.0,-1509.5,11.0,0.0,0.0991431427747217,143.5,48.0,16.5,7.0,-41.5,0.0,0.0,16.0,11914.065,11914.065,-1741.5,-1714.0,4.5,1.0,0.0,,,,,,,,,,,,,,,,,,,,,8347004712.0,184402384893.0,165588209064.0,51973033807.935,1863.0,1705.0,71125.0,70824.0,9140.0,506081.0,17808.34420000229,17870.504699999106,17321.912799998045,11296.240500000093,11234.019000000097,11181.312000000056,128418.0,662843.0,4137.970300000118,4135.639500000016,3946.2072000000944,13528250.586300973,-601918592.0,-921937757.0,-296529518.0,-1535201043.0416667,44019.0,30706.0,11350.095199999185,11226.059999998975,10710.340399997294,22887.787100009697,22809.650400009657,22195.139300008217,,158047.69874555414,126111.34900779463,35002.75420002793,34942.97080002837,34388.63400002878,22956.16579999592,22929.27559999549,22576.039699995723,3714368.0,8295.689600000165,8400.205300000078,8123.793100000229,9818.012700000718,9932.972100002162,10292.627699999646,16468.157499999757,16653.38939999969,16250.162499999702,828.7349000001761,813.9110000000459,759.8373000000131,3913.918000000125,3897.084400000163,3729.6606000001593,436486.0,431280.0,,6425.3668160028965,631982.0,625533.0,,16332.5600999998,154181.7444999906,154184.48909999017,154076.24319998713,77616.91039999628,77954.72120000658,78356.05450000652,48.5,44367073.01999997,,4760630039.475003,1568260741.41,53868358.21499996,709752.5099999999,91.0,11997.0,-15425850.0,6764043.5,-7974885.0,-8667116.0,-23.75,0.0,,1125000.0,0.0,0.0,0.0,0.0,0.0,-1848.0,-22.0,-650.0,-685.0,168404710.61250013,2407830767.6850023,2715027188.5800004,38903358.105,2407830767.6850023,173694.0,-11938522.0,2760924556.5,119306711.5,613163415.5,272692256.5,640033177.0,173324.0,2695.0,488.1688657093744,4093074.0,1426376.5,873425.5,-2857611.5,939779.0,99179.0,1905507151.987501,1917335560.7024832,-116312964.0,-115370427.5,2089522.5,94267.5,,,,,,,,,,,,,,,,,,,,,1467492.0,14783355.0,3232912.0,8555441.0,11608376.0,1415763.0,1058742281.3670008,,72109865076.81712,21676417805.362617,582257468.0294988,5792665.7475,689.5,94245.0,-276938018.0,21979381.0,-123794434.5,-218716217.0,-2018854.0,,,,,,,,,,,,,,,,,,,,,4273164.0,2479358.5,-9003898.5,921269.0,37582.5,3733604186.242463,3658348768.0949616,-260637573.0,-257326546.0,2526637.0,269208.0,3926278595.542456,33255090110.02592,36684271132.96514,1729403667.3600495,48087003338.843216,3988238.0,-247596833.5,103091142547.0,1054165102.0,17274761850.5,3504053202.5,18888600196.5,3672258.5,71923.0,20870.659700119173,89788592.0,-91.14212788823214,3.0744444444444445,8.581235697940503,437.5254694210213,26.382532418001524,1345.1477487644063,101250.0,1.0,0.0,0.0,0.0,0.0,0.0,0.0,0.0,1.0,0.0,0.0,0.0,0.0,0.0,0.0,1.0,0.0,0.0,0.0,0.0,1.0,1.0,0.0,0.0,0.0,0.0,0.0,1.0,0.0,0.0,0.0,0.0,0.0,0.0,0.0,0.0,0.0,0.0,0.0,0.0,1.0,0.0,0.0,0.0,0.0,0.0,0.0,0.0,0.0,0.0,0.0,0.0,0.0,1.0,0.0,0.0,0.0,0.0,0.0,0.0,0.0,0.0,0.0,0.0,0.0,0.0,0.0,0.0,0.0,0.0,0.0,0.0,0.0,0.0,0.0,0.0,0.0,0.0,0.0,0.0,0.0,0.0,0.0,0.0,0.0,0.0,0.0,0.0,0.0,0.0,0.0,0.0,0.0,0.0,0.0,0.0,0.0,0.0,0.0,0.0,0.0,0.0,0.0,0.0,0.0,0.0,0.0,0.0,0.0,0.0,1.0,0.0,1.0,0.0,0.0,0.0,0.0,0.0,0.0,0.0,1.0,0.0
102867,0,0.0,0.0,0.0,0.0,1.0,54000.0,450000.0,16164.0,450000.0,0.010006,43.95342465753425,-5407.0,-1844.0,-4476.0,,3.0,2.0,2.0,12.0,0.5084106114947687,0.5851050211074478,0.7544061731797895,0.0619,0.0698,0.997,0.9592,0.008,0.0,0.1034,0.1667,0.2083,0.0125,0.0504,0.0606,0.0,0.0,0.063,0.0725,0.997,0.9608,0.0081,0.0,0.1034,0.1667,0.2083,0.0128,0.0551,0.0631,0.0,0.0,0.0625,0.0698,0.997,0.9597,0.0081,0.0,0.1034,0.1667,0.2083,0.0127,0.0513,0.0617,0.0,0.0,0.0477,1.0,0.0,0.0,0.0,0.0,-1716.0,0.0,0.0,0.0,0.0,0.0,3.0,1.0,1.0,0.0,1.0,0.0,0.0,0.0,0.0,0.0,0.0,0.0,0.0,0.0,1.0,0.0,0.0,0.0,0.0,0.0,0.0,0.0,0.0,0.0,0.0,0.0,0.0,0.0,0.0,0.0,0.0,0.0,0.0,1.0,0.0,,182970.0,0.0,0.0,0.0,0.0,0.0,-1345.0,-979.0,-1193.0,-1193.0,45.0,-22.0,2.0,17078.895,304875.0,251644.5,56880.0,304875.0,18.0,-1197.5,365243.0,-1163.0,181929.0,-653.0,181932.0,11.5,0.0,0.15890771502738,227.0,34.0,24.0,10.0,-17.5,0.0,0.0,36.0,17495.055,17495.055,-484.5,-476.0,9.0,2.5,0.0,,,,,,,,,,,,,,,,,,,,,8347020876.0,184402834893.0,165588659064.0,51973087807.935,1863.0,1705.0,71125.0,70824.0,9140.0,506084.0,17808.406100002292,17870.567199999106,17321.975799998043,11296.310300000092,11234.088800000096,11181.384500000057,128419.0,662846.0,4137.978300000118,4135.647600000016,3946.2153000000944,13528294.539725628,-601923999.0,-921942233.0,-296531234.0,-1535202887.0416667,44019.0,30706.0,11350.095199999185,11226.059999998975,10710.340399997294,22887.890500009697,22809.753800009657,22195.242700008217,67467.3952564435,158048.28385057524,126112.1034139678,35002.92090002794,34943.137500028366,34388.800700028776,22956.374099995912,22929.483899995488,22576.24799999572,3714380.0,8295.702100000166,8400.218000000077,8123.805900000229,9818.063100000718,9933.02340000216,10292.682799999646,16468.218099999758,16653.45109999969,16250.2255999997,828.7349000001761,813.9110000000459,759.8373000000131,3913.918000000125,3897.084400000163,3729.6606000001593,436486.0,431280.0,,6425.376822002897,631984.0,625535.0,,16332.6077999998,154182.7414999906,154185.48609999014,154077.24019998714,77617.86959999628,77955.68090000657,78357.01530000652,45.0,44367073.01999997,,4776234908.355003,1580316275.0700002,53868358.21499996,709752.5099999999,91.0,11997.0,-15435558.0,6804992.0,-7978942.0,-8671573.0,-22.0,0.0,,182970.0,0.0,0.0,0.0,0.0,0.0,-1345.0,-979.0,-1193.0,-1193.0,168769963.8225001,2413222395.1650023,2721355036.8300004,39037808.83499999,2413222395.1650023,174328.0,-11958370.0,2765307472.5,119297845.5,613887788.5,272688910.5,640757606.5,173580.5,2697.0,489.1541964931904,4100072.0,1428630.0,874977.0,-2861051.0,939781.0,99179.0,1907751795.6600049,1919749330.1249864,-116389177.5,-115444866.5,2090313.0,94492.5,,,,,,,,,,,,,,,,,,,,,1467493.0,14783400.0,3232912.0,8555475.0,11608412.0,1415765.0,1058742281.3670008,,72110048046.81712,21676417805.362617,582257468.0294988,5792665.7475,689.5,94245.0,-276939363.0,21978402.0,-123795627.5,-218717410.0,-2018876.0,,,,,,,,,,,,,,,,,,,,,4273188.0,2479368.5,-9003916.0,921269.0,37582.5,3733621681.297464,3658366263.149962,-260638057.5,-257327022.0,2526646.0,269210.5,3926295674.437456,33255394985.02592,36684522777.46514,1729460547.3600495,48087308213.843216,3988256.0,-247598031.0,103091507790.0,1054163939.0,17274943779.5,3504052549.5,18888782128.5,3672270.0,71923.0,20870.818607834204,89788819.0,-123.01658044006732,8.333333333333334,3.3407572383073503,146.83772157305432,27.83964365256125,1223.6476797754526,18000.0,-0.2225209339563146,-0.9749279121818236,0.0,0.0,0.0,0.0,0.0,0.0,1.0,0.0,0.0,0.0,0.0,0.0,0.0,1.0,0.0,0.0,0.0,0.0,1.0,0.0,1.0,0.0,0.0,0.0,0.0,1.0,0.0,0.0,0.0,0.0,0.0,0.0,0.0,0.0,0.0,0.0,0.0,0.0,0.0,0.0,0.0,0.0,0.0,0.0,0.0,0.0,0.0,0.0,0.0,0.0,0.0,0.0,0.0,0.0,0.0,0.0,0.0,0.0,0.0,0.0,0.0,0.0,0.0,0.0,0.0,0.0,0.0,0.0,0.0,0.0,0.0,0.0,0.0,0.0,0.0,0.0,0.0,0.0,0.0,0.0,0.0,0.0,0.0,0.0,0.0,0.0,0.0,1.0,0.0,0.0,0.0,0.0,0.0,0.0,0.0,0.0,0.0,0.0,0.0,0.0,0.0,0.0,0.0,0.0,0.0,0.0,0.0,0.0,1.0,0.0,1.0,0.0,0.0,0.0,1.0,0.0,0.0,0.0,0.0,0.0
102868,0,0.0,0.0,0.0,1.0,0.0,58500.0,99000.0,10273.5,99000.0,0.018209,38.35342465753425,-6092.0,-5725.0,-5784.0,,2.0,3.0,3.0,15.0,0.4731168761002383,0.6890686718216129,0.6971469077844458,0.2165,0.0496,0.9871,0.8232,0.0322,0.04,0.0345,0.3333,0.375,0.0587,0.1748,0.0652,0.0077,0.009,0.2206,0.0515,0.9871,0.8301,0.0325,0.0403,0.0345,0.3333,0.375,0.06,0.1901,0.0677,0.0039,0.0046,0.2186,0.0496,0.9871,0.8256,0.0324,0.04,0.0345,0.3333,0.375,0.0597,0.1779,0.0664,0.0078,0.0092,0.0688,1.0,0.0,0.0,0.0,0.0,-1790.0,0.0,0.0,0.0,0.0,1.0,0.0,1.0,1.0,0.0,1.0,0.0,0.0,0.0,0.0,0.0,0.0,0.0,0.0,0.0,1.0,0.0,0.0,0.0,0.0,0.0,0.0,0.0,0.0,0.0,0.0,0.0,0.0,0.0,0.0,0.0,0.0,0.0,0.0,8.0,0.0,0.0,123171.48,0.0,0.0,0.0,0.0,0.0,-936.5,-814.0,-658.5,-814.0,286.0,-18.0,1.0,6671.52,34641.0,32719.5,3465.0,34641.0,6.0,-1790.0,365243.0,-1750.0,-1600.0,-1600.0,-1593.0,10.0,0.0,0.1042905111304564,93.0,7.0,6.0,3.0,-56.0,0.0,0.0,6.0,6671.52,6671.52,-1780.0,-1675.0,3.5,1.0,0.0,,,,,,,,,,,,,,,,,,,,,8347031149.5,184402933893.0,165588758064.0,51973146307.935,1863.0,1705.0,71125.0,70825.0,9140.0,506084.0,17808.62260000229,17870.78579999911,17322.196399998043,11296.359900000092,11234.138400000094,11181.436000000056,128419.0,662848.0,4138.010500000118,4135.680000000016,3946.247800000095,13528332.893150285,-601930091.0,-921948017.0,-296533024.0,-1535208612.0416667,44019.0,30706.0,11350.135199999184,11226.099999998976,10710.380699997297,22887.925000009694,22809.78830000966,22195.27720000822,67467.86837331961,158048.97291924703,126112.8005608756,35003.25420002793,34943.47080002837,34389.13400002878,22956.749099995912,22929.858899995488,22576.62299999572,3714395.0,8295.760800000166,8400.277700000077,8123.86590000023,9818.23790000072,9933.201300002162,10292.872899999646,16468.28329999976,16653.51749999969,16250.2932999997,828.7426000001761,813.9188000000457,759.8412000000131,3913.927000000125,3897.093600000163,3729.66520000016,436486.0,431280.0,,6425.395031002897,631987.0,625538.0,,16332.6765999998,154183.7285999906,154186.47319999017,154078.2272999871,77618.69279999626,77956.50650000657,78357.84540000654,31.0,44367073.01999997,19271975.715000022,4777456352.355003,1580731728.5700002,53868358.21499996,709752.5099999999,91.0,11997.0,-15440641.5,6803470.0,-7982798.0,-8675791.0,-15.0,0.0,0.0,100350.0,0.0,0.0,0.0,0.0,0.0,-1410.0,-1044.0,-990.0,-1134.0,168780957.1650001,2413297986.1650023,2721428260.8300004,39045368.83499999,2413297986.1650023,174340.0,-11961018.0,2765855337.0,119295253.0,613885496.0,272686633.0,640755324.0,173597.0,2697.0,489.3084856284391,4100387.0,1428905.0,875095.0,-2861907.0,939781.0,99179.0,1908025069.905004,1920064905.4949856,-116415731.0,-115470183.0,2090451.0,94524.5,,,,,,,,,,,,,,,,,,,,,1467501.0,14783686.0,3232912.0,8555482.0,11608418.0,1415766.0,1058742281.3670008,801687072.667495,72110171218.29712,21676417805.362617,582257468.0294988,5792665.7475,689.5,94245.0,-276940299.5,21977588.0,-123796286.0,-218718224.0,-2018894.0,,,,,,,,,,,,,,,,,,,,,4273194.0,2479371.5,-9003972.0,921269.0,37582.5,3733628352.8174624,3658372934.669962,-260639837.5,-257328697.0,2526649.5,269211.5,3926302345.957456,33255429626.02592,36684555496.96514,1729464012.3600495,48087342854.843216,3988262.0,-247599821.0,103091873033.0,1054162189.0,17274942179.5,3504050949.5,18888780535.5,3672280.0,71923.0,20870.922898345336,89788912.0,-158.83848846346166,1.6923076923076923,5.694261936049057,218.39444614452265,9.636443276390716,369.59060116765374,29250.0,-0.9009688679024191,0.4338837391175582,0.0,1.0,0.0,0.0,0.0,0.0,0.0,0.0,1.0,0.0,0.0,0.0,0.0,0.0,0.0,0.0,0.0,0.0,1.0,1.0,0.0,0.0,0.0,0.0,0.0,1.0,0.0,0.0,0.0,0.0,0.0,0.0,0.0,1.0,0.0,0.0,0.0,0.0,0.0,0.0,0.0,0.0,0.0,0.0,0.0,0.0,0.0,0.0,0.0,0.0,0.0,0.0,0.0,0.0,0.0,0.0,0.0,0.0,0.0,0.0,0.0,0.0,0.0,0.0,0.0,0.0,0.0,0.0,0.0,0.0,0.0,0.0,0.0,0.0,0.0,0.0,1.0,0.0,0.0,0.0,0.0,0.0,0.0,0.0,0.0,0.0,0.0,0.0,0.0,0.0,0.0,0.0,0.0,0.0,0.0,0.0,0.0,0.0,0.0,0.0,0.0,0.0,0.0,0.0,0.0,0.0,0.0,0.0,1.0,0.0,1.0,0.0,0.0,0.0,0.0,0.0,0.0,1.0,0.0,0.0
102878,0,0.0,1.0,0.0,0.0,0.0,135000.0,517536.0,21487.5,432000.0,0.022625,45.28493150684932,-4288.0,-8624.0,-77.0,,2.0,2.0,2.0,11.0,0.5679793909002485,0.2858978721410488,,0.1124,0.0826,0.9881,0.8368,0.0778,0.12,0.1034,0.3333,0.375,0.0246,0.0908,0.1175,0.0039,0.0026,0.1145,0.0858,0.9881,0.8432,0.0785,0.1208,0.1034,0.3333,0.375,0.0252,0.0992,0.1224,0.0039,0.0028,0.1135,0.0826,0.9881,0.8390000000000001,0.0783,0.12,0.1034,0.3333,0.375,0.0251,0.0923,0.1196,0.0039,0.0027,0.1355,1.0,0.0,0.0,0.0,0.0,-899.0,,,,,,,1.0,1.0,0.0,1.0,0.0,0.0,0.0,0.0,0.0,0.0,0.0,0.0,0.0,0.0,0.0,0.0,0.0,0.0,0.0,0.0,0.0,0.0,0.0,0.0,0.0,0.0,0.0,0.0,0.0,0.0,0.0,0.0,0.0,,,,,,,,,,,,,0.0,,0.0,,,,,,,,,,,,,,,,,0.0,,,,,,0.0,,,,,,,0.0,,,,,,,,,,,,,,,,,,,,,8347052637.0,184403451429.0,165589190064.0,51973281307.935,,,,,,,17808.735000002293,17870.899299999106,17322.310899998043,11296.442500000092,11234.221000000096,11181.521800000057,128419.0,662850.0,4138.088300000118,4135.758300000016,3946.326300000095,13528378.178081792,-601934379.0,-921948094.0,-296533923.0,-1535217236.0416667,44019.0,30706.0,11350.255199999185,11226.219999998975,10710.501499997295,22888.028400009694,22809.89170000966,22195.38060000822,67468.4363527105,158049.2588171192,,35003.58750002793,34943.80410002837,34389.46730002878,22957.124099995912,22930.233899995488,22576.99799999572,3714406.0,8295.785400000166,8400.302800000078,8123.89110000023,9818.32870000072,9933.293600002162,10292.972099999646,16468.40079999976,16653.63709999969,16250.4156999997,828.7465000001762,813.9227000000459,759.8451000000133,3913.929600000125,3897.096300000163,3729.66800000016,436486.0,431280.0,,6425.417656002896,631989.0,625540.0,,16332.8120999998,154184.71669999062,154187.46129999016,154079.21539998712,77619.52959999628,77957.34550000659,78358.68860000653,,,,,,,,,,,,,,,,,,,,,,,,,,,,,,,,,,,,,,,,,,,,,,,,,,,,,,,,,,,,,,,,,,,,,,,,,,1467501.0,14783686.0,3232912.0,8555482.0,11608418.0,1415766.0,,,,,,,,,,,,,,,,,,,,,,,,,,,,,,,,,,,,,,,,,,,,,,,,,,,,,,,,,,,,,-94.68933389799746,3.8336,6.282722513089006,284.5126586817758,24.08544502617801,1090.7077283224558,67500.0,-0.9009688679024191,-0.433883739117558,0.0,1.0,0.0,0.0,0.0,0.0,0.0,0.0,0.0,0.0,0.0,0.0,0.0,1.0,0.0,1.0,0.0,0.0,0.0,0.0,1.0,0.0,0.0,0.0,0.0,1.0,0.0,0.0,0.0,0.0,0.0,0.0,0.0,0.0,0.0,0.0,0.0,0.0,0.0,0.0,0.0,0.0,0.0,0.0,1.0,0.0,0.0,0.0,0.0,0.0,0.0,0.0,0.0,1.0,0.0,0.0,0.0,0.0,0.0,0.0,0.0,0.0,0.0,0.0,0.0,0.0,0.0,0.0,0.0,0.0,0.0,0.0,0.0,0.0,0.0,0.0,0.0,0.0,0.0,0.0,0.0,0.0,0.0,0.0,0.0,0.0,0.0,0.0,0.0,0.0,0.0,0.0,0.0,0.0,0.0,0.0,0.0,0.0,0.0,0.0,0.0,0.0,0.0,0.0,0.0,0.0,0.0,0.0,1.0,0.0,1.0,0.0,0.0,0.0,0.0,0.0,0.0,1.0,0.0,0.0
102887,0,0.0,0.0,0.0,1.0,0.0,180000.0,259794.0,27409.5,229500.0,0.018634,34.109589041095894,-1922.0,-3244.0,-4258.0,,2.0,2.0,2.0,11.0,0.4036159311482271,0.4209362556761687,0.5620604831738043,0.1485,0.0877,0.9851,0.7959999999999999,0.0295,0.16,0.1379,0.3333,0.375,0.0456,0.121,0.1546,0.0,0.0,0.1513,0.091,0.9851,0.804,0.0298,0.1611,0.1379,0.3333,0.375,0.0466,0.1322,0.161,0.0,0.0,0.1499,0.0877,0.9851,0.7987,0.0297,0.16,0.1379,0.3333,0.375,0.0464,0.1231,0.1573,0.0,0.0,0.1216,1.0,0.0,0.0,0.0,0.0,-505.0,0.0,0.0,0.0,0.0,0.0,5.0,1.0,1.0,0.0,1.0,0.0,0.0,0.0,0.0,0.0,0.0,0.0,0.0,0.0,1.0,0.0,0.0,0.0,0.0,0.0,0.0,0.0,0.0,0.0,0.0,0.0,0.0,0.0,0.0,0.0,0.0,0.0,0.0,23.0,0.0,0.0,63760.5,0.0,0.0,0.0,0.0,0.0,-1025.0,-639.5,-457.0,-895.0,864.0,-23.5,17.0,19970.55,103716.0,103716.0,0.0,180000.0,12.0,-416.0,365243.0,-930.0,-900.0,-698.0,-892.0,12.0,1.0,0.0,-1.0,61.0,15.0,8.0,-45.0,0.0,0.0,55.0,17651.52,17651.52,-1416.0,-1388.0,6.0,1.0,0.0,,,,,,,,,,,,,,,,,,,,,8347080046.5,184403711223.0,165589419564.0,51973461307.935,1863.0,1705.0,71125.0,70825.0,9140.0,506089.0,17808.883500002292,17871.049199999106,17322.462199998045,11296.530200000092,11234.308700000096,11181.612800000055,128419.0,662852.0,4138.117800000117,4135.788000000016,3946.356100000094,13528412.287670832,-601936301.0,-921952352.0,-296534428.0,-1535220480.0416667,44019.0,30706.0,11350.415199999185,11226.379999998975,10710.662599997297,22888.166300009703,22810.029600009657,22195.518500008217,67468.83996864165,158049.6797533749,126113.36262135876,35003.92080002793,34944.13740002837,34389.80060002878,22957.499099995912,22930.608899995488,22577.37299999572,3714417.0,8295.831000000166,8400.349200000077,8123.93770000023,9818.449700000718,9933.416700002164,10293.104299999646,16468.555399999757,16653.79439999969,16250.5766999997,828.7465000001762,813.9227000000459,759.8451000000133,3913.929600000125,3897.096300000163,3729.66800000016,436486.0,431280.0,,6425.436290002896,631991.0,625542.0,,16332.9336999998,154185.70179999058,154188.44639999015,154080.2004999871,77620.32559999629,77958.14420000659,78359.49260000655,34.0,45049322.51999997,19301456.65500002,4823924989.050005,1595394318.6000006,54099405.13499996,709788.5099999999,93.0,12014.0,-15572305.0,6838205.5,-8064656.0,-8763431.0,-16.5,0.0,0.0,63540.0,0.0,0.0,0.0,0.0,0.0,-1515.0,-1757.0,-929.0,-1388.0,170526638.83500022,2439992116.6650023,2750645460.3300004,39441953.83499999,2439992116.6650023,175818.0,-12053983.0,2783382896.0,119595725.0,616759039.0,274112445.0,643996116.0,174830.0,2716.0,493.46143689172857,4112786.0,1442257.0,883362.0,-2886444.0,939924.0,99185.0,1928512584.2699888,1942896066.9299731,-117338336.0,-116387124.0,2105518.0,95298.0,,,,,,,,,,,,,,,,,,,,,1467524.0,14784550.0,3232912.0,8555543.0,11608473.0,1415783.0,1058742281.3670008,801687072.667495,72110234978.79712,21676417805.362617,582257468.0294988,5792665.7475,689.5,94245.0,-276941324.5,21976948.5,-123796743.0,-218719119.0,-2018917.5,,,,,,,,,,,,,,,,,,,,,4273209.0,2479379.5,-9004017.0,921269.0,37582.5,3733646004.3374624,3658390586.189962,-260641253.5,-257330085.0,2526655.5,269212.5,3926322316.507456,33255533342.02592,36684659212.96514,1729464012.3600495,48087522854.843216,3988274.0,-247600237.0,103092238276.0,1054161259.0,17274941279.5,3504050251.5,18888779643.5,3672292.0,71924.0,20870.922898345336,89788911.0,-56.347791164658645,1.4433,6.567066163191594,223.9999280321516,9.478246593334427,323.2990961288044,90000.0,-0.9009688679024191,-0.433883739117558,0.0,0.0,0.0,0.0,0.0,0.0,1.0,0.0,0.0,0.0,0.0,0.0,0.0,1.0,0.0,0.0,0.0,0.0,1.0,1.0,0.0,0.0,0.0,0.0,0.0,1.0,0.0,0.0,0.0,0.0,0.0,0.0,0.0,0.0,0.0,0.0,0.0,0.0,0.0,0.0,0.0,0.0,0.0,0.0,0.0,0.0,0.0,0.0,0.0,0.0,0.0,0.0,0.0,1.0,0.0,0.0,0.0,0.0,0.0,0.0,0.0,0.0,0.0,0.0,0.0,0.0,0.0,0.0,0.0,0.0,0.0,0.0,0.0,0.0,0.0,0.0,0.0,0.0,0.0,0.0,0.0,0.0,0.0,0.0,0.0,0.0,0.0,0.0,0.0,0.0,0.0,0.0,0.0,0.0,0.0,0.0,0.0,0.0,0.0,0.0,0.0,0.0,0.0,0.0,0.0,0.0,0.0,0.0,0.0,1.0,1.0,0.0,0.0,0.0,0.0,0.0,0.0,1.0,0.0,0.0
102898,1,0.0,0.0,1.0,1.0,0.0,360000.0,440784.0,34956.0,360000.0,0.035792,48.96438356164385,-673.0,-8850.0,-1413.0,14.0,2.0,2.0,2.0,9.0,,0.4341873186796152,0.1376544619182607,,,,,,,,,,,,,,,,,,,,,,,,,,,,,,,,,,,,,,,,,,,,,0.0,0.0,0.0,0.0,-1166.0,0.0,0.0,0.0,0.0,0.0,4.0,1.0,1.0,1.0,1.0,1.0,0.0,0.0,1.0,1.0,0.0,1.0,1.0,0.0,1.0,0.0,0.0,0.0,0.0,0.0,0.0,0.0,0.0,0.0,0.0,0.0,0.0,0.0,0.0,0.0,0.0,0.0,0.0,5.0,6214.5,6750.0,54234.0,0.0,0.0,0.0,0.0,0.0,-855.0,-487.0,-490.0,-490.0,134.0,-14.0,7.0,19603.4175,0.0,0.0,1.485,39285.0,29.0,-178.0,365243.0,-830.0,-530.0,10.0,-526.5,11.0,0.5,3.407067817144547e-05,-1.0,26.0,48.0,35.5,-23.5,0.0,0.0,133.0,2175.66,2175.66,-1343.0,-1343.0,46.0,0.0,95.0,0.0,0.0,0.0,0.0,0.0,0.0,0.0,2175.66,0.0,0.0,0.0,0.0,0.0,0.0,0.0,0.0,16.0,-49.0,0.0,0.0,8347115002.5,184404152007.0,165589779564.0,51973821307.935,1863.0,1705.0,71125.0,70825.0,9140.0,506093.0,,,,,,,128419.0,662854.0,,,,13528461.252054391,-601936974.0,-921953765.0,-296535594.0,-1535229330.0416667,44019.0,30706.0,,,,,,,,158050.11394069358,126113.50027582068,,,,,,,3714426.0,,,,,,,,,,,,,,,,436486.0,431280.0,1263281.0,6425.472082002895,631993.0,625544.0,,,,,,,,,29.0,45289794.10499997,19362461.130000014,4842869823.180005,1600953232.9050002,54317242.21499996,709788.5099999999,93.0,12014.0,-15645597.0,6867265.0,-8103006.0,-8810148.0,-14.0,0.0,6750.0,37260.0,0.0,0.0,0.0,0.0,0.0,-855.0,-490.0,-504.0,-490.0,171250325.10000023,2452841820.360002,2765728258.8300004,39513730.545,2452841820.360002,176480.0,-12098271.0,2793424066.5,120296989.0,620025823.0,275562370.0,647629061.5,175566.0,2724.5,494.5833731644719,4120115.0,1447839.0,887287.0,-2895630.5,939950.0,99211.0,1937285639.504996,1951845428.92498,-117784050.0,-116827207.0,2114911.0,95556.0,1845006522.6149888,4953690000.0,155672772.39,243530953.37999964,9703691.1,77933317.50000003,104807916.67499962,265705327.57500255,245955880.7550004,1770902083.8899963,1837995231.914987,1838060483.8499875,7947.0,20373.0,127.0,12299.0,604903.0,-1085563.0,495645.0,968.0,1467529.0,14784684.0,3233007.0,8555569.0,11608606.0,1415790.0,1058748495.8670008,801693822.667495,72110289212.79712,21676417805.362617,582257468.0294988,5792665.7475,689.5,94245.0,-276942179.5,21976461.5,-123797233.0,-218719609.0,-2018931.5,5923144758.284962,18722893500.0,198783507.825,447973953.7049976,1948107.735,256768282.6650008,309134651.03999865,636576260.174998,459170099.0999993,5708288670.862533,5886434047.027499,5886677229.7725,13381.0,80838.5,44.0,70350.5,971577.5,-1698671.5,177364.0,6755.0,4273257.0,2479415.0,-9004040.5,921269.0,37582.5,3733648179.9974623,3658392761.849961,-260642596.5,-257331428.0,2526701.5,269212.5,3926341919.924956,33255533342.02592,36684659212.96514,1729464013.8450494,48087562139.843216,3988303.0,-247600415.0,103092603519.0,1054160429.0,17274940749.5,3504050261.5,18888779117.0,3672303.0,71924.5,20870.92293241601,89788910.0,-13.744684422560429,1.2244,10.298661174047371,504.2675958974648,12.609680741503606,617.4252444168559,180000.0,-0.9009688679024191,-0.433883739117558,0.0,0.0,0.0,0.0,0.0,0.0,1.0,0.0,0.0,0.0,0.0,0.0,0.0,1.0,0.0,0.0,0.0,0.0,1.0,1.0,0.0,0.0,0.0,0.0,0.0,1.0,0.0,0.0,0.0,0.0,0.0,0.0,0.0,0.0,0.0,0.0,0.0,0.0,1.0,0.0,0.0,0.0,0.0,0.0,0.0,0.0,0.0,0.0,0.0,0.0,0.0,0.0,0.0,0.0,0.0,0.0,0.0,0.0,0.0,0.0,0.0,0.0,0.0,0.0,0.0,0.0,0.0,0.0,0.0,0.0,0.0,0.0,0.0,0.0,1.0,0.0,0.0,0.0,0.0,0.0,0.0,0.0,0.0,0.0,0.0,0.0,0.0,0.0,0.0,0.0,0.0,0.0,0.0,0.0,0.0,0.0,0.0,0.0,0.0,0.0,0.0,0.0,0.0,0.0,0.0,0.0,0.0,0.0,0.0,0.0,0.0,0.0,0.0,0.0,0.0,0.0,0.0,0.0,0.0,0.0
102904,0,0.0,0.0,0.0,1.0,1.0,144000.0,523431.0,35109.0,427500.0,0.072508,38.8054794520548,-1740.0,-3265.0,-4814.0,,3.0,1.0,1.0,15.0,0.5614783474937872,0.3535847119478077,,0.1392,0.0813,0.9881,,,0.08,0.0345,0.625,,,,0.1229,,0.0686,0.1418,0.0843,0.9881,,,0.0806,0.0345,0.625,,,,0.1281,,0.0726,0.1405,0.0813,0.9881,,,0.08,0.0345,0.625,,,,0.1251,,0.07,0.0967,1.0,0.0,0.0,0.0,0.0,0.0,,,,,,,1.0,1.0,0.0,1.0,0.0,0.0,0.0,0.0,0.0,0.0,0.0,0.0,0.0,1.0,0.0,0.0,0.0,0.0,0.0,0.0,0.0,0.0,0.0,0.0,0.0,0.0,0.0,0.0,0.0,0.0,0.0,0.0,0.0,,,,,,,,,,,,,0.0,,2.0,5558.805,66890.25,51315.75,25875.0,66890.25,12.0,-1184.5,365243.0,-1150.0,-835.0,-820.0,-829.5,13.0,0.0,0.3086506627024401,210.0,25.0,12.0,6.0,-43.0,0.0,0.0,23.0,3507.885,3507.885,-1336.0,-1308.0,6.0,1.0,0.0,,,,,,,,,,,,,,,,,,,,,8347150111.5,184404675438.0,165590207064.0,51973965307.935,,,,,,,17809.022700002293,17871.189699999108,17322.603999998046,11296.611500000094,11234.390000000096,11181.69710000006,128420.0,662857.0,,,,13528500.057533843,-601938714.0,-921958579.0,-296535594.0,-1535232595.0416667,44019.0,30706.0,11350.495199999184,11226.459999998977,10710.743199997294,22888.2008000097,22810.064100009666,22195.553000008214,67469.40144698914,158050.46752540552,,35004.54580002793,34944.76240002837,34390.42560002878,,,,3714441.0,,,,,,,16468.67829999976,16653.91949999969,16250.7047999997,,,,3913.998200000125,3897.166300000163,3729.74060000016,436486.0,431280.0,,6425.544590002895,631994.0,625545.0,,16333.0303999998,154186.68989999054,154189.43449999017,154081.1885999871,,,,,,,,,,,,,,,,,,,,,,,,,,,,,,171380944.01250017,2454646090.860002,2767735398.3300004,39602323.53,2454646090.860002,176644.0,-12116814.5,2798172225.5,120646133.0,620378252.0,275550799.0,647981550.5,175892.0,2729.0,495.6727523131013,4122919.0,1449770.0,888496.0,-2901364.0,939957.0,99218.0,1939852770.480004,1954261386.0449865,-118038792.0,-117080546.0,2118250.0,95703.0,,,,,,,,,,,,,,,,,,,,,1467529.0,14784684.0,3233007.0,8555594.0,11608629.0,1415792.0,,,,,,,,,,,,,,,,,,,,,,,,,,,,,,,,,,4273269.0,2479421.0,-9004083.5,921269.0,37582.5,3733651687.882464,3658396269.7349615,-260643932.5,-257332736.0,2526707.5,269213.5,3926347478.729956,33255600232.27592,36684710528.71514,1729489888.8450494,48087629030.093216,3988315.0,-247601599.5,103092968762.0,1054159279.0,17274939914.5,3504049441.5,18888778287.5,3672316.0,71924.5,20871.23158307872,89789120.0,-44.8390285230161,3.6349375,4.101512432709562,159.16115642985818,14.908741348372214,578.5408560502576,48000.0,0.6234898018587334,-0.7818314824680299,0.0,0.0,0.0,0.0,0.0,0.0,1.0,0.0,0.0,0.0,0.0,0.0,0.0,1.0,0.0,0.0,0.0,0.0,1.0,1.0,0.0,0.0,0.0,0.0,0.0,1.0,0.0,0.0,0.0,0.0,0.0,0.0,0.0,0.0,0.0,0.0,0.0,0.0,0.0,0.0,0.0,0.0,0.0,0.0,0.0,0.0,0.0,0.0,0.0,0.0,0.0,0.0,0.0,1.0,0.0,0.0,0.0,0.0,0.0,0.0,0.0,0.0,0.0,0.0,0.0,0.0,0.0,0.0,0.0,0.0,0.0,0.0,0.0,0.0,0.0,0.0,0.0,0.0,0.0,0.0,0.0,0.0,0.0,0.0,0.0,0.0,0.0,0.0,0.0,0.0,0.0,0.0,0.0,0.0,0.0,0.0,0.0,0.0,0.0,0.0,0.0,0.0,0.0,0.0,0.0,0.0,0.0,0.0,0.0,0.0,1.0,0.0,0.0,0.0,0.0,0.0,0.0,1.0,0.0,0.0
102912,0,0.0,1.0,0.0,1.0,2.0,252000.0,301464.0,19395.0,238500.0,0.006629,30.408219178082188,-2982.0,-4577.0,-2835.0,,4.0,2.0,2.0,6.0,0.4399184526499518,0.4740574468111829,0.6246146584503397,,,,,,,,,,,,,,,,,,,,,,,,,,,,,,,,,,,,,,,,,,,,,0.0,0.0,0.0,0.0,0.0,0.0,0.0,0.0,0.0,0.0,2.0,1.0,1.0,0.0,1.0,0.0,0.0,0.0,0.0,0.0,0.0,0.0,0.0,0.0,1.0,0.0,0.0,0.0,0.0,0.0,0.0,0.0,0.0,0.0,0.0,0.0,0.0,0.0,0.0,0.0,0.0,0.0,0.0,7.0,0.0,0.0,89100.0,0.0,0.0,0.0,0.0,0.0,-1559.0,-812.0,-415.0,-1576.0,312.0,-25.0,5.0,19153.9125,169605.0,160114.5,22500.0,197302.5,15.0,-1606.0,365243.0,-1740.5,-1290.5,-1290.5,-1283.0,6.0,0.0,0.1937332626104505,8.0,60.0,18.0,8.5,-50.0,0.0,0.0,57.0,21223.62,21223.62,-1553.0,-1515.0,7.0,1.0,0.0,,,,,,,,,,,,,,,,,,,,,8347169506.5,184404976902.0,165590445564.0,51974217307.935,1863.0,1705.0,71125.0,70825.0,9140.0,506095.0,,,,,,,128422.0,662861.0,,,,13528530.465753024,-601941696.0,-921961414.0,-296535594.0,-1535237172.0416667,44019.0,30706.0,,,,,,,67469.8413654418,158050.94158285233,126114.12489047911,,,,,,,3714447.0,,,,,,,,,,,,,,,,436486.0,431280.0,,6425.551219002897,631996.0,625547.0,,,,,,,,,52.0,45396896.39999998,19404041.71500002,4863896091.900003,1611979237.575,54857378.96999996,709788.5099999999,93.0,12014.0,-15688098.0,6916756.0,-8125433.0,-8834992.0,-25.5,0.0,14829.885,69889.5,0.0,0.0,0.0,0.0,0.0,-1942.0,-1576.0,-1046.0,-1576.0,171734179.86000022,2460304282.860002,2774479309.8300004,39883222.53,2460191782.860002,177033.0,-12138540.0,2802919329.5,120632128.0,622925821.0,276640419.0,650529449.0,176272.0,2732.5,497.2456187600444,4129458.0,1452561.0,890253.5,-2905998.0,939958.0,99219.0,1942863722.3699992,1957976633.6549823,-118186339.0,-117225436.0,2120284.0,95912.0,,,,,,,,,,,,,,,,,,,,,1467536.0,14784996.0,3233007.0,8555654.0,11608686.0,1415797.0,1058748495.8670008,801693822.667495,72110378312.79712,21676417805.362617,582257468.0294988,5792665.7475,689.5,94245.0,-276943738.5,21975649.5,-123797648.0,-218721185.0,-2018956.5,,,,,,,,,,,,,,,,,,,,,4273287.0,2479429.5,-9004133.5,921269.0,37582.5,3733672911.5024624,3658417493.354962,-260645485.5,-257334251.0,2526714.5,269214.5,3926366632.642456,33255769837.27592,36684870643.21514,1729512388.8450494,48087826332.593216,3988330.0,-247603205.5,103093334005.0,1054157538.5,17274938624.0,3504048151.0,18888777004.5,3672322.0,71924.5,20871.42531634133,89789128.0,-98.06559149472928,1.1962857142857144,12.993039443155451,395.0951911769381,15.54338747099768,472.646732987954,63000.0,0.6234898018587336,0.7818314824680298,0.0,0.0,0.0,0.0,0.0,0.0,1.0,0.0,0.0,0.0,1.0,0.0,0.0,0.0,0.0,0.0,0.0,0.0,1.0,0.0,1.0,0.0,0.0,0.0,0.0,0.0,0.0,0.0,0.0,1.0,0.0,0.0,0.0,0.0,0.0,0.0,0.0,0.0,1.0,0.0,0.0,0.0,0.0,0.0,0.0,0.0,0.0,0.0,0.0,0.0,0.0,0.0,1.0,0.0,0.0,0.0,0.0,0.0,0.0,0.0,0.0,0.0,0.0,0.0,0.0,0.0,0.0,0.0,0.0,0.0,0.0,0.0,0.0,0.0,0.0,0.0,0.0,0.0,0.0,0.0,0.0,0.0,0.0,0.0,0.0,0.0,0.0,0.0,0.0,0.0,0.0,0.0,0.0,0.0,0.0,0.0,0.0,0.0,0.0,0.0,0.0,0.0,0.0,0.0,0.0,0.0,0.0,0.0,0.0,0.0,0.0,0.0,0.0,0.0,0.0,0.0,0.0,0.0,0.0,0.0
102919,0,0.0,0.0,0.0,1.0,0.0,157500.0,535306.5,25884.0,400500.0,0.01885,61.03561643835617,,-10830.0,-4916.0,,1.0,2.0,2.0,13.0,,0.6633192540013011,0.7136313997323308,0.1031,,0.9796,,,0.0,0.2069,0.1667,,0.0546,,0.09,,0.0722,0.105,,0.9796,,,0.0,0.2069,0.1667,,0.0559,,0.0938,,0.0764,0.1041,,0.9796,,,0.0,0.2069,0.1667,,0.0556,,0.0916,,0.0737,0.0925,1.0,2.0,0.0,2.0,0.0,0.0,0.0,0.0,0.0,0.0,0.0,0.0,1.0,0.0,0.0,1.0,0.0,0.0,0.0,0.0,0.0,0.0,0.0,0.0,0.0,1.0,0.0,0.0,0.0,0.0,0.0,0.0,0.0,0.0,0.0,0.0,0.0,0.0,0.0,0.0,0.0,0.0,0.0,0.0,1.0,0.0,,90000.0,,,0.0,0.0,0.0,-1556.0,-821.0,-1206.0,-1207.0,52.0,-25.5,11.0,10865.25,54000.0,57564.0,5377.5,135000.0,12.0,-570.0,365243.0,-909.0,-849.0,-579.0,-845.0,13.0,1.0,0.1089090909090909,-1.0,50.0,24.0,12.0,-23.5,0.0,0.0,53.0,10865.25,9349.515,-605.0,-571.0,6.0,1.0,0.0,,,,,,,,,,,,,,,,,,,,,8347195390.5,184405512208.5,165590846064.0,51974374807.935,1863.0,1705.0,71125.0,70825.0,9140.0,506095.0,17809.125800002294,17871.293799999108,17322.708999998045,,,,128422.0,662862.0,,,,13528591.50136946,,-921966330.0,-296535594.0,-1535248002.0416667,44019.0,30706.0,11350.495199999184,11226.459999998977,10710.743199997294,22888.407700009702,22810.271000009663,22195.759900008223,,158051.60490210634,126114.83852187885,35004.71250002793,34944.92910002837,34390.59230002878,,,,3714460.0,8295.885600000165,8400.404800000077,8123.99360000023,,,,16468.76829999976,16654.01109999969,16250.798599999702,,,,3914.070400000125,3897.240000000163,3729.81700000016,436488.0,431282.0,,6425.570069002897,631998.0,625549.0,,16333.1228999998,154187.66949999056,154190.41409999013,154082.16819998712,,,,52.0,45439119.89999998,,4870364511.915005,,,709788.5099999999,93.0,12014.0,-15710686.0,6974290.0,-8134831.0,-8842587.0,-25.5,0.0,,90000.0,,,0.0,0.0,0.0,-1556.0,-821.0,-1206.0,-1207.0,171949131.49500018,2462177713.860002,2776798137.3300004,39924240.03,2462587213.860002,177223.0,-12158687.0,2807484657.0,120621551.0,624378653.0,277000070.0,651982346.0,176591.0,2737.0,497.92280861658935,4137389.0,1454873.0,891655.0,-2909667.5,939964.0,99225.0,1945055193.12,1960062163.1999824,-118294784.0,-117331572.0,2121361.0,96119.0,,,,,,,,,,,,,,,,,,,,,1467537.0,14785048.0,3233007.0,8555704.0,11608739.0,1415808.0,1058748495.8670008,,72110468312.79712,,,5792665.7475,689.5,94245.0,-276945294.5,21974828.5,-123798854.0,-218722392.0,-2018982.0,,,,,,,,,,,,,,,,,,,,,4273311.0,2479441.5,-9004157.0,921269.0,37582.5,3733683776.7524624,3658426842.869961,-260646090.5,-257334822.0,2526720.5,269215.5,3926377497.892456,33255823837.27592,36684928207.21514,1729517766.3450494,48087961332.593216,3988342.0,-247603775.5,103093699248.0,1054156629.5,17274937775.0,3504047572.0,18888776159.5,3672335.0,71925.5,20871.53422543224,89789127.0,,3.398771428571429,6.084840055632824,371.3919637243508,20.68098052851182,1262.2763951073598,157500.0,-0.2225209339563146,-0.9749279121818236,0.0,0.0,0.0,0.0,0.0,0.0,1.0,0.0,0.0,1.0,0.0,0.0,0.0,0.0,0.0,0.0,0.0,0.0,1.0,0.0,0.0,0.0,1.0,0.0,0.0,1.0,0.0,0.0,0.0,0.0,0.0,0.0,0.0,0.0,0.0,0.0,0.0,0.0,0.0,0.0,0.0,0.0,0.0,0.0,0.0,0.0,0.0,0.0,0.0,0.0,0.0,0.0,0.0,0.0,0.0,0.0,0.0,0.0,0.0,0.0,0.0,0.0,0.0,0.0,0.0,0.0,0.0,0.0,0.0,0.0,0.0,0.0,0.0,0.0,0.0,0.0,0.0,0.0,0.0,0.0,0.0,0.0,0.0,0.0,0.0,0.0,0.0,0.0,0.0,0.0,0.0,0.0,0.0,0.0,0.0,0.0,0.0,0.0,0.0,0.0,0.0,0.0,0.0,0.0,0.0,1.0,0.0,0.0,0.0,0.0,1.0,0.0,0.0,0.0,0.0,0.0,0.0,0.0,1.0,0.0
102927,0,0.0,0.0,0.0,0.0,0.0,54000.0,118512.0,9490.5,90000.0,0.010643,28.86849315068493,-1629.0,-4719.0,-1127.0,,2.0,2.0,2.0,19.0,,0.5389074989080975,0.3876253444214701,0.1474,0.1222,0.9871,0.8232,0.041,0.16,0.1379,0.3333,0.375,0.0521,0.1194,0.1479,0.0039,0.0011,0.1502,0.1268,0.9871,0.8301,0.0414,0.1611,0.1379,0.3333,0.375,0.0533,0.1304,0.1541,0.0039,0.0012,0.1489,0.1222,0.9871,0.8256,0.0413,0.16,0.1379,0.3333,0.375,0.053,0.1214,0.1505,0.0039,0.0011,0.1165,1.0,0.0,0.0,0.0,0.0,-2019.0,0.0,0.0,0.0,0.0,0.0,1.0,1.0,1.0,1.0,1.0,1.0,0.0,0.0,0.0,0.0,0.0,0.0,0.0,0.0,1.0,0.0,0.0,0.0,0.0,0.0,0.0,0.0,0.0,0.0,0.0,0.0,0.0,0.0,0.0,0.0,0.0,0.0,0.0,3.0,33750.0,0.0,130324.95,0.0,30559.86,0.0,0.0,0.0,-708.0,-526.0,-25.0,-525.0,63.0,-10.0,3.0,5393.4975,51025.5,50440.5,3.6,51025.5,11.0,-709.0,365243.0,181627.5,181762.5,-680.5,181765.5,19.0,0.0,9.91682860152436e-05,120.0,11.0,10.0,5.0,-61.0,0.0,0.0,10.0,6264.045,6264.045,-1892.0,-1853.0,5.5,1.0,0.0,,,,,,,,,,,,,,,,,,,,,8347204881.0,184405630720.5,165590936064.0,51974428807.935,1863.0,1705.0,71125.0,70825.0,9140.0,506096.0,17809.273200002295,17871.44269999911,17322.859199998045,11296.733700000092,11234.512200000096,11181.82390000006,128422.0,662864.0,4138.1588000001175,4135.829300000016,3946.397500000094,13528620.369862612,-601943325.0,-921967457.0,-296537613.0,-1535252721.0416667,44019.0,30706.0,11350.655199999184,11226.619999998977,10710.904299997292,22888.545600009704,22810.408900009665,22195.897800008224,,158052.14380960524,126115.22614722328,35005.04580002793,34945.26240002837,34390.92560002878,22957.874099995912,22930.983899995488,22577.74799999572,3714479.0,8295.937700000166,8400.457800000077,8124.046900000229,9818.569100000715,9933.538100002164,10293.234699999646,16468.91619999976,16654.16159999969,16250.952699999702,828.7504000001762,813.9266000000459,759.8490000000132,3914.071500000125,3897.241100000163,3729.81820000016,436488.0,431282.0,,6425.580712002897,632000.0,625551.0,,16333.2393999998,154188.65659999056,154191.40119999013,154083.15529998712,77621.14879999628,77958.96980000657,78360.32270000655,24.0,45524700.89999998,19442992.86000002,4877591164.650003,1616757814.575,54965819.83499996,709788.5099999999,93.0,12014.0,-15744029.0,7022397.0,-8152974.0,-8862001.0,-11.5,33750.0,0.0,130324.95,0.0,0.0,0.0,0.0,0.0,-708.0,-650.0,-25.0,-648.0,172524748.47750014,2471787093.960002,2787560283.3300004,40044947.13,2471787093.960002,178073.0,-12192388.0,2817528550.5,120958110.0,626550204.0,277349547.0,654153991.0,177215.0,2747.0,499.511950762752,4178353.0,1459972.0,894893.0,-2919365.0,940006.0,99247.0,1949868934.537504,1964446025.332488,-118599863.0,-117633227.0,2123658.0,96483.5,,,,,,,,,,,,,,,,,,,,,1467540.0,14785111.0,3233007.0,8555715.0,11608749.0,1415811.0,1058782245.8670008,801693822.667495,72110598637.74713,21676417805.362617,582288027.8894991,5792665.7475,689.5,94245.0,-276946002.5,21974302.5,-123798879.0,-218722917.0,-2018992.0,,,,,,,,,,,,,,,,,,,,,4273321.0,2479446.5,-9004218.0,921269.0,37582.5,3733690040.797464,3658433106.914961,-260647982.5,-257336675.0,2526726.0,269216.5,3926382891.389957,33255874862.77592,36684978647.71514,1729517769.9450495,48088012358.093216,3988353.0,-247604484.5,103094064491.0,1054338257.0,17275119537.5,3504046891.5,18888957925.0,3672354.0,71925.5,20871.534324600525,89789247.0,-56.42830027522065,2.1946666666666665,5.689900426742533,164.25885149749604,12.487434803224277,360.4934260865048,27000.0,-0.2225209339563143,0.9749279121818236,0.0,0.0,0.0,0.0,0.0,0.0,1.0,0.0,0.0,0.0,0.0,0.0,0.0,1.0,0.0,0.0,0.0,0.0,1.0,0.0,1.0,0.0,0.0,0.0,0.0,1.0,0.0,0.0,0.0,0.0,0.0,0.0,0.0,0.0,0.0,0.0,0.0,0.0,0.0,0.0,0.0,1.0,0.0,0.0,0.0,0.0,0.0,0.0,0.0,0.0,0.0,0.0,0.0,0.0,0.0,0.0,0.0,0.0,0.0,0.0,0.0,0.0,0.0,0.0,0.0,0.0,0.0,0.0,0.0,0.0,0.0,0.0,0.0,0.0,0.0,0.0,0.0,0.0,1.0,0.0,0.0,0.0,0.0,0.0,0.0,0.0,0.0,0.0,0.0,0.0,0.0,0.0,0.0,0.0,0.0,0.0,0.0,0.0,0.0,0.0,0.0,0.0,0.0,0.0,0.0,0.0,0.0,0.0,0.0,1.0,1.0,0.0,0.0,0.0,0.0,0.0,0.0,1.0,0.0,0.0
102932,0,0.0,1.0,1.0,1.0,1.0,135000.0,207396.0,16515.0,157500.0,0.0228,38.31780821917808,-391.0,-3213.0,-4256.0,4.0,3.0,2.0,2.0,15.0,,0.4165345941187126,0.6925590674998008,,,,,,,,,,,,,,,,,,,,,,,,,,,,,,,,,,,,,,,,,,,,,3.0,0.0,3.0,0.0,-2092.0,0.0,0.0,0.0,0.0,0.0,1.0,1.0,1.0,0.0,1.0,0.0,1.0,0.0,0.0,0.0,0.0,0.0,0.0,0.0,1.0,0.0,0.0,0.0,0.0,0.0,0.0,0.0,0.0,0.0,0.0,0.0,0.0,0.0,0.0,0.0,0.0,0.0,0.0,7.0,0.0,14683.5,299664.0,0.0,0.0,0.0,0.0,0.0,-1805.0,-1074.0,-1014.0,-1308.0,345.0,-27.0,1.0,26142.705,180000.0,220297.5,0.0,180000.0,12.0,-2091.0,365243.0,-2056.0,-1726.0,-1726.0,-1718.0,16.0,0.0,0.0,-1.0,13.0,12.0,6.0,-62.0,0.0,0.0,12.0,26142.705,26142.705,-1896.0,-1891.0,6.5,1.0,0.0,,,,,,,,,,,,,,,,,,,,,8347221396.0,184405838116.5,165591093564.0,51974563807.935,1863.0,1705.0,71125.0,70825.0,9140.0,506097.0,,,,,,,128423.0,662867.0,,,,13528658.68767083,-601943716.0,-921971713.0,-296539705.0,-1535255934.0416667,44019.0,30706.0,,,,,,,,158052.56034419936,126115.91870629074,,,,,,,3714494.0,,,,,,,,,,,,,,,,436491.0,431285.0,1263285.0,6425.603512002896,632002.0,625553.0,,,,,,,,,60.0,45605633.39999998,19467712.800000027,4883268149.100004,1617791986.575,55049175.35999996,709788.5099999999,93.0,12014.0,-15761345.0,7020529.0,-8163134.0,-8871289.0,-29.5,0.0,29367.0,299664.0,0.0,0.0,0.0,0.0,0.0,-1805.0,-1074.0,-1193.0,-1308.0,172815660.81000015,2475290010.960002,2791528603.8300004,40097867.13,2475290010.960002,178295.0,-12214414.0,2822458245.0,121307010.0,627268265.0,278070001.0,655238074.0,177478.0,2752.0,500.4821307772345,4182655.0,1462516.0,896567.0,-2924018.0,940050.0,99281.0,1952854007.152507,1967489459.0774915,-118762746.5,-117794543.0,2125895.5,96661.5,,,,,,,,,,,,,,,,,,,,,1467547.0,14785456.0,3233007.0,8555728.0,11608761.0,1415812.0,1058782245.8670008,801708506.167495,72110898301.74713,21676417805.362617,582288027.8894991,5792665.7475,689.5,94245.0,-276947807.5,21973228.5,-123799893.0,-218724225.0,-2019019.0,,,,,,,,,,,,,,,,,,,,,4273333.0,2479452.5,-9004280.0,921269.0,37582.5,3733716183.5024624,3658459249.619961,-260649878.5,-257338566.0,2526732.5,269217.5,3926409034.094957,33256054862.77592,36685198945.21514,1729517769.9450495,48088192358.093216,3988365.0,-247606575.5,103094429734.0,1054336201.0,17275117811.5,3504045165.5,18888956207.0,3672370.0,71925.5,20871.534324600525,89789246.0,-10.204132704132704,1.536266666666667,8.174386920980927,313.22459034750483,12.558038147138966,481.1964973311933,45000.0,-0.2225209339563143,0.9749279121818236,0.0,0.0,0.0,0.0,0.0,0.0,1.0,0.0,1.0,0.0,0.0,0.0,0.0,0.0,0.0,0.0,1.0,0.0,0.0,0.0,1.0,0.0,0.0,0.0,0.0,1.0,0.0,0.0,0.0,0.0,0.0,0.0,0.0,0.0,0.0,0.0,0.0,0.0,1.0,0.0,0.0,0.0,0.0,0.0,0.0,0.0,0.0,0.0,0.0,0.0,0.0,0.0,0.0,0.0,0.0,1.0,0.0,0.0,0.0,0.0,0.0,0.0,0.0,0.0,0.0,0.0,0.0,0.0,0.0,0.0,0.0,0.0,0.0,0.0,0.0,0.0,0.0,0.0,0.0,0.0,0.0,0.0,0.0,0.0,0.0,0.0,0.0,0.0,0.0,0.0,0.0,0.0,0.0,0.0,0.0,0.0,0.0,0.0,0.0,0.0,0.0,0.0,0.0,0.0,0.0,0.0,0.0,0.0,0.0,0.0,0.0,0.0,0.0,0.0,0.0,0.0,0.0,0.0,0.0,0.0
102933,0,0.0,1.0,0.0,0.0,0.0,180000.0,254700.0,18531.0,225000.0,0.018634,29.09041095890411,-3052.0,-4763.0,-1944.0,,1.0,2.0,2.0,17.0,0.6009577796970585,0.2449691604382836,0.434733248750173,0.2299,0.1055,0.9811,,,0.16,0.1379,0.3333,,0.0862,,0.2152,,0.0,0.2342,0.1094,0.9811,,,0.1611,0.1379,0.3333,,0.0882,,0.2243,,0.0,0.2321,0.1055,0.9811,,,0.16,0.1379,0.3333,,0.0877,,0.2191,,0.0,0.2103,1.0,0.0,0.0,0.0,0.0,-1541.0,0.0,0.0,0.0,0.0,0.0,0.0,1.0,1.0,1.0,1.0,0.0,0.0,0.0,0.0,0.0,0.0,0.0,0.0,0.0,1.0,0.0,0.0,0.0,0.0,0.0,0.0,0.0,0.0,0.0,0.0,0.0,0.0,0.0,0.0,0.0,0.0,0.0,0.0,3.0,18967.455,0.0,225000.0,76322.295,228005.91,0.0,0.0,0.0,-941.0,-429.5,-9.0,-1007.0,107.0,-17.0,6.0,26408.34,154125.0,181966.5,6975.0,501750.0,5.0,-450.0,365243.0,-964.5,182002.0,-484.5,182004.0,10.5,0.5,0.1089090909090909,-1.0,25.0,24.0,12.0,-14.0,0.0,0.0,24.0,16816.68,16816.68,-386.0,-375.0,6.5,1.0,0.0,,,,,,,,,,,,,,,,,,,,,8347239927.0,184406092816.5,165591318564.0,51974743807.935,1863.0,1705.0,71125.0,70825.0,9140.0,506097.0,17809.503100002294,17871.67479999911,17323.093399998044,11296.839200000091,11234.617700000092,11181.933300000055,128423.0,662868.0,,,,13528687.77808179,-601946768.0,-921973657.0,-296541246.0,-1535260697.0416667,44019.0,30706.0,11350.815199999184,11226.779999998977,10711.065399997293,22888.6835000097,22810.546800009663,22196.035700008222,67470.44232322149,158052.8053133598,126116.35343953953,35005.37910002793,34945.59570002837,34391.25890002878,,,,3714511.0,8296.023900000166,8400.545500000077,8124.13510000023,,,,16469.13139999976,16654.38069999969,16251.1769999997,,,,3914.071500000125,3897.241100000163,3729.81820000016,436491.0,431285.0,,6425.622146002896,632004.0,625555.0,,16333.4496999998,154189.63769999053,154192.38229999013,154084.1363999871,,,,31.0,45656168.35499997,19482396.300000027,4884980399.100004,1617878634.12,55277181.26999996,709788.5099999999,93.0,12014.0,-15766173.0,7027074.0,-8165171.0,-8873965.0,-15.0,18967.455,0.0,225000.0,20650.5,228005.91,0.0,0.0,0.0,-1744.0,-1013.0,-1003.0,-1007.0,172876635.13500014,2475742260.960002,2791951378.8300004,40104842.13,2476507260.960002,178305.0,-12217080.0,2823006109.5,121305291.0,627449647.5,278068897.0,655419460.5,177518.5,2752.5,500.5910398681437,4182760.5,1462746.0,896698.0,-2924918.0,940050.0,99281.0,1953109577.5200076,1967745029.4449923,-118787695.5,-117819381.0,2126000.5,96679.5,,,,,,,,,,,,,,,,,,,,,1467550.0,14785563.0,3233007.0,8555753.0,11608785.0,1415818.0,1058801213.3220012,801708506.167495,72111123301.74713,21676494127.657616,582516033.7994988,5792665.7475,689.5,94245.0,-276948748.5,21972799.0,-123799902.0,-218725232.0,-2019036.0,,,,,,,,,,,,,,,,,,,,,4273357.0,2479464.5,-9004294.0,921269.0,37582.5,3733733000.1824617,3658476066.299961,-260650264.5,-257338941.0,2526739.0,269218.5,3926435442.434956,33256208987.77592,36685380911.71514,1729524744.9450495,48088694108.093216,3988370.0,-247607025.5,103094794977.0,1054335236.5,17275299813.5,3504044681.0,18889138211.0,3672380.5,71926.0,20871.64323369144,89789245.0,-104.9142964776794,1.415,9.713453132588636,282.5683434570578,13.74453618261292,399.8342059917369,180000.0,-0.9009688679024191,0.4338837391175582,0.0,0.0,0.0,0.0,0.0,0.0,1.0,0.0,0.0,0.0,0.0,0.0,0.0,1.0,0.0,0.0,0.0,0.0,1.0,0.0,0.0,0.0,1.0,0.0,0.0,1.0,0.0,0.0,0.0,0.0,0.0,0.0,0.0,0.0,0.0,0.0,0.0,0.0,1.0,0.0,0.0,0.0,0.0,0.0,0.0,0.0,0.0,0.0,0.0,0.0,0.0,0.0,0.0,1.0,0.0,0.0,0.0,0.0,0.0,0.0,0.0,0.0,0.0,0.0,0.0,0.0,0.0,0.0,0.0,0.0,0.0,0.0,0.0,0.0,0.0,0.0,0.0,0.0,0.0,0.0,0.0,0.0,0.0,0.0,0.0,0.0,0.0,0.0,0.0,0.0,0.0,0.0,0.0,0.0,0.0,0.0,0.0,0.0,0.0,0.0,0.0,0.0,0.0,0.0,0.0,0.0,0.0,0.0,0.0,0.0,0.0,0.0,0.0,0.0,0.0,0.0,0.0,1.0,0.0,0.0
102935,0,0.0,0.0,0.0,1.0,0.0,171000.0,732915.0,79065.0,675000.0,0.010032,64.27397260273972,,-12215.0,-4635.0,,2.0,2.0,2.0,6.0,,0.5228430612347231,0.6626377922738201,0.0742,0.0565,0.9831,0.7688,0.018,0.08,0.069,0.3333,0.375,0.1184,0.0605,0.0768,0.0,0.0,0.0756,0.0587,0.9831,0.7779,0.0181,0.0806,0.069,0.3333,0.375,0.1211,0.0661,0.08,0.0,0.0,0.0749,0.0565,0.9831,0.7719,0.0181,0.08,0.069,0.3333,0.375,0.1204,0.0616,0.0782,0.0,0.0,0.0702,1.0,0.0,0.0,0.0,0.0,-305.0,0.0,0.0,0.0,0.0,0.0,0.0,1.0,0.0,0.0,1.0,0.0,0.0,0.0,0.0,0.0,0.0,0.0,0.0,0.0,1.0,0.0,0.0,0.0,0.0,0.0,0.0,0.0,0.0,0.0,0.0,0.0,0.0,0.0,0.0,0.0,0.0,0.0,0.0,3.0,,0.0,114831.0,0.0,0.0,0.0,0.0,0.0,-1055.0,-870.0,-867.0,-870.0,152.0,-25.0,2.0,14123.34,107122.5,113080.5,0.0,107122.5,4.0,-305.0,365243.0,182484.0,182589.0,182589.0,182592.0,9.0,0.5,0.0,345.5,8.0,8.0,3.5,-6.5,0.0,0.0,8.0,25996.68,25996.68,-178.0,-170.0,4.5,1.0,8.0,0.0,45000.0,,0.0,,,0.0,,0.0,0.0,0.0,0.0,,0.0,,,0.0,-6.5,0.0,0.0,8347318992.0,184406825731.5,165591993564.0,51974914807.935,1863.0,1705.0,71125.0,70825.0,9140.0,506097.0,17809.577300002293,17871.74969999911,17323.168999998044,11296.895700000092,11234.674200000096,11181.992000000057,128423.0,662870.0,4138.1768000001175,4135.847400000016,3946.415600000094,13528752.052054392,,-921978292.0,-296541551.0,-1535272912.0416667,44019.0,30706.0,11350.895199999184,11226.859999998976,10711.145999997292,22888.7525000097,22810.615800009666,22196.10470000822,,158053.32815642105,126117.0160773318,35005.71240002793,34945.929000028365,34391.592200028776,22958.249099995912,22931.358899995488,22578.12299999572,3714517.0,8296.142300000165,8400.665900000076,8124.25620000023,9818.629600000717,9933.599700002163,10293.300799999646,16469.208199999757,16654.45889999969,16251.2569999997,828.7504000001762,813.9266000000459,759.8490000000132,3914.071500000125,3897.241100000163,3729.81820000016,436491.0,431285.0,,6425.632178002897,632006.0,625557.0,,16333.5198999998,154190.62079999055,154193.36539999014,154085.1194999871,77621.91759999628,77959.74170000659,78361.10060000655,35.0,,19482396.300000027,4892144305.455004,1620200566.665,55277181.26999996,709788.5099999999,93.0,12014.0,-15784407.0,7019668.0,-8177081.0,-8886260.0,-17.0,,0.0,114831.0,0.0,0.0,0.0,0.0,0.0,-2756.0,-2513.0,-2143.0,-2144.0,172995001.38000014,2477908772.460002,2794176102.3300004,40121384.13,2477908772.460002,178365.0,-12222357.5,2824466408.5,121484507.5,627812539.5,278614963.5,656148100.5,177584.5,2755.0,500.8993704365096,4183382.0,1463256.0,896976.5,-2926103.0,940674.0,99321.0,1954004186.8800075,1968616378.3949928,-118834615.5,-117866257.5,2126810.0,96714.5,1856080573.019988,4989906000.0,,245206176.83999968,,,105355719.4049996,,247190477.1750005,1781638868.3399966,1849015541.114987,1849080793.0499864,,20523.0,,,606393.0,-1094011.5,495646.0,969.0,1467553.0,14785715.0,3233015.0,8555761.0,11608793.0,1415820.0,,801708506.167495,72111238132.74713,21676494127.657616,582516033.7994988,5792665.7475,689.5,94245.0,-276949803.5,21971929.0,-123800769.0,-218726102.0,-2019061.0,5923144758.284962,18722938500.0,,447973953.7049976,,,309134651.03999865,,459170099.0999993,5708288670.862533,5886434047.027499,5886677229.7725,,80838.5,,,971577.5,-1698678.0,177364.0,6755.0,4273365.0,2479468.0,-9004300.5,921269.0,37582.5,3733758996.8624616,3658502062.979961,-260650442.5,-257339111.0,2526743.5,269219.5,3926449565.774956,33256316110.27592,36685493992.21514,1729524744.9450495,48088801230.593216,3988374.0,-247607330.5,103095160220.0,1054517720.5,17275482402.5,3504227270.0,18889320803.0,3672389.5,71926.5,20871.64323369144,89789590.5,,4.286052631578947,2.1627774615822424,139.01029931156003,9.269778030734209,595.8054591808891,85500.0,-0.2225209339563143,0.9749279121818236,0.0,0.0,0.0,0.0,0.0,0.0,1.0,0.0,0.0,1.0,0.0,0.0,0.0,0.0,0.0,0.0,0.0,0.0,1.0,0.0,1.0,0.0,0.0,0.0,0.0,1.0,0.0,0.0,0.0,0.0,0.0,0.0,0.0,0.0,0.0,0.0,0.0,0.0,0.0,0.0,0.0,0.0,0.0,0.0,0.0,0.0,0.0,0.0,0.0,0.0,0.0,0.0,0.0,0.0,0.0,0.0,0.0,0.0,0.0,0.0,0.0,0.0,0.0,0.0,0.0,0.0,0.0,0.0,0.0,0.0,0.0,0.0,0.0,0.0,0.0,0.0,0.0,0.0,0.0,0.0,0.0,0.0,0.0,0.0,0.0,0.0,0.0,0.0,0.0,0.0,0.0,0.0,0.0,0.0,0.0,0.0,0.0,0.0,0.0,0.0,0.0,0.0,0.0,0.0,0.0,1.0,0.0,0.0,1.0,0.0,1.0,0.0,0.0,0.0,0.0,0.0,0.0,1.0,0.0,0.0
102958,0,0.0,0.0,0.0,1.0,0.0,90000.0,248877.0,12834.0,189000.0,0.008625,45.98356164383562,-1240.0,-9669.0,-326.0,,1.0,2.0,2.0,12.0,,0.5413408910046952,0.5585066276769286,,,,,,,,,,,,,,,,,,,,,,,,,,,,,,,,,,,,,,,,,,,,,0.0,0.0,0.0,0.0,-644.0,0.0,0.0,0.0,0.0,0.0,1.0,1.0,1.0,1.0,1.0,0.0,0.0,0.0,0.0,0.0,0.0,0.0,0.0,0.0,1.0,0.0,0.0,0.0,0.0,0.0,0.0,0.0,0.0,0.0,0.0,0.0,0.0,0.0,0.0,0.0,0.0,0.0,0.0,3.0,0.0,,246748.5,13351.5,0.0,0.0,0.0,0.0,-1869.0,-704.0,-690.0,-1624.0,196.0,-32.0,1.0,11570.4,112860.0,112860.0,0.0,112860.0,12.0,-644.0,365243.0,-613.0,-463.0,-283.0,-456.0,17.0,0.0,0.0,500.0,7.0,12.0,9.0,-18.0,0.0,0.0,6.0,11570.4,11570.4,-570.0,-538.0,3.5,1.0,0.0,,,,,,,,,,,,,,,,,,,,,8347331826.0,184407074608.5,165592182564.0,51975004807.935,1863.0,1705.0,71125.0,70825.0,9140.0,506098.0,,,,,,,128423.0,662871.0,,,,13528798.035616037,-601948008.0,-921978618.0,-296542195.0,-1535282581.0416667,44019.0,30706.0,,,,,,,,158053.86949731206,126117.57458395947,,,,,,,3714529.0,,,,,,,,,,,,,,,,436491.0,431285.0,,6425.640803002897,632008.0,625559.0,,,,,,,,,62.0,45994784.21999998,,4921836416.010005,1632695230.125,55476480.91499996,709788.5099999999,93.0,12014.0,-15875713.0,7080760.0,-8226396.0,-8942069.0,-30.5,0.0,,246748.5,13351.5,0.0,0.0,0.0,0.0,-1869.0,-704.0,-690.0,-1624.0,174216413.61000004,2496226274.460002,2814761100.3300004,40311216.63,2496226274.460002,179447.0,-12290988.0,2844732209.0,123076729.0,634900152.0,282059693.0,662505306.0,179002.0,2775.0,503.1267738440416,4220142.0,1470899.0,901856.0,-2940728.0,940677.0,99324.0,1969707654.090018,1985908999.1850028,-119658988.5,-118682831.5,2150762.5,97343.5,,,,,,,,,,,,,,,,,,,,,1467556.0,14785911.0,3233015.0,8555768.0,11608799.0,1415821.0,1058801213.3220012,,72111484881.24713,21676507479.157616,582516033.7994988,5792665.7475,689.5,94245.0,-276951672.5,21971225.0,-123801459.0,-218727726.0,-2019093.0,,,,,,,,,,,,,,,,,,,,,4273377.0,2479477.0,-9004318.5,921269.0,37582.5,3733770567.2624617,3658513633.379961,-260651012.5,-257339649.0,2526747.0,269220.5,3926461136.174956,33256428970.27592,36685606852.21514,1729524744.9450495,48088914090.593216,3988386.0,-247607974.5,103095525463.0,1054517107.5,17275481939.5,3504226987.0,18889320347.0,3672406.5,71926.5,20871.64323369144,89790090.5,-26.966158245948524,2.7653,7.012622720897616,322.4653691713578,19.392005610098177,891.7134853695558,90000.0,1.0,0.0,0.0,0.0,0.0,0.0,0.0,0.0,1.0,0.0,1.0,0.0,0.0,0.0,0.0,0.0,0.0,0.0,0.0,0.0,1.0,0.0,0.0,0.0,0.0,1.0,0.0,1.0,0.0,0.0,0.0,0.0,0.0,0.0,0.0,0.0,0.0,0.0,0.0,0.0,0.0,0.0,0.0,0.0,0.0,0.0,1.0,0.0,0.0,0.0,0.0,0.0,0.0,0.0,0.0,0.0,0.0,0.0,0.0,0.0,0.0,0.0,0.0,0.0,0.0,0.0,0.0,0.0,0.0,0.0,0.0,0.0,0.0,0.0,0.0,0.0,0.0,0.0,0.0,0.0,0.0,0.0,0.0,0.0,0.0,0.0,0.0,0.0,0.0,0.0,0.0,0.0,1.0,0.0,0.0,0.0,0.0,0.0,0.0,0.0,0.0,0.0,0.0,0.0,0.0,0.0,0.0,0.0,0.0,0.0,0.0,0.0,0.0,0.0,0.0,0.0,0.0,0.0,0.0,0.0,0.0,0.0
102969,0,0.0,1.0,1.0,1.0,1.0,157500.0,509400.0,37197.0,450000.0,0.031329,30.91780821917808,-1461.0,-8962.0,-3824.0,15.0,3.0,2.0,2.0,10.0,,0.1724350885889568,0.722392890081304,0.1082,0.0427,0.9871,,,0.08,0.069,0.3333,,0.0852,,0.0905,,0.0,0.1103,0.0443,0.9871,,,0.0806,0.069,0.3333,,0.0871,,0.0943,,0.0,0.1093,0.0427,0.9871,,,0.08,0.069,0.3333,,0.0867,,0.0921,,0.0,0.0712,1.0,0.0,0.0,0.0,0.0,0.0,0.0,0.0,0.0,0.0,1.0,3.0,1.0,1.0,0.0,1.0,0.0,0.0,0.0,0.0,0.0,0.0,0.0,0.0,0.0,1.0,0.0,0.0,0.0,0.0,0.0,0.0,0.0,0.0,0.0,0.0,0.0,0.0,0.0,0.0,0.0,0.0,0.0,0.0,4.0,21883.5,0.0,675000.0,0.0,0.0,0.0,0.0,0.0,-759.0,227.0,-455.0,-459.5,95.0,-11.0,11.0,10529.955,112500.0,112500.0,10530.0,128025.0,10.0,-249.0,365243.0,-865.0,-865.0,-595.0,-857.0,12.0,0.0,0.1089090909090909,-1.0,11.0,10.0,6.0,-32.0,0.0,0.0,49.0,6703.74,6703.74,-379.0,-372.0,16.0,0.0,20.0,122156.28,180000.0,0.0,0.0,0.0,0.0,6239.07,9450.0,9450.0,111297.96,113842.0575,113842.0575,0.0,0.0,0.0,0.0,9.5,-11.5,0.0,0.0,8347369023.0,184407584008.5,165592632564.0,51975162307.935,1863.0,1705.0,71125.0,70826.0,9140.0,506101.0,17809.68550000229,17871.85899999911,17323.279299998045,11296.938400000094,11234.716900000096,11182.036300000056,128424.0,662874.0,,,,13528828.953424254,-601949469.0,-921982442.0,-296542195.0,-1535291543.0416667,44019.0,30706.0,11350.975199999184,11226.939999998976,10711.226599997291,22888.8215000097,22810.68480000966,22196.17370000822,,158054.04193240064,126118.29697684955,35006.04570002793,34946.262300028364,34391.925500028774,,,,3714539.0,8296.227500000165,8400.752600000076,8124.34330000023,,,,16469.298699999756,16654.55099999969,16251.351299999702,,,,3914.071500000125,3897.241100000163,3729.81820000016,436491.0,431285.0,1263300.0,6425.672132002896,632010.0,625561.0,,16333.5910999998,154191.60789999054,154194.35249999014,154086.1065999871,,,,25.5,46059543.71999998,19517946.840000022,4941625182.660005,1639575230.625,55476480.91499996,709788.5099999999,93.0,12014.0,-15920674.0,7103393.5,-8245085.0,-8961845.0,-12.25,24615.0,0.0,675000.0,0.0,0.0,0.0,0.0,0.0,-900.0,227.0,-494.0,-420.0,174634166.02499998,2501089194.960002,2820173070.3300004,40400501.13,2501122719.960002,179902.0,-12325626.0,2854227898.0,123779940.0,637070954.0,282771097.0,664311040.0,179667.0,2778.0,504.3935521685072,4239321.0,1473696.0,903361.0,-2949066.0,940868.0,99324.0,1972691546.715021,1989227034.9450064,-120074892.0,-119094562.0,2160320.0,97649.0,1892977413.0074875,5060299500.0,158254422.39,248653611.0449997,9919421.1,80258454.94500001,107506466.41499963,270478143.7200027,250335864.8550005,1817139256.064997,1885790509.0424871,1885865210.977487,8103.0,20876.0,128.0,12645.0,616858.5,-1108275.0,495809.0,1085.0,1467560.0,14786006.0,3233035.0,8555779.0,11608848.0,1415832.0,1058823096.8220012,801708506.167495,72112159881.24713,21676507479.157616,582516033.7994988,5792665.7475,689.5,94245.0,-276952431.5,21971452.0,-123801914.0,-218728185.5,-2019104.0,5923266914.5649605,18723118500.0,198783507.825,447973953.7049976,1948107.735,256768282.6650008,309140890.10999864,636585710.174998,459179549.0999993,5708399968.822533,5886547889.084999,5886791071.83,13381.0,80838.5,44.0,70350.5,971587.0,-1698689.5,177364.0,6755.0,4273387.0,2479483.0,-9004350.5,921269.0,37582.5,3733777271.002462,3658520337.119961,-260651391.5,-257340021.0,2526763.0,269220.5,3926471666.129956,33256541470.27592,36685719352.21514,1729535274.9450495,48089042115.593216,3988396.0,-247608223.5,103095890706.0,1054516242.5,17275481074.5,3504226392.0,18889319490.0,3672418.5,71926.5,20871.75214278234,89790089.5,-47.25431989366416,3.2342857142857144,4.234212436486813,130.91256807055805,13.694652794580207,423.408648731062,52500.0,-0.9009688679024191,-0.433883739117558,0.0,1.0,0.0,0.0,0.0,0.0,0.0,0.0,0.0,0.0,0.0,0.0,0.0,1.0,0.0,0.0,0.0,0.0,1.0,0.0,1.0,0.0,0.0,0.0,0.0,1.0,0.0,0.0,0.0,0.0,0.0,0.0,0.0,0.0,0.0,0.0,0.0,0.0,1.0,0.0,0.0,0.0,0.0,0.0,0.0,0.0,0.0,0.0,0.0,0.0,0.0,0.0,0.0,0.0,0.0,0.0,0.0,0.0,0.0,0.0,0.0,0.0,0.0,0.0,0.0,0.0,0.0,0.0,0.0,0.0,0.0,0.0,1.0,0.0,0.0,0.0,0.0,0.0,0.0,0.0,0.0,0.0,0.0,0.0,0.0,0.0,0.0,0.0,0.0,0.0,0.0,0.0,0.0,0.0,0.0,0.0,0.0,0.0,0.0,0.0,0.0,0.0,0.0,0.0,0.0,0.0,0.0,0.0,0.0,0.0,1.0,0.0,0.0,0.0,0.0,0.0,0.0,1.0,0.0,0.0
102971,0,0.0,0.0,0.0,1.0,1.0,270000.0,964575.0,31243.5,675000.0,0.016612,54.6958904109589,-1637.0,-11162.0,-3501.0,,3.0,2.0,2.0,16.0,0.7061169808812817,0.6095465233234576,0.746300213050371,,,,,,,,,,,,,,,,,,,,,,,,,,,,,,,,,,,,,,,,,,,,,0.0,0.0,0.0,0.0,0.0,0.0,0.0,0.0,0.0,0.0,1.0,1.0,1.0,0.0,1.0,0.0,1.0,0.0,0.0,0.0,0.0,1.0,1.0,0.0,1.0,0.0,0.0,0.0,0.0,0.0,0.0,0.0,0.0,0.0,0.0,0.0,0.0,0.0,0.0,0.0,0.0,0.0,0.0,3.0,18994.5,,675000.0,148968.0,0.0,0.0,0.0,0.0,-2140.0,-314.0,-291.0,-342.0,179.0,-29.0,0.0,,,,,,,,,,,,,,,,,0.0,,,,,,0.0,,,,,,,0.0,,,,,,,,,,,,,,,,,,,,,8347400266.5,184408548583.5,165593307564.0,51975432307.935,1863.0,1705.0,71125.0,70826.0,9140.0,506102.0,,,,,,,128425.0,662877.0,,,,13528883.649314668,-601951106.0,-921985943.0,-296542195.0,-1535302705.0416667,44019.0,30706.0,,,,,,,67471.14844020238,158054.65147892394,126119.04327706262,,,,,,,3714555.0,,,,,,,,,,,,,,,,436491.0,431285.0,,6425.688744002898,632012.0,625563.0,,,,,,,,,71.0,46100408.21999998,,4944405759.660005,1639724198.625,55476480.91499996,709788.5099999999,93.0,12014.0,-15927943.0,7101777.0,-8247506.0,-8963838.0,-35.0,18994.5,,675000.0,148968.0,0.0,0.0,0.0,0.0,-2140.0,-314.0,-291.0,-342.0,,,,,,,,,,,,,,,,,,,,,,,,,,,,,,,,,,,,,,,,,,,,,,,,1467563.0,14786185.0,3233035.0,8555779.0,11608848.0,1415832.0,1058842091.3220012,,72112834881.24713,21676656447.157616,582516033.7994988,5792665.7475,689.5,94245.0,-276954571.5,21971138.0,-123802205.0,-218728527.5,-2019133.0,,,,,,,,,,,,,,,,,,,,,,,,,,,,,,,,,,,,,,,,,,,,,,,,-29.92912242035664,3.5725,8.641797493878727,472.6708086788901,30.872821546881752,1688.616464005335,90000.0,0.6234898018587336,0.7818314824680298,0.0,0.0,0.0,0.0,0.0,0.0,1.0,0.0,1.0,0.0,0.0,0.0,0.0,0.0,0.0,1.0,0.0,0.0,0.0,0.0,1.0,0.0,0.0,0.0,0.0,0.0,0.0,0.0,1.0,0.0,0.0,0.0,0.0,0.0,0.0,0.0,0.0,0.0,0.0,0.0,1.0,0.0,0.0,0.0,0.0,0.0,0.0,0.0,0.0,0.0,0.0,0.0,0.0,1.0,0.0,0.0,0.0,0.0,0.0,0.0,0.0,0.0,0.0,0.0,0.0,0.0,0.0,0.0,0.0,0.0,0.0,0.0,0.0,0.0,0.0,0.0,0.0,0.0,0.0,0.0,0.0,0.0,0.0,0.0,0.0,0.0,0.0,0.0,0.0,0.0,0.0,0.0,0.0,0.0,0.0,0.0,0.0,0.0,0.0,0.0,0.0,0.0,0.0,0.0,0.0,0.0,0.0,0.0,0.0,0.0,0.0,0.0,0.0,0.0,0.0,0.0,0.0,0.0,0.0,0.0
102975,0,0.0,1.0,1.0,0.0,0.0,225000.0,431730.0,46494.0,405000.0,0.04622,42.86301369863013,-2169.0,-4886.0,-656.0,10.0,1.0,1.0,1.0,11.0,,0.6626352060420682,,0.1316,0.0909,0.9886,0.8436,0.0994,0.1332,0.1148,0.3608,0.4025,,0.107,0.1384,0.0013,0.0013,0.1261,0.0871,0.9891,0.8563,0.0929,0.1208,0.1034,0.375,0.4167,,0.1093,0.1373,0.0,0.0,0.1249,0.0839,0.9891,0.8524,0.0927,0.12,0.1034,0.375,0.4167,,0.1026,0.1357,0.0,0.0,0.1805,1.0,0.0,0.0,0.0,0.0,-334.0,,,,,,,1.0,1.0,1.0,1.0,0.0,0.0,1.0,0.0,1.0,1.0,0.0,1.0,0.0,0.0,0.0,0.0,0.0,0.0,1.0,0.0,0.0,0.0,0.0,0.0,0.0,0.0,0.0,0.0,0.0,0.0,0.0,0.0,0.0,,,,,,,,,,,,,0.0,,1.0,3964.59,56200.5,39339.0,16861.5,56200.5,12.0,-334.0,365243.0,-301.0,365243.0,29.0,365243.0,17.0,0.0,0.3267534339309501,1.0,10.0,12.0,7.5,-6.5,0.0,0.0,11.0,3964.59,3964.59,-190.0,-151.0,6.0,1.0,0.0,,,,,,,,,,,,,,,,,,,,,8347446760.5,184408980313.5,165593712564.0,51975657307.935,,,,,,,17809.817100002292,17871.983899999108,17323.405399998046,11297.029300000091,11234.800800000095,11182.123400000057,128425.0,662878.0,4138.276200000118,4135.940100000016,3946.508500000094,13528926.512328366,-601953275.0,-921986599.0,-296542529.0,-1535307591.0416667,44019.0,30706.0,11351.108399999184,11227.059999998975,10711.347399997292,22888.936300009704,22810.78820000966,22196.27710000822,,158055.31411413,,35006.40650002793,34946.637300028364,34392.300500028774,22958.651599995912,22931.77559999549,22578.539699995723,3714566.0,,,,9818.736600000717,9933.702300002164,10293.410099999646,16469.437099999755,16654.68669999969,16251.488599999702,828.7517000001762,813.9266000000459,759.8490000000132,3914.072800000125,3897.241100000163,3729.81820000016,436491.0,431285.0,1263310.0,6425.734964002898,632013.0,625564.0,,16333.771599999802,154192.59649999056,154195.34159999015,154087.0956999871,77622.76119999628,77960.59410000661,78361.95690000655,,,,,,,,,,,,,,,,,,,,,,,,,,,174740719.54499996,2502367379.460002,2821767019.8300004,40451463.63,2502367379.460002,180005.0,-12333041.0,2856417192.0,124140825.0,639260958.0,283865709.0,666501065.0,179866.0,2778.0,505.1014874206199,4243126.0,1474118.0,903611.0,-2949533.5,940868.0,99324.0,1974653351.8650208,1991157184.350007,-120190863.0,-119209126.0,2165435.0,97684.0,,,,,,,,,,,,,,,,,,,,,1467563.0,14786185.0,3233035.0,8555789.0,11608859.0,1415833.0,,,,,,,,,,,,,,,,,,,,,,,,,,,,,,,,,,4273399.0,2479490.5,-9004357.0,921269.0,37582.5,3733781235.5924616,3658524301.709961,-260651581.5,-257340172.0,2526769.0,269221.5,3926475630.719957,33256597670.77592,36685758691.21514,1729552136.4450495,48089098316.093216,3988408.0,-247608557.5,103096255949.0,1054515941.5,17275846317.5,3504226421.0,18889684733.0,3672435.5,71926.5,20872.07889621628,89790090.5,-50.603068072866726,1.9188,4.83933410762679,207.42844414745517,9.285714285714286,398.013698630137,225000.0,1.0,0.0,0.0,0.0,0.0,0.0,0.0,0.0,1.0,0.0,1.0,0.0,0.0,0.0,0.0,0.0,0.0,1.0,0.0,0.0,0.0,0.0,0.0,0.0,1.0,0.0,0.0,1.0,0.0,0.0,0.0,0.0,0.0,0.0,0.0,0.0,0.0,0.0,1.0,0.0,0.0,0.0,0.0,0.0,0.0,0.0,0.0,0.0,0.0,0.0,0.0,0.0,0.0,0.0,0.0,1.0,0.0,0.0,0.0,0.0,0.0,0.0,0.0,0.0,0.0,0.0,0.0,0.0,0.0,0.0,0.0,0.0,0.0,0.0,0.0,0.0,0.0,0.0,0.0,0.0,0.0,0.0,0.0,0.0,0.0,0.0,0.0,0.0,0.0,0.0,0.0,0.0,0.0,0.0,0.0,0.0,0.0,0.0,0.0,0.0,0.0,0.0,0.0,0.0,0.0,0.0,0.0,0.0,0.0,0.0,1.0,0.0,1.0,0.0,0.0,0.0,0.0,0.0,0.0,1.0,0.0,0.0
102979,0,0.0,0.0,0.0,1.0,1.0,112500.0,431280.0,22149.0,360000.0,0.0060079999999999,35.07397260273972,-2250.0,-6594.0,-4770.0,,3.0,2.0,2.0,13.0,0.3227593024755941,0.4785738485730471,0.6144143775673561,,,,,,,,,,,,,,,,,,,,,,,,,,,,,,,,,,,,,,,,,,,,,5.0,0.0,5.0,0.0,0.0,0.0,0.0,0.0,0.0,0.0,4.0,1.0,1.0,0.0,1.0,0.0,0.0,0.0,0.0,0.0,0.0,0.0,0.0,0.0,1.0,0.0,0.0,0.0,0.0,0.0,0.0,0.0,0.0,0.0,0.0,0.0,0.0,0.0,0.0,0.0,0.0,0.0,0.0,3.0,0.0,,92871.36,0.0,0.0,0.0,0.0,0.0,-929.0,-746.0,-39.0,-1026.0,102.0,-16.5,5.0,14958.135,72000.0,83038.5,5571.0,72000.0,12.0,-1289.0,365243.0,-1259.0,-929.0,-929.0,-924.0,12.0,1.0,0.1013831525268475,-1.0,44.0,10.0,5.0,-41.5,0.0,0.0,40.0,15291.72,15291.72,-1247.5,-1244.0,5.0,1.0,0.0,,,,,,,,,,,,,,,,,,,,,8347468909.5,184409411593.5,165594072564.0,51975769807.935,1863.0,1705.0,71125.0,70826.0,9140.0,506106.0,,,,,,,128426.0,662881.0,,,,13528961.58630097,-601955525.0,-921991369.0,-296542529.0,-1535314185.0416667,44019.0,30706.0,,,,,,,67471.47119950486,158055.7926879786,126119.6576914402,,,,,,,3714579.0,,,,,,,,,,,,,,,,436496.0,431290.0,,6425.740972002898,632015.0,625566.0,,,,,,,,,31.0,46173283.46999998,,4964145596.145004,1647180109.3950002,56007435.64499996,709788.5099999999,93.0,12014.0,-15966418.0,7099212.0,-8267174.0,-8979795.0,-15.0,0.0,,92871.36,0.0,0.0,0.0,0.0,0.0,-929.0,-746.0,-39.0,-1310.0,174851275.00499997,2503393587.945002,2823380395.8300004,40482470.115,2503393587.945002,180147.0,-12350580.0,2860068695.0,124126410.0,639615037.0,284221371.0,667220524.0,180065.0,2780.0,505.8469128098667,4249706.0,1475466.0,904335.0,-2954647.5,940877.0,99326.0,1977391650.015024,1993876374.6000104,-120513813.5,-119530630.0,2173376.5,97788.5,,,,,,,,,,,,,,,,,,,,,1467566.0,14786287.0,3233035.0,8555833.0,11608899.0,1415838.0,1058842091.3220012,,72112927752.60713,21676656447.157616,582516033.7994988,5792665.7475,689.5,94245.0,-276955500.5,21970392.0,-123802244.0,-218729553.5,-2019149.5,,,,,,,,,,,,,,,,,,,,,4273409.0,2479495.5,-9004398.5,921269.0,37582.5,3733796527.312462,3658539593.4299607,-260652829.0,-257341416.0,2526774.0,269222.5,3926490588.854957,33256669670.77592,36685841729.71514,1729557707.4450495,48089170316.093216,3988420.0,-247609846.5,103096621192.0,1054514682.5,17275845388.5,3504225492.0,18889683809.0,3672447.5,71927.5,20872.1802793688,89790089.5,-64.15013279175129,3.8336,5.079236082893132,178.1489872142408,19.471759447379117,682.9519573845134,37500.0,1.0,0.0,0.0,1.0,0.0,0.0,0.0,0.0,0.0,0.0,1.0,0.0,0.0,0.0,0.0,0.0,0.0,0.0,0.0,0.0,1.0,1.0,0.0,0.0,0.0,0.0,0.0,1.0,0.0,0.0,0.0,0.0,0.0,0.0,1.0,0.0,0.0,0.0,0.0,0.0,0.0,0.0,0.0,0.0,0.0,0.0,0.0,0.0,0.0,0.0,0.0,0.0,0.0,0.0,0.0,0.0,0.0,0.0,0.0,0.0,0.0,0.0,0.0,0.0,0.0,0.0,0.0,0.0,0.0,0.0,0.0,0.0,0.0,0.0,0.0,0.0,0.0,0.0,0.0,0.0,0.0,0.0,0.0,0.0,0.0,0.0,0.0,0.0,0.0,1.0,0.0,0.0,0.0,0.0,0.0,0.0,0.0,0.0,0.0,0.0,0.0,0.0,0.0,0.0,0.0,0.0,0.0,0.0,0.0,0.0,0.0,0.0,0.0,0.0,0.0,0.0,0.0,0.0,0.0,0.0,0.0,0.0
102982,0,0.0,0.0,1.0,1.0,1.0,207000.0,332946.0,14665.5,238500.0,0.00712,39.49315068493151,-6389.0,-535.0,-4719.0,8.0,3.0,2.0,2.0,10.0,0.6400615811058743,0.5799200103791952,0.5298898341969072,0.0619,0.0779,0.9866,,,0.0,0.1379,0.1667,,0.054,,0.057,,,0.063,0.0808,0.9866,,,0.0,0.1379,0.1667,,0.0552,,0.0594,,,0.0625,0.0779,0.9866,,,0.0,0.1379,0.1667,,0.055,,0.058,,,0.0448,1.0,3.0,1.0,3.0,0.0,-1429.0,0.0,0.0,0.0,0.0,1.0,1.0,1.0,1.0,0.0,1.0,0.0,0.0,0.0,0.0,0.0,0.0,0.0,0.0,0.0,1.0,0.0,0.0,0.0,0.0,0.0,0.0,0.0,0.0,0.0,0.0,0.0,0.0,0.0,0.0,0.0,0.0,0.0,0.0,5.0,36144.0,0.0,42935.85,0.0,0.0,0.0,0.0,0.0,-947.0,-556.0,-552.0,-999.0,160.0,-16.0,2.0,10221.8625,76911.75,73451.25,4923.0,76911.75,8.0,-1093.0,365243.0,-1062.0,-852.0,-852.0,-849.5,11.0,0.0,0.0544545454545454,34.5,17.0,10.0,4.0,-38.0,0.0,0.0,16.0,9853.875,9853.875,-1179.5,-1173.0,4.5,1.0,0.0,,,,,,,,,,,,,,,,,,,,,8347483575.0,184409744539.5,165594311064.0,51975976807.935,1863.0,1705.0,71125.0,70827.0,9140.0,506107.0,17809.879000002293,17872.046399999108,17323.468399998044,11297.107200000091,11234.878700000096,11182.204200000057,128427.0,662884.0,,,,13529001.079451654,-601961914.0,-921996088.0,-296543958.0,-1535314720.0416667,44020.0,30706.0,11351.108399999184,11227.059999998975,10711.347399997292,22889.0742000097,22810.926100009667,22196.415000008223,67472.11126108597,158056.37260798895,126120.1875812744,35006.57320002793,34946.804000028365,34392.467200028776,,,,3714589.0,8296.281500000165,8400.807600000076,8124.398500000229,,,,16469.494099999756,16654.74469999969,16251.547999999702,,,,,,,436499.0,431293.0,1263318.0,6425.748092002898,632017.0,625568.0,,16333.8163999998,154193.58309999062,154196.32819999015,154088.08229998712,,,,32.0,46209427.46999998,19609366.09500002,4966979063.265004,1649370740.8950002,56007435.64499996,709788.5099999999,93.0,12014.0,-15971680.0,7100560.0,-8269605.0,-8982756.0,-15.5,36144.0,0.0,41595.12,0.0,0.0,0.0,0.0,0.0,-1186.0,-973.0,-910.0,-999.0,175012760.1375,2505290846.445002,2825371186.8300004,40535678.115,2505290846.445002,180248.0,-12361333.5,2863173260.5,124484015.0,640340174.0,284581781.0,667580231.0,180226.0,2784.0,506.08328642153697,4249856.5,1477030.0,905280.0,-2957111.0,940877.0,99326.0,1979517357.0675237,1996002081.6525085,-120583005.0,-119599325.0,2174010.5,97874.5,,,,,,,,,,,,,,,,,,,,,1467571.0,14786447.0,3233035.0,8555850.0,11608915.0,1415840.0,1058878235.3220012,801708506.167495,72112970688.45712,21676656447.157616,582516033.7994988,5792665.7475,689.5,94245.0,-276956447.5,21969836.0,-123802796.0,-218730552.5,-2019165.5,,,,,,,,,,,,,,,,,,,,,4273419.0,2479499.5,-9004436.5,921269.0,37582.5,3733806381.187462,3658549447.3049607,-260654008.5,-257342589.0,2526778.5,269223.5,3926500810.717457,33256746582.52592,36685915180.96514,1729562630.4450495,48089247227.843216,3988428.0,-247610939.5,103096986435.0,1054513620.5,17275844536.5,3504224640.0,18889682959.5,3672458.5,71927.5,20872.23473391425,89790124.0,-161.77488727020466,1.6084347826086955,14.114759128567044,557.4363091460108,22.70266953053084,896.5999487194575,69000.0,-0.2225209339563146,-0.9749279121818236,0.0,0.0,0.0,0.0,0.0,0.0,1.0,0.0,0.0,0.0,0.0,0.0,0.0,1.0,0.0,1.0,0.0,0.0,0.0,0.0,1.0,0.0,0.0,0.0,0.0,1.0,0.0,0.0,0.0,0.0,0.0,0.0,0.0,0.0,0.0,0.0,0.0,0.0,0.0,0.0,1.0,0.0,0.0,0.0,0.0,0.0,0.0,0.0,0.0,0.0,0.0,0.0,0.0,0.0,0.0,0.0,0.0,0.0,0.0,0.0,0.0,0.0,0.0,0.0,0.0,0.0,0.0,0.0,0.0,0.0,0.0,0.0,0.0,0.0,0.0,0.0,0.0,0.0,0.0,0.0,0.0,0.0,1.0,0.0,0.0,0.0,0.0,0.0,0.0,0.0,0.0,0.0,0.0,0.0,0.0,0.0,0.0,0.0,0.0,0.0,0.0,0.0,0.0,0.0,0.0,0.0,0.0,0.0,0.0,0.0,1.0,0.0,0.0,0.0,0.0,0.0,0.0,0.0,1.0,0.0
102987,0,0.0,1.0,1.0,1.0,2.0,225000.0,688500.0,35284.5,688500.0,0.014464,33.41643835616439,-2863.0,-483.0,-2549.0,6.0,4.0,2.0,2.0,6.0,0.2357248684242011,0.3220503833900294,0.266456808245056,,,,,,,,,,,,,,,,,,,,,,,,,,,,,,,,,,,,,,,,,,,,,2.0,0.0,2.0,0.0,-1351.0,0.0,0.0,0.0,0.0,0.0,0.0,1.0,1.0,0.0,1.0,0.0,0.0,0.0,0.0,0.0,0.0,0.0,0.0,0.0,0.0,0.0,0.0,0.0,0.0,1.0,0.0,0.0,0.0,0.0,0.0,0.0,0.0,0.0,0.0,0.0,0.0,0.0,0.0,4.0,35550.0,5886.225,48386.61,164299.5,0.0,0.0,0.0,0.0,-1639.5,-1646.0,-1566.5,-1566.5,222.0,-27.0,5.0,20250.0,0.0,84573.0,0.0,377664.75,6.0,-825.0,365243.0,-1013.0,-444.0,397.0,-437.0,5.0,0.0,0.0,-1.0,26.0,48.0,35.5,-27.5,0.0,0.0,50.0,23416.9425,22898.295,-661.0,-660.0,11.5,0.0,25.0,0.0,405000.0,0.0,0.0,0.0,0.0,0.0,0.0,0.0,0.0,0.0,0.0,0.0,0.0,0.0,0.0,12.0,-15.0,0.0,0.0,8347518859.5,184410433039.5,165594999564.0,51976201807.935,1863.0,1705.0,71125.0,70827.0,9140.0,506107.0,,,,,,,128429.0,662888.0,,,,13529034.49589001,-601964777.0,-921998637.0,-296545309.0,-1535315203.0416667,44020.0,30706.0,,,,,,,67472.34698595437,158056.69465837238,126120.45403808264,,,,,,,3714595.0,,,,,,,,,,,,,,,,436501.0,431295.0,1263324.0,6425.762556002898,632019.0,625570.0,,,,,,,,,54.5,46288646.95499998,19638913.54500002,4971546254.115005,1650980476.3950002,56007435.64499996,709788.5099999999,93.0,12014.0,-15985871.5,7094690.0,-8277600.0,-8989597.5,-26.75,35550.0,5886.225,49990.5,164299.5,0.0,0.0,0.0,0.0,-1928.0,-1646.0,-1906.0,-1906.0,175339823.94000003,2509084708.695002,2829838962.3300004,40589558.865,2508747208.695002,180585.0,-12383370.0,2868466099.0,124468968.0,641059572.0,284941089.0,668666397.0,180450.0,2792.0,506.7400327087007,4254035.0,1479071.0,906704.5,-2960533.0,940877.0,99326.0,1983435299.3250265,2000295506.880013,-120819818.5,-119833544.5,2179016.0,98040.0,1922121556.2899864,5120937000.0,160451500.815,251075118.64499965,9921738.6,80480566.62,109167685.2899996,273938764.3200008,253721100.1950005,1845008409.509996,1914873538.3649848,1914948240.2999847,8202.0,21015.0,129.0,12684.0,624280.0,-1119803.0,495830.0,1104.0,1467575.0,14786669.0,3233060.0,8555876.0,11608965.0,1415845.0,1058913785.3220012,801714392.392495,72113019075.06712,21676820746.657616,582516033.7994988,5792665.7475,689.5,94245.0,-276958087.0,21968190.0,-123804362.5,-218732119.0,-2019192.5,5923266914.5649605,18723523500.0,198783507.825,447973953.7049976,1948107.735,256768282.6650008,309140890.10999864,636585710.174998,459179549.0999993,5708399968.822533,5886547889.084999,5886791071.83,13381.0,80838.5,44.0,70350.5,971599.0,-1698704.5,177364.0,6755.0,4273467.0,2479535.0,-9004464.0,921269.0,37582.5,3733829798.1299615,3658572345.599961,-260654669.5,-257343249.0,2526790.0,269223.5,3926521060.717457,33256746582.52592,36685999753.96514,1729562630.4450495,48089624892.593216,3988434.0,-247611764.5,103097351678.0,1054512607.5,17275844092.5,3504225037.0,18889682522.5,3672463.5,71927.5,20872.23473391425,89790123.0,-85.6763958350414,3.06,6.376737661012625,213.0878609626603,19.512817242698635,652.0488545457404,56250.0,-0.2225209339563143,0.9749279121818236,0.0,0.0,0.0,0.0,0.0,0.0,1.0,0.0,0.0,0.0,1.0,0.0,0.0,0.0,0.0,0.0,0.0,0.0,1.0,0.0,1.0,0.0,0.0,0.0,0.0,0.0,0.0,0.0,1.0,0.0,0.0,0.0,0.0,0.0,0.0,0.0,0.0,0.0,0.0,0.0,1.0,0.0,0.0,0.0,0.0,0.0,0.0,0.0,0.0,0.0,0.0,0.0,0.0,0.0,0.0,0.0,0.0,0.0,0.0,0.0,0.0,0.0,0.0,0.0,0.0,0.0,0.0,0.0,0.0,0.0,0.0,0.0,0.0,0.0,0.0,0.0,0.0,0.0,0.0,1.0,0.0,0.0,0.0,0.0,0.0,0.0,0.0,0.0,0.0,0.0,0.0,0.0,0.0,0.0,0.0,0.0,0.0,0.0,0.0,0.0,0.0,0.0,0.0,0.0,0.0,0.0,0.0,0.0,0.0,0.0,0.0,0.0,0.0,0.0,0.0,0.0,0.0,0.0,0.0,0.0
102989,0,0.0,0.0,0.0,1.0,0.0,67500.0,225000.0,9589.5,225000.0,0.025164,36.96986301369864,-1522.0,-5630.0,-4449.0,,2.0,2.0,2.0,18.0,0.5154780672187087,0.4710270288266977,0.3962195720630885,0.1969,0.0659,0.9677,0.5579999999999999,0.052,0.0,0.069,0.0833,0.0417,0.0643,0.1605,0.0888,0.0,0.0,0.2006,0.0684,0.9677,0.5753,0.0525,0.0,0.069,0.0833,0.0417,0.0657,0.1754,0.0925,0.0,0.0,0.1988,0.0659,0.9677,0.5639,0.0524,0.0,0.069,0.0833,0.0417,0.0654,0.1633,0.0904,0.0,0.0,0.0983,1.0,0.0,0.0,0.0,0.0,-1413.0,0.0,0.0,0.0,0.0,2.0,1.0,1.0,1.0,1.0,1.0,1.0,0.0,0.0,0.0,0.0,0.0,0.0,0.0,0.0,1.0,0.0,0.0,0.0,0.0,0.0,0.0,0.0,0.0,0.0,0.0,0.0,0.0,0.0,0.0,0.0,0.0,0.0,0.0,20.0,0.0,0.0,61981.56,0.0,0.0,0.0,0.0,0.0,-888.5,-310.0,-524.0,-677.5,679.0,-19.0,13.0,6777.3825,53226.0,66375.0,0.0,75681.0,11.0,-475.0,365243.0,-436.0,182543.0,116.5,-191.5,13.0,0.0,0.0,2390.0,54.0,18.0,12.5,-15.0,0.0,0.0,54.0,13558.365,13558.365,-425.0,-415.5,6.0,1.0,15.0,0.0,0.0,0.0,0.0,0.0,0.0,0.0,0.0,0.0,0.0,0.0,0.0,0.0,0.0,0.0,0.0,0.0,-9.0,0.0,0.0,8347528449.0,184410658039.5,165595224564.0,51976269307.935,1863.0,1705.0,71125.0,70829.0,9140.0,506108.0,17810.07590000229,17872.245199999106,17323.668999998044,11297.173100000093,11234.944600000092,11182.272600000057,128429.0,662890.0,4138.328200000117,4135.992500000016,3946.561000000094,13529071.465753024,-601966299.0,-922003086.0,-296546722.0,-1535320833.0416667,44020.0,30706.0,11351.108399999184,11227.059999998975,10711.347399997292,22889.1432000097,22810.995100009663,22196.484000008222,67472.8624640216,158057.16568540118,126120.8502576547,35006.65650002793,34946.887300028364,34392.550500028774,22958.69329999592,22931.817299995488,22578.58139999572,3714613.0,8296.345800000165,8400.873000000076,8124.464200000229,9818.897100000717,9933.865600002164,10293.585499999646,16469.582899999758,16654.83509999969,16251.640499999705,828.7517000001762,813.9266000000459,759.8490000000132,3914.072800000125,3897.241100000163,3729.81820000016,436501.0,431295.0,,6425.787720002898,632021.0,625572.0,,16333.9146999998,154194.5507999906,154197.29589999016,154089.04999998712,77623.31919999627,77961.15800000659,78362.53220000655,29.5,46288646.95499998,19638913.54500002,4972586820.885005,1651133845.3950002,56007435.64499996,709788.5099999999,93.0,12014.0,-16005018.5,7084685.0,-8287428.5,-9001974.0,-14.25,0.0,0.0,52325.55,0.0,0.0,0.0,0.0,0.0,-1278.0,-850.0,-610.0,-996.0,175509540.60750005,2511212778.945002,2832646071.3300004,40639461.615,2511212778.945002,180734.0,-12390841.0,2871570443.5,124828884.0,642334568.5,285305891.0,669941485.5,180598.0,2796.5,507.2653324265233,4263864.0,1480979.0,908107.5,-2962284.5,940889.5,99326.0,1986026325.187528,2002800449.295014,-120874670.5,-119887421.5,2179720.0,98108.5,1925220928.9499865,5124987000.0,160863250.815,251486868.64499965,9921738.6,80480566.62,109324876.0949996,274592665.17000085,254350626.2550005,1847958437.294996,1917940076.054985,1918014777.9899848,8224.0,21037.0,129.0,12684.0,624379.0,-1120084.0,495848.0,1104.0,1467595.0,14787348.0,3233075.0,8555930.0,11609019.0,1415858.0,1058913785.3220012,801714392.392495,72113081056.62712,21676820746.657616,582516033.7994988,5792665.7475,689.5,94245.0,-276958975.5,21967880.0,-123804886.5,-218732796.5,-2019211.5,5923266914.5649605,18723523500.0,198783507.825,447973953.7049976,1948107.735,256768282.6650008,309140890.10999864,636585710.174998,459179549.0999993,5708399968.822533,5886547889.084999,5886791071.83,13381.0,80838.5,44.0,70350.5,971599.0,-1698713.5,177364.0,6755.0,4273485.0,2479547.5,-9004479.0,921269.0,37582.5,3733843356.4949617,3658585903.964961,-260655094.5,-257343664.5,2526796.0,269224.5,3926527838.099957,33256799808.52592,36686066128.96514,1729562630.4450495,48089700573.593216,3988445.0,-247612239.5,103097716921.0,1054512171.5,17276026635.5,3504225153.5,18889682331.0,3672476.5,71927.5,20872.23473391425,89792513.0,-41.1686675559508,3.333333333333333,7.0389488503050215,260.22897475620806,23.463162834350072,867.4299158540268,33750.0,1.0,0.0,0.0,0.0,0.0,0.0,0.0,0.0,1.0,0.0,0.0,0.0,0.0,0.0,0.0,1.0,0.0,0.0,0.0,0.0,1.0,0.0,1.0,0.0,0.0,0.0,0.0,1.0,0.0,0.0,0.0,0.0,0.0,1.0,0.0,0.0,0.0,0.0,0.0,0.0,0.0,0.0,0.0,0.0,0.0,0.0,0.0,0.0,0.0,0.0,0.0,0.0,0.0,0.0,0.0,0.0,0.0,0.0,0.0,0.0,0.0,0.0,0.0,0.0,0.0,0.0,1.0,0.0,0.0,0.0,0.0,0.0,0.0,0.0,0.0,0.0,0.0,0.0,0.0,0.0,0.0,0.0,0.0,0.0,0.0,0.0,0.0,0.0,0.0,0.0,0.0,0.0,0.0,0.0,0.0,0.0,0.0,0.0,0.0,0.0,0.0,0.0,0.0,0.0,0.0,0.0,0.0,0.0,0.0,0.0,1.0,0.0,1.0,0.0,0.0,0.0,0.0,0.0,0.0,0.0,1.0,0.0
102995,0,0.0,0.0,0.0,0.0,0.0,216000.0,272520.0,21658.5,225000.0,0.002042,62.30958904109588,,-199.0,-4699.0,,1.0,3.0,3.0,15.0,0.7550650936994993,0.5988737797985781,0.3139166772114369,,,,,,,,,,,,,,,,,,,,,,,,,,,,,,,,,,,,,,,,,,,,,4.0,0.0,4.0,0.0,0.0,0.0,0.0,0.0,0.0,0.0,2.0,1.0,0.0,0.0,1.0,0.0,0.0,0.0,0.0,0.0,0.0,0.0,0.0,0.0,1.0,0.0,0.0,0.0,0.0,0.0,0.0,0.0,0.0,0.0,0.0,0.0,0.0,0.0,0.0,0.0,0.0,0.0,0.0,6.0,15437.25,0.0,362250.0,193032.0,0.0,0.0,0.0,0.0,-803.0,524.0,-85.0,-481.5,164.0,-14.5,1.0,6862.365,149265.0,149265.0,0.0,149265.0,24.0,-1761.0,365243.0,-1730.0,-1040.0,-1040.0,-1034.0,11.0,0.0,0.0,854.0,25.0,24.0,12.0,-46.0,0.0,0.0,24.0,6862.365,6862.365,-1389.5,-1385.0,12.5,1.0,0.0,,,,,,,,,,,,,,,,,,,,,8347550107.5,184410930559.5,165595449564.0,51976485307.935,1863.0,1705.0,71125.0,70829.0,9140.0,506110.0,,,,,,,128429.0,662891.0,,,,13529133.775342066,,-922007785.0,-296546722.0,-1535321032.0416667,44020.0,30706.0,,,,,,,67473.6175291153,158057.764559181,126121.16417433192,,,,,,,3714628.0,,,,,,,,,,,,,,,,436505.0,431299.0,,6425.789762002898,632024.0,625575.0,,,,,,,,,27.0,46331662.45499998,20346203.970000014,4977318492.900003,1652174110.7100005,56014567.82999996,709788.5099999999,93.0,12014.0,-16029495.0,7108221.5,-8297051.5,-9015466.5,-13.0,9972.0,0.0,450000.0,0.0,0.0,0.0,0.0,0.0,-1035.0,-305.0,-305.0,-658.0,175713927.48000002,2513788728.1200023,2835605617.650001,40684322.96999999,2513788728.1200023,181025.0,-12418355.0,2877959283.0,125538383.0,644692271.0,286391085.0,672301343.0,180990.0,2803.0,507.94298219607424,4277518.0,1483514.0,909860.0,-2969004.0,940903.0,99327.0,1988857896.277525,2005710595.222512,-121188392.0,-120199208.0,2186035.0,98271.5,,,,,,,,,,,,,,,,,,,,,1467601.0,14787512.0,3233075.0,8555955.0,11609043.0,1415859.0,1058929222.5720012,801714392.392495,72113443306.62712,21677013778.657616,582516033.7994988,5792665.7475,689.5,94245.0,-276959778.5,21968404.0,-123804971.5,-218733278.0,-2019226.0,,,,,,,,,,,,,,,,,,,,,4273509.0,2479559.5,-9004525.0,921269.0,37582.5,3733850218.8599615,3658592766.32996,-260656484.0,-257345049.5,2526808.5,269225.5,3926534700.464957,33256949073.52592,36686215393.96514,1729562630.4450495,48089849838.593216,3988469.0,-247614000.5,103098082164.0,1054510441.5,17276025595.5,3504224113.5,18889681297.0,3672487.5,71927.5,20872.23473391425,89793367.0,,1.2616666666666667,9.97298981923956,621.4128971478501,12.582588821940575,784.0159385682042,216000.0,-0.9009688679024191,-0.433883739117558,0.0,1.0,0.0,0.0,0.0,0.0,0.0,0.0,0.0,1.0,0.0,0.0,0.0,0.0,0.0,0.0,0.0,0.0,1.0,0.0,0.0,0.0,0.0,1.0,0.0,1.0,0.0,0.0,0.0,0.0,0.0,0.0,0.0,0.0,0.0,0.0,0.0,0.0,0.0,0.0,0.0,0.0,0.0,0.0,0.0,0.0,0.0,0.0,0.0,0.0,0.0,0.0,0.0,0.0,0.0,0.0,0.0,0.0,0.0,0.0,0.0,0.0,0.0,0.0,0.0,0.0,0.0,0.0,0.0,0.0,0.0,0.0,0.0,0.0,0.0,0.0,0.0,0.0,0.0,0.0,0.0,0.0,0.0,0.0,0.0,0.0,0.0,0.0,0.0,0.0,0.0,0.0,0.0,0.0,0.0,0.0,0.0,0.0,0.0,0.0,0.0,0.0,0.0,0.0,0.0,1.0,0.0,0.0,0.0,0.0,0.0,0.0,0.0,0.0,0.0,0.0,0.0,0.0,0.0,0.0
102996,0,1.0,1.0,1.0,1.0,1.0,270000.0,270000.0,13500.0,270000.0,0.0105,37.895890410958906,-2905.0,-4699.0,-5079.0,8.0,3.0,3.0,3.0,14.0,,0.3794863933828797,0.7352209993926424,0.0072,0.0088,0.9513,0.3336,0.0022,0.0,0.0345,0.0417,0.0833,0.0015,0.0042,0.0121,0.0077,0.0071,0.0074,0.0092,0.9513,0.3597,0.0022,0.0,0.0345,0.0417,0.0833,0.0015,0.0046,0.0126,0.0078,0.0075,0.0073,0.0088,0.9513,0.3425,0.0022,0.0,0.0345,0.0417,0.0833,0.0015,0.0043,0.0123,0.0078,0.0073,0.0176,1.0,0.0,0.0,0.0,0.0,-1036.0,0.0,0.0,0.0,0.0,1.0,2.0,1.0,1.0,0.0,1.0,0.0,0.0,0.0,0.0,0.0,0.0,0.0,0.0,0.0,0.0,0.0,0.0,0.0,0.0,0.0,0.0,0.0,0.0,0.0,0.0,0.0,0.0,0.0,0.0,0.0,0.0,0.0,0.0,6.0,0.0,0.0,704250.0,0.0,0.0,0.0,0.0,0.0,-1451.5,928.0,-205.0,-398.0,227.0,-22.0,3.0,46844.1,95220.0,76176.0,19044.0,274860.0,15.0,-558.0,365243.0,-766.5,-541.5,-346.5,-532.0,15.0,0.5,0.2178181818181818,-1.0,19.0,24.0,15.0,-25.0,0.0,0.0,17.0,3495.735,3495.735,-772.0,-765.0,8.0,1.0,0.0,,,,,,,,,,,,,,,,,,,,,8347563607.5,184411200559.5,165595719564.0,51976755307.935,1863.0,1705.0,71125.0,70830.0,9140.0,506112.0,17810.08310000229,17872.252499999107,17323.676399998043,11297.18190000009,11234.953400000091,11182.281800000055,128430.0,662894.0,4138.330400000117,4135.994700000016,3946.563200000093,13529171.671232477,-601969204.0,-922012864.0,-296547758.0,-1535325731.0416667,44020.0,30706.0,11351.108399999184,11227.059999998975,10711.347399997292,22889.177700009703,22811.029600009668,22196.518500008227,,158058.1440455744,126121.89939533132,35006.69820002793,34946.929000028365,34392.592200028776,22958.776599995912,22931.90059999549,22578.664699995723,3714642.0,8296.347300000165,8400.874500000076,8124.46570000023,9818.901300000716,9933.869900002164,10293.590099999648,16469.594999999757,16654.84739999969,16251.653099999705,828.7594000001762,813.9344000000459,759.8568000000133,3914.079900000124,3897.2484000001623,3729.82570000016,436505.0,431299.0,1263332.0,6425.800262002898,632027.0,625578.0,,16333.9322999998,154195.50209999055,154198.24719999015,154090.0012999871,77623.65279999629,77961.50050000659,78362.89190000655,48.5,46352465.95499998,20346203.970000014,4983484800.600004,1655674593.2100005,56014567.82999996,709788.5099999999,93.0,12014.0,-16035383.0,7114980.5,-8299940.0,-9017119.0,-23.75,0.0,0.0,832500.0,0.0,0.0,0.0,0.0,0.0,-1465.0,280.0,-398.0,-398.0,175762519.44750005,2513883948.1200023,2835681793.650001,40703366.96999999,2514111198.1200023,181052.0,-12419949.0,2878507147.5,125537114.0,644691452.0,286390581.0,672300538.0,181022.0,2803.5,508.1608003778924,4279028.0,1484042.0,910121.0,-2969773.0,940903.0,99327.0,1988968275.090024,2005820974.035011,-121211885.0,-120222553.0,2186242.0,98292.0,,,,,,,,,,,,,,,,,,,,,1467607.0,14787739.0,3233075.0,8555974.0,11609060.0,1415862.0,1058929222.5720012,801714392.392495,72114147556.62712,21677013778.657616,582516033.7994988,5792665.7475,689.5,94245.0,-276961230.0,21969332.0,-123805176.5,-218733676.0,-2019248.0,,,,,,,,,,,,,,,,,,,,,4273533.0,2479574.5,-9004550.0,921269.0,37582.5,3733853714.5949616,3658596262.064961,-260657256.0,-257345814.5,2526816.5,269226.5,3926581544.564957,33257044293.52592,36686291569.96514,1729581674.4450495,48090124698.593216,3988484.0,-247614558.5,103098447407.0,1054509675.0,17276025054.0,3504223767.0,18889680765.0,3672502.5,71928.0,20872.45255209608,89793366.0,-76.65738866396761,1.0,20.0,757.9178082191781,20.0,757.9178082191781,90000.0,0.6234898018587334,-0.7818314824680299,0.0,0.0,0.0,0.0,0.0,0.0,1.0,0.0,0.0,0.0,0.0,0.0,0.0,1.0,0.0,1.0,0.0,0.0,0.0,0.0,1.0,0.0,0.0,0.0,0.0,1.0,0.0,0.0,0.0,0.0,0.0,0.0,0.0,0.0,0.0,0.0,0.0,0.0,1.0,0.0,0.0,0.0,0.0,0.0,0.0,0.0,0.0,0.0,0.0,0.0,0.0,0.0,0.0,0.0,0.0,0.0,0.0,0.0,0.0,0.0,0.0,0.0,0.0,0.0,0.0,0.0,0.0,0.0,0.0,0.0,0.0,0.0,0.0,0.0,0.0,0.0,0.0,0.0,0.0,0.0,0.0,0.0,0.0,0.0,0.0,0.0,0.0,0.0,0.0,0.0,0.0,0.0,0.0,0.0,0.0,0.0,0.0,0.0,0.0,0.0,0.0,0.0,0.0,1.0,0.0,0.0,0.0,0.0,1.0,0.0,1.0,0.0,0.0,0.0,1.0,0.0,0.0,0.0,0.0,0.0
103000,0,0.0,0.0,0.0,1.0,0.0,247500.0,601470.0,25614.0,450000.0,0.007305,59.01917808219178,,-1706.0,-1370.0,,2.0,3.0,3.0,9.0,0.8094810269677267,0.6005536083257055,,0.0299,0.042,0.9712,0.6056,0.006,0.0,0.1034,0.125,0.0417,0.0148,0.0235,0.0289,0.0039,0.032,0.0305,0.0436,0.9712,0.621,0.006,0.0,0.1034,0.125,0.0417,0.0152,0.0257,0.0301,0.0039,0.0338,0.0302,0.042,0.9712,0.6109,0.006,0.0,0.1034,0.125,0.0417,0.0151,0.0239,0.0294,0.0039,0.0326,0.0329,1.0,1.0,0.0,1.0,0.0,-2062.0,,,,,,,1.0,0.0,0.0,1.0,1.0,1.0,0.0,0.0,0.0,0.0,0.0,0.0,0.0,0.0,0.0,0.0,1.0,0.0,0.0,0.0,0.0,0.0,0.0,0.0,0.0,0.0,0.0,0.0,0.0,0.0,0.0,0.0,0.0,,,,,,,,,,,,,0.0,,2.0,3879.1575,23737.5,22749.75,2387.25,23737.5,8.0,-2229.5,365243.0,-2193.0,-1998.0,-1983.0,-1990.0,10.0,0.0,0.1034206739018802,32.0,18.0,9.0,3.5,-66.5,0.0,0.0,125.0,3069.63,3069.63,-1687.0,-1692.0,62.0,0.0,96.0,0.0,135000.0,0.0,0.0,0.0,0.0,0.0,67.725,0.0,0.0,0.0,0.0,0.0,0.0,0.0,0.0,54.0,-48.5,0.0,0.0,8347589221.5,184411802029.5,165596169564.0,51977002807.935,,,,,,,17810.113000002293,17872.28269999911,17323.706899998044,11297.22390000009,11234.995400000093,11182.325400000058,128430.0,662896.0,4138.3364000001175,4136.000700000016,3946.5692000000936,13529230.690410558,,-922014234.0,-296549820.0,-1535327437.0416667,44020.0,30706.0,11351.108399999184,11227.059999998975,10711.347399997292,22889.281100009703,22811.133000009668,22196.621900008227,67474.42701014227,158058.74459918268,,35006.82320002793,34947.054000028365,34392.717200028776,22958.81829999592,22931.942299995488,22578.70639999572,3714651.0,8296.362100000166,8400.889600000077,8124.48090000023,9818.924800000716,9933.893800002164,10293.615799999649,16469.62389999976,16654.87679999969,16251.683199999705,828.7633000001763,813.938300000046,759.8607000000133,3914.111900000125,3897.2810000001623,3729.85950000016,436506.0,431300.0,,6425.807567002898,632030.0,625581.0,,16333.9651999998,154196.47329999055,154199.21839999015,154090.9724999871,77624.25839999628,77962.11140000659,78363.51290000655,,,,,,,,,,,,,,,,,,,,,,,,,,,175900852.66500005,2515400529.1200023,2837239461.900001,40742741.96999999,2515400529.1200023,181162.0,-12434599.0,2881429091.5,125523017.0,644680055.0,286379544.0,672289210.0,181112.5,2807.0,508.67777547424873,4280662.0,1485992.5,911148.0,-2974993.5,940904.5,99328.5,1991212275.33002,2008059654.645007,-121438656.0,-120447446.0,2190525.0,98408.0,1929123226.664986,5145147000.0,161059900.815,251737460.18999964,9921738.6,80518357.62,109572969.1949996,275128612.8074993,254793669.3000005,1851702104.4749968,1921831363.3049853,1921906065.239986,8238.0,21052.0,129.0,12685.0,627559.0,-1126554.5,495851.0,1107.0,1467607.0,14787739.0,3233171.0,8555992.0,11609185.0,1415864.0,,,,,,,,,,,,,,5923266914.5649605,18723658500.0,198783507.825,447973953.7049976,1948107.735,256768282.6650008,309140890.10999864,636585777.8999982,459179549.0999993,5708399968.822533,5886547889.084999,5886791071.83,13381.0,80838.5,44.0,70350.5,971653.0,-1698762.0,177364.0,6755.0,4273542.0,2479578.0,-9004616.5,921269.0,37582.5,3733856784.2249618,3658599331.694961,-260658943.0,-257347506.5,2526878.5,269226.5,3926585423.722457,33257068031.02592,36686314319.71514,1729584061.6950495,48090148436.093216,3988492.0,-247616788.0,103098812650.0,1054507482.0,17276023056.0,3504221784.0,18889678775.0,3672512.5,71928.0,20872.555972769977,89793398.0,,2.4301818181818184,9.66268446943078,570.283695453364,23.482080112438517,1385.8930678963025,123750.0,0.6234898018587336,0.7818314824680298,0.0,0.0,0.0,0.0,0.0,0.0,1.0,0.0,0.0,1.0,0.0,0.0,0.0,0.0,0.0,0.0,0.0,0.0,1.0,0.0,1.0,0.0,0.0,0.0,0.0,1.0,0.0,0.0,0.0,0.0,0.0,0.0,0.0,0.0,0.0,0.0,0.0,0.0,0.0,0.0,0.0,0.0,0.0,0.0,0.0,0.0,0.0,0.0,0.0,0.0,0.0,0.0,0.0,0.0,0.0,0.0,0.0,0.0,0.0,0.0,0.0,0.0,0.0,0.0,0.0,0.0,0.0,0.0,0.0,0.0,0.0,0.0,0.0,0.0,0.0,0.0,0.0,0.0,0.0,0.0,0.0,0.0,0.0,0.0,0.0,0.0,0.0,0.0,0.0,0.0,0.0,0.0,0.0,0.0,0.0,0.0,0.0,0.0,0.0,0.0,0.0,0.0,0.0,0.0,0.0,1.0,0.0,0.0,1.0,0.0,1.0,0.0,0.0,0.0,0.0,0.0,0.0,0.0,1.0,0.0
103001,0,0.0,0.0,0.0,1.0,2.0,202500.0,378706.5,18346.5,306000.0,0.020246,39.86301369863013,-4097.0,-485.0,-5171.0,,3.0,3.0,3.0,7.0,0.3715407593274521,0.1590464579429276,0.7838324335199619,,,,,,,,,,,,,,,,,,,,,,,,,,,,,,,,,,,,,,,,,,,,,3.0,0.0,3.0,0.0,-2895.0,0.0,0.0,0.0,0.0,0.0,4.0,1.0,1.0,0.0,1.0,1.0,0.0,0.0,0.0,0.0,0.0,0.0,0.0,0.0,1.0,0.0,0.0,0.0,0.0,0.0,0.0,0.0,0.0,0.0,0.0,0.0,0.0,0.0,0.0,0.0,0.0,0.0,0.0,6.0,0.0,0.0,140213.25,0.0,0.0,0.0,0.0,0.0,-1945.0,-1289.0,-974.0,-1324.0,368.0,-32.0,6.0,11359.125,99675.0,113355.9,0.0,175275.0,15.0,-566.5,365243.0,-407.0,182378.0,643.0,182382.0,13.0,1.0,0.0,149.5,20.0,24.0,19.5,-17.5,0.0,0.0,31.0,5777.19,5777.19,-186.0,-177.0,4.0,1.0,8.0,43794.6075,225000.0,18000.0,6750.0,0.0,14483.1375,0.0,9000.0,2925.0,41607.0,41903.73,41903.73,1.5,0.5,0.0,1.0,0.0,-4.5,0.0,0.0,8347607568.0,184412180736.0,165596475564.0,51977205307.935,1863.0,1705.0,71125.0,70830.0,9140.0,506116.0,,,,,,,128432.0,662899.0,,,,13529270.553424256,-601973301.0,-922019405.0,-296552715.0,-1535327922.0416667,44020.0,30706.0,,,,,,,67474.7985509016,158058.90364564065,126122.68322776484,,,,,,,3714658.0,,,,,,,,,,,,,,,,436509.0,431303.0,,6425.8278130028975,632033.0,625584.0,,,,,,,,,64.5,46369687.45499998,20346203.970000014,4994508970.935004,1657864385.3250003,56014567.82999996,709788.5099999999,93.0,12014.0,-16073244.5,7104945.0,-8318257.0,-9039145.0,-31.75,0.0,0.0,42750.0,0.0,0.0,0.0,0.0,0.0,-1993.0,-1316.0,-1323.0,-1324.0,175924044.36000004,2515848280.0200024,2837713328.550001,40746319.46999999,2515836444.1200023,181197.0,-12439748.5,2882342133.5,125518885.0,645225426.0,286560413.5,672834592.5,181165.5,2809.0,508.8333344578096,4281967.5,1486276.0,911359.0,-2975800.5,940908.0,99332.0,1991561232.105018,2008411442.055004,-121559153.0,-120567515.0,2194826.0,98433.0,1931755282.7849853,5150884500.0,161282650.815,252007424.18999964,9921738.6,80565571.62,109717363.2149996,275416817.3549999,255063439.8000005,1854214369.2224965,1924453373.489986,1924528075.424986,8253.5,21069.5,129.0,12687.0,629575.0,-1128869.0,495855.0,1111.0,1467613.0,14788107.0,3233179.0,8556012.0,11609216.0,1415870.0,1058929222.5720012,801714392.392495,72114287769.87712,21677013778.657616,582516033.7994988,5792665.7475,689.5,94245.0,-276963175.0,21968043.0,-123806150.5,-218735000.0,-2019280.0,5923310709.1724615,18723883500.0,198801507.825,447980703.7049976,1948107.735,256782765.80250075,309140890.10999864,636594777.8999982,459182474.0999993,5708441575.822533,5886589792.815,5886832975.559999,13382.5,80839.0,44.0,70351.5,971653.0,-1698766.5,177364.0,6755.0,4273566.0,2479597.5,-9004634.0,921269.0,37582.5,3733862561.414962,3658605108.884961,-260659129.0,-257347683.5,2526882.5,269227.5,3926596782.847457,33257167706.02592,36686427675.615135,1729584061.6950495,48090323711.093216,3988507.0,-247617354.5,103099177893.0,1054507075.0,17276205434.0,3504222427.0,18889861157.0,3672525.5,71929.0,20872.555972769977,89793547.5,-102.77697594501718,1.870155555555556,11.037527593818984,439.9891136714143,20.64189354917832,822.8480853165602,67500.0,-0.2225209339563143,0.9749279121818236,0.0,0.0,0.0,0.0,0.0,0.0,1.0,0.0,0.0,0.0,0.0,0.0,0.0,1.0,0.0,0.0,0.0,0.0,1.0,0.0,0.0,1.0,0.0,0.0,0.0,1.0,0.0,0.0,0.0,0.0,0.0,0.0,0.0,0.0,0.0,0.0,1.0,0.0,0.0,0.0,0.0,0.0,0.0,0.0,0.0,0.0,0.0,0.0,0.0,0.0,0.0,0.0,0.0,0.0,0.0,0.0,0.0,1.0,0.0,0.0,0.0,0.0,0.0,0.0,0.0,0.0,0.0,0.0,0.0,0.0,0.0,0.0,0.0,0.0,0.0,0.0,0.0,0.0,0.0,0.0,0.0,0.0,0.0,0.0,0.0,0.0,0.0,0.0,0.0,0.0,0.0,0.0,0.0,0.0,0.0,0.0,0.0,0.0,0.0,0.0,0.0,0.0,0.0,0.0,0.0,0.0,0.0,0.0,0.0,0.0,0.0,0.0,0.0,0.0,0.0,0.0,0.0,0.0,0.0,0.0
103004,0,0.0,0.0,0.0,1.0,0.0,112500.0,538389.0,37602.0,477000.0,0.006852,56.47945205479452,,-3697.0,-3579.0,,2.0,3.0,3.0,7.0,0.7681757710766972,0.409515574534517,0.3740208032583212,,,,,,,,,,,,,,,,,,,,,,,,,,,,,,,,,,,,,,,,,,,,,0.0,0.0,0.0,0.0,-835.0,0.0,0.0,0.0,0.0,1.0,1.0,1.0,0.0,0.0,1.0,0.0,0.0,0.0,0.0,0.0,0.0,0.0,0.0,0.0,1.0,0.0,0.0,0.0,0.0,0.0,0.0,0.0,0.0,0.0,0.0,0.0,0.0,0.0,0.0,0.0,0.0,0.0,0.0,6.0,22482.0,,439875.0,0.0,0.0,0.0,0.0,0.0,-569.5,154.0,-100.0,-320.0,205.0,-21.0,5.0,25238.295,135000.0,139455.0,2286.0,135000.0,6.0,-837.0,365243.0,-805.0,-775.0,-655.0,-766.0,10.0,0.0,0.0506925216985689,294.0,48.0,10.0,5.0,-66.5,0.0,0.0,43.0,25238.295,21788.19,-1983.0,-1984.0,5.0,1.0,0.0,,,,,,,,,,,,,,,,,,,,,8347645170.0,184412719125.0,165596952564.0,51977317807.935,1863.0,1705.0,71125.0,70831.0,9140.0,506117.0,,,,,,,128432.0,662901.0,,,,13529327.03287631,,-922022984.0,-296553550.0,-1535331619.0416667,44020.0,30706.0,,,,,,,67475.56672667268,158059.3131612152,126123.05724856806,,,,,,,3714665.0,,,,,,,,,,,,,,,,436509.0,431303.0,,6425.834665002899,632036.0,625587.0,,,,,,,,,19.5,46452446.95499998,,5002709926.230004,1660981794.0750003,56014567.82999996,709788.5099999999,93.0,12014.0,-16089051.5,7105045.5,-8324867.0,-9045461.0,-9.25,504.0,,439875.0,0.0,0.0,0.0,0.0,0.0,-2004.0,-178.0,-544.0,-554.0,176153960.38500005,2518019530.9200025,2840010417.450001,40823147.96999999,2518019530.9200025,181363.0,-12458735.0,2885994498.0,125505275.0,645758492.0,286731896.0,673367707.0,181441.0,2811.0,509.45691909822153,4286680.0,1487442.0,912058.0,-2980955.5,940913.0,99337.0,1993414338.67502,2010232746.4050064,-121692487.0,-120699417.0,2195346.0,98522.0,,,,,,,,,,,,,,,,,,,,,1467619.0,14788312.0,3233179.0,8556060.0,11609259.0,1415875.0,1058951704.5720012,,72114727644.87712,21677013778.657616,582516033.7994988,5792665.7475,689.5,94245.0,-276963744.5,21968197.0,-123806250.5,-218735320.0,-2019301.0,,,,,,,,,,,,,,,,,,,,,4273576.0,2479602.5,-9004700.5,921269.0,37582.5,3733887799.709962,3658626897.0749607,-260661112.0,-257349667.5,2526887.5,269228.5,3926622021.142457,33257302706.02592,36686567130.615135,1729586347.6950495,48090458711.093216,3988513.0,-247618191.5,103099543136.0,1054506270.0,17276204659.0,3504221772.0,18889860391.0,3672535.5,71929.0,20872.606665291674,89793841.5,,4.78568,2.9918621349928194,168.9787340078821,14.318094782192436,808.6781477668413,56250.0,-0.2225209339563143,0.9749279121818236,0.0,0.0,0.0,0.0,0.0,0.0,1.0,0.0,0.0,1.0,0.0,0.0,0.0,0.0,0.0,0.0,1.0,0.0,0.0,0.0,1.0,0.0,0.0,0.0,0.0,1.0,0.0,0.0,0.0,0.0,0.0,0.0,0.0,0.0,0.0,0.0,0.0,0.0,0.0,0.0,0.0,0.0,0.0,0.0,0.0,0.0,0.0,0.0,0.0,0.0,0.0,0.0,0.0,0.0,0.0,0.0,0.0,0.0,0.0,0.0,0.0,0.0,0.0,0.0,0.0,0.0,0.0,0.0,0.0,0.0,0.0,0.0,0.0,0.0,0.0,0.0,0.0,0.0,0.0,0.0,0.0,0.0,0.0,0.0,0.0,0.0,0.0,0.0,0.0,0.0,0.0,0.0,0.0,0.0,0.0,0.0,0.0,0.0,0.0,0.0,0.0,0.0,0.0,0.0,0.0,1.0,0.0,0.0,0.0,0.0,0.0,0.0,0.0,0.0,0.0,0.0,0.0,0.0,0.0,0.0
103010,0,0.0,0.0,0.0,1.0,2.0,225000.0,180000.0,21361.5,180000.0,0.0196889999999999,40.30958904109589,-3322.0,-154.0,-5371.0,,4.0,2.0,2.0,7.0,0.7447630740200334,0.6648607313962377,,,,,,,,,,,,,,,,,,,,,,,,,,,,,,,,,,,,,,,,,,,,,,1.0,0.0,1.0,0.0,-3312.0,,,,,,,1.0,1.0,1.0,1.0,0.0,0.0,0.0,0.0,0.0,0.0,0.0,0.0,0.0,1.0,0.0,0.0,0.0,0.0,0.0,0.0,0.0,0.0,0.0,0.0,0.0,0.0,0.0,0.0,0.0,0.0,0.0,0.0,0.0,,,,,,,,,,,,,0.0,,1.0,25886.7,144675.0,144675.0,0.0,144675.0,6.0,-153.0,365243.0,-116.0,365243.0,34.0,365243.0,17.0,0.0,0.0,200.0,4.0,6.0,4.5,-3.5,0.0,0.0,4.0,25886.7,25886.7,-81.5,-71.0,2.5,1.0,0.0,,,,,,,,,,,,,,,,,,,,,8347666531.5,184412899125.0,165597132564.0,51977542807.935,,,,,,,,,,,,,128434.0,662905.0,,,,13529367.342465352,-601976623.0,-922028355.0,-296556862.0,-1535331773.0416667,44020.0,30706.0,,,,,,,67476.3114897467,158059.9780219466,,,,,,,,3714672.0,,,,,,,,,,,,,,,,436510.0,431304.0,,6425.8543540029,632038.0,625589.0,,,,,,,,,,,,,,,,,,,,,,,,,,,,,,,,,,,176362343.32500002,2520562294.1700025,2842737876.450001,40871961.71999999,2520562294.1700025,181605.0,-12483458.0,2891473143.0,125481219.0,646106778.0,286714650.0,673716062.0,181649.0,2820.0,510.43833833385634,4295813.0,1490969.0,914052.5,-2991327.0,940941.0,99365.0,1996982629.335019,2013672659.3100052,-122004479.0,-121010103.0,2196983.0,98742.5,,,,,,,,,,,,,,,,,,,,,1467619.0,14788312.0,3233179.0,8556064.0,11609263.0,1415876.0,,,,,,,,,,,,,,,,,,,,,,,,,,,,,,,,,,4273582.0,2479607.0,-9004704.0,921269.0,37582.5,3733913686.4099617,3658652783.774961,-260661193.5,-257349738.5,2526890.0,269229.5,3926647907.842456,33257447381.02592,36686711805.615135,1729586347.6950495,48090603386.093216,3988519.0,-247618344.5,103099908379.0,1054506154.0,17276569902.0,3504221806.0,18890225634.0,3672552.5,71929.0,20872.606665291674,89794041.5,-82.4121525181812,0.8,10.532968190436064,424.5796191394133,8.426374552348852,339.6636953115305,56250.0,-0.2225209339563143,0.9749279121818236,0.0,0.0,0.0,0.0,0.0,0.0,1.0,0.0,1.0,0.0,0.0,0.0,0.0,0.0,0.0,0.0,0.0,0.0,1.0,0.0,1.0,0.0,0.0,0.0,0.0,1.0,0.0,0.0,0.0,0.0,0.0,0.0,0.0,0.0,0.0,0.0,0.0,0.0,0.0,0.0,1.0,0.0,0.0,0.0,0.0,0.0,0.0,0.0,0.0,0.0,0.0,0.0,0.0,1.0,0.0,0.0,0.0,0.0,0.0,0.0,0.0,0.0,0.0,0.0,0.0,0.0,0.0,0.0,0.0,0.0,0.0,0.0,0.0,0.0,0.0,0.0,0.0,0.0,0.0,0.0,0.0,0.0,0.0,0.0,0.0,0.0,0.0,0.0,0.0,0.0,0.0,0.0,0.0,0.0,0.0,0.0,0.0,0.0,0.0,0.0,0.0,0.0,0.0,0.0,0.0,0.0,0.0,0.0,0.0,0.0,0.0,0.0,0.0,0.0,0.0,0.0,0.0,0.0,0.0,0.0
103025,1,0.0,0.0,0.0,1.0,3.0,180000.0,440784.0,34956.0,360000.0,0.006629,34.11232876712329,-1287.0,-1360.0,-3606.0,,5.0,2.0,2.0,7.0,0.2782848490188926,0.621402429079078,0.3016248916841194,,,0.9791,,,,0.1034,0.0417,,,,0.01,,0.0045,,,0.9791,,,,0.1034,0.0417,,,,0.0104,,0.0047,,,0.9791,,,,0.1034,0.0417,,,,0.0102,,0.0046,0.0088,1.0,2.0,1.0,2.0,1.0,-502.0,0.0,0.0,0.0,0.0,0.0,3.0,1.0,1.0,0.0,1.0,0.0,1.0,0.0,0.0,0.0,0.0,0.0,0.0,0.0,1.0,0.0,0.0,0.0,0.0,0.0,0.0,0.0,0.0,0.0,0.0,0.0,0.0,0.0,0.0,0.0,0.0,0.0,0.0,8.0,0.0,0.0,193446.0,0.0,0.0,0.0,0.0,0.0,-594.5,649.0,-311.5,-322.0,180.0,-14.0,3.0,25996.365,337500.0,384277.5,,337500.0,36.0,-905.0,365243.0,-929.0,-884.0,-59.0,-874.5,7.0,1.0,,-1.0,8.0,24.0,23.5,-26.5,0.0,0.0,5.0,25996.365,25996.365,-790.0,-775.0,2.0,1.0,0.0,,,,,,,,,,,,,,,,,,,,,8347701487.5,184413339909.0,165597492564.0,51977722807.935,1863.0,1705.0,71125.0,70831.0,9140.0,506120.0,,,,,,,128437.0,662910.0,,,,13529401.45479412,-601977910.0,-922031961.0,-296557364.0,-1535333133.0416667,44021.0,30707.0,,,,22889.384500009703,22811.236400009668,22196.725300008227,67476.58977459572,158060.59942437566,126123.35887345974,35006.86490002793,34947.09570002837,34392.75890002878,,,,3714679.0,,,,,,,16469.633899999757,16654.88699999969,16251.693599999702,,,,3914.116400000125,3897.285600000163,3729.86420000016,436512.0,431306.0,,6425.860983002899,632040.0,625591.0,,16333.9739999998,154197.45239999058,154200.19749999014,154091.9515999871,,,,20.0,46978483.13999998,20506363.785000023,5037926203.125007,1675127905.4700005,56149545.32999996,709847.0099999999,94.0,12039.0,-16209510.5,7191775.0,-8379582.5,-9104246.0,-9.5,0.0,0.0,74407.5,0.0,0.0,0.0,0.0,0.0,-1265.0,-310.0,-319.0,-322.0,176992718.04000005,2527159743.9450026,2851996315.950001,,2527159743.9450026,182350.0,-12536709.0,2905532332.5,126176570.5,650098346.5,288159146.5,677708252.5,182402.0,2831.5,,4322546.0,1496095.5,917675.0,-3000065.5,940967.0,99370.0,2002149264.73502,2019257776.665008,-122361879.0,-121362718.0,2203112.0,99082.0,,,,,,,,,,,,,,,,,,,,,1467627.0,14788492.0,3233179.0,8556072.0,11609268.0,1415879.0,1058951704.5720012,801714392.392495,72114921090.87712,21677013778.657616,582516033.7994988,5792665.7475,689.5,94245.0,-276964339.0,21968846.0,-123806562.0,-218735642.0,-2019315.0,,,,,,,,,,,,,,,,,,,,,4273606.0,2479630.5,-9004730.5,921269.0,37582.5,3733939682.774962,3658678780.13996,-260661983.5,-257350513.5,2526892.0,269230.5,3926673904.207456,33257784881.02592,36687096083.115135,,48090940886.093216,3988555.0,-247619249.5,103100273622.0,1054505225.0,17276569018.0,3504221747.0,18890224759.5,3672559.5,71930.0,,89794040.5,-37.728294916071,2.4488,5.149330587023687,175.65565791515598,12.609680741503606,430.1455751026338,36000.0,-0.2225209339563143,0.9749279121818236,0.0,0.0,0.0,0.0,0.0,0.0,1.0,0.0,1.0,0.0,0.0,0.0,0.0,0.0,0.0,0.0,0.0,0.0,1.0,1.0,0.0,0.0,0.0,0.0,0.0,1.0,0.0,0.0,0.0,0.0,0.0,0.0,0.0,0.0,0.0,0.0,0.0,0.0,0.0,0.0,0.0,0.0,0.0,0.0,1.0,0.0,0.0,0.0,0.0,0.0,0.0,0.0,0.0,0.0,0.0,0.0,0.0,0.0,0.0,0.0,0.0,0.0,0.0,0.0,0.0,0.0,0.0,0.0,0.0,0.0,0.0,0.0,0.0,0.0,0.0,0.0,0.0,0.0,0.0,0.0,0.0,0.0,0.0,0.0,0.0,0.0,0.0,0.0,0.0,0.0,1.0,0.0,0.0,0.0,0.0,0.0,0.0,0.0,0.0,0.0,0.0,0.0,0.0,0.0,0.0,0.0,0.0,0.0,0.0,0.0,0.0,0.0,0.0,0.0,1.0,0.0,0.0,0.0,0.0,0.0
103029,0,0.0,1.0,1.0,0.0,0.0,162000.0,108000.0,11340.0,108000.0,0.006305,27.93972602739726,-214.0,-1595.0,-2689.0,14.0,1.0,3.0,3.0,12.0,0.5374452553163558,0.3103772896036892,0.5298898341969072,0.0495,0.0636,0.9757,0.6668,0.0194,0.0,0.1034,0.1667,0.2083,0.032,0.0403,0.0268,0.0,0.0,0.0504,0.066,0.9757,0.6798,0.0196,0.0,0.1034,0.1667,0.2083,0.0327,0.0441,0.0279,0.0,0.0,0.05,0.0636,0.9757,0.6713,0.0195,0.0,0.1034,0.1667,0.2083,0.0326,0.041,0.0273,0.0,0.0,0.0317,1.0,0.0,0.0,0.0,0.0,-619.0,0.0,0.0,0.0,0.0,0.0,0.0,1.0,1.0,1.0,1.0,0.0,0.0,0.0,0.0,0.0,0.0,0.0,0.0,0.0,0.0,0.0,0.0,0.0,0.0,1.0,0.0,0.0,0.0,0.0,0.0,0.0,0.0,0.0,0.0,0.0,0.0,0.0,0.0,7.0,0.0,0.0,89977.5,0.0,0.0,0.0,0.0,0.0,-1301.0,-697.0,-1024.0,-1027.0,269.0,-21.0,5.0,6364.53,62955.0,49635.0,9443.25,62955.0,6.0,-361.0,365243.0,-331.0,-331.0,-181.0,-325.0,14.0,0.0,0.1500924195657235,1440.0,9.0,2.0,1.0,-17.0,0.0,0.0,5.0,34794.36,34794.36,-530.0,-512.0,1.0,2.0,10.0,0.0,90000.0,,0.0,,,0.0,,0.0,0.0,0.0,0.0,,0.0,,,0.0,-7.5,0.0,0.0,8347712827.5,184413447909.0,165597600564.0,51977884807.935,1863.0,1705.0,71125.0,70831.0,9140.0,506120.0,17810.162500002294,17872.332699999108,17323.757299998044,11297.28750000009,11235.059000000092,11182.39140000006,128437.0,662911.0,4138.355800000118,4136.020200000016,3946.588800000093,13529429.394520149,-601978124.0,-922034650.0,-296557983.0,-1535334728.0416667,44021.0,30707.0,11351.108399999184,11227.059999998975,10711.347399997292,22889.487900009703,22811.339800009668,22196.828700008227,67477.12721985104,158060.90980166526,126123.88876329394,35007.03160002793,34947.26240002837,34392.92560002878,22959.026599995912,22932.15059999549,22578.914699995723,3714691.0,8296.394100000165,8400.922200000077,8124.513600000229,9818.965100000716,9933.934800002164,10293.659899999646,16469.660699999757,16654.91429999969,16251.7214999997,828.7633000001763,813.938300000046,759.8607000000133,3914.116400000125,3897.285600000163,3729.86420000016,436512.0,431306.0,1263346.0,6425.867288002899,632043.0,625594.0,,16334.0056999998,154198.42809999062,154201.17319999015,154092.92729998712,77624.92519999627,77962.78270000659,78364.19270000655,43.0,47019019.13999998,20513577.285000023,5040906866.820006,1675706704.4700005,56159431.24499996,709847.0099999999,94.0,12039.0,-16222899.0,7188225.0,-8387973.0,-9112741.0,-21.0,0.0,0.0,89977.5,0.0,0.0,0.0,0.0,0.0,-1485.0,-935.0,-1027.0,-1085.0,177127599.37500003,2528350421.1750026,2853496071.1800013,41132538.49499999,2528350421.1750026,182496.0,-12547178.0,2909366821.0,126167871.0,650822678.0,288519602.0,678432685.0,182549.0,2833.0,514.468417077308,4326829.0,1497146.0,918272.0,-3002769.0,941035.0,99370.0,2003754740.0400207,2020855687.425009,-122447508.0,-121447323.0,2204350.0,99163.0,1945420387.8749852,5198958000.0,,252978129.31499964,,,110419830.0449996,,256250355.75000048,1867280804.6849957,1938074604.164986,1938149306.0999863,,21200.0,,,632811.0,-1133114.5,495889.0,1145.0,1467634.0,14788761.0,3233189.0,8556081.0,11609273.0,1415884.0,1058951704.5720012,801714392.392495,72115011068.37712,21677013778.657616,582516033.7994988,5792665.7475,689.5,94245.0,-276965640.0,21968149.0,-123807586.0,-218736669.0,-2019336.0,5923310709.1724615,18723973500.0,,447980703.7049976,,,309140890.10999864,,459182474.0999993,5708441575.822533,5886589792.815,5886832975.559999,,80839.0,,,971653.0,-1698774.0,177364.0,6755.0,4273608.0,2479631.5,-9004747.5,921269.0,37582.5,3733974477.1349616,3658713574.49996,-260662513.5,-257351025.5,2526893.0,269232.5,3926680268.737456,33257847836.02592,36687145718.115135,1729595790.9450495,48091003841.093216,3988561.0,-247619610.5,103100638865.0,1054504894.0,17276568687.0,3504221566.0,18890224434.5,3672573.5,71930.0,20872.75675771124,89795480.5,-7.659344969601882,0.6666666666666666,14.285714285714285,399.1389432485323,9.523809523809524,266.0926288323549,162000.0,-0.2225209339563143,0.9749279121818236,0.0,0.0,0.0,0.0,0.0,0.0,1.0,0.0,0.0,0.0,0.0,0.0,0.0,1.0,0.0,1.0,0.0,0.0,0.0,0.0,0.0,0.0,1.0,0.0,0.0,1.0,0.0,0.0,0.0,0.0,0.0,0.0,0.0,0.0,0.0,0.0,0.0,0.0,0.0,0.0,0.0,0.0,0.0,0.0,0.0,0.0,0.0,0.0,0.0,0.0,0.0,0.0,0.0,0.0,0.0,0.0,0.0,0.0,0.0,0.0,0.0,0.0,0.0,0.0,0.0,0.0,0.0,0.0,0.0,0.0,0.0,0.0,0.0,0.0,0.0,0.0,0.0,0.0,0.0,0.0,0.0,0.0,0.0,0.0,0.0,0.0,0.0,0.0,0.0,1.0,0.0,0.0,0.0,0.0,0.0,0.0,0.0,0.0,0.0,0.0,0.0,0.0,0.0,0.0,0.0,0.0,0.0,0.0,1.0,0.0,1.0,0.0,0.0,0.0,0.0,0.0,0.0,0.0,1.0,0.0
103046,0,0.0,0.0,0.0,1.0,1.0,234000.0,1096020.0,59589.0,900000.0,0.011703,32.83013698630137,-2079.0,-1197.0,-4431.0,,3.0,2.0,2.0,10.0,,0.5898057638479994,,,,,,,,,,,,,,,,,,,,,,,,,,,,,,,,,,,,,,,,,,,,,,0.0,0.0,0.0,0.0,0.0,,,,,,,1.0,1.0,0.0,1.0,0.0,0.0,0.0,0.0,0.0,1.0,1.0,0.0,0.0,1.0,0.0,0.0,0.0,0.0,0.0,0.0,0.0,0.0,0.0,0.0,0.0,0.0,0.0,0.0,0.0,0.0,0.0,0.0,0.0,,,,,,,,,,,,,0.0,,1.0,18902.115,211442.58,206622.0,21146.58,211442.58,12.0,-491.0,365243.0,-461.0,-191.0,-131.0,-186.0,14.0,1.0,0.101113806111289,3650.0,11.0,12.0,7.0,-11.0,0.0,0.0,10.0,18902.115,18902.115,-336.5,-326.0,5.5,1.0,0.0,,,,,,,,,,,,,,,,,,,,,8347772416.5,184414543929.0,165598500564.0,51978118807.935,,,,,,,,,,,,,128438.0,662914.0,,,,13529462.224657131,-601980203.0,-922039081.0,-296557983.0,-1535335925.0416667,44021.0,30707.0,,,,,,,,158061.4996074291,,,,,,,,3714701.0,,,,,,,,,,,,,,,,436512.0,431306.0,,6425.878991002899,632045.0,625596.0,,,,,,,,,,,,,,,,,,,,,,,,,,,,,,,,,,,177610129.65000004,2535582372.2550025,2861235436.6800013,41324185.57499999,2535582372.2550025,183100.0,-12592521.0,2921053692.0,127231198.0,654085480.0,290327236.0,682061084.0,183093.0,2847.0,516.8332061755724,4340487.0,1502982.0,922125.0,-3012156.0,941035.0,99370.0,2009123404.987523,2026984971.757511,-122725207.5,-121721610.5,2207580.5,99735.5,,,,,,,,,,,,,,,,,,,,,1467634.0,14788761.0,3233189.0,8556092.0,11609283.0,1415885.0,,,,,,,,,,,,,,,,,,,,,,,,,,,,,,,,,,4273620.0,2479638.5,-9004758.5,921269.0,37582.5,3733993379.249962,3658732476.61496,-260662850.0,-257351351.5,2526898.5,269233.5,3926699170.852456,33258059278.60592,36687352340.115135,1729616937.5250494,48091215283.67322,3988573.0,-247620101.5,103101004108.0,1054504433.0,17276568496.0,3504221435.0,18890224248.5,3672587.5,71931.0,20872.85787151735,89799130.5,-63.32596177918718,4.6838461538461535,3.926899259930524,128.92064063492455,18.39299199516689,603.8444467892738,78000.0,-0.9009688679024191,0.4338837391175582,0.0,0.0,0.0,0.0,0.0,0.0,1.0,0.0,1.0,0.0,0.0,0.0,0.0,0.0,0.0,0.0,0.0,0.0,1.0,0.0,1.0,0.0,0.0,0.0,0.0,1.0,0.0,0.0,0.0,0.0,0.0,0.0,0.0,0.0,0.0,0.0,0.0,0.0,0.0,0.0,0.0,0.0,0.0,0.0,1.0,0.0,0.0,0.0,0.0,0.0,0.0,0.0,0.0,0.0,0.0,0.0,0.0,0.0,0.0,0.0,0.0,0.0,0.0,0.0,0.0,0.0,0.0,0.0,0.0,0.0,0.0,0.0,0.0,0.0,0.0,0.0,0.0,0.0,0.0,0.0,0.0,0.0,0.0,0.0,0.0,0.0,0.0,0.0,0.0,0.0,0.0,0.0,0.0,0.0,0.0,1.0,0.0,0.0,0.0,0.0,0.0,0.0,0.0,0.0,0.0,0.0,0.0,0.0,0.0,0.0,0.0,0.0,0.0,0.0,0.0,0.0,0.0,0.0,0.0,0.0
103056,0,0.0,0.0,0.0,0.0,0.0,180000.0,315000.0,16213.5,315000.0,0.04622,53.65479452054793,,-9445.0,-3137.0,,1.0,1.0,1.0,15.0,,0.7319585788317885,0.4135967602644276,,,,,,,,,,,,,,,,,,,,,,,,,,,,,,,,,,,,,,,,,,,,,3.0,1.0,3.0,1.0,0.0,0.0,0.0,0.0,0.0,0.0,4.0,1.0,0.0,0.0,1.0,0.0,0.0,0.0,0.0,0.0,0.0,0.0,0.0,0.0,1.0,0.0,0.0,0.0,0.0,0.0,0.0,0.0,0.0,0.0,0.0,0.0,0.0,0.0,0.0,0.0,0.0,0.0,0.0,7.0,10926.0,105.75,279900.0,136840.5,0.0,0.0,0.0,0.0,-2515.0,1554.0,-25.0,-1755.0,495.0,-39.0,10.0,15666.885,116406.0,121569.75,2479.5,145395.0,12.0,-1139.0,365243.0,-1469.0,-967.0,-768.0,-959.5,14.0,0.5,0.0544545454545454,23.5,91.0,12.0,10.0,-39.0,0.0,0.0,102.0,19348.065,15666.885,-1121.0,-1116.0,8.0,1.0,0.0,,,,,,,,,,,,,,,,,,,,,8347788630.0,184414858929.0,165598815564.0,51978298807.935,1863.0,1705.0,71125.0,70831.0,9140.0,506124.0,,,,,,,128438.0,662915.0,,,,13529515.879451651,,-922042218.0,-296557983.0,-1535345370.0416667,44022.0,30708.0,,,,,,,,158062.23156600795,126124.30236005424,,,,,,,3714716.0,,,,,,,,,,,,,,,,436515.0,431309.0,,6425.925211002899,632046.0,625597.0,,,,,,,,,83.0,47644248.68999998,20547376.47000002,5086036545.975006,1686496746.9150002,56429110.12499996,709847.0099999999,94.0,12039.0,-16369564.0,7354792.0,-8458908.0,-9194334.0,-41.0,8415.0,105.75,279900.0,136840.5,0.0,0.0,0.0,0.0,-2599.0,1554.0,-16.0,-1755.0,178163569.08000004,2544468216.930003,2870853160.6800013,41446433.24999999,2544400716.930003,183780.0,-12655671.5,2932190819.5,127548569.5,656603882.5,291025155.5,684947379.0,183899.5,2861.0,518.6533044730486,4363773.0,1509893.0,926221.0,-3027492.0,941041.0,99376.0,2018578755.3975327,2036119928.8275192,-123491443.0,-122483934.5,2221742.5,100081.0,,,,,,,,,,,,,,,,,,,,,1467641.0,14789256.0,3233189.0,8556183.0,11609385.0,1415895.0,1058962630.5720012,801714498.142495,72115290968.37712,21677150619.157616,582516033.7994988,5792665.7475,689.5,94245.0,-276968155.0,21969703.0,-123807611.0,-218738424.0,-2019375.0,,,,,,,,,,,,,,,,,,,,,4273632.0,2479648.5,-9004797.5,921269.0,37582.5,3734012727.314962,3658748143.49996,-260663971.0,-257352467.5,2526906.5,269234.5,3926714837.737456,33258175684.60592,36687473909.865135,1729619417.0250494,48091360678.67322,3988585.0,-247621240.5,103101369351.0,1054502964.0,17276567529.0,3504220667.0,18890223289.0,3672601.5,71931.5,20872.912326062804,89799154.0,,1.75,11.101859561476548,595.6679935670048,19.42825423258396,1042.418988742258,180000.0,-0.9009688679024191,0.4338837391175582,0.0,0.0,0.0,0.0,0.0,0.0,1.0,0.0,0.0,1.0,0.0,0.0,0.0,0.0,0.0,0.0,0.0,0.0,1.0,0.0,0.0,0.0,0.0,1.0,0.0,1.0,0.0,0.0,0.0,0.0,0.0,0.0,0.0,0.0,0.0,0.0,0.0,0.0,0.0,0.0,0.0,0.0,0.0,0.0,0.0,0.0,0.0,0.0,0.0,0.0,0.0,0.0,0.0,0.0,0.0,0.0,0.0,0.0,0.0,0.0,0.0,0.0,0.0,0.0,0.0,0.0,0.0,0.0,0.0,0.0,0.0,0.0,0.0,0.0,0.0,0.0,0.0,0.0,0.0,0.0,0.0,0.0,0.0,0.0,0.0,0.0,0.0,0.0,0.0,0.0,0.0,0.0,0.0,0.0,0.0,0.0,0.0,0.0,0.0,0.0,0.0,0.0,0.0,0.0,0.0,1.0,0.0,0.0,0.0,0.0,0.0,0.0,0.0,0.0,0.0,0.0,0.0,0.0,0.0,0.0
103062,0,0.0,0.0,1.0,1.0,0.0,180000.0,603000.0,32841.0,603000.0,0.018209,54.11780821917807,-3121.0,-1082.0,-3311.0,3.0,2.0,3.0,3.0,9.0,,0.3969922785842201,0.3556387169923543,0.1237,0.0755,0.9801,0.728,0.0923,0.0,0.069,0.1667,0.2083,0.0,0.1009,0.0642,0.0,0.0,0.1261,0.0783,0.9801,0.7387,0.0932,0.0,0.069,0.1667,0.2083,0.0,0.1102,0.0669,0.0,0.0,0.1249,0.0755,0.9801,0.7316,0.0929,0.0,0.069,0.1667,0.2083,0.0,0.1026,0.0653,0.0,0.0,0.0505,1.0,0.0,0.0,0.0,0.0,-922.0,0.0,0.0,0.0,0.0,2.0,4.0,1.0,1.0,0.0,1.0,0.0,1.0,0.0,0.0,0.0,0.0,0.0,0.0,0.0,1.0,0.0,0.0,0.0,0.0,0.0,0.0,0.0,0.0,0.0,0.0,0.0,0.0,0.0,0.0,0.0,0.0,0.0,0.0,10.0,1961.28,0.0,38727.0,0.0,0.0,0.0,0.0,0.0,-614.5,-384.5,-346.0,-642.0,202.0,-10.0,12.0,12214.8,59715.0,59530.5,7443.0,171000.0,12.0,-307.0,365243.0,-480.5,-300.5,-150.5,-296.0,13.0,0.0,0.0994565130099582,-1.0,28.0,12.0,7.5,-19.0,0.0,0.0,24.0,12214.8,12214.8,-570.0,-567.0,4.5,1.0,11.0,0.0,45000.0,,0.0,,,0.0,,0.0,0.0,0.0,0.0,,0.0,,,0.0,-7.0,0.0,0.0,8347821471.0,184415461929.0,165599418564.0,51978478807.935,1863.0,1705.0,71125.0,70833.0,9140.0,506128.0,17810.286200002294,17872.45759999911,17323.883399998045,11297.36300000009,11235.134500000093,11182.469700000058,128438.0,662917.0,4138.448100000118,4136.113100000016,3946.6820000000935,13529569.997259872,-601983324.0,-922045529.0,-296558905.0,-1535346452.0416667,44022.0,30708.0,11351.108399999184,11227.059999998975,10711.347399997292,22889.556900009706,22811.408800009667,22196.897700008227,,158062.62855828652,126124.65799877125,35007.198300027936,34947.42910002837,34393.09230002878,22959.234899995907,22932.358899995488,22579.12299999572,3714725.0,8296.394100000165,8400.922200000077,8124.513600000229,9819.066000000716,9934.037400002164,10293.770099999643,16469.724899999757,16654.97959999969,16251.7883999997,828.7633000001763,813.938300000046,759.8607000000133,3914.116400000125,3897.285600000163,3729.86420000016,436515.0,431309.0,1263349.0,6425.943420002899,632049.0,625600.0,,16334.0561999998,154199.40819999058,154202.15329999017,154093.9073999871,77625.65319999628,77963.51430000659,78364.93140000655,20.5,47670893.18999998,20575645.695000023,5091387250.095006,1687784757.0750003,56476096.96499996,709847.0099999999,94.0,12039.0,-16398398.5,7417833.0,-8469064.5,-9206240.0,-9.75,0.0,0.0,44523.0,0.0,0.0,0.0,0.0,0.0,-761.0,-568.0,-511.0,-673.0,178490865.015,2549445108.930003,2876091259.6800013,41515089.74999999,2549152608.930003,184226.0,-12679039.5,2937303742.5,127538623.5,657692258.5,291387181.5,686035834.0,184312.0,2865.0,519.5049233912853,4364417.5,1512336.0,927570.0,-3034059.0,969297.0,99390.0,2021643517.995036,2039035423.2750204,-123608066.5,-122600738.5,2223102.0,100212.5,1959779422.2599823,5240268000.0,,258280523.8199996,,,111264584.08499964,,260666933.2200004,1881052891.649994,1952320281.4799829,1952394983.4149835,,21370.0,,,637732.0,-1142703.0,502501.0,1149.0,1467651.0,14789458.0,3233200.0,8556211.0,11609409.0,1415907.0,1058964591.8520012,801714498.142495,72115329695.37712,21677150619.157616,582516033.7994988,5792665.7475,689.5,94245.0,-276968769.5,21969318.5,-123807957.0,-218739066.0,-2019385.0,5923310709.1724615,18724018500.0,,447980703.7049976,,,309140890.10999864,,459182474.0999993,5708441575.822533,5886589792.815,5886832975.559999,,80839.0,,,971653.0,-1698781.0,177364.0,6755.0,4273644.0,2479656.0,-9004816.5,921269.0,37582.5,3734024942.1149616,3658760358.299961,-260664541.0,-257353034.5,2526911.0,269235.5,3926727052.537457,33258235399.60592,36687533440.365135,1729626860.0250494,48091531678.67322,3988597.0,-247621547.5,103101734594.0,1054502483.5,17276567228.5,3504220516.5,18890222993.0,3672614.5,71931.5,20873.011782575813,89799153.0,-57.6704804333519,3.35,5.480953685941354,296.6172004339714,18.361194847903537,993.6676214538044,90000.0,0.6234898018587336,0.7818314824680298,0.0,1.0,0.0,0.0,0.0,0.0,0.0,0.0,0.0,0.0,0.0,0.0,0.0,1.0,0.0,0.0,0.0,0.0,1.0,0.0,1.0,0.0,0.0,0.0,0.0,1.0,0.0,0.0,0.0,0.0,0.0,1.0,0.0,0.0,0.0,0.0,0.0,0.0,0.0,0.0,0.0,0.0,0.0,0.0,0.0,0.0,0.0,0.0,0.0,0.0,0.0,0.0,0.0,0.0,0.0,0.0,0.0,0.0,0.0,0.0,0.0,0.0,0.0,0.0,0.0,0.0,0.0,0.0,1.0,0.0,0.0,0.0,0.0,0.0,0.0,0.0,0.0,0.0,0.0,0.0,0.0,0.0,0.0,0.0,0.0,0.0,0.0,0.0,0.0,0.0,0.0,0.0,0.0,0.0,0.0,0.0,0.0,0.0,0.0,0.0,0.0,0.0,0.0,0.0,0.0,0.0,0.0,0.0,1.0,0.0,1.0,0.0,0.0,0.0,0.0,0.0,0.0,0.0,1.0,0.0
103078,0,0.0,1.0,0.0,1.0,1.0,90000.0,675000.0,24376.5,675000.0,0.015221,34.273972602739725,-4775.0,-457.0,-4392.0,,3.0,2.0,2.0,15.0,0.6627435367893676,0.7876130967570385,0.5762088360175724,,,,,,,,,,,,,,,,,,,,,,,,,,,,,,,,,,,,,,,,,,,,,3.0,0.0,3.0,0.0,-1906.0,0.0,0.0,0.0,0.0,0.0,2.0,1.0,1.0,0.0,1.0,0.0,0.0,0.0,0.0,0.0,1.0,1.0,0.0,0.0,1.0,0.0,0.0,0.0,0.0,0.0,0.0,0.0,0.0,0.0,0.0,0.0,0.0,0.0,0.0,0.0,0.0,0.0,0.0,6.0,14487.75,0.0,726750.0,0.0,0.0,0.0,0.0,0.0,-792.0,697.5,-130.5,-803.0,180.0,-15.0,6.0,6330.0825,64676.25,64487.25,3600.0,64676.25,10.0,-1532.5,365243.0,-1501.5,-1336.5,-1291.5,-1330.0,12.5,0.0,0.0544556045930185,30.0,50.0,8.0,6.0,-47.0,0.0,0.0,45.0,15953.22,6535.665,-1421.0,-1408.0,5.0,1.0,0.0,,,,,,,,,,,,,,,,,,,,,8347845847.5,184416136929.0,165600093564.0,51978568807.935,1863.0,1705.0,71125.0,70833.0,9140.0,506130.0,,,,,,,128439.0,662920.0,,,,13529604.271232476,-601988099.0,-922049921.0,-296560811.0,-1535346909.0416667,44022.0,30708.0,,,,,,,67477.78996338783,158063.4161713833,126125.23420760724,,,,,,,3714740.0,,,,,,,,,,,,,,,,436518.0,431312.0,,6425.958641002899,632051.0,625602.0,,,,,,,,,27.0,47874912.74999998,20707600.14000002,5111612460.855006,1692220187.7000003,56491751.06999996,709847.0099999999,94.0,12039.0,-16485822.5,7419586.5,-8508882.0,-9253064.0,-13.0,17509.5,0.0,675000.0,0.0,0.0,0.0,0.0,0.0,-1289.0,539.0,-317.0,-1288.0,179204394.1275,2560729482.3600025,2888087031.1800013,41729573.42999999,2560729482.3600025,185463.0,-12746925.5,2955564726.5,128575839.0,662761665.0,293911794.5,691105517.0,185338.0,2882.0,522.5092784329588,4391616.0,1524240.5,935859.0,-3053118.5,969368.0,99417.0,2031963530.3550296,2049050656.125016,-124322786.0,-123308607.0,2230955.0,100787.0,,,,,,,,,,,,,,,,,,,,,1467657.0,14789638.0,3233200.0,8556261.0,11609454.0,1415913.0,1058979079.6020012,801714498.142495,72116056445.37712,21677150619.157616,582516033.7994988,5792665.7475,689.5,94245.0,-276969561.5,21970016.0,-123808087.5,-218739869.0,-2019400.0,,,,,,,,,,,,,,,,,,,,,4273652.0,2479662.0,-9004863.5,921269.0,37582.5,3734040895.334962,3658766893.964961,-260665962.0,-257354442.5,2526916.0,269236.5,3926733382.619957,33258300075.85592,36687597927.615135,1729630460.0250494,48091596354.92322,3988607.0,-247623080.0,103102099837.0,1054500982.0,17276565892.0,3504219225.0,18890221663.0,3672627.0,71931.5,20873.066238180407,89799183.0,-139.31854516386892,7.5,3.692080487354625,126.5422654707023,27.690603655159684,949.0669910302676,30000.0,-0.9009688679024191,0.4338837391175582,0.0,0.0,0.0,0.0,0.0,0.0,1.0,0.0,1.0,0.0,0.0,0.0,0.0,0.0,0.0,0.0,0.0,0.0,1.0,0.0,1.0,0.0,0.0,0.0,0.0,1.0,0.0,0.0,0.0,0.0,0.0,0.0,0.0,0.0,0.0,0.0,0.0,0.0,1.0,0.0,0.0,0.0,0.0,0.0,0.0,0.0,0.0,0.0,0.0,0.0,0.0,0.0,0.0,0.0,0.0,0.0,0.0,0.0,0.0,0.0,0.0,0.0,0.0,0.0,1.0,0.0,0.0,0.0,0.0,0.0,0.0,0.0,0.0,0.0,0.0,0.0,0.0,0.0,0.0,0.0,0.0,0.0,0.0,0.0,0.0,0.0,0.0,0.0,0.0,0.0,0.0,0.0,0.0,0.0,0.0,0.0,0.0,0.0,0.0,0.0,0.0,0.0,0.0,0.0,0.0,0.0,0.0,0.0,0.0,0.0,0.0,0.0,0.0,0.0,0.0,0.0,0.0,0.0,0.0,0.0
103083,0,0.0,0.0,0.0,1.0,0.0,202500.0,929088.0,33502.5,720000.0,0.04622,47.89041095890411,-4599.0,-1273.0,-1015.0,,2.0,1.0,1.0,12.0,,0.7392142283477329,0.6785676886853644,0.0041,,0.9667,,,0.0,,0.0,,,,0.0016,,,0.0042,,0.9667,,,0.0,,0.0,,,,0.0017,,,0.0042,,0.9667,,,0.0,,0.0,,,,0.0016,,,0.0016,1.0,1.0,0.0,1.0,0.0,-1174.0,0.0,0.0,0.0,0.0,0.0,0.0,1.0,1.0,0.0,1.0,0.0,0.0,0.0,0.0,0.0,0.0,0.0,0.0,0.0,1.0,0.0,0.0,0.0,0.0,0.0,0.0,0.0,0.0,0.0,0.0,0.0,0.0,0.0,0.0,0.0,0.0,0.0,0.0,3.0,16578.0,0.0,123750.0,0.0,0.0,0.0,0.0,0.0,-1299.0,511.0,-222.0,-677.0,116.0,-19.0,5.0,19791.9,135000.0,161856.0,8543.25,152928.0,11.0,-879.0,365243.0,-775.0,-517.0,-445.0,-443.0,14.0,0.0,0.0544574138987855,-1.0,24.0,12.0,5.5,-26.5,0.0,0.0,53.0,2250.0,2250.0,-571.0,-565.0,9.0,0.0,28.0,0.0,450000.0,0.0,0.0,0.0,0.0,0.0,8.1,8.1,0.0,0.0,0.0,0.0,0.0,0.0,0.0,6.0,-15.5,0.0,0.0,8347879350.0,184417066017.0,165600813564.0,51978771307.935,1863.0,1705.0,71125.0,70833.0,9140.0,506130.0,17810.290300002292,17872.461799999106,17323.887599998045,,,,128439.0,662922.0,,,,13529652.161643434,-601992698.0,-922050936.0,-296561985.0,-1535348182.0416667,44022.0,30708.0,11351.108399999184,11227.059999998975,10711.347399997292,,,,,158064.15538561164,126125.91277529592,35007.198300027936,34947.42910002837,34393.09230002878,,,,3714752.0,,,,,,,16469.726499999757,16654.98119999969,16251.790099999702,,,,,,,436519.0,431313.0,,6426.004861002899,632052.0,625603.0,,16334.0577999998,154200.37489999054,154203.11999999013,154094.87409998712,,,,43.0,48124161.85499997,20736647.64000002,5127055328.205007,1694208466.0800006,56523153.68999996,709847.0099999999,94.0,12039.0,-16547169.0,7387300.0,-8548137.0,-9294628.0,-21.0,20781.0,0.0,123750.0,0.0,0.0,0.0,0.0,0.0,-1299.0,511.0,-222.0,-677.0,179874174.60000002,2568967161.4350023,2897868725.505001,41796758.42999999,2569034661.4350023,186093.0,-12796702.0,2966338683.0,129635071.0,664558853.0,294981925.0,693268498.0,186021.0,2898.0,523.5405921675214,4403313.0,1528554.0,938238.0,-3065334.5,969368.0,99417.0,2036668508.235031,2053753455.0150173,-124664655.0,-123647878.0,2233271.0,101122.0,1969408228.9949827,5268483000.0,167155468.55999997,259171326.9449996,10044138.6,81734256.62999998,111816998.63999964,283025206.57500017,261299302.0200004,1890031754.654995,1961844713.054982,1961919414.989982,8499.0,21535.0,134.0,12902.0,641954.0,-1148666.5,502507.0,1155.0,1467660.0,14789754.0,3233228.0,8556285.0,11609507.0,1415918.0,1058995657.6020012,801714498.142495,72116180195.37712,21677150619.157616,582516033.7994988,5792665.7475,689.5,94245.0,-276970860.5,21970527.0,-123808309.5,-218740546.0,-2019419.0,5923310709.1724615,18724468500.0,198801507.825,447980703.7049976,1948107.735,256782765.80250075,309140890.10999864,636594785.9999981,459182482.1999993,5708441575.822533,5886589792.815,5886832975.559999,13382.5,80839.0,44.0,70351.5,971659.0,-1698796.5,177364.0,6755.0,4273664.0,2479667.5,-9004890.0,921269.0,37582.5,3734043145.334962,3658769143.964961,-260666533.0,-257355007.5,2526925.0,269236.5,3926753174.519957,33258435075.85592,36687759783.615135,1729639003.2750494,48091749282.92322,3988618.0,-247623959.0,103102465080.0,1054500207.0,17276565375.0,3504218780.0,18890221220.0,3672641.0,71931.5,20873.120695594305,89799182.0,-96.03175057208236,4.588088888888889,6.044325050369375,289.46521063138823,27.7319006044325,1328.0921166177538,101250.0,0.6234898018587336,0.7818314824680298,0.0,0.0,0.0,0.0,0.0,0.0,1.0,0.0,0.0,0.0,1.0,0.0,0.0,0.0,0.0,1.0,0.0,0.0,0.0,0.0,1.0,0.0,0.0,0.0,0.0,1.0,0.0,0.0,0.0,0.0,0.0,0.0,0.0,0.0,0.0,0.0,0.0,0.0,0.0,0.0,0.0,0.0,0.0,0.0,0.0,0.0,0.0,0.0,0.0,0.0,0.0,0.0,0.0,0.0,0.0,0.0,0.0,0.0,0.0,0.0,0.0,0.0,0.0,0.0,0.0,0.0,0.0,0.0,0.0,0.0,0.0,0.0,0.0,0.0,0.0,0.0,1.0,0.0,0.0,0.0,0.0,0.0,0.0,0.0,0.0,0.0,0.0,0.0,0.0,0.0,0.0,0.0,0.0,0.0,0.0,0.0,0.0,0.0,0.0,0.0,0.0,0.0,0.0,0.0,0.0,0.0,0.0,0.0,0.0,0.0,0.0,0.0,0.0,0.0,0.0,0.0,0.0,0.0,1.0,0.0
103092,0,0.0,0.0,0.0,1.0,0.0,202500.0,783927.0,42655.5,688500.0,0.010032,54.44657534246576,-4771.0,-5584.0,-3358.0,,1.0,2.0,2.0,8.0,,0.1716718997065354,0.6610235391308081,0.2598,0.193,0.9806,,,0.28,0.2414,0.3333,,0.1057,,0.2617,,0.0044,0.2647,0.2003,0.9806,,,0.282,0.2414,0.3333,,0.1081,,0.2727,,0.0047,0.2623,0.193,0.9806,,,0.28,0.2414,0.3333,,0.1076,,0.2664,,0.0045,0.2068,1.0,0.0,0.0,0.0,0.0,-86.0,0.0,0.0,0.0,0.0,1.0,3.0,1.0,1.0,1.0,1.0,0.0,0.0,0.0,0.0,0.0,0.0,0.0,0.0,0.0,1.0,0.0,0.0,0.0,0.0,0.0,0.0,0.0,0.0,0.0,0.0,0.0,0.0,0.0,0.0,0.0,0.0,0.0,0.0,2.0,1131.75,,184500.0,35109.0,0.0,0.0,0.0,0.0,-1547.0,-86.0,-853.5,-1686.0,102.0,-36.5,8.0,18235.575,225000.0,239850.0,8010.0,225000.0,18.0,-897.0,365243.0,-734.0,-316.0,14.0,-308.0,8.0,1.0,0.1047598929036378,-1.0,63.0,36.0,18.5,-21.0,0.0,0.0,62.0,23354.055,20121.3,-495.5,-495.0,6.0,1.0,34.0,0.0,45000.0,,0.0,,,0.0,,0.0,0.0,0.0,0.0,,0.0,,,0.0,-17.5,0.0,0.0,8347922005.5,184417849944.0,165601502064.0,51978973807.935,1863.0,1705.0,71125.0,70834.0,9140.0,506133.0,17810.550100002292,17872.724099999105,17324.152299998044,11297.55600000009,11235.327500000092,11182.670000000058,128439.0,662923.0,,,,13529706.608218774,-601997469.0,-922054294.0,-296562071.0,-1535353766.0416667,44022.0,30708.0,11351.388399999183,11227.339999998978,10711.629399997291,22889.7983000097,22811.650200009663,22197.139100008226,,158064.32705751134,126126.57379883506,35007.53160002793,34947.76240002837,34393.42560002878,,,,3714760.0,8296.499800000165,8401.029800000077,8124.62170000023,,,,16469.988199999756,16655.24759999969,16252.0627999997,,,,3914.120800000124,3897.290100000163,3729.86890000016,436519.0,431313.0,,6426.014893002899,632054.0,625605.0,,16334.2645999998,154201.35549999058,154204.10059999017,154095.8546999871,,,,51.0,48141144.85499997,,5154870400.245007,1711153528.6500006,56523153.68999996,709847.0099999999,94.0,12039.0,-16587803.5,7457655.5,-8567380.0,-9316345.0,-25.0,0.0,,270000.0,0.0,0.0,0.0,0.0,0.0,-2673.0,-1577.0,-1686.0,-1686.0,181399502.25,2578929405.4350023,2909252179.755001,41872844.42999999,2578969455.4350023,186488.0,-12830864.0,2974373925.0,129614636.0,665638972.0,295332863.0,694346486.0,186635.0,2910.0,524.9185923037339,4409909.5,1531824.0,940049.0,-3071886.0,969378.0,99424.0,2042428992.907532,2059248493.4850173,-124858497.5,-123839622.0,2235100.5,101375.0,1969754466.4649827,5277010500.0,,259381942.46999955,,,111833038.79999964,,261416361.10500032,1890358686.2249956,1962178385.0399816,1962253086.974982,,21545.0,,,641996.0,-1149219.0,502507.0,1155.0,1467662.0,14789856.0,3233262.0,8556348.0,11609569.0,1415926.0,1058996789.3520012,,72116364695.37712,21677185728.157616,582516033.7994988,5792665.7475,689.5,94245.0,-276972407.5,21970441.0,-123809163.0,-218742232.0,-2019455.5,5923310709.1724615,18724513500.0,,447980703.7049976,,,309140890.10999864,,459182482.1999993,5708441575.822533,5886589792.815,5886832975.559999,,80839.0,,,971659.0,-1698814.0,177364.0,6755.0,4273700.0,2479686.0,-9004911.0,921269.0,37582.5,3734066499.389961,3658789265.264961,-260667028.5,-257355502.5,2526931.0,269237.5,3926771410.094957,33258660075.85592,36687999633.615135,1729647013.2750494,48091974282.92322,3988636.0,-247624856.0,103102830323.0,1054499473.0,17276565059.0,3504218794.0,18890220912.0,3672649.0,71932.5,20873.22545548721,89799181.0,-87.62718260957077,3.871244444444444,4.747336216900517,258.4761990094904,18.37809895558604,1000.6245494366063,202500.0,0.6234898018587334,-0.7818314824680299,0.0,0.0,0.0,0.0,0.0,0.0,1.0,0.0,0.0,0.0,0.0,0.0,0.0,1.0,0.0,0.0,0.0,0.0,1.0,0.0,0.0,0.0,0.0,1.0,0.0,1.0,0.0,0.0,0.0,0.0,0.0,0.0,0.0,0.0,0.0,0.0,0.0,0.0,1.0,0.0,0.0,0.0,0.0,0.0,0.0,0.0,0.0,0.0,0.0,0.0,0.0,0.0,0.0,0.0,0.0,0.0,0.0,0.0,0.0,1.0,0.0,0.0,0.0,0.0,0.0,0.0,0.0,0.0,0.0,0.0,0.0,0.0,0.0,0.0,0.0,0.0,0.0,0.0,0.0,0.0,0.0,0.0,0.0,0.0,0.0,0.0,0.0,0.0,0.0,0.0,0.0,0.0,0.0,0.0,0.0,0.0,0.0,0.0,0.0,0.0,0.0,0.0,0.0,0.0,0.0,0.0,0.0,0.0,0.0,0.0,1.0,0.0,0.0,0.0,0.0,0.0,0.0,1.0,0.0,0.0
103096,0,0.0,0.0,0.0,1.0,0.0,117000.0,278460.0,21676.5,225000.0,0.0196889999999999,31.317808219178087,-2696.0,-4122.0,-4122.0,,1.0,2.0,2.0,13.0,0.3119081871031828,0.5705056180928978,,0.0619,0.0,0.9896,0.8572,0.0094,0.0,0.1379,0.1667,0.2083,0.0747,0.0504,0.0556,0.0,0.0,0.063,0.0,0.9896,0.8628,0.0095,0.0,0.1379,0.1667,0.2083,0.0764,0.0551,0.058,0.0,0.0,0.0625,0.0,0.9896,0.8591,0.0095,0.0,0.1379,0.1667,0.2083,0.076,0.0513,0.0566,0.0,0.0,0.0503,1.0,0.0,0.0,0.0,0.0,-720.0,,,,,,,1.0,1.0,0.0,1.0,0.0,0.0,0.0,0.0,0.0,0.0,0.0,0.0,0.0,1.0,0.0,0.0,0.0,0.0,0.0,0.0,0.0,0.0,0.0,0.0,0.0,0.0,0.0,0.0,0.0,0.0,0.0,0.0,0.0,,,,,,,,,,,,,0.0,,5.0,14344.4925,67500.0,78196.5,0.0,86949.0,6.0,-1204.0,365243.0,-1858.0,-1633.0,-1466.5,-1630.0,12.0,1.0,0.0,0.0,31.0,6.0,5.0,-39.0,0.0,0.0,26.0,13472.73,13472.73,-1171.5,-1158.0,4.0,1.0,0.0,,,,,,,,,,,,,,,,,,,,,8347943682.0,184418128404.0,165601727064.0,51979090807.935,,,,,,,17810.612000002293,17872.786599999105,17324.215299998046,11297.55600000009,11235.327500000092,11182.670000000058,128439.0,662924.0,4138.457500000118,4136.122600000016,3946.6915000000936,13529737.926026994,-602000165.0,-922058416.0,-296562791.0,-1535357888.0416667,44022.0,30708.0,11351.388399999183,11227.339999998978,10711.629399997291,22889.936200009703,22811.788100009668,22197.277000008227,67478.10187157492,158064.89756312946,,35007.698300027936,34947.92910002837,34393.59230002878,22959.44319999591,22932.567199995487,22579.33129999572,3714773.0,8296.574500000164,8401.105800000076,8124.69810000023,9819.116400000716,9934.088700002165,10293.825199999645,16470.043799999756,16655.30419999969,16252.120799999702,828.7633000001763,813.938300000046,759.8607000000133,3914.120800000124,3897.290100000163,3729.86890000016,436519.0,431313.0,,6426.034582002899,632056.0,625607.0,,16334.3148999998,154202.34509999058,154205.09019999017,154096.8442999871,77626.51039999627,77964.37340000659,78365.79420000655,,,,,,,,,,,,,,,,,,,,,,,,,,,181596664.43999988,2581394393.5200024,2911802751.090001,41938566.92999999,2581428143.5200024,186641.0,-12842546.0,2977478490.5,129968901.5,666726280.5,295691973.5,695070676.0,186817.0,2913.5,525.4225251240922,4415795.0,1533222.0,941091.0,-3073798.0,969378.0,99424.0,2044132874.1900291,2061215098.830016,-124908088.5,-123888614.5,2235472.5,101457.5,,,,,,,,,,,,,,,,,,,,,1467662.0,14789856.0,3233262.0,8556379.0,11609595.0,1415931.0,,,,,,,,,,,,,,,,,,,,,,,,,,,,,,,,,,4273706.0,2479691.0,-9004950.0,921269.0,37582.5,3734079972.119961,3658802737.994961,-260668200.0,-257356660.5,2526935.0,269238.5,3926785754.587456,33258727575.85592,36688077830.115135,1729647013.2750494,48092061231.92322,3988642.0,-247626060.0,103103195566.0,1054497615.0,17276563426.0,3504217327.5,18890219282.0,3672661.0,71933.5,20873.22545548721,89799181.0,-86.08520689353512,2.38,5.3975503425368485,169.03944648092795,12.8461698152377,402.3138826246086,117000.0,-0.2225209339563143,0.9749279121818236,0.0,0.0,0.0,0.0,0.0,0.0,1.0,0.0,1.0,0.0,0.0,0.0,0.0,0.0,0.0,0.0,0.0,0.0,1.0,0.0,0.0,0.0,1.0,0.0,0.0,1.0,0.0,0.0,0.0,0.0,0.0,0.0,0.0,0.0,0.0,0.0,0.0,0.0,0.0,0.0,0.0,0.0,0.0,0.0,0.0,0.0,1.0,0.0,0.0,0.0,0.0,0.0,0.0,0.0,0.0,0.0,0.0,0.0,0.0,0.0,0.0,0.0,0.0,0.0,0.0,0.0,0.0,0.0,0.0,0.0,0.0,0.0,0.0,0.0,0.0,0.0,0.0,0.0,0.0,0.0,0.0,0.0,0.0,0.0,0.0,0.0,0.0,0.0,0.0,0.0,0.0,0.0,0.0,0.0,0.0,0.0,0.0,0.0,0.0,0.0,0.0,0.0,0.0,1.0,0.0,0.0,0.0,0.0,1.0,0.0,1.0,0.0,0.0,0.0,0.0,0.0,0.0,0.0,1.0,0.0
103097,0,0.0,0.0,1.0,0.0,1.0,90000.0,585000.0,41733.0,585000.0,0.028663,29.32876712328768,-3671.0,-4485.0,-2212.0,9.0,3.0,2.0,2.0,13.0,0.3093358049510504,0.02179977594918,0.3876253444214701,,,,,,,,,,,,,,,,,,,,,,,,,,,,,,,,,,,,,,,,,,,,,0.0,0.0,0.0,0.0,-1300.0,0.0,0.0,0.0,0.0,0.0,3.0,1.0,1.0,0.0,1.0,0.0,0.0,0.0,0.0,0.0,0.0,0.0,0.0,0.0,1.0,0.0,0.0,0.0,0.0,0.0,0.0,0.0,0.0,0.0,0.0,0.0,0.0,0.0,0.0,0.0,0.0,0.0,0.0,7.0,27301.5,0.0,90000.0,88044.75,0.0,0.0,0.0,0.0,-665.0,-105.5,-156.0,-604.0,177.0,-15.0,3.0,20390.49,188712.0,182358.0,18435.375,188712.0,10.0,-1300.0,365243.0,-1269.0,-1149.0,-1119.0,-1144.0,9.0,0.0,0.1651790151432745,133.0,37.0,18.0,5.0,-22.0,0.0,0.0,33.0,35201.025,35201.025,-615.0,-603.0,6.0,1.0,0.0,,,,,,,,,,,,,,,,,,,,,8347985415.0,184418713404.0,165602312064.0,51979180807.935,1863.0,1705.0,71125.0,70834.0,9140.0,506136.0,,,,,,,128440.0,662927.0,,,,13529767.254794115,-602003836.0,-922060628.0,-296564091.0,-1535362373.0416667,44022.0,30708.0,,,,,,,67478.41120737988,158064.91936290538,126126.96142417948,,,,,,,3714786.0,,,,,,,,,,,,,,,,436519.0,431313.0,1263358.0,6426.063245002899,632058.0,625609.0,,,,,,,,,22.0,48232935.85499997,20774363.04000001,5170625736.525006,1712402967.1500006,56523153.68999996,709847.0099999999,94.0,12039.0,-16601141.0,7494902.5,-8573639.0,-9322091.0,-10.5,64489.5,0.0,90000.0,105655.5,0.0,0.0,0.0,0.0,-1451.0,-414.0,-411.0,-1525.0,181666447.4249999,2582059729.7700024,2912473066.590001,41966001.17999999,2582059729.7700024,186674.0,-12847806.0,2978756841.0,129965038.0,666723182.0,295688995.0,695067596.0,186861.0,2915.0,525.7018114687854,4415927.0,1533648.0,941309.0,-3074981.0,969378.0,99424.0,2044984746.915032,2062066971.5550172,-124940598.0,-123920724.0,2235681.0,101488.0,,,,,,,,,,,,,,,,,,,,,1467669.0,14790033.0,3233262.0,8556416.0,11609628.0,1415934.0,1059024090.8520012,801714498.142495,72116454695.37712,21677273772.907616,582516033.7994988,5792665.7475,689.5,94245.0,-276973072.5,21970335.5,-123809319.0,-218742836.0,-2019470.5,,,,,,,,,,,,,,,,,,,,,4273724.0,2479696.0,-9004972.0,921269.0,37582.5,3734115173.144962,3658837939.019961,-260668815.0,-257357263.5,2526941.0,269239.5,3926806145.077457,33258916287.85592,36688260188.115135,1729665448.6500494,48092249943.92322,3988652.0,-247627360.0,103103560809.0,1054496346.0,17276562277.0,3504216208.5,18890218138.0,3672670.0,71933.5,20873.39063450236,89799314.0,-125.16721158337224,6.5,2.1565667457407813,63.2494438716577,14.017683847315077,411.121385165775,30000.0,-0.2225209339563143,0.9749279121818236,0.0,1.0,0.0,0.0,0.0,0.0,0.0,0.0,0.0,0.0,0.0,0.0,0.0,1.0,0.0,0.0,1.0,0.0,0.0,0.0,1.0,0.0,0.0,0.0,0.0,1.0,0.0,0.0,0.0,0.0,0.0,0.0,0.0,0.0,0.0,0.0,0.0,0.0,1.0,0.0,0.0,0.0,0.0,0.0,0.0,0.0,0.0,0.0,0.0,0.0,0.0,0.0,0.0,0.0,0.0,0.0,0.0,0.0,0.0,0.0,0.0,0.0,0.0,0.0,0.0,0.0,0.0,0.0,0.0,0.0,0.0,0.0,0.0,0.0,1.0,0.0,0.0,0.0,0.0,0.0,0.0,0.0,0.0,0.0,0.0,0.0,0.0,0.0,0.0,0.0,0.0,0.0,0.0,0.0,0.0,0.0,0.0,0.0,0.0,0.0,0.0,0.0,0.0,0.0,0.0,0.0,0.0,0.0,0.0,0.0,0.0,0.0,0.0,0.0,0.0,0.0,0.0,0.0,0.0,0.0
103102,1,0.0,1.0,0.0,1.0,0.0,112500.0,1079581.5,55251.0,886500.0,0.020713,31.85205479452055,-875.0,-882.0,-2917.0,,2.0,3.0,3.0,6.0,,0.4611560177000933,,,,,,,,,,,,,,,,,,,,,,,,,,,,,,,,,,,,,,,,,,,,,,2.0,0.0,2.0,0.0,-489.0,,,,,,,1.0,1.0,1.0,1.0,0.0,0.0,0.0,0.0,0.0,0.0,0.0,0.0,0.0,1.0,0.0,0.0,0.0,0.0,0.0,0.0,0.0,0.0,0.0,0.0,0.0,0.0,0.0,0.0,0.0,0.0,0.0,0.0,0.0,,,,,,,,,,,,,0.0,,1.0,4748.49,58095.0,67297.5,0.0,58095.0,18.0,-489.0,365243.0,-459.0,365243.0,51.0,365243.0,11.0,1.0,0.0,23.0,16.0,18.0,10.5,-8.5,0.0,0.0,16.0,4748.49,4748.49,-241.0,-234.0,8.5,1.0,0.0,,,,,,,,,,,,,,,,,,,,,8348040666.0,184419792985.5,165603198564.0,51979293307.935,,,,,,,,,,,,,128440.0,662929.0,,,,13529799.106848912,-602004711.0,-922063545.0,-296564580.0,-1535363255.0416667,44022.0,30708.0,,,,,,,,158065.38051892308,,,,,,,,3714792.0,,,,,,,,,,,,,,,,436521.0,431315.0,,6426.083958002899,632061.0,625612.0,,,,,,,,,,,,,,,,,,,,,,,,,,,,,,,,,,,181955085.075,2585682985.7700024,2916315598.590001,42000790.67999999,2585682985.7700024,186898.0,-12862074.0,2983870243.0,129954551.0,668176424.0,295683368.0,696521022.0,187145.0,2917.0,526.1879534280333,4417855.0,1535271.0,942369.0,-3078108.0,969378.0,99424.0,2047295665.93503,2065245322.9500165,-125018388.5,-123997506.5,2236196.5,101633.5,,,,,,,,,,,,,,,,,,,,,1467669.0,14790033.0,3233262.0,8556432.0,11609644.0,1415935.0,,,,,,,,,,,,,,,,,,,,,,,,,,,,,,,,,,4273742.0,2479706.5,-9004980.5,921269.0,37582.5,3734119921.634961,3658842687.509961,-260669056.0,-257357497.5,2526949.5,269240.5,3926810893.567456,33258974382.85592,36688327485.615135,1729665448.6500494,48092308038.92322,3988670.0,-247627849.0,103103926052.0,1054495887.0,17276927520.0,3504216259.5,18890583381.0,3672681.0,71934.5,20873.39063450236,89799337.0,-27.470755203853432,9.59628,2.0361622414073954,64.85595128384213,19.53958299397296,622.3758681861086,56250.0,0.6234898018587336,0.7818314824680298,0.0,1.0,0.0,0.0,0.0,0.0,0.0,0.0,0.0,0.0,0.0,0.0,0.0,1.0,0.0,0.0,0.0,0.0,1.0,0.0,1.0,0.0,0.0,0.0,0.0,1.0,0.0,0.0,0.0,0.0,0.0,0.0,0.0,0.0,1.0,0.0,0.0,0.0,0.0,0.0,0.0,0.0,0.0,0.0,0.0,0.0,0.0,0.0,0.0,0.0,0.0,0.0,0.0,0.0,0.0,0.0,0.0,0.0,0.0,0.0,0.0,0.0,0.0,0.0,0.0,0.0,0.0,0.0,0.0,0.0,0.0,0.0,0.0,0.0,1.0,0.0,0.0,0.0,0.0,0.0,0.0,0.0,0.0,0.0,0.0,0.0,0.0,0.0,0.0,0.0,0.0,0.0,0.0,0.0,0.0,0.0,0.0,0.0,0.0,0.0,0.0,0.0,0.0,0.0,0.0,0.0,0.0,0.0,0.0,0.0,0.0,0.0,0.0,0.0,0.0,0.0,0.0,0.0,0.0,0.0
103112,0,0.0,1.0,1.0,0.0,0.0,270000.0,675000.0,45108.0,675000.0,0.072508,25.383561643835613,-92.0,-9238.0,-1928.0,2.0,1.0,1.0,1.0,10.0,0.3320360226306959,0.3678541056467873,0.5549467685334323,0.2392,0.3822,0.9732,0.6328,0.3503,0.44,0.3793,0.25,0.2917,0.1958,0.1874,0.3169,0.0347,0.4072,0.2437,0.3967,0.9732,0.6472,0.3535,0.4431,0.3793,0.25,0.2917,0.2003,0.2048,0.3301,0.035,0.431,0.2415,0.3822,0.9732,0.6377,0.3525,0.44,0.3793,0.25,0.2917,0.1992,0.1907,0.3226,0.0349,0.4157,0.3378,1.0,0.0,0.0,0.0,0.0,0.0,0.0,0.0,0.0,0.0,1.0,0.0,1.0,1.0,0.0,1.0,1.0,1.0,0.0,0.0,0.0,0.0,0.0,0.0,0.0,0.0,0.0,0.0,0.0,0.0,1.0,0.0,0.0,0.0,0.0,0.0,0.0,0.0,0.0,0.0,0.0,0.0,0.0,0.0,2.0,70965.0,33216.75,677943.72,0.0,0.0,0.0,0.0,0.0,-668.0,-271.0,-328.5,-630.0,45.0,-11.0,2.0,13992.9525,99380.25,80511.75,19890.0,99380.25,7.0,-847.5,365243.0,-810.5,-645.5,-630.5,-641.5,13.5,0.0,0.2138941678007705,59.5,15.0,6.0,4.0,-41.0,0.0,0.0,13.0,19545.075,19545.075,-235.0,-219.0,4.0,1.0,0.0,,,,,,,,,,,,,,,,,,,,,8348085774.0,184420467985.5,165603873564.0,51979563307.935,1863.0,1705.0,71125.0,70835.0,9140.0,506136.0,17810.851200002293,17873.028099999105,17324.458999998038,11297.93820000009,11235.709700000092,11183.06670000006,128440.0,662930.0,4138.807800000118,4136.475100000016,3947.045000000093,13529824.490410555,-602004803.0,-922065473.0,-296564580.0,-1535372493.0416667,44022.0,30708.0,11351.828399999184,11227.779999998977,10712.072499997292,22890.315500009707,22812.16740000967,22197.656300008228,67478.74324340251,158065.7483730287,126127.516370948,35007.948300027936,34948.17910002837,34393.84230002878,22959.734899995907,22932.858899995488,22579.62299999572,3714802.0,8296.770300000164,8401.305000000075,8124.898400000229,9819.303800000716,9934.279400002162,10294.029999999644,16470.360699999757,16655.62679999969,16252.450899999702,828.7980000001762,813.973200000046,759.8957000000132,3914.528000000125,3897.705800000163,3730.29990000016,436521.0,431315.0,1263360.0,6426.156466002899,632062.0,625613.0,,16334.6526999998,154203.31829999055,154206.06339999015,154097.8174999871,77627.14319999628,77965.0111000066,78366.44140000656,22.5,48490490.29499997,20872844.86500002,5187893064.525004,1719999575.4150002,56540529.62999996,709847.0099999999,94.0,12039.0,-16644780.0,7523650.0,-8592268.0,-9339676.0,-10.75,70965.0,0.0,95887.44,0.0,0.0,0.0,0.0,0.0,-694.0,-630.0,-624.0,-630.0,182486174.625,2592162164.1600018,2924782965.090001,42239355.56999999,2592162164.1600018,187434.0,-12904792.0,2993913534.5,130653260.0,670342804.0,296759105.0,698322247.5,187644.5,2930.0,529.7707062437166,4419707.0,1539453.0,945068.0,-3088735.0,969381.0,99424.0,2052500831.2350304,2070912805.7850163,-125325697.0,-124301630.0,2238262.0,101922.0,,,,,,,,,,,,,,,,,,,,,1467671.0,14790078.0,3233262.0,8556447.0,11609657.0,1415937.0,1059095055.8520012,801747714.892495,72117132639.09712,21677273772.907616,582516033.7994988,5792665.7475,689.5,94245.0,-276973740.5,21970064.5,-123809647.5,-218743466.0,-2019481.5,,,,,,,,,,,,,,,,,,,,,4273748.0,2479710.5,-9005021.5,921269.0,37582.5,3734139466.709961,3658862232.584961,-260669291.0,-257357716.5,2526953.5,269241.5,3926824886.519956,33259073763.10592,36688407997.365135,1729685338.6500494,48092407419.17322,3988677.0,-247628696.5,103104291295.0,1054495076.5,17276926874.5,3504215629.0,18890582739.5,3672694.5,71934.5,20873.604528670163,89799396.5,-3.624392876416622,2.5,5.985634477254589,151.93672173085963,14.964086193136472,379.84180432714913,270000.0,1.0,0.0,0.0,0.0,0.0,0.0,0.0,0.0,1.0,0.0,0.0,0.0,0.0,0.0,0.0,1.0,0.0,0.0,0.0,0.0,1.0,0.0,0.0,0.0,1.0,0.0,0.0,1.0,0.0,0.0,0.0,0.0,0.0,0.0,0.0,0.0,0.0,0.0,0.0,0.0,0.0,0.0,0.0,0.0,0.0,0.0,0.0,0.0,0.0,0.0,0.0,0.0,0.0,0.0,0.0,1.0,0.0,0.0,0.0,0.0,0.0,0.0,0.0,0.0,0.0,0.0,0.0,0.0,0.0,0.0,0.0,0.0,0.0,0.0,0.0,0.0,0.0,0.0,0.0,0.0,0.0,0.0,0.0,0.0,0.0,0.0,0.0,0.0,0.0,0.0,0.0,0.0,0.0,0.0,0.0,0.0,0.0,0.0,0.0,0.0,0.0,0.0,0.0,0.0,0.0,0.0,0.0,0.0,0.0,0.0,1.0,0.0,1.0,0.0,0.0,0.0,0.0,0.0,0.0,0.0,1.0,0.0
103132,0,0.0,0.0,0.0,1.0,0.0,112500.0,634662.0,24057.0,472500.0,0.010966,64.12328767123286,,-2087.0,-4528.0,,2.0,2.0,2.0,11.0,,0.5225648244418105,0.4902575124990026,0.1031,0.1064,0.9831,,0.0089,0.0,0.2069,0.1667,0.2083,0.0732,0.0841,0.0933,0.0,0.0,0.105,0.1104,0.9831,,0.009,0.0,0.2069,0.1667,0.2083,0.0749,0.0918,0.0973,0.0,0.0,0.1041,0.1064,0.9831,,0.0089,0.0,0.2069,0.1667,0.2083,0.0745,0.0855,0.095,0.0,0.0,0.0734,1.0,0.0,0.0,0.0,0.0,0.0,0.0,0.0,0.0,0.0,0.0,0.0,1.0,0.0,0.0,1.0,0.0,0.0,0.0,0.0,0.0,0.0,0.0,0.0,0.0,0.0,0.0,0.0,1.0,0.0,0.0,0.0,0.0,0.0,0.0,0.0,0.0,0.0,0.0,0.0,0.0,0.0,0.0,0.0,8.0,19710.0,0.0,171294.75,0.0,0.0,0.0,0.0,0.0,-747.5,-200.0,-542.5,-701.0,195.0,-12.0,5.0,14876.955,103500.0,106915.5,3375.0,103500.0,6.0,-1156.0,365243.0,-1126.0,-1126.0,-796.0,-1122.0,10.0,1.0,0.091479245359859,-1.0,32.0,6.0,4.5,-36.5,0.0,0.0,28.0,21092.31,21092.31,-1094.5,-1071.0,3.5,1.0,0.0,,,,,,,,,,,,,,,,,,,,,8348109831.0,184421102647.5,165604346064.0,51979675807.935,1863.0,1705.0,71125.0,70835.0,9140.0,506136.0,17810.954300002293,17873.132199999105,17324.56399999804,11298.04460000009,11235.816100000093,11183.177100000055,128440.0,662932.0,4138.816700000118,4136.484000000016,3947.054000000093,13529888.613698227,,-922070001.0,-296564580.0,-1535374580.0416667,44022.0,30708.0,11351.828399999184,11227.779999998977,10712.072499997292,22890.522400009708,22812.37430000967,22197.863200008236,,158066.27093785314,126128.00662846051,35008.11500002794,34948.34580002837,34394.00900002878,22959.94319999591,22933.067199995487,22579.83129999572,3714813.0,8296.843500000165,8401.379500000074,8124.97330000023,9819.387900000716,9934.36490000216,10294.121799999644,16470.453999999758,16655.72179999969,16252.5481999997,828.7980000001762,813.973200000046,759.8957000000132,3914.528000000125,3897.705800000163,3730.29990000016,436521.0,431315.0,,6426.167432002899,632064.0,625615.0,,16334.726099999798,154204.3013999906,154207.04649999016,154098.80059998712,,,,25.0,50051585.29499997,20887329.60000002,5222195754.300005,1728444690.3150003,57095873.81999996,709847.0099999999,95.0,12039.0,-16729139.0,7585994.0,-8631762.5,-9382648.0,-12.0,19710.0,0.0,225000.0,0.0,0.0,0.0,0.0,0.0,-832.0,-291.0,-729.0,-729.0,183419473.41,2604298610.1600018,2938265977.590001,42342473.06999999,2604298610.1600018,188353.0,-12964040.0,3010164052.0,131702359.0,674324977.0,298558861.0,702671865.0,188635.0,2946.0,530.9756105525992,4432541.0,1546534.0,949445.5,-3103554.5,969449.0,99492.0,2060653727.0025327,2078757558.630021,-126068247.5,-125038596.0,2254110.5,102479.5,,,,,,,,,,,,,,,,,,,,,1467679.0,14790273.0,3233262.0,8556479.0,11609685.0,1415942.0,1059114765.8520012,801747714.892495,72117303933.84712,21677273772.907616,582516033.7994988,5792665.7475,689.5,94245.0,-276974488.0,21969864.5,-123810190.0,-218744167.0,-2019493.5,,,,,,,,,,,,,,,,,,,,,4273754.0,2479715.0,-9005058.0,921269.0,37582.5,3734160559.019961,3658883324.89496,-260670385.5,-257358787.5,2526957.0,269242.5,3926839763.474956,33259177263.10592,36688514912.865135,1729688713.6500494,48092510919.17322,3988683.0,-247629852.5,103104656538.0,1054493950.5,17276925748.5,3504214833.0,18890581617.5,3672704.5,71935.5,20873.696007915514,89799395.5,,5.64144,4.676393565282454,299.8657298505091,26.38159371492705,1691.6745230078564,56250.0,0.6234898018587336,0.7818314824680298,0.0,0.0,0.0,0.0,0.0,0.0,1.0,0.0,0.0,1.0,0.0,0.0,0.0,0.0,0.0,0.0,0.0,0.0,1.0,0.0,1.0,0.0,0.0,0.0,0.0,1.0,0.0,0.0,0.0,0.0,0.0,0.0,0.0,0.0,0.0,0.0,0.0,0.0,0.0,0.0,0.0,0.0,0.0,0.0,0.0,0.0,0.0,0.0,0.0,0.0,0.0,0.0,0.0,0.0,0.0,0.0,0.0,0.0,0.0,0.0,0.0,0.0,0.0,0.0,0.0,0.0,0.0,0.0,0.0,0.0,0.0,0.0,0.0,0.0,0.0,0.0,0.0,0.0,0.0,0.0,0.0,0.0,0.0,0.0,0.0,0.0,0.0,0.0,0.0,0.0,0.0,0.0,0.0,0.0,0.0,0.0,0.0,0.0,0.0,0.0,0.0,0.0,0.0,0.0,0.0,1.0,0.0,0.0,0.0,1.0,1.0,0.0,0.0,0.0,0.0,0.0,0.0,1.0,0.0,0.0
103144,0,0.0,0.0,0.0,1.0,0.0,112500.0,643500.0,50971.5,643500.0,0.028663,22.63835616438357,-819.0,-3143.0,-442.0,,2.0,2.0,2.0,8.0,,0.5760048906613269,0.5226973172821112,0.0041,,0.9762,,,,0.0345,0.0417,,,,,,,0.0042,,0.9762,,,,0.0345,0.0417,,,,,,,0.0042,,0.9762,,,,0.0345,0.0417,,,,,,,0.0025,1.0,0.0,0.0,0.0,0.0,-678.0,0.0,0.0,0.0,0.0,0.0,0.0,1.0,1.0,0.0,1.0,0.0,0.0,0.0,0.0,0.0,0.0,0.0,0.0,0.0,1.0,0.0,0.0,0.0,0.0,0.0,0.0,0.0,0.0,0.0,0.0,0.0,0.0,0.0,0.0,0.0,0.0,0.0,0.0,4.0,18130.5,,82077.75,0.0,,0.0,0.0,0.0,-305.0,-128.0,-183.5,-189.0,44.0,-5.0,2.0,41086.98,396000.0,396000.0,0.0,396000.0,14.0,-578.5,365243.0,-546.5,182344.0,-156.5,182346.0,14.5,0.0,0.0,20.0,20.0,24.0,14.5,-10.5,0.0,0.0,20.0,30757.23,30691.98,-324.5,-313.0,5.5,1.0,0.0,,,,,,,,,,,,,,,,,,,,,8348160802.5,184421746147.5,165604989564.0,51979788307.935,1863.0,1705.0,71125.0,70835.0,9140.0,506136.0,17810.95840000229,17873.136399999104,17324.56819999804,,,,128440.0,662934.0,,,,13529911.252054391,-602005622.0,-922070443.0,-296565258.0,-1535377723.0416667,44022.0,30708.0,,,,22890.556900009706,22812.408800009667,22197.897700008238,,158066.84694274384,126128.5293257778,35008.15670002794,34948.387500028366,34394.050700028776,,,,3714821.0,,,,,,,,,,,,,,,,436521.0,431315.0,,6426.196095002899,632066.0,625617.0,,16334.728599999797,154205.2775999906,154208.02269999016,154099.77679998713,,,,10.5,50069715.79499997,,5238073690.965004,1734237121.8150003,,709847.0099999999,95.0,12039.0,-16797813.0,7649484.0,-8667693.0,-9418357.5,-4.75,18130.5,,62950.5,0.0,,0.0,0.0,0.0,-312.0,-128.0,-189.0,-189.0,184527744.39,2619012749.940002,2953606833.2700005,42541997.66999999,2619012749.940002,189155.0,-13037225.5,3024588044.5,131657721.0,677397727.5,299627690.0,706110675.5,189638.5,2957.0,533.5928431475572,4445217.0,1555815.0,953652.0,-3123223.0,1176256.0,99632.0,2074324019.2650423,2092408648.4700289,-126860875.5,-125825536.0,2269970.0,102989.5,,,,,,,,,,,,,,,,,,,,,1467683.0,14790317.0,3233262.0,8556499.0,11609705.0,1415944.0,1059132896.3520012,,72117386011.59712,21677273772.907616,,5792665.7475,689.5,94245.0,-276974793.0,21969736.5,-123810373.5,-218744356.0,-2019498.5,,,,,,,,,,,,,,,,,,,,,4273778.0,2479729.5,-9005068.5,921269.0,37582.5,3734191316.249961,3658914016.87496,-260670710.0,-257359100.5,2526962.5,269243.5,3926880850.454956,33259573263.10592,36688910912.865135,1729688713.6500494,48092906919.17322,3988697.0,-247630431.0,103105021781.0,1054493404.0,17277108092.5,3504214676.5,18890763963.5,3672719.0,71935.5,20873.696007915514,89799415.5,-36.1775384243011,5.72,2.2071157411494657,49.965472244159,12.624702039374943,285.80250123658953,56250.0,-0.9009688679024191,-0.433883739117558,0.0,0.0,0.0,0.0,0.0,0.0,1.0,0.0,0.0,0.0,0.0,0.0,0.0,1.0,0.0,0.0,0.0,0.0,1.0,0.0,1.0,0.0,0.0,0.0,0.0,1.0,0.0,0.0,0.0,0.0,0.0,0.0,0.0,0.0,0.0,0.0,0.0,0.0,0.0,0.0,0.0,0.0,0.0,0.0,1.0,0.0,0.0,0.0,0.0,0.0,0.0,0.0,0.0,1.0,0.0,0.0,0.0,0.0,0.0,0.0,0.0,0.0,0.0,0.0,0.0,0.0,0.0,0.0,0.0,0.0,0.0,0.0,0.0,0.0,0.0,0.0,0.0,0.0,0.0,0.0,0.0,0.0,0.0,0.0,0.0,0.0,0.0,0.0,0.0,0.0,0.0,0.0,0.0,0.0,0.0,0.0,0.0,0.0,0.0,0.0,0.0,0.0,0.0,0.0,0.0,0.0,0.0,0.0,0.0,0.0,1.0,0.0,0.0,0.0,0.0,0.0,0.0,0.0,1.0,0.0
103145,0,0.0,0.0,0.0,0.0,1.0,54000.0,315000.0,25015.5,315000.0,0.019101,26.5972602739726,-92.0,-4521.0,-242.0,,3.0,2.0,2.0,13.0,0.3669723780458906,0.4917858785382714,,,,,,,,,,,,,,,,,,,,,,,,,,,,,,,,,,,,,,,,,,,,,,1.0,0.0,1.0,0.0,-259.0,,,,,,,1.0,1.0,1.0,1.0,0.0,0.0,0.0,0.0,0.0,0.0,0.0,0.0,0.0,1.0,0.0,0.0,0.0,0.0,0.0,0.0,0.0,0.0,0.0,0.0,0.0,0.0,0.0,0.0,0.0,0.0,0.0,0.0,0.0,,,,,,,,,,,,,0.0,,2.0,9146.34,17300.25,16391.25,3460.5,34600.5,4.0,-302.0,365243.0,-314.0,-224.0,-224.0,-218.0,14.0,0.0,0.1039869517123055,1.0,5.0,4.0,2.0,-10.0,0.0,0.0,4.0,9146.34,9146.34,-272.0,-269.0,2.5,1.0,0.0,,,,,,,,,,,,,,,,,,,,,8348185818.0,184422061147.5,165605304564.0,51979842307.935,,,,,,,,,,,,,128441.0,662937.0,,,,13529937.849314664,-602005714.0,-922070685.0,-296565517.0,-1535382244.0416667,44022.0,30708.0,,,,,,,67479.11021578057,158067.3387286224,,,,,,,,3714834.0,,,,,,,,,,,,,,,,436522.0,431316.0,,6426.2151960029,632068.0,625619.0,,,,,,,,,,,,,,,,,,,,,,,,,,,,,,,,,,,184552236.72,2619327050.190002,2953920224.5200005,42545458.16999999,2619344350.440002,189171.0,-13037896.5,3025135909.0,131657183.0,677580125.0,299627587.0,706293079.0,189665.5,2957.0,533.6968300992695,4445227.5,1556055.0,953816.0,-3123326.0,1176256.0,99632.0,2074638980.880043,2092723610.085029,-126864162.5,-125828522.0,2270050.5,103005.5,,,,,,,,,,,,,,,,,,,,,1467683.0,14790317.0,3233262.0,8556504.0,11609709.0,1415946.0,,,,,,,,,,,,,,,,,,,,,,,,,,,,,,,,,,4273782.0,2479731.5,-9005078.5,921269.0,37582.5,3734200462.589961,3658923163.214961,-260670982.0,-257359369.5,2526965.0,269244.5,3926889996.794956,33259590563.35592,36688927304.115135,1729692174.1500494,48092941519.67322,3988701.0,-247630733.0,103105387024.0,1054493090.0,17277107868.5,3504214452.5,18890763745.5,3672733.0,71935.5,20873.799994867222,89799416.5,-3.4590028842192013,5.833333333333332,2.1586616297895307,57.41448521095003,12.592192840438928,334.91783039720855,18000.0,1.0,0.0,0.0,0.0,0.0,0.0,0.0,0.0,1.0,0.0,0.0,0.0,1.0,0.0,0.0,0.0,0.0,1.0,0.0,0.0,0.0,0.0,1.0,0.0,0.0,0.0,0.0,1.0,0.0,0.0,0.0,0.0,0.0,0.0,0.0,1.0,0.0,0.0,0.0,0.0,0.0,0.0,0.0,0.0,0.0,0.0,0.0,0.0,0.0,0.0,0.0,0.0,0.0,0.0,0.0,0.0,0.0,0.0,0.0,0.0,0.0,0.0,0.0,0.0,0.0,0.0,0.0,0.0,0.0,0.0,0.0,0.0,0.0,0.0,0.0,0.0,0.0,0.0,0.0,0.0,0.0,0.0,0.0,1.0,0.0,0.0,0.0,0.0,0.0,0.0,0.0,0.0,0.0,0.0,0.0,0.0,0.0,0.0,0.0,0.0,0.0,0.0,0.0,0.0,0.0,0.0,0.0,0.0,0.0,0.0,0.0,0.0,0.0,0.0,0.0,0.0,0.0,0.0,0.0,0.0,0.0,0.0
103146,0,0.0,0.0,0.0,1.0,2.0,180000.0,156384.0,16551.0,135000.0,0.022625,30.68493150684932,-2937.0,-5522.0,-3855.0,,4.0,2.0,2.0,16.0,0.6750099386656958,0.5985112606714299,0.6430255641096323,0.0124,,0.9786,,,,0.0517,0.1042,,,,0.0121,,,0.0084,,0.9702,,,,0.0345,0.0417,,,,0.0079,,,0.0125,,0.9786,,,,0.0517,0.1042,,,,0.0123,,,0.0166,1.0,1.0,0.0,1.0,0.0,-356.0,0.0,0.0,0.0,0.0,1.0,3.0,1.0,1.0,1.0,1.0,1.0,0.0,0.0,0.0,0.0,0.0,0.0,0.0,0.0,1.0,0.0,0.0,0.0,0.0,0.0,0.0,0.0,0.0,0.0,0.0,0.0,0.0,0.0,0.0,0.0,0.0,0.0,0.0,6.0,0.0,0.0,87313.5,0.0,0.0,0.0,0.0,0.0,-2202.0,-1492.0,-1019.0,-1492.0,413.0,-34.0,5.0,9313.38,68310.0,75523.5,0.0,121273.02,10.0,-356.0,365243.0,-55.0,365243.0,215.0,365243.0,10.0,0.0,0.0,67.0,19.0,12.0,5.0,-17.0,0.0,0.0,16.0,9313.38,9313.38,-490.5,-490.0,5.5,1.0,11.0,0.0,180000.0,,0.0,,,0.0,,0.0,0.0,0.0,0.0,,0.0,,,0.0,-7.0,0.0,0.0,8348202369.0,184422217531.5,165605439564.0,51980022307.935,1863.0,1705.0,71125.0,70836.0,9140.0,506139.0,17810.97080000229,17873.148899999105,17324.57659999804,,,,128443.0,662941.0,,,,13529968.534246173,-602008651.0,-922074540.0,-296565873.0,-1535387766.0416667,44022.0,30708.0,,,,22890.608600009706,22812.460500009667,22197.932200008232,67479.78522571923,158067.93723988306,126129.1723513419,35008.26090002794,34948.491700028375,34394.092400028785,,,,3714850.0,,,,,,,16470.466099999758,16655.73409999969,16252.5560999997,,,,,,,436523.0,431317.0,,6426.237821002898,632070.0,625621.0,,16334.7451999998,154206.2561999906,154209.00129999017,154100.74699998714,,,,73.0,50129669.29499997,20897981.10000002,5245191277.965004,1739162398.8150003,57905873.81999996,709847.0099999999,95.0,12039.0,-16804998.5,7649698.0,-8670961.5,-9424559.0,-36.0,0.0,0.0,82305.0,0.0,0.0,0.0,0.0,0.0,-2546.0,-2234.0,-1023.0,-1492.0,184570550.1,2619480970.440002,2954080449.2700005,42545458.16999999,2619570970.440002,189183.0,-13039797.0,3025866395.0,132021716.0,677945043.0,299992505.0,706658005.0,189710.0,2957.0,533.6968300992695,4445361.0,1556165.0,953855.0,-3123742.0,1176258.0,99634.0,2074726777.1850436,2092802093.0100293,-126871422.0,-125835731.5,2270102.0,103015.5,1991512394.6849816,5358280500.0,,261902749.9499996,,,113200542.62999968,,264364551.49500012,1911132983.5649948,1983847824.89998,1983922526.83498,,21682.0,,,652994.0,-1167938.0,502522.0,1170.0,1467689.0,14790730.0,3233273.0,8556523.0,11609725.0,1415951.0,1059132896.3520012,801747714.892495,72117473325.09712,21677273772.907616,582516033.7994988,5792665.7475,689.5,94245.0,-276976995.0,21968244.5,-123811392.5,-218745848.0,-2019532.5,5923310709.1724615,18724693500.0,,447980703.7049976,,,309140890.10999864,,459182482.1999993,5708441575.822533,5886589792.815,5886832975.559999,,80839.0,,,971659.0,-1698821.0,177364.0,6755.0,4273794.0,2479736.5,-9005095.5,921269.0,37582.5,3734209775.969961,3658932476.594961,-260671472.5,-257359859.5,2526970.5,269245.5,3926899310.174956,33259658873.35592,36689002827.615135,1729692174.1500494,48093062792.69322,3988711.0,-247631089.0,103105752267.0,1054493035.0,17277473111.5,3504214667.5,18891128988.5,3672743.0,71935.5,20873.799994867222,89799483.5,-95.71473214285712,0.8688,10.87547580206634,333.7132300908028,9.448613376835237,289.93005430288946,45000.0,0.6234898018587336,0.7818314824680298,0.0,0.0,0.0,0.0,0.0,0.0,1.0,0.0,1.0,0.0,0.0,0.0,0.0,0.0,0.0,0.0,0.0,0.0,1.0,0.0,1.0,0.0,0.0,0.0,0.0,1.0,0.0,0.0,0.0,0.0,0.0,0.0,0.0,0.0,0.0,0.0,1.0,0.0,0.0,0.0,0.0,0.0,0.0,0.0,0.0,0.0,0.0,0.0,0.0,0.0,0.0,0.0,0.0,0.0,0.0,0.0,0.0,0.0,1.0,0.0,0.0,0.0,0.0,0.0,0.0,0.0,0.0,0.0,0.0,0.0,0.0,0.0,0.0,0.0,0.0,0.0,0.0,0.0,0.0,0.0,0.0,0.0,0.0,0.0,0.0,0.0,0.0,0.0,0.0,0.0,0.0,0.0,0.0,0.0,0.0,0.0,0.0,0.0,0.0,0.0,0.0,0.0,0.0,0.0,0.0,0.0,0.0,0.0,0.0,0.0,1.0,0.0,0.0,0.0,0.0,0.0,0.0,0.0,0.0,0.0
103147,0,0.0,1.0,0.0,1.0,0.0,315000.0,969979.5,49657.5,796500.0,0.0038179999999999,34.24383561643835,-227.0,-452.0,-4597.0,,2.0,2.0,2.0,10.0,0.4920081619271217,0.4914907487471729,0.5442347412142162,0.0619,0.0496,0.9712,,,0.0,0.069,0.0833,,0.0139,,0.0278,,0.0,0.063,0.0515,0.9603,,,0.0,0.0,0.0,,0.0,,0.0021,,0.0,0.0625,0.0496,0.9712,,,0.0,0.069,0.0833,,0.0141,,0.0283,,0.0,0.0022,2.0,0.0,0.0,0.0,0.0,-263.0,0.0,0.0,0.0,0.0,0.0,4.0,1.0,1.0,0.0,1.0,1.0,0.0,0.0,0.0,0.0,0.0,0.0,0.0,0.0,1.0,0.0,0.0,0.0,0.0,0.0,0.0,0.0,0.0,0.0,0.0,0.0,0.0,0.0,0.0,0.0,0.0,0.0,0.0,6.0,16895.25,0.0,427500.0,0.0,0.0,0.0,0.0,0.0,-840.5,-230.0,-581.0,-942.0,179.0,-19.0,5.0,47645.4825,213952.5,223132.5,0.0,213952.5,6.0,-724.0,365243.0,-819.0,-669.0,-669.0,-667.0,10.0,0.0,0.0,36.0,15.0,6.0,3.0,-26.0,0.0,0.0,12.0,39148.605,39148.605,-785.0,-774.0,2.5,1.0,0.0,,,,,,,,,,,,,,,,,,,,,8348252026.5,184423187511.0,165606236064.0,51980337307.935,1863.0,1705.0,71125.0,70836.0,9140.0,506143.0,17811.03270000229,17873.211399999105,17324.639599998038,11298.09420000009,11235.865700000091,11183.228600000057,128443.0,662943.0,,,,13530002.77808179,-602008878.0,-922079137.0,-296566136.0,-1535388218.0416667,44022.0,30708.0,11351.828399999184,11227.779999998977,10712.072499997292,22890.67760000971,22812.529500009667,22197.932200008232,67480.27723388115,158068.4287306318,126129.71658608312,35008.34420002794,34948.575000028366,34394.092400028785,,,,3714860.0,8296.857400000163,8401.393600000076,8124.97330000023,,,,16470.493899999758,16655.76239999969,16252.5581999997,,,,3914.528000000125,3897.705800000163,3730.29990000016,436523.0,431317.0,,6426.2416390028975,632072.0,625623.0,,16334.7473999998,154207.2273999906,154209.97249999017,154101.70729998717,,,,28.0,50363565.79499997,20897981.10000002,5253136257.465004,1745073013.8150003,57905873.81999996,709847.0099999999,95.0,12039.0,-16813866.0,7647999.0,-8675834.5,-9428875.0,-13.5,0.0,0.0,405000.0,0.0,0.0,0.0,0.0,0.0,-1334.0,-786.0,-943.0,-1331.0,184726287.0675,2621185800.480002,2955864951.8100004,42545458.16999999,2621185800.480002,189226.0,-13041803.0,3026962124.0,132020352.0,678309102.0,299991656.0,707022075.0,189756.0,2957.0,533.6968300992695,4445831.0,1556313.0,953938.0,-3124041.0,1176258.0,99634.0,2075325343.717544,2093400659.5425296,-126878629.5,-125842824.5,2270162.5,103030.5,,,,,,,,,,,,,,,,,,,,,1467695.0,14790909.0,3233273.0,8556538.0,11609737.0,1415956.0,1059149791.6020012,801747714.892495,72117900825.09712,21677273772.907616,582516033.7994988,5792665.7475,689.5,94245.0,-276977835.5,21968014.5,-123811973.5,-218746790.0,-2019551.5,,,,,,,,,,,,,,,,,,,,,4273800.0,2479739.5,-9005121.5,921269.0,37582.5,3734248924.5749607,3658971625.1999607,-260672257.5,-257360633.5,2526973.0,269246.5,3926946955.657456,33259872825.85592,36689225960.115135,1729692174.1500494,48093276745.19322,3988717.0,-247631813.0,103106117510.0,1054492216.0,17277472442.5,3504213998.5,18891128321.5,3672753.0,71935.5,20873.799994867222,89799519.5,-6.628930314425155,3.0793,6.343452650657,217.22414980975844,19.533393747168105,668.8983245091893,157500.0,0.6234898018587336,0.7818314824680298,0.0,0.0,0.0,0.0,0.0,0.0,1.0,0.0,1.0,0.0,0.0,0.0,0.0,0.0,0.0,0.0,0.0,0.0,1.0,0.0,1.0,0.0,0.0,0.0,0.0,0.0,0.0,0.0,0.0,1.0,0.0,0.0,0.0,0.0,0.0,0.0,0.0,0.0,0.0,0.0,1.0,0.0,0.0,0.0,0.0,0.0,0.0,0.0,0.0,0.0,0.0,0.0,0.0,1.0,0.0,0.0,0.0,0.0,0.0,0.0,0.0,0.0,0.0,0.0,0.0,0.0,0.0,0.0,0.0,0.0,0.0,0.0,0.0,0.0,0.0,0.0,0.0,0.0,0.0,0.0,0.0,0.0,0.0,0.0,0.0,0.0,0.0,0.0,0.0,0.0,0.0,0.0,0.0,0.0,0.0,0.0,0.0,0.0,0.0,0.0,0.0,0.0,0.0,0.0,0.0,0.0,0.0,0.0,0.0,0.0,1.0,0.0,0.0,0.0,0.0,0.0,1.0,0.0,0.0,0.0
103158,0,0.0,0.0,0.0,1.0,0.0,135000.0,104256.0,10813.5,90000.0,0.005002,53.72876712328768,,-7072.0,-2746.0,,1.0,3.0,3.0,10.0,,0.7427856657619976,0.6363761710860439,0.0124,,0.9757,,,,0.069,0.0417,,,,0.0104,,0.0012,0.0126,,0.9757,,,,0.069,0.0417,,,,0.0108,,0.0012,0.0125,,0.9757,,,,0.069,0.0417,,,,0.0106,,0.0012,0.0084,1.0,7.0,0.0,7.0,0.0,-1571.0,0.0,0.0,0.0,0.0,0.0,2.0,1.0,0.0,0.0,1.0,0.0,0.0,0.0,0.0,0.0,0.0,0.0,0.0,0.0,1.0,0.0,0.0,0.0,0.0,0.0,0.0,0.0,0.0,0.0,0.0,0.0,0.0,0.0,0.0,0.0,0.0,0.0,0.0,9.0,8136.0,0.0,225000.0,89743.5,0.0,0.0,0.0,0.0,-1030.0,24.0,-27.0,-298.5,291.0,-17.0,5.0,11137.86,99891.0,99891.0,24664.5,117155.25,12.0,-762.0,365243.0,-732.0,-702.0,-402.0,-697.0,12.0,0.0,0.2083838734963893,4.0,51.0,12.0,12.0,-24.0,0.0,0.0,89.0,14790.96,14569.38,-443.0,-437.0,11.0,1.0,25.0,545826.195,540000.0,8550.0,6875.55,0.0,0.0,27548.865,28350.0,28350.0,531124.425,544534.02,544534.02,2.0,2.0,0.0,0.0,8.0,-13.0,0.0,0.0,8348262840.0,184423291767.0,165606326064.0,51980472307.935,1863.0,1705.0,71125.0,70836.0,9140.0,506145.0,17811.04510000229,17873.223899999106,17324.652199998036,,,,128443.0,662944.0,,,,13530056.506848913,,-922081883.0,-296567707.0,-1535395290.0416667,44022.0,30708.0,,,,22890.74660000971,22812.598500009663,22198.00120000823,,158069.17151629756,126130.3529622542,35008.38590002794,34948.616700028375,34394.13410002879,,,,3714870.0,,,,,,,16470.504299999757,16655.772999999692,16252.5689999997,,,,3914.529200000125,3897.707000000164,3730.30110000016,436530.0,431324.0,,6426.246641002898,632075.0,625626.0,,16334.7557999998,154208.2030999906,154210.94819999018,154102.68299998716,,,,34.0,50433009.79499997,20925037.44000002,5277254713.875005,1751408623.8900006,58355873.81999996,709847.0099999999,95.0,12039.0,-16895195.0,7675233.0,-8720990.0,-9468697.5,-16.5,6156.0,0.0,225000.0,142501.5,0.0,0.0,0.0,0.0,-1259.0,-16.0,-552.0,-569.0,185054983.155,2626041876.480002,2961449366.3100004,42686969.66999999,2626091821.980002,189553.0,-13063495.0,3031706867.0,132003733.0,680853486.0,301078217.0,709933544.0,190088.0,2961.0,535.1091401206975,4455657.0,1559105.0,955727.0,-3128151.0,1176345.0,99637.0,2078170110.3600447,2096422409.2500312,-127052013.0,-126018761.0,2273050.0,103193.0,1999338077.429988,5378035500.0,170124118.55999997,262623239.4599996,10044138.6,82202669.145,113607570.50999968,287035811.5500009,265077081.3600002,1918680101.099995,1991633868.5849853,1991708570.519986,8656.0,21879.0,134.0,13086.0,654636.0,-1171368.0,553038.0,1171.0,1467704.0,14791200.0,3233298.0,8556589.0,11609826.0,1415961.0,1059157927.6020012,801747714.892495,72118125825.09712,21677363516.407616,582516033.7994988,5792665.7475,689.5,94245.0,-276978865.5,21968038.5,-123812000.5,-218747088.5,-2019568.5,5923856535.367461,18725233500.0,198810057.825,447987579.2549976,1948107.735,256782765.80250075,309168438.97499865,636623135.9999981,459210832.1999993,5708972700.247533,5887134326.834999,5887377509.58,13384.5,80841.0,44.0,70351.5,971667.0,-1698834.0,177364.0,6755.0,4273812.0,2479751.5,-9005145.5,921269.0,37582.5,3734263715.5349607,3658986194.579961,-260672700.5,-257361070.5,2526984.0,269247.5,3926958093.517456,33259972716.85592,36689325851.115135,1729716838.6500494,48093393900.44322,3988729.0,-247632575.0,103106482753.0,1054491484.0,17277471740.5,3504213596.5,18891127624.5,3672765.0,71935.5,20874.008378740724,89799523.5,,0.7722666666666667,12.484394506866414,670.7711251346776,9.641281731169371,518.014180904007,135000.0,-0.9009688679024191,0.4338837391175582,0.0,0.0,0.0,0.0,0.0,0.0,1.0,0.0,0.0,1.0,0.0,0.0,0.0,0.0,0.0,0.0,0.0,0.0,1.0,0.0,0.0,1.0,0.0,0.0,0.0,0.0,1.0,0.0,0.0,0.0,0.0,0.0,0.0,0.0,0.0,0.0,0.0,0.0,0.0,0.0,0.0,0.0,0.0,0.0,0.0,0.0,0.0,0.0,0.0,0.0,0.0,0.0,0.0,0.0,0.0,0.0,0.0,0.0,0.0,0.0,0.0,0.0,0.0,0.0,0.0,0.0,0.0,0.0,0.0,0.0,0.0,0.0,0.0,0.0,0.0,0.0,0.0,0.0,0.0,0.0,0.0,0.0,0.0,0.0,0.0,0.0,0.0,0.0,0.0,0.0,0.0,0.0,0.0,0.0,0.0,0.0,0.0,0.0,0.0,0.0,0.0,0.0,0.0,0.0,0.0,1.0,0.0,0.0,0.0,0.0,1.0,0.0,0.0,0.0,0.0,0.0,0.0,0.0,0.0,1.0
103171,0,0.0,1.0,1.0,1.0,0.0,157500.0,291114.0,22657.5,243000.0,0.002042,30.16712328767123,-1908.0,-5186.0,-3468.0,14.0,2.0,3.0,3.0,10.0,,0.3990671239652089,0.7062051096536562,,,,,,,,,,,,,,,,,,,,,,,,,,,,,,,,,,,,,,,,,,,,,7.0,2.0,7.0,0.0,-1803.0,0.0,0.0,0.0,0.0,1.0,5.0,1.0,1.0,0.0,1.0,0.0,0.0,0.0,0.0,0.0,0.0,0.0,0.0,0.0,1.0,0.0,0.0,0.0,0.0,0.0,0.0,0.0,0.0,0.0,0.0,0.0,0.0,0.0,0.0,0.0,0.0,0.0,0.0,2.0,0.0,0.0,25729.425,0.0,0.0,0.0,0.0,0.0,-1124.0,-865.0,-960.0,-865.0,75.0,-18.0,11.0,22468.23,94950.0,93915.0,6070.5,160103.25,12.0,-843.0,365243.0,-974.5,-764.5,-734.5,-757.0,12.0,1.0,0.0999992087981643,-1.0,72.0,12.0,5.5,-31.0,0.0,0.0,68.0,28633.32,28357.335,-915.0,-899.5,5.0,1.0,0.0,,,,,,,,,,,,,,,,,,,,,8348285497.5,184423582881.0,165606569064.0,51980629807.935,1863.0,1705.0,71125.0,70837.0,9140.0,506150.0,,,,,,,128443.0,662946.0,,,,13530086.6739722,-602010786.0,-922085351.0,-296569510.0,-1535400476.0416667,44024.0,30708.0,,,,,,,,158069.57058342153,126131.05916736384,,,,,,,3714880.0,,,,,,,,,,,,,,,,436537.0,431331.0,1263374.0,6426.248683002898,632078.0,625629.0,,,,,,,,,37.5,50574539.29499997,21087915.48000002,5296263897.870007,1754876497.8150003,58407555.77999997,709847.0099999999,95.0,12039.0,-16994799.5,7641248.0,-8776713.0,-9534672.0,-18.25,0.0,0.0,37958.85,0.0,0.0,0.0,0.0,0.0,-1171.0,-865.0,-862.0,-865.0,185819876.39249983,2634104938.9500017,2970956552.3100004,42904489.13999999,2634012335.7000017,190088.0,-13108712.0,3045036600.5,132698349.5,683385152.5,302883776.5,712830804.0,190809.0,2977.0,537.5382712637717,4467557.0,1564172.0,958640.0,-3139407.0,1176357.0,99647.0,2087285940.157548,2105125918.290032,-127416777.0,-126379890.5,2276976.5,103566.5,,,,,,,,,,,,,,,,,,,,,1467706.0,14791275.0,3233298.0,8556661.0,11609894.0,1415972.0,1059157927.6020012,801747714.892495,72118151554.52213,21677363516.407616,582516033.7994988,5792665.7475,689.5,94245.0,-276979989.5,21967173.5,-123812960.5,-218747953.5,-2019586.5,,,,,,,,,,,,,,,,,,,,,4273824.0,2479757.0,-9005176.5,921269.0,37582.5,3734292348.854962,3659014551.914961,-260673615.5,-257361970.0,2526989.0,269248.5,3926980561.747456,33260067666.85592,36689419766.115135,1729722909.1500494,48093554003.69322,3988741.0,-247633418.0,103106847996.0,1054490509.5,17277470976.0,3504212862.0,18891126867.5,3672777.0,71936.5,20874.10837794952,89799522.5,-63.24766142947961,1.848342857142857,6.951340615690169,209.7019493681218,12.848460774577957,387.6011002435009,78750.0,1.0,0.0,0.0,0.0,0.0,0.0,0.0,0.0,1.0,0.0,0.0,0.0,0.0,0.0,0.0,1.0,0.0,0.0,0.0,0.0,1.0,0.0,1.0,0.0,0.0,0.0,0.0,1.0,0.0,0.0,0.0,0.0,0.0,0.0,0.0,0.0,0.0,0.0,0.0,0.0,1.0,0.0,0.0,0.0,0.0,0.0,0.0,0.0,0.0,0.0,0.0,0.0,0.0,0.0,0.0,0.0,0.0,0.0,0.0,0.0,0.0,0.0,0.0,0.0,0.0,0.0,0.0,0.0,0.0,0.0,0.0,0.0,0.0,0.0,0.0,0.0,0.0,0.0,0.0,0.0,0.0,0.0,0.0,0.0,0.0,0.0,0.0,0.0,0.0,0.0,0.0,0.0,0.0,0.0,0.0,0.0,0.0,0.0,0.0,0.0,0.0,0.0,0.0,0.0,0.0,1.0,0.0,0.0,0.0,0.0,0.0,0.0,0.0,0.0,0.0,0.0,0.0,0.0,0.0,0.0,0.0,0.0
103173,0,0.0,0.0,1.0,1.0,1.0,112500.0,1035000.0,33516.0,1035000.0,0.031329,37.00821917808219,-249.0,-4388.0,-1431.0,1.0,3.0,2.0,2.0,12.0,0.722230687725011,0.5864951695322006,0.6279908192952864,0.0165,,0.9856,,,,,0.125,,,,0.0151,,0.0088,0.0168,,0.9856,,,,,0.125,,,,0.0157,,0.0093,0.0167,,0.9856,,,,,0.125,,,,0.0154,,0.009,0.0138,1.0,14.0,0.0,14.0,0.0,-956.0,0.0,0.0,0.0,0.0,0.0,2.0,1.0,1.0,0.0,1.0,0.0,0.0,0.0,0.0,0.0,0.0,1.0,1.0,0.0,1.0,0.0,0.0,0.0,0.0,0.0,0.0,0.0,0.0,0.0,0.0,0.0,0.0,0.0,0.0,0.0,0.0,0.0,0.0,7.0,4500.0,0.0,67500.0,0.0,0.0,0.0,0.0,0.0,-754.0,168.5,-155.0,-847.0,206.0,-16.0,14.0,17490.33,283786.4925,283785.75,0.0,450000.0,48.0,-712.0,365243.0,-1292.0,-1112.0,-1082.0,-1106.0,12.0,0.0,0.0,-1.0,68.0,12.0,8.5,-30.5,0.0,0.0,68.0,12041.3925,11604.285,-820.5,-819.0,6.0,1.0,0.0,,,,,,,,,,,,,,,,,,,,,8348319013.5,184424617881.0,165607604064.0,51980742307.935,1863.0,1705.0,71125.0,70837.0,9140.0,506152.0,17811.061600002293,17873.240599999106,17324.668999998037,,,,128444.0,662949.0,,,,13530123.68219138,-602011035.0,-922086782.0,-296570466.0,-1535404864.0416667,44024.0,30708.0,,,,,,,67480.99946456887,158070.15707859106,126131.68715818317,35008.51090002794,34948.741700028375,34394.25910002879,,,,3714892.0,,,,,,,16470.519399999757,16655.788399999692,16252.5846999997,,,,3914.538000000125,3897.716000000164,3730.31040000016,436551.0,431345.0,1263375.0,6426.280012002899,632080.0,625631.0,,16334.7695999998,154209.18869999066,154211.9337999902,154103.66859998714,,,,25.0,50579039.29499997,21087915.48000002,5296797722.295007,1754876497.8150003,58407555.77999997,709847.0099999999,95.0,12039.0,-16999345.0,7640474.0,-8779834.0,-9536988.0,-12.0,4500.0,0.0,135000.0,0.0,0.0,0.0,0.0,0.0,-1187.0,-175.0,-690.0,-1002.0,186033314.74499992,2638089704.7000017,2975248890.8100004,42919246.88999999,2638089704.7000017,190327.0,-13121032.5,3048323787.5,133054934.0,684109246.0,302880244.0,713554940.0,190983.0,2980.0,537.7396024124387,4469050.5,1566061.0,960008.0,-3141538.5,1176357.0,99647.0,2089433769.795048,2107381864.005032,-127472952.0,-126436180.0,2277577.5,103672.5,,,,,,,,,,,,,,,,,,,,,1467713.0,14791481.0,3233298.0,8556729.0,11609962.0,1415986.0,1059162427.6020012,801747714.892495,72118219054.52213,21677363516.407616,582516033.7994988,5792665.7475,689.5,94245.0,-276980743.5,21967342.0,-123813115.5,-218748800.5,-2019602.5,,,,,,,,,,,,,,,,,,,,,4273836.0,2479765.5,-9005207.0,921269.0,37582.5,3734304390.247461,3659026156.1999607,-260674436.0,-257362789.0,2526995.0,269249.5,3926998052.077457,33260351453.34841,36689703551.865135,1729722909.1500494,48094004003.69322,3988789.0,-247634130.0,103107213239.0,1054489217.5,17277469864.0,3504211780.0,18891125761.5,3672789.0,71936.5,20874.10837794952,89799521.5,-6.7282351199289305,9.2,3.356605800214824,124.22200314877212,30.88077336197637,1142.8424289687034,37500.0,0.6234898018587334,-0.7818314824680299,0.0,1.0,0.0,0.0,0.0,0.0,0.0,0.0,1.0,0.0,0.0,0.0,0.0,0.0,0.0,0.0,0.0,0.0,1.0,0.0,1.0,0.0,0.0,0.0,0.0,1.0,0.0,0.0,0.0,0.0,0.0,0.0,0.0,1.0,0.0,0.0,0.0,0.0,0.0,0.0,0.0,0.0,0.0,0.0,0.0,0.0,0.0,0.0,0.0,0.0,0.0,0.0,0.0,0.0,0.0,0.0,0.0,0.0,0.0,1.0,0.0,0.0,0.0,0.0,0.0,0.0,0.0,0.0,0.0,0.0,0.0,0.0,0.0,0.0,0.0,0.0,0.0,0.0,0.0,0.0,0.0,0.0,0.0,0.0,0.0,0.0,0.0,0.0,0.0,0.0,0.0,0.0,0.0,0.0,0.0,0.0,0.0,0.0,0.0,0.0,0.0,0.0,0.0,0.0,0.0,0.0,0.0,0.0,0.0,0.0,1.0,0.0,0.0,0.0,0.0,0.0,0.0,0.0,1.0,0.0
103184,0,0.0,1.0,1.0,1.0,0.0,225000.0,257391.0,29241.0,238500.0,0.016612,29.232876712328768,-1132.0,-773.0,-3335.0,14.0,2.0,2.0,2.0,13.0,,0.547366741783887,0.7180328113294772,,,,,,,,,,,,,,,,,,,,,,,,,,,,,,,,,,,,,,,,,,,,,0.0,0.0,0.0,0.0,-657.0,0.0,0.0,0.0,0.0,1.0,0.0,1.0,1.0,0.0,1.0,0.0,0.0,0.0,0.0,0.0,0.0,0.0,0.0,0.0,1.0,0.0,0.0,0.0,0.0,0.0,0.0,0.0,0.0,0.0,0.0,0.0,0.0,0.0,0.0,0.0,0.0,0.0,0.0,3.0,14041.665,0.0,135000.0,0.0,0.0,0.0,0.0,0.0,-473.0,1364.0,-134.0,-243.0,61.0,-10.0,5.0,10365.3,94230.0,95841.0,0.0,94230.0,12.0,-516.0,365243.0,-416.0,-188.5,-116.0,-183.5,16.0,0.0,0.0,2000.0,27.0,12.0,8.0,-12.0,0.0,0.0,27.0,28550.07,28550.07,-329.0,-317.0,4.0,2.0,0.0,,,,,,,,,,,,,,,,,,,,,8348348254.5,184424875272.0,165607842564.0,51980967307.935,1863.0,1705.0,71125.0,70838.0,9140.0,506152.0,,,,,,,128444.0,662951.0,,,,13530152.915068092,-602012167.0,-922090117.0,-296571123.0,-1535405637.0416667,44024.0,30708.0,,,,,,,,158070.70444533284,126132.40519099448,,,,,,,3714905.0,,,,,,,,,,,,,,,,436551.0,431345.0,1263389.0,6426.296624002899,632082.0,625633.0,,,,,,,,,16.0,50621952.95999997,21126719.025000013,5306949330.525004,1758265359.2550006,58452555.77999997,709847.0099999999,95.0,12039.0,-17050623.0,7623677.0,-8805448.0,-9569192.5,-7.5,14041.665,0.0,135000.0,0.0,0.0,0.0,0.0,0.0,-473.0,1364.0,-134.0,-243.0,186652049.0399999,2649766051.935002,2987854943.3100004,43048495.12499999,2649766051.935002,191303.0,-13183785.0,3060375598.5,133371220.5,685895725.0,303575274.5,715341990.0,191814.0,2988.5,540.5308272842414,4489137.0,1571033.0,962952.0,-3159063.0,1177808.0,99652.0,2095366615.9650488,2112974970.1200323,-128011357.0,-126971842.0,2281196.0,104080.0,,,,,,,,,,,,,,,,,,,,,1467716.0,14791542.0,3233298.0,8556756.0,11609989.0,1415991.0,1059176469.267001,801747714.892495,72118354054.52213,21677363516.407616,582516033.7994988,5792665.7475,689.5,94245.0,-276981216.5,21968706.0,-123813249.5,-218749043.5,-2019612.5,,,,,,,,,,,,,,,,,,,,,4273848.0,2479773.5,-9005219.0,921269.0,37582.5,3734332940.3174615,3659054706.269961,-260674765.0,-257363106.0,2526999.0,269251.5,3927008417.377456,33260445683.34841,36689799392.865135,1729722909.1500494,48094098233.69322,3988801.0,-247634646.0,103107578482.0,1054488801.5,17277469675.5,3504211664.0,18891125578.0,3672805.0,71936.5,20874.10837794952,89801521.5,-38.72352389878164,1.14396,7.694675284702987,224.93749393912563,8.802400738688828,257.3194955666022,112500.0,-0.9009688679024191,-0.433883739117558,0.0,0.0,0.0,0.0,0.0,0.0,1.0,0.0,1.0,0.0,0.0,0.0,0.0,0.0,0.0,1.0,0.0,0.0,0.0,0.0,1.0,0.0,0.0,0.0,0.0,0.0,0.0,0.0,0.0,1.0,0.0,0.0,0.0,0.0,0.0,0.0,0.0,0.0,0.0,0.0,0.0,0.0,0.0,0.0,1.0,0.0,0.0,0.0,0.0,0.0,0.0,0.0,0.0,1.0,0.0,0.0,0.0,0.0,0.0,0.0,0.0,0.0,0.0,0.0,0.0,0.0,0.0,0.0,0.0,0.0,0.0,0.0,0.0,0.0,0.0,0.0,0.0,0.0,0.0,0.0,0.0,0.0,0.0,0.0,0.0,0.0,0.0,0.0,0.0,0.0,0.0,0.0,0.0,0.0,0.0,0.0,0.0,0.0,0.0,0.0,0.0,0.0,0.0,0.0,0.0,0.0,0.0,0.0,0.0,0.0,0.0,0.0,0.0,0.0,0.0,0.0,0.0,0.0,0.0,0.0
103195,0,0.0,0.0,0.0,1.0,2.0,148500.0,599778.0,30753.0,477000.0,0.0084739999999999,35.25753424657535,-1548.0,-130.0,-4069.0,,4.0,2.0,2.0,10.0,0.2518584739431075,0.6463487557110311,0.2539628093363117,,,,,,,,,,,,,,,,,,,,,,,,,,,,,,,,,,,,,,,,,,,,,0.0,0.0,0.0,0.0,-350.0,0.0,0.0,0.0,0.0,0.0,4.0,1.0,1.0,0.0,1.0,0.0,1.0,0.0,0.0,0.0,0.0,0.0,0.0,0.0,1.0,0.0,0.0,0.0,0.0,0.0,0.0,0.0,0.0,0.0,0.0,0.0,0.0,0.0,0.0,0.0,0.0,0.0,0.0,10.0,0.0,0.0,135000.0,0.0,0.0,0.0,0.0,0.0,-1669.5,-423.0,-264.5,-1034.0,494.0,-26.0,9.0,25733.205,146250.0,146250.0,0.0,180000.0,11.0,-837.0,365243.0,-1448.5,-1208.5,-1208.5,-1199.5,10.0,1.0,0.0,0.0,63.0,12.0,6.0,-53.0,0.0,0.0,57.0,24892.785,24892.785,-1736.0,-1599.0,5.0,1.0,0.0,,,,,,,,,,,,,,,,,,,,,8348379007.5,184425475050.0,165608319564.0,51981115807.935,1863.0,1705.0,71125.0,70838.0,9140.0,506156.0,,,,,,,128446.0,662955.0,,,,13530188.17260234,-602013715.0,-922094186.0,-296571473.0,-1535405767.0416667,44024.0,30708.0,,,,,,,67481.25132304282,158071.35079408856,126132.65915380383,,,,,,,3714915.0,,,,,,,,,,,,,,,,436551.0,431345.0,,6426.305098002899,632084.0,625635.0,,,,,,,,,55.5,50724639.49499998,21152636.460000016,5331091836.645004,1763769598.4700005,58716671.39999996,709847.0099999999,95.0,12039.0,-17126427.5,7598551.0,-8851622.5,-9610794.0,-27.25,0.0,0.0,135000.0,0.0,0.0,0.0,0.0,0.0,-1689.0,-866.0,-930.0,-1125.0,187859677.11749995,2671174715.310002,3011637191.3550005,43121519.95499998,2671084715.310002,192769.0,-13253682.0,3075348016.5,134051288.5,689143906.5,304649380.5,718956498.0,192937.0,3011.5,541.4654100118091,4507615.0,1579861.0,969360.0,-3174470.0,1177872.0,99652.0,2110506226.2000527,2128145099.130036,-128620408.0,-127577657.0,2291040.0,104553.0,,,,,,,,,,,,,,,,,,,,,1467726.0,14792036.0,3233298.0,8556819.0,11610046.0,1416000.0,1059176469.267001,801747714.892495,72118489054.52213,21677363516.407616,582516033.7994988,5792665.7475,689.5,94245.0,-276982886.0,21968283.0,-123813514.0,-218750077.5,-2019638.5,,,,,,,,,,,,,,,,,,,,,4273860.0,2479779.5,-9005272.0,921269.0,37582.5,3734357833.102461,3659079599.0549607,-260676501.0,-257364705.0,2527004.0,269252.5,3927034150.582456,33260591933.34841,36689945642.865135,1729722909.1500494,48094278233.69322,3988812.0,-247635483.0,103107943725.0,1054487353.0,17277468467.0,3504210455.5,18891124378.5,3672815.0,71937.5,20874.10837794952,89801521.5,-43.90550936358692,4.038909090909091,4.828797190517999,170.2514823144551,19.503072870939423,687.630259660601,37125.0,-0.2225209339563146,-0.9749279121818236,0.0,0.0,0.0,0.0,0.0,0.0,1.0,0.0,0.0,0.0,0.0,0.0,0.0,1.0,0.0,0.0,0.0,0.0,1.0,0.0,1.0,0.0,0.0,0.0,0.0,1.0,0.0,0.0,0.0,0.0,0.0,0.0,0.0,0.0,0.0,0.0,1.0,0.0,0.0,0.0,0.0,0.0,0.0,0.0,0.0,0.0,0.0,0.0,0.0,0.0,0.0,0.0,1.0,0.0,0.0,0.0,0.0,0.0,0.0,0.0,0.0,0.0,0.0,0.0,0.0,0.0,0.0,0.0,0.0,0.0,0.0,0.0,0.0,0.0,0.0,0.0,0.0,0.0,0.0,0.0,0.0,0.0,0.0,0.0,0.0,0.0,0.0,0.0,0.0,0.0,0.0,0.0,0.0,0.0,0.0,0.0,0.0,0.0,0.0,0.0,0.0,0.0,0.0,0.0,0.0,0.0,0.0,0.0,0.0,0.0,0.0,0.0,0.0,0.0,0.0,0.0,0.0,0.0,0.0,0.0
103196,0,0.0,0.0,0.0,1.0,2.0,112500.0,900000.0,45954.0,900000.0,0.026392,36.86301369863013,-2184.0,-433.0,-4404.0,,4.0,2.0,2.0,10.0,0.6913673304653782,0.4339079862364583,0.4382813743111921,0.4701,0.3869,0.9811,0.7416,,0.0,1.0,0.1667,0.0,0.4042,,0.4229,,0.0114,0.479,0.4015,0.9811,0.7517,,0.0,1.0,0.1667,0.0,0.4134,,0.4406,,0.0121,0.4747,0.3869,0.9811,0.7451,,0.0,1.0,0.1667,0.0,0.4112,,0.4305,,0.0117,0.3731,1.0,0.0,0.0,0.0,0.0,-2463.0,0.0,0.0,0.0,0.0,0.0,2.0,1.0,1.0,0.0,1.0,1.0,0.0,0.0,0.0,0.0,0.0,0.0,0.0,0.0,1.0,0.0,0.0,0.0,0.0,0.0,0.0,0.0,0.0,0.0,0.0,0.0,0.0,0.0,0.0,0.0,0.0,0.0,0.0,6.0,0.0,,75213.0,0.0,0.0,0.0,0.0,0.0,-988.0,-728.0,-736.5,-837.0,205.0,-17.0,5.0,17523.2925,48060.0,48060.0,0.0,86940.0,33.0,-585.0,365243.0,-888.5,-513.5,71.5,-508.5,12.0,0.5,0.0,-1.0,30.0,24.0,13.5,-26.5,0.0,0.0,28.0,4513.32,4513.32,-873.5,-860.0,10.5,1.0,0.0,,,,,,,,,,,,,,,,,,,,,8348424961.5,184426375050.0,165609219564.0,51981228307.935,1863.0,1705.0,71125.0,70838.0,9140.0,506158.0,17811.53170000229,17873.715299999105,17325.147999998037,11298.48110000009,11236.252600000093,11183.630100000057,128448.0,662959.0,,,,13530225.035616037,-602015899.0,-922098590.0,-296573936.0,-1535406200.0416667,44024.0,30708.0,11351.828399999184,11227.779999998977,10712.072499997292,22891.74660000971,22813.598500009663,22199.00120000823,67481.94269037327,158071.7847020748,126133.09743517812,35008.67760002794,34948.90840002838,34394.42580002879,22959.94319999591,22933.067199995487,22579.83129999572,3714925.0,8297.261600000165,8401.804800000076,8125.386700000229,,,,16470.94229999976,16656.21889999969,16253.0252999997,,,,3914.549400000125,3897.727700000164,3730.32250000016,436551.0,431345.0,,6426.331490002899,632086.0,625637.0,,16335.142699999802,154210.16979999063,154212.9148999902,154104.64969998717,77627.88479999627,77965.7562000066,78367.19310000655,33.0,50749335.49499998,,5332204377.495005,1764084359.9700005,58716671.39999996,709847.0099999999,95.0,12039.0,-17134772.5,7626445.0,-8855018.0,-9614456.0,-16.0,0.0,,73476.0,0.0,0.0,0.0,0.0,0.0,-1056.0,-872.0,-864.0,-901.0,187958674.07999992,2672004965.310002,3012617835.8550005,43121519.95499998,2672053025.310002,192847.0,-13258092.0,3076808988.5,134047374.5,689140877.5,304647886.5,718953515.0,193020.0,3014.0,541.4654100118091,4507641.0,1580593.0,969868.5,-3176239.0,1177872.0,99652.0,2112087398.400053,2129671849.545036,-128667344.5,-127623936.5,2291298.5,104597.5,,,,,,,,,,,,,,,,,,,,,1467732.0,14792241.0,3233298.0,8556849.0,11610074.0,1416005.0,1059176469.267001,,72118564267.52213,21677363516.407616,582516033.7994988,5792665.7475,689.5,94245.0,-276983874.0,21967555.0,-123814250.5,-218750914.5,-2019655.5,,,,,,,,,,,,,,,,,,,,,4273884.0,2479793.0,-9005298.5,921269.0,37582.5,3734362346.4224615,3659084112.374961,-260677374.5,-257365565.0,2527014.5,269253.5,3927051673.874956,33260639993.34841,36689993702.865135,1729722909.1500494,48094365173.69322,3988845.0,-247636068.0,103108308968.0,1054486464.5,17277467953.5,3504210527.0,18891123870.0,3672827.0,71938.0,20874.10837794952,89801520.5,-59.24637681159421,8.0,2.448100274187231,90.24435394298408,19.584802193497847,721.9548315438727,28125.0,1.0,0.0,0.0,0.0,0.0,0.0,0.0,0.0,1.0,0.0,0.0,0.0,0.0,0.0,0.0,1.0,0.0,1.0,0.0,0.0,0.0,0.0,1.0,0.0,0.0,0.0,0.0,1.0,0.0,0.0,0.0,0.0,0.0,0.0,0.0,0.0,0.0,0.0,0.0,0.0,1.0,0.0,0.0,0.0,0.0,0.0,0.0,0.0,0.0,0.0,0.0,0.0,0.0,0.0,1.0,0.0,0.0,0.0,0.0,0.0,0.0,0.0,0.0,0.0,0.0,0.0,0.0,0.0,0.0,0.0,0.0,0.0,0.0,0.0,0.0,0.0,0.0,0.0,0.0,0.0,0.0,0.0,0.0,0.0,0.0,0.0,0.0,0.0,0.0,0.0,0.0,0.0,0.0,0.0,0.0,0.0,0.0,0.0,0.0,0.0,0.0,0.0,0.0,0.0,0.0,0.0,0.0,0.0,0.0,0.0,0.0,0.0,1.0,0.0,0.0,0.0,0.0,0.0,0.0,1.0,0.0,0.0
103206,0,0.0,0.0,0.0,1.0,0.0,81000.0,166810.5,17221.5,144000.0,0.019101,35.295890410958904,-996.0,-4168.0,-4168.0,,2.0,2.0,2.0,10.0,,0.6957471002419962,0.8435435389318647,,,,,,,,,,,,,,,,,,,,,,,,,,,,,,,,,,,,,,,,,,,,,6.0,0.0,6.0,0.0,0.0,0.0,0.0,0.0,0.0,0.0,1.0,1.0,1.0,0.0,1.0,1.0,0.0,0.0,0.0,0.0,0.0,0.0,0.0,0.0,1.0,0.0,0.0,0.0,0.0,0.0,0.0,0.0,0.0,0.0,0.0,0.0,0.0,0.0,0.0,0.0,0.0,0.0,0.0,7.0,0.0,4175.955,48712.5,0.0,0.0,0.0,0.0,0.0,-1466.0,-1281.0,-1002.0,-1281.0,446.0,-32.0,4.0,9169.56,69345.0,95602.5,7533.0,89955.0,6.0,-2718.0,365243.0,-2399.0,-2069.0,-2069.0,-2066.0,14.5,0.0,0.0821418419381924,15.0,32.0,8.0,4.0,-84.5,0.0,0.0,26.0,10864.755,10864.755,-2514.5,-2492.0,5.0,1.0,87.0,0.0,0.0,,0.0,,,0.0,,0.0,0.0,0.0,0.0,,0.0,,,0.0,-46.0,0.0,0.0,8348442183.0,184426541860.5,165609363564.0,51981309307.935,1863.0,1705.0,71125.0,70838.0,9140.0,506159.0,,,,,,,128448.0,662961.0,,,,13530260.331506448,-602016895.0,-922102758.0,-296573936.0,-1535410368.0416667,44024.0,30708.0,,,,,,,,158072.48044917503,126133.94097871704,,,,,,,3714935.0,,,,,,,,,,,,,,,,436557.0,431351.0,,6426.350591002899,632088.0,625639.0,,,,,,,,,49.0,50749335.49499998,21170263.455000017,5341393988.370007,1766440006.4700005,59073068.96999996,709847.0099999999,95.0,12039.0,-17199947.0,7622038.0,-8897973.0,-9656371.0,-24.0,0.0,4175.955,48712.5,0.0,0.0,0.0,0.0,0.0,-2705.0,-2384.0,-1062.0,-2384.0,188318955.95999995,2677232259.810002,3017711676.1050005,43427416.45499998,2677279338.810002,193373.0,-13299106.0,3085390239.0,134750288.0,691677862.0,305362365.0,721124264.0,193439.5,3019.0,543.6576282834084,4515032.5,1587509.0,974175.0,-3188293.0,1177893.0,99673.0,2117332099.417549,2134712773.282532,-129445522.0,-128395264.5,2317481.5,104938.5,2034583913.2949872,5447502000.0,,265421342.0249996,,,115524802.48499969,,268106707.6200004,1952543469.5099933,2026829579.0849853,2026906171.0199847,,22174.0,,,667362.0,-1188770.0,554739.0,1183.0,1467739.0,14792687.0,3233385.0,8556881.0,11610100.0,1416009.0,1059176469.267001,801751890.8474951,72118612980.02213,21677363516.407616,582516033.7994988,5792665.7475,689.5,94245.0,-276985340.0,21966274.0,-123815252.5,-218752195.5,-2019687.5,5923856535.367461,18725233500.0,,447987579.2549976,,,309168438.97499865,,459210832.1999993,5708972700.247533,5887134326.834999,5887377509.58,,80841.0,,,971667.0,-1698880.0,177364.0,6755.0,4273892.0,2479797.0,-9005383.0,921269.0,37582.5,3734373211.1774616,3659094977.129961,-260679889.0,-257368057.0,2527019.5,269254.5,3927060843.434956,33260709338.34841,36690089305.365135,1729730442.1500494,48094455128.69322,3988851.0,-247638786.0,103108674211.0,1054484065.5,17277465884.5,3504208458.0,18891121804.0,3672841.5,71938.0,20874.190519791457,89801535.5,-28.21858262826981,2.0593888888888894,4.7034230467729286,166.01150441527574,9.686177162268097,341.8822476205476,40500.0,1.0,0.0,0.0,1.0,0.0,0.0,0.0,0.0,0.0,0.0,0.0,0.0,0.0,0.0,0.0,1.0,0.0,0.0,0.0,0.0,1.0,0.0,1.0,0.0,0.0,0.0,0.0,1.0,0.0,0.0,0.0,0.0,0.0,0.0,0.0,0.0,0.0,0.0,0.0,0.0,0.0,0.0,1.0,0.0,0.0,0.0,0.0,0.0,0.0,0.0,0.0,0.0,0.0,0.0,0.0,0.0,0.0,0.0,0.0,0.0,0.0,0.0,0.0,0.0,0.0,0.0,0.0,0.0,0.0,0.0,0.0,0.0,0.0,0.0,0.0,0.0,0.0,0.0,0.0,0.0,0.0,1.0,0.0,0.0,0.0,0.0,0.0,0.0,0.0,0.0,0.0,0.0,0.0,0.0,0.0,0.0,0.0,0.0,0.0,0.0,0.0,0.0,0.0,0.0,0.0,0.0,0.0,0.0,0.0,0.0,0.0,0.0,0.0,0.0,0.0,0.0,0.0,0.0,0.0,0.0,0.0,0.0
103230,0,0.0,1.0,1.0,0.0,0.0,202500.0,643500.0,50971.5,643500.0,0.026392,54.26575342465753,-4240.0,-5258.0,-3367.0,12.0,2.0,2.0,2.0,11.0,,0.6699912435603458,0.0850326148969535,0.1485,,0.9921,,,0.16,0.1379,0.3333,,,,0.1549,,0.0,0.1513,,0.9921,,,0.1611,0.1379,0.3333,,,,0.1614,,0.0,0.1499,,0.9921,,,0.16,0.1379,0.3333,,,,0.1577,,0.0,0.1219,1.0,0.0,0.0,0.0,0.0,0.0,0.0,0.0,0.0,0.0,0.0,4.0,1.0,1.0,0.0,1.0,0.0,0.0,0.0,0.0,0.0,0.0,0.0,0.0,0.0,1.0,0.0,0.0,0.0,0.0,0.0,0.0,0.0,0.0,0.0,0.0,0.0,0.0,0.0,0.0,0.0,0.0,0.0,0.0,13.0,0.0,21750.075,36000.0,0.0,0.0,0.0,0.0,0.0,-150.0,-70.0,-59.0,-105.0,211.0,-16.0,15.0,7751.0475,58500.0,70947.0,23886.0,58500.0,12.0,-1417.0,365243.0,-1139.0,-179.0,271.0,-172.0,13.0,0.0,0.1905873185234916,-1.0,76.0,36.0,23.5,-24.5,0.0,0.0,99.0,17751.42,9292.995,-710.0,-689.0,12.0,1.0,23.0,0.0,495000.0,,0.0,,,0.0,,0.0,0.0,0.0,0.0,,0.0,,,0.0,-15.0,0.0,0.0,8348493154.5,184427185360.5,165610007064.0,51981511807.935,1863.0,1705.0,71125.0,70838.0,9140.0,506163.0,17811.68020000229,17873.865199999105,17325.299299998038,,,,128448.0,662963.0,,,,13530314.597259872,-602021135.0,-922106125.0,-296573936.0,-1535415626.0416667,44024.0,30708.0,11351.988399999183,11227.939999998976,10712.233599997291,22891.884500009703,22813.736400009668,22199.13910000824,,158073.15044041866,126134.02601133195,35009.01090002794,34949.241700028375,34394.75910002879,,,,3714946.0,,,,,,,16471.09719999976,16656.37659999969,16253.186699999702,,,,3914.549400000125,3897.727700000164,3730.32250000016,436557.0,431351.0,1263401.0,6426.3769830029,632090.0,625641.0,,16335.264599999802,154211.16189999063,154213.9069999902,154105.64179998718,,,,5.0,51099554.38499998,21329389.260000013,5370266346.300006,1773802079.5500004,59073124.99499996,709847.0099999999,95.0,12039.0,-17348937.0,7592928.0,-8987095.0,-9746179.0,-2.0,17482.5,21750.075,675000.0,176742.0,0.0,0.0,0.0,0.0,-1378.0,-222.0,-37.0,-1165.0,189580944.93749988,2695965278.310002,3038612166.8550005,43797563.95499998,2695965278.310002,194896.0,-13416626.0,3109125699.0,135401411.0,697095522.0,308605117.0,727275741.0,194897.0,3044.0,547.1341770106122,4527657.0,1600233.0,982289.5,-3217506.0,1182367.0,99687.0,2133807343.7400644,2150477709.1200376,-130526832.0,-129469419.0,2331935.0,105678.0,2054596886.3249865,5490067500.0,,268249290.1649996,,,116524102.72499973,,270497476.8450002,1971776410.424993,2046611275.874984,2046687867.809984,,22468.0,,,670396.0,-1195807.0,554739.0,1183.0,1467752.0,14792898.0,3233408.0,8556957.0,11610199.0,1416024.0,1059176469.267001,801773640.9224951,72118648980.02213,21677363516.407616,582516033.7994988,5792665.7475,689.5,94245.0,-276985490.0,21966204.0,-123815311.5,-218752300.5,-2019703.5,5923856535.367461,18725728500.0,,447987579.2549976,,,309168438.97499865,,459210832.1999993,5708972700.247533,5887134326.834999,5887377509.58,,80841.0,,,971667.0,-1698895.0,177364.0,6755.0,4273928.0,2479820.5,-9005407.5,921269.0,37582.5,3734390962.5974617,3659104270.124961,-260680599.0,-257368746.0,2527031.5,269255.5,3927068594.482456,33260767838.34841,36690160252.365135,1729754328.1500494,48094513628.69322,3988863.0,-247640203.0,103109039454.0,1054482926.5,17277465705.5,3504208729.0,18891121632.0,3672854.5,71938.0,20874.38110710998,89801534.5,-78.1339930327662,3.1777777777777776,3.972808334069039,215.5874374600149,12.624702039374943,685.0889679284919,101250.0,-0.9009688679024191,0.4338837391175582,0.0,0.0,0.0,0.0,0.0,0.0,1.0,0.0,1.0,0.0,0.0,0.0,0.0,0.0,0.0,0.0,0.0,0.0,1.0,0.0,1.0,0.0,0.0,0.0,0.0,1.0,0.0,0.0,0.0,0.0,0.0,0.0,0.0,0.0,0.0,0.0,0.0,0.0,1.0,0.0,0.0,0.0,0.0,0.0,0.0,0.0,0.0,0.0,0.0,0.0,0.0,0.0,0.0,0.0,0.0,0.0,0.0,0.0,0.0,0.0,0.0,1.0,0.0,0.0,0.0,0.0,0.0,0.0,0.0,0.0,0.0,0.0,0.0,0.0,0.0,0.0,0.0,0.0,0.0,0.0,0.0,0.0,0.0,0.0,0.0,0.0,0.0,0.0,0.0,0.0,0.0,0.0,0.0,0.0,0.0,0.0,0.0,0.0,0.0,0.0,0.0,0.0,0.0,0.0,0.0,0.0,0.0,0.0,0.0,0.0,1.0,0.0,0.0,0.0,0.0,0.0,0.0,1.0,0.0,0.0
103231,0,0.0,1.0,1.0,1.0,1.0,193500.0,495000.0,23944.5,495000.0,0.0088659999999999,29.252054794520543,-3325.0,-4855.0,-2818.0,7.0,3.0,2.0,2.0,15.0,0.2854596326213185,0.3805374141069877,0.1510075350878296,0.0928,0.079,0.9781,0.7008,0.0122,0.0,0.2069,0.1667,0.2083,0.0222,0.0756,0.0786,0.0,0.0,0.0945,0.0819999999999999,0.9782,0.7125,0.0123,0.0,0.2069,0.1667,0.2083,0.0227,0.0826,0.0818,0.0,0.0,0.0937,0.079,0.9781,0.7048,0.0123,0.0,0.2069,0.1667,0.2083,0.0226,0.077,0.08,0.0,0.0,0.0626,1.0,0.0,0.0,0.0,0.0,-961.0,0.0,0.0,0.0,0.0,2.0,2.0,1.0,1.0,1.0,1.0,0.0,0.0,0.0,0.0,0.0,0.0,0.0,0.0,0.0,1.0,0.0,0.0,0.0,0.0,0.0,0.0,0.0,0.0,0.0,0.0,0.0,0.0,0.0,0.0,0.0,0.0,0.0,0.0,8.0,5956.8975,0.0,53932.5,4072.5,0.0,0.0,0.0,0.0,-549.0,9.0,-39.5,-299.0,141.0,-8.0,5.0,13763.205,101691.0,106020.0,10170.0,225000.0,18.0,-572.0,365243.0,-494.5,182411.5,285.5,182414.5,14.0,0.5,0.0953270896415744,-1.0,21.0,18.0,10.0,-22.0,0.0,0.0,21.0,7840.26,7840.26,-637.0,-630.0,8.0,1.0,0.0,,,,,,,,,,,,,,,,,,,,,8348517099.0,184427680360.5,165610502064.0,51981705307.935,1863.0,1705.0,71125.0,70840.0,9140.0,506165.0,17811.77300000229,17873.95889999911,17325.393799998037,11298.56010000009,11236.331600000092,11183.712100000055,128449.0,662966.0,4138.828900000118,4136.496300000016,3947.066300000093,13530343.849314664,-602024460.0,-922108943.0,-296574897.0,-1535420481.0416667,44024.0,30708.0,11351.988399999183,11227.939999998976,10712.233599997291,22892.091400009707,22813.943300009672,22199.34600000824,67482.2281500059,158073.53097783276,126134.17701886703,35009.17760002794,34949.40840002838,34394.92580002879,22960.151499995907,22933.275499995485,22580.03959999572,3714961.0,8297.283800000165,8401.827400000077,8125.409400000231,9819.463500000717,9934.44190000216,10294.204399999644,16471.175799999757,16656.456599999692,16253.268499999702,828.7980000001762,813.973200000046,759.8957000000132,3914.549400000125,3897.727700000164,3730.32250000016,436557.0,431351.0,1263408.0,6426.385849002899,632092.0,625643.0,,16335.3271999998,154212.13999999064,154214.8850999902,154106.61999998722,77628.58559999628,77966.4610000066,78367.90560000655,18.5,51197360.78249998,21356528.760000013,5374009410.885006,1774407428.9550004,59073124.99499996,709847.0099999999,95.0,12039.0,-17356710.0,7592933.0,-8989536.0,-9748826.0,-8.75,6300.0,0.0,44865.0,0.0,0.0,0.0,0.0,0.0,-652.0,-130.0,-40.0,-468.0,189692817.2549999,2697319778.310002,3040772333.3550005,43807733.95499998,2697319778.310002,195022.0,-13426737.0,3110404049.5,135762540.0,697824068.0,308969766.0,728004314.0,195037.0,3046.0,547.2295041002538,4527652.0,1601799.0,983350.0,-3218991.0,1182376.0,99696.0,2134572365.8350656,2150943776.100038,-130581174.0,-129523145.0,2332658.0,105738.0,,,,,,,,,,,,,,,,,,,,,1467760.0,14793039.0,3233408.0,8556978.0,11610220.0,1416029.0,1059182426.1645012,801773640.9224951,72118702912.52213,21677367588.907616,582516033.7994988,5792665.7475,689.5,94245.0,-276986039.0,21966213.0,-123815351.0,-218752599.5,-2019711.5,,,,,,,,,,,,,,,,,,,,,4273946.0,2479830.5,-9005429.5,921269.0,37582.5,3734398802.857462,3659112110.384961,-260681236.0,-257369376.0,2527039.5,269256.5,3927082357.687456,33260869529.34841,36690266272.365135,1729764498.1500494,48094738628.69322,3988881.0,-247640775.0,103109404697.0,1054482432.0,17277648117.0,3504209014.5,18891304046.5,3672868.5,71938.5,20874.476434199623,89801533.5,-113.6672286222722,2.5581395348837206,8.081187746664162,236.39134677022807,20.67280586355948,604.7220498773278,64500.0,1.0,0.0,0.0,0.0,0.0,0.0,0.0,0.0,1.0,0.0,0.0,0.0,0.0,0.0,0.0,1.0,0.0,0.0,0.0,0.0,1.0,0.0,1.0,0.0,0.0,0.0,0.0,1.0,0.0,0.0,0.0,0.0,0.0,0.0,0.0,0.0,0.0,0.0,0.0,0.0,0.0,0.0,0.0,0.0,0.0,0.0,0.0,0.0,0.0,0.0,0.0,0.0,0.0,0.0,0.0,0.0,0.0,1.0,0.0,0.0,0.0,0.0,0.0,0.0,0.0,0.0,0.0,0.0,0.0,0.0,0.0,0.0,0.0,0.0,0.0,0.0,0.0,0.0,0.0,0.0,0.0,0.0,0.0,0.0,0.0,0.0,0.0,0.0,0.0,0.0,0.0,0.0,0.0,0.0,0.0,0.0,0.0,0.0,0.0,0.0,0.0,0.0,0.0,0.0,0.0,0.0,0.0,0.0,0.0,0.0,1.0,0.0,1.0,0.0,0.0,0.0,0.0,0.0,0.0,1.0,0.0,0.0
103232,0,0.0,1.0,1.0,1.0,0.0,180000.0,278460.0,20947.5,225000.0,0.022625,48.03561643835617,-201.0,-2948.0,-956.0,9.0,2.0,2.0,2.0,10.0,,0.627561102421452,0.7922644738669378,,,,,,,,,,,,,,,,,,,,,,,,,,,,,,,,,,,,,,,,,,,,,1.0,0.0,1.0,0.0,-543.0,0.0,0.0,0.0,0.0,0.0,5.0,1.0,1.0,0.0,1.0,0.0,0.0,0.0,0.0,0.0,0.0,1.0,1.0,0.0,0.0,0.0,0.0,0.0,0.0,1.0,0.0,0.0,0.0,0.0,0.0,0.0,0.0,0.0,0.0,0.0,0.0,0.0,0.0,2.0,0.0,,153447.75,0.0,0.0,0.0,0.0,0.0,-2027.5,-1510.0,-1386.5,-1510.0,134.0,-33.0,9.0,25900.92,0.0,0.0,,454500.0,24.0,-492.0,365243.0,-462.0,365243.0,228.0,365243.0,16.0,0.0,,-1.0,28.0,24.0,12.5,-14.5,0.0,0.0,23.0,25900.92,25900.92,-369.0,-342.0,6.0,1.0,18.0,0.0,90000.0,,0.0,,,0.0,,0.0,0.0,0.0,0.0,,0.0,,,0.0,-9.5,0.0,0.0,8348538046.5,184427958820.5,165610727064.0,51981885307.935,1863.0,1705.0,71125.0,70840.0,9140.0,506170.0,,,,,,,128449.0,662968.0,,,,13530391.884931104,-602024661.0,-922109899.0,-296575440.0,-1535423429.0416667,44024.0,30708.0,,,,,,,,158074.15853893515,126134.96928334088,,,,,,,3714971.0,,,,,,,,,,,,,,,,436558.0,431352.0,1263417.0,6426.408474002898,632094.0,625645.0,,,,,,,,,67.0,51209467.51499998,,5374396716.885006,1774500740.9550004,59079810.37499996,709847.0099999999,95.0,12039.0,-17361782.5,7590280.5,-8992335.0,-9751797.5,-33.0,0.0,,81895.5,0.0,0.0,0.0,0.0,0.0,-2160.0,-1857.0,-1613.0,-1857.0,189753947.68499988,2698339469.310002,3041869059.8550005,,2698339469.310002,195088.0,-13429969.0,3111317157.0,135761563.0,698188619.0,308969962.0,728368875.0,195142.0,3047.0,,4529454.0,1602259.0,983619.5,-3219542.5,1182376.0,99696.0,2135424292.1100664,2151795702.375041,-130591166.0,-129532929.0,2332852.0,105761.0,2054596886.3249865,5495814000.0,,268249290.1649996,,,116524102.72499973,,270497476.8450002,1971776410.424993,2046611275.874984,2046687867.809984,,22468.0,,,670396.0,-1196075.5,554739.0,1183.0,1467762.0,14793173.0,3233426.0,8557006.0,11610243.0,1416038.0,1059182426.1645012,,72118856360.27213,21677367588.907616,582516033.7994988,5792665.7475,689.5,94245.0,-276988066.5,21964703.0,-123816737.5,-218754109.5,-2019744.5,5923856535.367461,18725818500.0,,447987579.2549976,,,309168438.97499865,,459210832.1999993,5708972700.247533,5887134326.834999,5887377509.58,,80841.0,,,971667.0,-1698904.5,177364.0,6755.0,4273970.0,2479843.0,-9005444.0,921269.0,37582.5,3734424703.7774615,3659138011.3049607,-260681605.0,-257369718.0,2527045.5,269257.5,3927108258.607456,33260869529.34841,36690266272.365135,,48095193128.69322,3988905.0,-247641267.0,103109769940.0,1054481970.0,17278013360.0,3504209242.5,18891669289.5,3672884.5,71938.5,,89801532.5,-4.184395140592026,1.547,8.592910848549948,412.76576960993486,13.293233082706768,638.5486455865691,90000.0,-0.2225209339563146,-0.9749279121818236,0.0,0.0,0.0,0.0,0.0,0.0,1.0,0.0,0.0,0.0,0.0,0.0,0.0,1.0,0.0,0.0,1.0,0.0,0.0,0.0,1.0,0.0,0.0,0.0,0.0,1.0,0.0,0.0,0.0,0.0,0.0,0.0,0.0,0.0,0.0,0.0,0.0,0.0,1.0,0.0,0.0,0.0,0.0,0.0,0.0,0.0,0.0,0.0,0.0,0.0,0.0,0.0,0.0,1.0,0.0,0.0,0.0,0.0,0.0,0.0,0.0,0.0,0.0,0.0,0.0,0.0,0.0,0.0,0.0,0.0,0.0,0.0,0.0,0.0,0.0,0.0,0.0,0.0,0.0,0.0,0.0,0.0,0.0,0.0,0.0,0.0,0.0,0.0,0.0,0.0,0.0,0.0,0.0,0.0,0.0,0.0,0.0,0.0,0.0,0.0,0.0,0.0,0.0,0.0,0.0,0.0,0.0,0.0,0.0,0.0,0.0,0.0,0.0,0.0,0.0,0.0,0.0,0.0,0.0,0.0
103239,0,0.0,0.0,0.0,0.0,0.0,254700.0,773955.0,29308.5,639000.0,0.014464,58.66575342465754,-12446.0,-7067.0,-955.0,,1.0,2.0,2.0,7.0,0.5915994295157766,0.0141881697375688,0.5779691187553125,,,,,,,,,,,,,,,,,,,,,,,,,,,,,,,,,,,,,,,,,,,,,0.0,0.0,0.0,0.0,-475.0,0.0,0.0,0.0,0.0,0.0,1.0,1.0,1.0,0.0,1.0,0.0,0.0,0.0,0.0,0.0,0.0,1.0,1.0,0.0,1.0,0.0,0.0,0.0,0.0,0.0,0.0,0.0,0.0,0.0,0.0,0.0,0.0,0.0,0.0,0.0,0.0,0.0,0.0,3.0,23557.5,0.0,225000.0,162193.5,0.0,0.0,0.0,0.0,-439.0,276.0,-4.0,-154.0,50.0,-8.0,3.0,6950.5425,45000.0,45000.0,,90000.0,9.0,-475.0,182396.5,182399.0,365243.0,182654.0,365243.0,7.0,0.5,,5.0,15.0,18.0,11.0,-8.0,0.0,0.0,16.0,11651.085,11651.085,-263.5,-250.0,7.5,1.0,15.0,0.0,45000.0,0.0,0.0,0.0,0.0,0.0,0.0,0.0,0.0,0.0,0.0,0.0,0.0,0.0,0.0,0.0,-8.0,0.0,0.0,8348567355.0,184428732775.5,165611366064.0,51982140007.935,1863.0,1705.0,71125.0,70840.0,9140.0,506171.0,,,,,,,128449.0,662969.0,,,,13530450.550684528,-602037107.0,-922110854.0,-296575915.0,-1535430496.0416667,44024.0,30708.0,,,,,,,67482.81974943542,158074.17272710492,126135.54725245966,,,,,,,3714978.0,,,,,,,,,,,,,,,,436558.0,431352.0,,6426.422938002898,632096.0,625647.0,,,,,,,,,15.0,51288549.38999998,21360916.260000013,5377892302.620007,1775666955.7800004,59106810.37499996,709847.0099999999,95.0,12039.0,-17382603.0,7612130.0,-9004171.0,-9763926.0,-7.0,32850.0,0.0,382500.0,334282.5,0.0,0.0,0.0,0.0,-596.5,276.0,-3.5,-154.0,190310341.65749985,2705684589.810002,3050512326.8550005,,2705617089.810002,195609.0,-13454836.0,3118073702.5,136841941.5,700551394.5,310058017.5,730731739.5,195577.0,3050.5,,4534896.0,1605174.0,985740.0,-3224112.0,1182376.0,99696.0,2140204437.5175736,2156922006.59254,-130723329.0,-129661488.5,2333717.5,105965.5,2054596886.3249865,5502339000.0,174290893.55999997,268249290.1649996,10184538.6,83536369.28999995,116524102.72499973,293027341.09500086,270497476.8450002,1971776410.424993,2046611275.874984,2046687867.809984,8990.0,22468.0,135.0,13343.0,670396.0,-1197339.0,554739.0,1183.0,1467765.0,14793223.0,3233441.0,8557021.0,11610259.0,1416041.0,1059205983.6645012,801773640.9224951,72119081360.27213,21677529782.407616,582516033.7994988,5792665.7475,689.5,94245.0,-276988505.5,21964979.0,-123816741.5,-218754263.5,-2019752.5,5923856535.367461,18725863500.0,198810057.825,447987579.2549976,1948107.735,256782765.80250075,309168438.97499865,636623135.9999981,459210832.1999993,5708972700.247533,5887134326.834999,5887377509.58,13384.5,80841.0,44.0,70351.5,971667.0,-1698912.5,177364.0,6755.0,4273988.0,2479854.0,-9005452.0,921269.0,37582.5,3734436354.8624616,3659149662.389961,-260681868.5,-257369968.0,2527053.0,269258.5,3927115209.149956,33260914529.34841,36690311272.365135,,48095283128.69322,3988914.0,-247641742.0,103109952336.5,1054664369.0,17278378603.0,3504391896.5,18892034532.5,3672891.5,71939.0,,89801537.5,-212.15102974828375,3.0386925795053004,8.69031168432366,509.82368245595217,26.407185628742518,1549.1974407349685,254700.0,1.0,0.0,0.0,0.0,0.0,0.0,0.0,0.0,1.0,0.0,0.0,0.0,1.0,0.0,0.0,0.0,0.0,0.0,0.0,0.0,1.0,0.0,0.0,0.0,0.0,1.0,0.0,0.0,1.0,0.0,0.0,0.0,0.0,0.0,0.0,0.0,0.0,0.0,0.0,0.0,0.0,0.0,1.0,0.0,0.0,0.0,0.0,0.0,0.0,0.0,0.0,0.0,0.0,0.0,0.0,0.0,0.0,0.0,0.0,0.0,0.0,0.0,0.0,0.0,0.0,0.0,0.0,0.0,0.0,0.0,0.0,0.0,0.0,0.0,0.0,0.0,0.0,0.0,0.0,0.0,0.0,0.0,0.0,0.0,0.0,1.0,0.0,0.0,0.0,0.0,0.0,0.0,0.0,0.0,0.0,0.0,0.0,0.0,0.0,0.0,0.0,0.0,0.0,0.0,0.0,0.0,0.0,0.0,0.0,0.0,0.0,0.0,0.0,0.0,0.0,0.0,0.0,0.0,0.0,0.0,0.0,0.0
103240,0,0.0,0.0,0.0,0.0,0.0,360000.0,781920.0,40054.5,675000.0,0.002506,47.45205479452055,-1939.0,-1972.0,-857.0,,2.0,2.0,2.0,11.0,0.4239717332995136,0.7263445277642034,0.1624419982223248,0.1227,,0.9801,0.728,0.0,0.0,0.2759,0.1667,0.0417,,0.1,0.1152,0.0,0.0,0.125,,0.9801,0.7387,0.0,0.0,0.2759,0.1667,0.0417,,0.1093,0.1201,0.0,0.0,0.1239,,0.9801,0.7316,0.0,0.0,0.2759,0.1667,0.0417,,0.1018,0.1173,0.0,0.0,0.0906,1.0,1.0,0.0,1.0,0.0,-428.0,0.0,0.0,0.0,0.0,0.0,2.0,1.0,1.0,1.0,1.0,1.0,0.0,0.0,0.0,0.0,0.0,0.0,0.0,0.0,1.0,0.0,0.0,0.0,0.0,0.0,0.0,0.0,0.0,0.0,0.0,0.0,0.0,0.0,0.0,0.0,0.0,0.0,0.0,2.0,45713.25,0.0,1466718.75,1081083.915,0.0,0.0,0.0,0.0,-753.0,830.0,-17.0,,51.0,-12.0,6.0,15835.23,69709.5,69709.5,0.0,139419.0,10.0,-406.5,365243.0,-393.0,-123.0,-123.0,-120.0,9.5,0.0,0.0,-1.0,11.0,10.0,5.0,-9.0,0.0,0.0,10.0,15835.23,15835.23,-275.5,-258.0,5.5,1.0,0.0,,,,,,,,,,,,,,,,,,,,,8348607409.5,184429514695.5,165612041064.0,51982500007.935,1863.0,1705.0,71125.0,70840.0,9140.0,506173.0,17811.89570000229,17874.082799999105,17325.518799998037,,,,128449.0,662971.0,4138.828900000118,4136.496300000016,3947.066300000093,13530498.002739323,-602039046.0,-922111711.0,-296576343.0,-1535432468.0416667,44024.0,30708.0,11351.988399999183,11227.939999998976,10712.233599997291,22892.367300009708,22814.21920000968,22199.62190000824,67483.24372116872,158074.89907163265,126135.70969445788,35009.344300027944,34949.57510002838,34395.09250002879,22960.19319999591,22933.317199995487,22580.08129999572,3714989.0,,,,9819.563500000717,9934.54370000216,10294.313699999644,16471.290999999757,16656.573899999694,16253.388599999702,828.7980000001762,813.973200000046,759.8957000000132,3914.549400000125,3897.727700000164,3730.32250000016,436559.0,431353.0,,6426.425444002898,632098.0,625649.0,,16335.4177999998,154213.12009999066,154215.8651999902,154107.60009998718,77629.31359999628,77967.1926000066,78368.64430000655,25.5,51370762.13999998,21360916.260000013,5379941501.370007,1777000131.36,59106810.37499996,709847.0099999999,95.0,12039.0,-17384346.0,7613079.0,-9004355.0,,-12.25,40149.0,0.0,1035000.0,504183.33,0.0,0.0,0.0,0.0,-1102.0,238.0,-26.0,,190389688.55999985,2705824008.810002,3050651745.8550005,43870364.95499998,2706499008.810002,195652.0,-13456702.5,3118621567.0,136841326.0,700733893.0,310057927.0,730914241.0,195615.5,3051.0,547.8258968382888,4534948.5,1605360.0,985840.0,-3224215.0,1182376.0,99696.0,2140378901.5050745,2157096470.58004,-130726623.5,-129664467.5,2333814.5,105978.5,,,,,,,,,,,,,,,,,,,,,1467767.0,14793274.0,3233441.0,8557032.0,11610269.0,1416047.0,1059251696.9145012,801773640.9224951,72120548079.02213,21678610866.322617,582516033.7994988,5792665.7475,689.5,94245.0,-276989258.5,21965809.0,-123816758.5,,-2019764.5,,,,,,,,,,,,,,,,,,,,,4273998.0,2479859.0,-9005461.0,921269.0,37582.5,3734452190.0924616,3659165497.619961,-260682144.0,-257370226.0,2527058.5,269259.5,3927131044.379956,33260984238.84841,36690380981.865135,1729764498.1500494,48095422547.69322,3988924.0,-247642148.5,103110317579.5,1054663976.0,17278378480.0,3504391773.5,18892034412.5,3672901.0,71939.0,20874.476434199623,89801536.5,-40.86229792147806,2.172,8.987754184923043,426.4874040626496,19.52140208965285,926.3306416240748,180000.0,-0.9009688679024191,-0.433883739117558,0.0,0.0,0.0,0.0,0.0,0.0,1.0,0.0,0.0,0.0,0.0,0.0,0.0,1.0,0.0,0.0,0.0,0.0,1.0,0.0,1.0,0.0,0.0,0.0,0.0,1.0,0.0,0.0,0.0,0.0,0.0,0.0,0.0,0.0,0.0,0.0,0.0,0.0,0.0,0.0,1.0,0.0,0.0,0.0,0.0,0.0,0.0,0.0,0.0,0.0,0.0,0.0,0.0,0.0,0.0,0.0,0.0,0.0,0.0,0.0,0.0,0.0,0.0,0.0,0.0,0.0,0.0,0.0,0.0,0.0,0.0,0.0,0.0,0.0,0.0,0.0,0.0,0.0,0.0,0.0,0.0,0.0,0.0,0.0,0.0,0.0,0.0,0.0,0.0,0.0,1.0,0.0,0.0,0.0,0.0,0.0,0.0,0.0,0.0,0.0,0.0,0.0,0.0,0.0,0.0,0.0,0.0,0.0,1.0,0.0,1.0,0.0,0.0,0.0,0.0,0.0,0.0,0.0,0.0,0.0
103243,0,0.0,0.0,0.0,1.0,0.0,144000.0,360000.0,40846.5,360000.0,0.028663,49.12876712328767,-10393.0,-5422.0,-1471.0,,2.0,2.0,2.0,9.0,0.591264080410941,0.4826514569563281,0.5280927512030451,0.1598,0.1075,0.994,0.9524,0.0748,0.1,0.1552,0.25,0.375,0.0714,0.2101,0.1556,0.0,0.0,0.063,0.0723,0.9921,0.9543,0.0755,0.0,0.1379,0.1667,0.375,0.0132,0.2296,0.0653,0.0,0.0,0.1613,0.1075,0.994,0.953,0.0753,0.1,0.1552,0.25,0.375,0.0726,0.2138,0.1584,0.0,0.0,0.2291,1.0,0.0,0.0,0.0,0.0,-210.0,0.0,0.0,0.0,0.0,1.0,0.0,1.0,1.0,0.0,1.0,0.0,0.0,0.0,0.0,0.0,0.0,0.0,0.0,0.0,1.0,0.0,0.0,0.0,0.0,0.0,0.0,0.0,0.0,0.0,0.0,0.0,0.0,0.0,0.0,0.0,0.0,0.0,0.0,6.0,0.0,,247500.0,0.0,0.0,0.0,0.0,0.0,-955.5,-174.0,-268.5,-774.5,231.0,-20.0,3.0,11455.29,123102.0,78102.0,25880.355,123102.0,12.0,-1673.0,365243.0,-1643.0,-953.0,-953.0,-943.0,14.0,0.0,0.3079030512220384,6.0,41.0,24.0,8.0,-47.0,0.0,0.0,37.0,29228.94,29228.94,-1374.0,-1373.0,8.0,2.0,0.0,,,,,,,,,,,,,,,,,,,,,8348648256.0,184429874695.5,165612401064.0,51982644007.935,1863.0,1705.0,71125.0,70841.0,9140.0,506173.0,17812.05550000229,17874.244099999105,17325.581799998035,11298.66760000009,11236.439100000092,11183.784400000057,128449.0,662973.0,4138.903700000118,4136.5716000000175,3947.1418000000936,13530547.131506449,-602049439.0,-922113182.0,-296576553.0,-1535437890.0416667,44024.0,30708.0,11352.088399999187,11228.03999999898,10712.233599997291,22892.52250000972,22814.37440000968,22199.759800008243,67483.83498524914,158075.3817230896,126136.23778720907,35009.594300027944,34949.82510002838,34395.25920002879,22960.56819999591,22933.692199995487,22580.45629999572,3714998.0,8297.355200000165,8401.900000000076,8125.422600000231,9819.773600000715,9934.75750000216,10294.543299999645,16471.44659999976,16656.732299999694,16253.453899999702,828.7980000001762,813.973200000046,759.8957000000132,3914.549400000125,3897.727700000164,3730.32250000016,436559.0,431353.0,,6426.454107002898,632100.0,625651.0,,16335.6468999998,154214.11409999063,154216.8591999902,154108.59219998718,77630.26599999628,77968.1456000066,78369.59860000655,32.0,51432934.31999999,,5383503181.890006,1778349058.11,59117381.41499996,709847.0099999999,95.0,12039.0,-17404601.5,7648507.0,-9014113.5,-9775995.5,-15.5,0.0,,270000.0,0.0,0.0,0.0,0.0,0.0,-1087.0,-764.0,-738.0,-803.0,190563073.73999983,2708948557.5750017,3054054766.4100003,43950043.664999984,2708948557.5750017,195918.0,-13470846.0,3121543511.0,136833124.0,701093087.0,310053205.0,731273478.0,195834.0,3052.0,548.8700860682088,4535116.0,1607238.0,987109.0,-3226575.0,1182376.0,99696.0,2141503878.3750763,2158191318.9600406,-130792732.0,-129729555.0,2334499.0,106076.0,,,,,,,,,,,,,,,,,,,,,1467773.0,14793505.0,3233441.0,8557073.0,11610306.0,1416050.0,1059251696.9145012,,72120795579.02213,21678610866.322617,582516033.7994988,5792665.7475,689.5,94245.0,-276990214.0,21965635.0,-123817027.0,-218755038.0,-2019784.5,,,,,,,,,,,,,,,,,,,,,4274022.0,2479867.0,-9005508.0,921269.0,37582.5,3734481419.0324616,3659194726.559961,-260683518.0,-257371599.0,2527066.5,269261.5,3927142499.669956,33261107340.84841,36690459083.865135,1729790378.5050497,48095545649.69322,3988936.0,-247643821.5,103110682822.5,1054662333.0,17278377527.0,3504390820.5,18892033469.5,3672915.0,71939.0,20874.784337250847,89801542.5,-211.5461186705331,2.5,3.525393852594469,173.19825360198365,8.813484631486174,432.99563400495913,72000.0,-0.2225209339563146,-0.9749279121818236,0.0,0.0,0.0,0.0,0.0,0.0,1.0,0.0,0.0,0.0,0.0,0.0,0.0,1.0,0.0,0.0,0.0,0.0,1.0,0.0,1.0,0.0,0.0,0.0,0.0,1.0,0.0,0.0,0.0,0.0,0.0,0.0,0.0,0.0,0.0,0.0,1.0,0.0,0.0,0.0,0.0,0.0,0.0,0.0,0.0,0.0,0.0,0.0,0.0,0.0,0.0,0.0,1.0,0.0,0.0,0.0,0.0,0.0,0.0,0.0,0.0,0.0,0.0,0.0,0.0,0.0,0.0,0.0,0.0,0.0,0.0,0.0,0.0,0.0,0.0,0.0,0.0,0.0,0.0,0.0,0.0,0.0,0.0,0.0,0.0,0.0,0.0,0.0,0.0,0.0,0.0,0.0,0.0,0.0,0.0,0.0,0.0,0.0,0.0,0.0,0.0,0.0,0.0,0.0,0.0,0.0,0.0,0.0,1.0,0.0,1.0,0.0,0.0,0.0,0.0,0.0,0.0,0.0,1.0,0.0
103252,0,0.0,1.0,1.0,1.0,3.0,225000.0,622413.0,33894.0,495000.0,0.030755,31.964383561643835,-2952.0,-4135.0,-3967.0,65.0,5.0,2.0,2.0,15.0,0.3702990768743648,0.3245716533255963,,0.0825,0.0494,0.9826,0.762,,0.08,0.0345,0.5417,0.5833,0.0747,0.0672,0.0826,0.0,0.0573,0.084,0.0512,0.9826,0.7713,,0.0806,0.0345,0.5417,0.5833,0.0764,0.0735,0.086,0.0,0.0606,0.0833,0.0494,0.9826,0.7652,,0.08,0.0345,0.5417,0.5833,0.076,0.0684,0.084,0.0,0.0585,0.1018,1.0,0.0,0.0,0.0,0.0,0.0,0.0,0.0,0.0,0.0,0.0,0.0,1.0,1.0,0.0,1.0,0.0,0.0,0.0,0.0,0.0,0.0,0.0,0.0,0.0,1.0,0.0,0.0,0.0,0.0,0.0,0.0,0.0,0.0,0.0,0.0,0.0,0.0,0.0,0.0,0.0,0.0,0.0,0.0,1.0,,,0.0,0.0,0.0,0.0,0.0,0.0,-1417.0,-669.0,-76.0,,47.0,-23.0,3.0,9325.98,53955.0,45729.0,3750.75,53955.0,6.0,-459.0,365243.0,-429.0,-279.0,-279.0,-273.0,15.0,1.0,0.2079331210191082,100.0,20.0,6.0,4.0,-13.5,0.0,0.0,17.0,9325.98,9325.98,-381.0,-369.0,3.0,1.0,0.0,,,,,,,,,,,,,,,,,,,,,8348682150.0,184430497108.5,165612896064.0,51982869007.935,1863.0,1705.0,71125.0,70841.0,9140.0,506173.0,17812.13800000229,17874.327399999103,17325.665799998034,11298.71700000009,11236.488500000092,11183.835600000057,128452.0,662978.0,,,,13530579.095890008,-602052391.0,-922117149.0,-296576553.0,-1535442025.0416667,44024.0,30708.0,11352.168399999187,11228.11999999898,10712.31419999729,22892.55700000972,22814.40890000968,22199.79430000824,67484.20528432603,158075.70629474294,,35010.136000027946,34950.36680002838,34395.800900028786,22961.151499995907,22934.275499995485,22581.03959999572,3715013.0,8297.429900000165,8401.976000000075,8125.499000000231,9819.840800000717,9934.82590000216,10294.616799999643,16471.529199999757,16656.816299999693,16253.5398999997,828.7980000001762,813.973200000046,759.8957000000132,3914.606700000125,3897.786200000164,3730.38310000016,436559.0,431353.0,1263482.0,6426.484862002898,632102.0,625653.0,,16335.748699999802,154215.09669999062,154217.8417999902,154109.57479998714,77631.02799999628,77968.91080000659,78370.36990000654,47.0,,,5390312104.440006,1781762626.215,59273323.10999996,709847.0099999999,97.0,12039.0,-17430174.0,7823852.0,-9022575.0,,-23.0,,,0.0,0.0,0.0,0.0,0.0,0.0,-1417.0,-669.0,-76.0,,191237863.58999985,2717957247.0750017,3063642952.4100003,44040961.664999984,2717957247.0750017,196442.0,-13492903.0,3127752642.0,137184498.0,702542554.0,310044303.0,732723494.0,196330.0,3059.0,550.3911042801795,4537400.0,1609374.0,988081.5,-3233482.0,1182501.0,99710.0,2144808680.4900825,2161457033.3100405,-131156745.0,-130092436.0,2343364.0,106263.0,,,,,,,,,,,,,,,,,,,,,1467774.0,14793552.0,3233441.0,8557093.0,11610323.0,1416053.0,,,72120795579.02213,21678610866.322617,582516033.7994988,5792665.7475,689.5,94245.0,-276991631.0,21964966.0,-123817103.0,,-2019807.5,,,,,,,,,,,,,,,,,,,,,4274028.0,2479871.0,-9005521.5,921269.0,37582.5,3734490745.0124617,3659204052.539961,-260683899.0,-257371968.0,2527069.5,269262.5,3927151825.649956,33261161295.84841,36690504812.865135,1729794129.2550497,48095599604.69322,3988942.0,-247644280.5,103111048065.5,1054661904.0,17278377248.0,3504390541.5,18892033196.5,3672930.0,71940.0,20874.992270371866,89801642.5,-92.352789920288,2.76628,6.638343069569834,212.1905440895104,18.363515666489644,586.9784583039306,45000.0,0.6234898018587334,-0.7818314824680299,0.0,0.0,0.0,0.0,0.0,0.0,1.0,0.0,0.0,0.0,0.0,0.0,0.0,1.0,0.0,1.0,0.0,0.0,0.0,1.0,0.0,0.0,0.0,0.0,0.0,0.0,0.0,0.0,0.0,1.0,0.0,0.0,0.0,0.0,0.0,0.0,0.0,0.0,0.0,0.0,1.0,0.0,0.0,0.0,0.0,0.0,0.0,0.0,0.0,0.0,0.0,0.0,0.0,0.0,0.0,0.0,0.0,0.0,0.0,0.0,0.0,0.0,0.0,0.0,0.0,0.0,0.0,0.0,0.0,0.0,0.0,0.0,0.0,0.0,0.0,0.0,0.0,0.0,0.0,0.0,0.0,0.0,0.0,0.0,0.0,0.0,0.0,0.0,0.0,0.0,1.0,0.0,0.0,0.0,0.0,0.0,0.0,0.0,0.0,0.0,0.0,0.0,0.0,0.0,0.0,0.0,0.0,0.0,0.0,0.0,1.0,0.0,0.0,0.0,0.0,0.0,0.0,0.0,1.0,0.0
103258,0,0.0,0.0,0.0,1.0,1.0,157500.0,167076.0,12010.5,135000.0,0.00823,40.56986301369864,-7954.0,-1532.0,-5277.0,,3.0,2.0,2.0,16.0,0.5264722689365432,0.5497386585509856,0.3774042489507649,0.1113,0.0489,0.9975,0.966,0.1028,0.12,0.1034,0.375,0.0417,0.0159,,0.1069,,0.0,0.1134,0.0508,0.9975,0.9673,0.1037,0.1208,0.1034,0.375,0.0417,0.0163,,0.1114,,0.0,0.1124,0.0489,0.9975,0.9665,0.1035,0.12,0.1034,0.375,0.0417,0.0162,,0.1088,,0.0,0.1403,1.0,0.0,0.0,0.0,0.0,-1380.0,0.0,0.0,0.0,0.0,0.0,1.0,1.0,1.0,0.0,1.0,0.0,1.0,0.0,0.0,0.0,0.0,1.0,1.0,0.0,1.0,0.0,0.0,0.0,0.0,0.0,0.0,0.0,0.0,0.0,0.0,0.0,0.0,0.0,0.0,0.0,0.0,0.0,0.0,14.0,0.0,0.0,251066.25,0.0,0.0,0.0,0.0,0.0,-972.0,261.0,-451.5,-797.0,561.0,-23.0,3.0,12870.72,213466.5,215716.5,4956.75,213466.5,24.0,-1380.0,365243.0,-1349.0,-839.0,-659.0,-834.0,12.0,1.0,0.050001401982479,17.0,32.0,24.0,10.5,-41.5,0.0,0.0,37.0,12870.72,11373.84,-1170.0,-1169.0,9.0,1.0,0.0,,,,,,,,,,,,,,,,,,,,,8348694160.5,184430664184.5,165613031064.0,51983026507.935,1863.0,1705.0,71125.0,70841.0,9140.0,506174.0,17812.24930000229,17874.439799999105,17325.779199998033,11298.76590000009,11236.537400000092,11183.88640000006,128453.0,662981.0,4139.006500000118,4136.675100000017,3947.245500000093,13530619.665753022,-602060345.0,-922122426.0,-296577933.0,-1535443557.0416667,44024.0,30708.0,11352.288399999186,11228.23999999898,10712.434999997293,22892.66040000972,22814.51230000968,22199.89770000824,67484.73175659495,158076.2560334015,126136.61519145804,35010.511000027946,34950.74180002838,34396.175900028786,22961.19319999591,22934.317199995487,22581.08129999572,3715029.0,8297.445800000165,8401.992200000075,8125.515300000231,,,,16471.63609999976,16656.925099999695,16253.6512999997,,,,3914.606700000125,3897.786200000164,3730.38310000016,436559.0,431353.0,,6426.493092002898,632104.0,625655.0,,16335.8889999998,154216.09419999062,154218.83929999018,154110.57229998714,77631.99399999628,77969.87730000657,78371.33720000653,32.5,51655283.81999999,21400094.43000001,5399638814.160007,1784758942.89,59507989.46999996,709847.0099999999,97.0,12039.0,-17464209.5,7880186.5,-9037512.5,-9800583.0,-15.75,0.0,0.0,135000.0,0.0,0.0,0.0,0.0,0.0,-1764.0,-911.0,-592.0,-1657.0,191619437.93999985,2722960864.125002,3069177934.4100003,44092675.21499998,2722960864.125002,196914.0,-13525915.0,3137248960.0,137886783.0,703617613.0,310756690.0,733798743.0,196809.0,3067.0,551.5543478796142,4555102.0,1614771.0,991348.0,-3244699.0,1182744.0,99787.0,2153090502.3150945,2168982753.300042,-131934580.0,-130866404.0,2362473.0,106627.0,,,,,,,,,,,,,,,,,,,,,1467788.0,14794113.0,3233441.0,8557125.0,11610360.0,1416056.0,1059251696.9145012,801773640.9224951,72121046645.27213,21678610866.322617,582516033.7994988,5792665.7475,689.5,94245.0,-276992603.0,21965227.0,-123817554.5,-218755835.0,-2019830.5,,,,,,,,,,,,,,,,,,,,,4274052.0,2479881.5,-9005563.0,921269.0,37582.5,3734503615.732462,3659215426.3799615,-260685069.0,-257373137.0,2527078.5,269263.5,3927164696.369956,33261374762.34841,36690720529.365135,1729799086.0050497,48095813071.19322,3988966.0,-247645660.5,103111413308.5,1054660555.0,17278376409.0,3504389882.5,18892032362.5,3672942.0,71941.0,20875.042271773847,89801659.5,-196.05686115613184,1.0608,13.113525665043086,532.0139398574192,13.910828025477707,564.3603874007504,52500.0,0.6234898018587336,0.7818314824680298,0.0,0.0,0.0,0.0,0.0,0.0,1.0,0.0,0.0,0.0,0.0,0.0,0.0,1.0,0.0,0.0,0.0,0.0,1.0,0.0,1.0,0.0,0.0,0.0,0.0,1.0,0.0,0.0,0.0,0.0,0.0,0.0,0.0,0.0,0.0,0.0,0.0,0.0,0.0,0.0,0.0,1.0,0.0,0.0,0.0,0.0,0.0,0.0,0.0,0.0,0.0,0.0,0.0,0.0,0.0,0.0,0.0,0.0,0.0,0.0,0.0,0.0,0.0,0.0,0.0,0.0,0.0,0.0,0.0,0.0,0.0,0.0,0.0,0.0,0.0,0.0,0.0,0.0,0.0,0.0,0.0,1.0,0.0,0.0,0.0,0.0,0.0,0.0,0.0,0.0,0.0,0.0,0.0,0.0,0.0,0.0,0.0,0.0,0.0,0.0,0.0,0.0,0.0,0.0,0.0,0.0,0.0,0.0,1.0,0.0,1.0,0.0,0.0,0.0,0.0,0.0,0.0,0.0,1.0,0.0
103259,0,0.0,0.0,0.0,0.0,0.0,180000.0,746280.0,54306.0,675000.0,0.018801,30.86575342465753,-2689.0,-2190.0,-1919.0,,2.0,2.0,2.0,8.0,0.5366650576003943,0.1465543582996152,0.25533177083329,,,,,,,,,,,,,,,,,,,,,,,,,,,,,,,,,,,,,,,,,,,,,3.0,0.0,3.0,0.0,-2050.0,0.0,0.0,0.0,0.0,1.0,0.0,1.0,1.0,1.0,1.0,1.0,0.0,0.0,0.0,0.0,0.0,0.0,0.0,0.0,1.0,0.0,0.0,0.0,0.0,0.0,0.0,0.0,0.0,0.0,0.0,0.0,0.0,0.0,0.0,0.0,0.0,0.0,0.0,6.0,11475.0,3255.75,157533.75,5744.25,0.0,0.0,0.0,0.0,-949.5,-166.5,-241.5,-742.0,216.0,-18.0,2.0,8135.2125,73235.25,68892.75,7323.75,73235.25,10.0,-1673.0,365243.0,-1627.5,-1402.5,-1357.5,-1396.0,9.0,0.0,0.1051489042927448,64.5,20.0,10.0,6.0,-57.5,0.0,0.0,17.0,6614.325,6614.325,-1784.0,-1766.0,5.0,1.0,0.0,,,,,,,,,,,,,,,,,,,,,8348748466.5,184431410464.5,165613706064.0,51983206507.935,1863.0,1705.0,71125.0,70842.0,9140.0,506174.0,,,,,,,128453.0,662983.0,,,,13530650.531506447,-602063034.0,-922124345.0,-296579983.0,-1535445747.0416667,44024.0,30708.0,,,,,,,67485.26842165255,158076.4025877598,126136.87052322886,,,,,,,3715037.0,,,,,,,,,,,,,,,,436562.0,431356.0,,6426.5118930028975,632106.0,625657.0,,,,,,,,,32.0,51711970.31999999,21406605.93000001,5404207232.160007,1786492484.64,59509339.46999996,709847.0099999999,97.0,12039.0,-17472915.0,7882399.0,-9041394.5,-9805632.0,-15.5,0.0,0.0,180000.0,0.0,0.0,0.0,0.0,0.0,-1070.0,-318.0,-297.0,-742.0,191645271.92249972,2723287726.125002,3069501668.9100003,44104015.21499998,2723287726.125002,196953.0,-13529616.0,3138162067.5,137883182.0,703614837.0,310754824.0,733795983.0,196833.5,3067.0,551.7101911427451,4557294.0,1615234.0,991625.0,-3245708.0,1182744.0,99787.0,2153429736.120089,2169257992.785039,-131966063.0,-130897501.0,2362698.0,106655.0,,,,,,,,,,,,,,,,,,,,,1467794.0,14794329.0,3233441.0,8557145.0,11610377.0,1416058.0,1059263171.9145012,801776896.6724951,72121204179.02213,21678616610.572617,582516033.7994988,5792665.7475,689.5,94245.0,-276993552.5,21965060.5,-123817796.0,-218756577.0,-2019848.5,,,,,,,,,,,,,,,,,,,,,4274062.0,2479887.5,-9005620.5,921269.0,37582.5,3734510230.0574617,3659222040.704961,-260686853.0,-257374903.0,2527083.5,269264.5,3927172831.582456,33261447997.59841,36690789422.115135,1729806409.7550497,48095886306.44322,3988976.0,-247647333.5,103111778551.5,1054658927.5,17278375006.5,3504388525.0,18892030966.5,3672951.0,71941.0,20875.14742067814,89801724.0,-87.11920823717381,4.146,3.3145508783559827,102.3061101248178,13.742127941663904,424.1611325774946,90000.0,0.6234898018587334,-0.7818314824680299,0.0,0.0,0.0,0.0,0.0,0.0,1.0,0.0,0.0,0.0,0.0,0.0,0.0,1.0,0.0,1.0,0.0,0.0,0.0,0.0,1.0,0.0,0.0,0.0,0.0,1.0,0.0,0.0,0.0,0.0,0.0,0.0,0.0,1.0,0.0,0.0,0.0,0.0,0.0,0.0,0.0,0.0,0.0,0.0,0.0,0.0,0.0,0.0,0.0,0.0,0.0,0.0,0.0,0.0,0.0,0.0,0.0,0.0,0.0,0.0,0.0,0.0,0.0,0.0,0.0,0.0,0.0,0.0,0.0,0.0,0.0,0.0,0.0,0.0,0.0,0.0,1.0,0.0,0.0,0.0,0.0,0.0,0.0,0.0,0.0,0.0,0.0,0.0,0.0,0.0,0.0,0.0,0.0,0.0,0.0,0.0,0.0,0.0,0.0,0.0,0.0,0.0,0.0,0.0,0.0,0.0,0.0,0.0,0.0,0.0,0.0,0.0,0.0,0.0,0.0,0.0,0.0,0.0,0.0,0.0
103279,0,0.0,1.0,1.0,1.0,1.0,360000.0,539100.0,27652.5,450000.0,0.04622,39.0986301369863,-2451.0,-1498.0,-4685.0,3.0,3.0,1.0,1.0,13.0,,0.7897778197721518,,0.034,,0.997,,,0.0,0.1034,0.0833,,,,0.0402,,,0.0347,,0.997,,,0.0,0.1034,0.0833,,,,0.0418,,,0.0344,,0.997,,,0.0,0.1034,0.0833,,,,0.0409,,,0.0316,1.0,0.0,0.0,0.0,0.0,-757.0,,,,,,,1.0,1.0,0.0,1.0,1.0,0.0,0.0,0.0,0.0,0.0,1.0,1.0,0.0,0.0,0.0,0.0,0.0,0.0,1.0,0.0,0.0,0.0,0.0,0.0,0.0,0.0,0.0,0.0,0.0,0.0,0.0,0.0,0.0,,,,,,,,,,,,,0.0,,2.0,7887.622499999998,134410.5,74299.5,67207.5,134410.5,12.0,-757.0,365243.0,-725.0,-515.0,-395.0,-508.0,12.0,0.0,0.5172541560565697,1500.0,9.0,11.0,7.0,-21.0,0.0,0.0,8.0,7657.83,7657.83,-627.0,-620.0,4.5,2.0,0.0,,,,,,,,,,,,,,,,,,,,,8348776119.0,184431949564.5,165614156064.0,51983566507.935,,,,,,,17812.28330000229,17874.474199999106,17325.813899998033,,,,128454.0,662986.0,,,,13530689.630136585,-602065485.0,-922129030.0,-296580740.0,-1535447245.0416667,44024.0,30708.0,11352.288399999186,11228.23999999898,10712.434999997293,22892.76380000972,22814.61570000968,22200.00110000824,,158077.19236557954,,35010.594300027944,34950.82510002838,34396.25920002879,,,,3715050.0,,,,,,,16471.67629999976,16656.965999999695,16253.693099999702,,,,,,,436562.0,431356.0,1263485.0,6426.5581130029,632107.0,625658.0,,16335.9205999998,154217.09119999062,154219.8362999902,154111.56929998714,,,,,,,,,,,,,,,,,,,,,,,,,,,,,,192897379.52999985,2745149157.270002,3093968636.9100003,44462180.60999998,2745149157.270002,198455.0,-13606220.5,3155144503.0,138559577.0,706861117.0,311817625.0,737408580.0,198013.0,3083.0,555.7084707389854,4577263.0,1624746.0,997715.0,-3264763.0,1182796.0,99789.0,2164379002.560088,2182514402.2950377,-132583094.0,-131507885.5,2368508.5,107460.5,,,,,,,,,,,,,,,,,,,,,1467794.0,14794329.0,3233441.0,8557154.0,11610385.0,1416060.0,,,,,,,,,,,,,,,,,,,,,,,,,,,,,,,,,,4274073.0,2479894.5,-9005641.5,921269.0,37582.5,3734517887.8874617,3659229698.5349607,-260687480.0,-257375523.0,2527088.0,269266.5,3927180719.204956,33261582408.09841,36690863721.615135,1729873617.2550497,48096020716.94322,3988988.0,-247648090.5,103112143794.5,1054658202.5,17278374491.5,3504388130.0,18892030458.5,3672963.0,71941.0,20875.664674834195,89803224.0,-62.68761824679419,1.4975,13.018714401952806,509.01389926100967,19.49552481692433,762.248314143362,120000.0,-0.9009688679024191,0.4338837391175582,0.0,0.0,0.0,0.0,0.0,0.0,1.0,0.0,1.0,0.0,0.0,0.0,0.0,0.0,0.0,0.0,0.0,0.0,1.0,0.0,1.0,0.0,0.0,0.0,0.0,1.0,0.0,0.0,0.0,0.0,0.0,0.0,0.0,0.0,1.0,0.0,0.0,0.0,0.0,0.0,0.0,0.0,0.0,0.0,0.0,0.0,0.0,0.0,0.0,0.0,0.0,0.0,0.0,0.0,0.0,0.0,0.0,0.0,0.0,0.0,0.0,0.0,0.0,0.0,0.0,0.0,0.0,0.0,0.0,0.0,0.0,0.0,0.0,0.0,0.0,0.0,0.0,0.0,0.0,0.0,0.0,0.0,0.0,0.0,0.0,0.0,0.0,0.0,0.0,0.0,1.0,0.0,0.0,0.0,0.0,0.0,0.0,0.0,0.0,0.0,0.0,0.0,0.0,0.0,0.0,0.0,0.0,0.0,0.0,0.0,1.0,0.0,0.0,0.0,0.0,1.0,0.0,0.0,0.0,0.0
103280,0,0.0,0.0,1.0,1.0,2.0,90000.0,502497.0,28188.0,454500.0,0.022625,44.50136986301371,-3010.0,-10376.0,-4446.0,7.0,4.0,2.0,2.0,8.0,0.7296482545046304,0.6436348732394035,0.7688075728291359,0.0845,0.0,0.9846,0.7892,0.0237,0.0,0.2414,0.1667,0.2083,0.0271,0.0689,0.0877,0.0116,0.017,0.0861,0.0,0.9846,0.7975,0.0239,0.0,0.2414,0.1667,0.2083,0.0278,0.0753,0.0913,0.0117,0.0179,0.0854,0.0,0.9846,0.792,0.0239,0.0,0.2414,0.1667,0.2083,0.0276,0.0701,0.0893,0.0116,0.0173,0.0856,1.0,0.0,0.0,0.0,0.0,-2043.0,0.0,0.0,0.0,0.0,1.0,1.0,1.0,1.0,0.0,1.0,0.0,0.0,0.0,0.0,0.0,0.0,0.0,0.0,0.0,1.0,0.0,0.0,0.0,0.0,0.0,0.0,0.0,0.0,0.0,0.0,0.0,0.0,0.0,0.0,0.0,0.0,0.0,0.0,4.0,0.0,0.0,235320.75,0.0,0.0,0.0,0.0,0.0,-2314.5,-1492.5,-687.0,-1678.0,260.0,-36.5,5.0,9254.7,97978.95,95454.0,9000.0,97978.95,8.0,-2043.0,365243.0,-1995.0,-1905.0,-1845.0,-1901.0,17.0,0.0,0.0948070376748482,40.0,24.0,6.0,3.0,-63.5,0.0,0.0,20.0,9838.0575,9838.0575,-1938.0,-1920.0,4.0,1.0,0.0,,,,,,,,,,,,,,,,,,,,,8348804307.0,184432452061.5,165614610564.0,51983656507.935,1863.0,1705.0,71125.0,70843.0,9140.0,506175.0,17812.367800002292,17874.559599999106,17325.899999998033,11298.76590000009,11236.537400000092,11183.88640000006,128456.0,662990.0,4139.0302000001175,4136.699000000017,3947.269400000094,13530734.131506449,-602068495.0,-922133476.0,-296582783.0,-1535457621.0416667,44024.0,30708.0,11352.288399999186,11228.23999999898,10712.434999997293,22893.00520000972,22814.85710000968,22200.242500008244,67485.99806990706,158077.83600045278,126137.6393308017,35010.761000027946,34950.99180002838,34396.425900028786,22961.401499995907,22934.525499995485,22581.28959999572,3715058.0,8297.472900000164,8402.019800000075,8125.543100000231,9819.909700000717,9934.896000002162,10294.692099999646,16471.76399999976,16657.055299999694,16253.784399999702,828.8096000001764,813.9848000000459,759.9074000000132,3914.623700000124,3897.803500000164,3730.40100000016,436562.0,431356.0,1263492.0,6426.580738002898,632109.0,625660.0,,16336.006199999802,154218.07579999062,154220.82089999018,154112.55389998714,77632.78319999628,77970.66930000659,78372.13470000653,76.5,51900272.27999999,21442426.380000014,5441203249.335007,1806123111.39,59816254.67999996,709847.0099999999,97.0,12039.0,-17598700.5,7874265.0,-9108283.0,-9879147.0,-37.75,0.0,0.0,315000.0,0.0,0.0,0.0,0.0,0.0,-2542.0,-1994.0,-751.0,-2161.0,192922181.23499984,2745489967.4700017,3094268741.9100003,44513607.05999998,2745489967.4700017,198483.0,-13610924.0,3155874989.0,138555900.0,706857770.0,311814368.0,737405241.0,198073.0,3083.0,556.3411289024339,4580939.0,1624874.0,997769.5,-3265555.0,1182796.0,99789.0,2164540056.9975896,2182675456.73254,-132603226.0,-131527821.0,2368573.0,107479.5,,,,,,,,,,,,,,,,,,,,,1467798.0,14794589.0,3233441.0,8557178.0,11610405.0,1416065.0,1059263171.9145012,801776896.6724951,72121439499.77213,21678616610.572617,582516033.7994988,5792665.7475,689.5,94245.0,-276995867.0,21963568.0,-123818483.0,-218758255.0,-2019885.0,,,,,,,,,,,,,,,,,,,,,4274079.0,2479897.5,-9005705.0,921269.0,37582.5,3734527725.9449615,3659239536.592461,-260689418.0,-257377443.0,2527092.0,269267.5,3927189973.904956,33261680387.04842,36690959175.615135,1729882617.2550497,48096118695.89321,3988996.0,-247650133.5,103112509037.5,1054656207.5,17278372586.5,3504386285.0,18892028557.5,3672980.0,71941.0,20875.759481871868,89803264.0,-67.63836729668165,5.5833,3.192848020434228,142.08611067373468,17.826628352490424,793.3093817246628,22500.0,-0.9009688679024191,0.4338837391175582,0.0,0.0,0.0,0.0,0.0,0.0,1.0,0.0,0.0,0.0,0.0,0.0,0.0,1.0,0.0,1.0,0.0,0.0,0.0,0.0,1.0,0.0,0.0,0.0,0.0,1.0,0.0,0.0,0.0,0.0,1.0,0.0,0.0,0.0,0.0,0.0,0.0,0.0,0.0,0.0,0.0,0.0,0.0,0.0,0.0,0.0,0.0,0.0,0.0,0.0,0.0,0.0,0.0,1.0,0.0,0.0,0.0,0.0,0.0,0.0,0.0,0.0,0.0,0.0,0.0,0.0,0.0,0.0,0.0,0.0,0.0,0.0,0.0,0.0,0.0,0.0,0.0,0.0,0.0,0.0,0.0,0.0,0.0,0.0,0.0,0.0,0.0,0.0,0.0,0.0,0.0,0.0,0.0,0.0,0.0,0.0,0.0,0.0,0.0,0.0,0.0,0.0,0.0,0.0,0.0,0.0,0.0,0.0,1.0,0.0,1.0,0.0,0.0,0.0,0.0,0.0,0.0,0.0,1.0,0.0
103286,0,0.0,0.0,1.0,1.0,0.0,135000.0,135000.0,10575.0,135000.0,0.004849,47.83013698630136,-4513.0,-6483.0,-988.0,7.0,2.0,2.0,2.0,11.0,,0.5151624015962046,0.722392890081304,,,,,,,,,,,,,,,,,,,,,,,,,,,,,,,,,,,,,,,,,,,,,0.0,0.0,0.0,0.0,-1395.0,0.0,0.0,0.0,0.0,0.0,4.0,1.0,1.0,0.0,1.0,0.0,0.0,0.0,0.0,0.0,0.0,0.0,0.0,0.0,1.0,0.0,0.0,0.0,0.0,0.0,0.0,0.0,0.0,0.0,0.0,0.0,0.0,0.0,0.0,0.0,0.0,0.0,0.0,4.0,9499.5,,98844.75,0.0,,0.0,0.0,0.0,-209.0,294.0,-54.0,-169.0,109.0,-37.0,11.0,14697.495,135000.0,152820.0,0.0,191250.0,24.0,-877.0,365243.0,-1252.0,-1064.0,-562.0,-1061.0,14.0,1.0,0.0,-1.0,67.0,48.0,21.0,-34.0,0.0,0.0,74.0,16613.955,16601.8275,-933.0,-929.0,8.0,1.0,0.0,,,,,,,,,,,,,,,,,,,,,8348814882.0,184432587061.5,165614745564.0,51983791507.935,1863.0,1705.0,71125.0,70843.0,9140.0,506179.0,,,,,,,128456.0,662992.0,,,,13530781.961643437,-602073008.0,-922134464.0,-296584178.0,-1535464104.0416667,44024.0,30708.0,,,,,,,,158078.3511628544,126138.36172369178,,,,,,,3715069.0,,,,,,,,,,,,,,,,436562.0,431356.0,1263499.0,6426.585587002898,632111.0,625662.0,,,,,,,,,7.5,52000077.77999999,,5454260312.940004,1810240990.29,,709847.0099999999,98.0,12039.0,-17636177.0,7907360.0,-9124267.0,-9896478.0,-3.25,0.0,,45000.0,0.0,,0.0,0.0,0.0,-2779.0,874.0,-25.0,-169.0,193289696.59499985,2753714201.940001,3103114594.4100003,44541433.52999998,2753601701.940001,198883.0,-13628923.0,3160257905.0,138910340.0,708675612.0,312176698.0,739223140.0,198425.0,3089.0,556.6962748733858,4584051.0,1628748.0,1000610.0,-3268630.0,1182820.0,99800.0,2169143332.672594,2187282642.817544,-132842458.0,-131764732.0,2374702.0,107732.5,,,,,,,,,,,,,,,,,,,,,1467802.0,14794698.0,3233441.0,8557245.0,11610479.0,1416076.0,1059272671.4145012,,72121538344.52213,21678616610.572617,,5792665.7475,689.5,94245.0,-276996076.0,21963862.0,-123818537.0,-218758424.0,-2019922.0,,,,,,,,,,,,,,,,,,,,,4274127.0,2479918.5,-9005739.0,921269.0,37582.5,3734544339.899962,3659256138.419961,-260690351.0,-257378372.0,2527100.0,269268.5,3927204671.399956,33261815387.04842,36691111995.615135,1729882617.2550497,48096309945.89321,3989020.0,-247651010.5,103112874280.5,1054654955.5,17278371522.5,3504385723.0,18892027496.5,3672994.0,71942.0,20875.759481871868,89803263.0,-94.3547370832856,1.0,12.76595744680851,610.5974934421453,12.76595744680851,610.5974934421453,67500.0,-0.9009688679024191,0.4338837391175582,0.0,0.0,0.0,0.0,0.0,0.0,1.0,0.0,1.0,0.0,0.0,0.0,0.0,0.0,0.0,0.0,0.0,0.0,1.0,1.0,0.0,0.0,0.0,0.0,0.0,1.0,0.0,0.0,0.0,0.0,0.0,0.0,0.0,1.0,0.0,0.0,0.0,0.0,0.0,0.0,0.0,0.0,0.0,0.0,0.0,0.0,0.0,0.0,0.0,0.0,0.0,0.0,0.0,0.0,0.0,0.0,0.0,0.0,0.0,0.0,0.0,0.0,0.0,0.0,0.0,0.0,0.0,0.0,0.0,0.0,0.0,0.0,0.0,0.0,0.0,0.0,0.0,0.0,0.0,0.0,0.0,0.0,0.0,0.0,0.0,0.0,0.0,0.0,0.0,0.0,1.0,0.0,0.0,0.0,0.0,0.0,0.0,0.0,0.0,0.0,0.0,0.0,0.0,0.0,0.0,0.0,0.0,0.0,0.0,0.0,0.0,0.0,0.0,0.0,0.0,0.0,0.0,0.0,0.0,0.0
103287,0,0.0,0.0,0.0,1.0,0.0,180000.0,450000.0,23107.5,450000.0,0.010032,43.98356164383562,-2530.0,-5558.0,-5380.0,,2.0,2.0,2.0,4.0,0.4687869474791264,0.0029754979456439,0.1464420666789632,,,,,,,,,,,,,,,,,,,,,,,,,,,,,,,,,,,,,,,,,,,,,1.0,1.0,1.0,1.0,0.0,0.0,0.0,0.0,0.0,1.0,1.0,1.0,1.0,1.0,1.0,1.0,0.0,0.0,0.0,0.0,0.0,1.0,1.0,0.0,1.0,0.0,0.0,0.0,0.0,0.0,0.0,0.0,0.0,0.0,0.0,0.0,0.0,0.0,0.0,0.0,0.0,0.0,0.0,14.0,19935.0,0.0,450000.0,69302.25,0.0,0.0,0.0,0.0,-1125.0,-408.5,-653.5,-1129.0,571.0,-23.0,6.0,11250.0,143766.0,143766.0,2238.75,143766.0,12.0,-1473.5,365243.0,-280.0,-280.0,50.0,-278.0,6.0,0.0,0.0544545454545454,44.0,5.0,2.0,0.0,-94.0,0.0,0.0,2.0,210020.85,210020.85,-1597.5,-1594.0,1.5,2.0,0.0,,,,,,,,,,,,,,,,,,,,,8348837989.5,184433037061.5,165615195564.0,51983971507.935,1863.0,1705.0,71125.0,70844.0,9140.0,506180.0,,,,,,,128456.0,662994.0,,,,13530825.94520508,-602075538.0,-922139844.0,-296584178.0,-1535469662.0416667,44025.0,30709.0,,,,,,,67486.46685685452,158078.35413835236,126138.50816575844,,,,,,,3715073.0,,,,,,,,,,,,,,,,436563.0,431357.0,,6426.595619002898,632113.0,625664.0,,,,,,,,,37.5,52107330.77999999,21474191.07000001,5457587284.440004,1810532754.54,59908678.82999996,709847.0099999999,98.0,12039.0,-17652398.5,7906530.0,-9134574.0,-9903792.0,-18.25,17532.0,0.0,344700.0,0.0,0.0,0.0,0.0,0.0,-1941.0,-1272.0,-1272.0,-1635.0,193388739.16499987,2754766495.440001,3104321561.9100003,44552672.27999998,2754766495.440001,199013.0,-13637437.5,3161353634.0,138907061.0,708674118.0,312174169.0,739221655.0,198517.5,3089.0,556.9303288431629,4584519.0,1629472.0,1001069.0,-3269971.0,1182832.0,99812.0,2170413394.9650946,2188641036.240044,-132885050.0,-131807175.0,2374993.0,107798.0,,,,,,,,,,,,,,,,,,,,,1467816.0,14795269.0,3233441.0,8557250.0,11610481.0,1416082.0,1059292606.4145012,801776896.6724951,72121988344.52213,21678685912.822617,582516033.7994988,5792665.7475,689.5,94245.0,-276997201.0,21963453.5,-123819190.5,-218759553.0,-2019945.0,,,,,,,,,,,,,,,,,,,,,4274129.0,2479918.5,-9005833.0,921269.0,37582.5,3734754360.749962,3659466159.269961,-260691948.5,-257379966.0,2527101.5,269270.5,3927215921.399956,33261959153.04842,36691255761.615135,1729884856.0050497,48096453711.89321,3989032.0,-247652484.0,103113239523.5,1054654675.5,17278371242.5,3504385773.0,18892027218.5,3673000.0,71942.0,20875.81393641733,89803307.0,-57.52148997134671,2.5,7.789678675754625,342.61781222072534,19.474196689386567,856.5445305518132,90000.0,-0.9009688679024191,-0.433883739117558,0.0,0.0,0.0,0.0,0.0,0.0,1.0,0.0,1.0,0.0,0.0,0.0,0.0,0.0,0.0,0.0,0.0,0.0,1.0,0.0,1.0,0.0,0.0,0.0,0.0,1.0,0.0,0.0,0.0,0.0,0.0,0.0,0.0,0.0,0.0,0.0,0.0,0.0,0.0,0.0,0.0,0.0,0.0,0.0,1.0,0.0,0.0,0.0,0.0,0.0,0.0,0.0,0.0,0.0,0.0,0.0,0.0,0.0,0.0,0.0,0.0,0.0,0.0,0.0,0.0,0.0,0.0,0.0,0.0,0.0,0.0,0.0,0.0,0.0,0.0,0.0,0.0,0.0,0.0,0.0,0.0,0.0,0.0,0.0,0.0,0.0,0.0,0.0,0.0,0.0,1.0,0.0,0.0,0.0,0.0,0.0,0.0,0.0,0.0,0.0,0.0,0.0,0.0,0.0,0.0,0.0,0.0,0.0,0.0,0.0,0.0,0.0,0.0,0.0,0.0,0.0,0.0,0.0,0.0,0.0
103290,0,0.0,1.0,1.0,1.0,1.0,225000.0,543037.5,33349.5,463500.0,0.035792,37.75616438356165,-4404.0,-4032.0,-4665.0,7.0,3.0,2.0,2.0,14.0,0.3439797268743812,0.6219167522470002,0.6279908192952864,,,,,,,,,,,,,,,,,,,,,,,,,,,,,,,,,,,,,,,,,,,,,3.0,0.0,3.0,0.0,-2238.0,0.0,0.0,0.0,0.0,1.0,3.0,1.0,1.0,1.0,1.0,0.0,0.0,0.0,0.0,0.0,0.0,0.0,0.0,0.0,1.0,0.0,0.0,0.0,0.0,0.0,0.0,0.0,0.0,0.0,0.0,0.0,0.0,0.0,0.0,0.0,0.0,0.0,0.0,3.0,,0.0,80687.25,0.0,0.0,0.0,0.0,0.0,-1903.0,-1719.0,-1719.0,-2215.0,186.0,-32.5,4.0,42359.8725,420358.5,431147.25,12024.0,420358.5,12.0,-1283.0,365243.0,-2207.0,-1877.0,-1877.0,-1874.0,14.0,1.0,0.1085008473951595,530.0,34.0,12.0,5.0,-67.5,0.0,0.0,33.0,17646.12,17646.12,-2061.0,-2057.0,5.0,1.0,0.0,,,,,,,,,,,,,,,,,,,,,8348871339.0,184433580099.0,165615659064.0,51984196507.935,1863.0,1705.0,71125.0,70845.0,9140.0,506183.0,,,,,,,128457.0,662997.0,,,,13530863.701369464,-602079942.0,-922144509.0,-296586416.0,-1535473694.0416667,44025.0,30709.0,,,,,,,67486.81083658141,158078.9760551046,126139.13615657776,,,,,,,3715087.0,,,,,,,,,,,,,,,,436566.0,431360.0,1263506.0,6426.631411002898,632115.0,625666.0,,,,,,,,,63.0,,21474191.07000001,5468677520.805005,1813219325.55,59908678.82999996,709847.0099999999,98.0,12039.0,-17670594.0,7935342.0,-9144008.0,-9914804.5,-31.0,,0.0,25191.0,0.0,0.0,0.0,0.0,0.0,-2894.0,-2711.0,-2710.0,-2711.0,193574690.21249992,2756623964.940001,3106238084.9100003,44572659.02999998,2756623964.940001,199101.0,-13649316.0,3163910335.0,139264641.0,709396502.0,312533277.0,740309312.0,198673.5,3092.0,557.2323918906217,4592187.5,1630116.0,1001387.5,-3273418.0,1182858.0,99812.0,2171288202.570096,2189498043.465046,-132964345.0,-131885896.0,2375306.0,107858.0,,,,,,,,,,,,,,,,,,,,,1467819.0,14795455.0,3233441.0,8557284.0,11610514.0,1416086.0,,801776896.6724951,72122069031.77213,21678685912.822617,582516033.7994988,5792665.7475,689.5,94245.0,-276999104.0,21961734.5,-123820909.5,-218761768.0,-2019977.5,,,,,,,,,,,,,,,,,,,,,4274141.0,2479923.5,-9005900.5,921269.0,37582.5,3734772006.869961,3659483805.389961,-260694009.5,-257382023.0,2527106.5,269271.5,3927258281.272456,33262379511.54842,36691686908.865135,1729896880.0050497,48096874070.39321,3989044.0,-247653767.0,103113604766.5,1054652468.5,17278369365.5,3504383896.0,18892025344.5,3673014.0,71943.0,20875.92243726472,89803837.0,-116.6432044118714,2.4135,6.746727836999057,254.7305652648876,16.28322763459722,614.7922192668062,75000.0,-0.9009688679024191,-0.433883739117558,0.0,0.0,0.0,0.0,0.0,0.0,1.0,0.0,0.0,0.0,1.0,0.0,0.0,0.0,0.0,0.0,0.0,0.0,1.0,0.0,1.0,0.0,0.0,0.0,0.0,1.0,0.0,0.0,0.0,0.0,0.0,0.0,0.0,1.0,0.0,0.0,0.0,0.0,0.0,0.0,0.0,0.0,0.0,0.0,0.0,0.0,0.0,0.0,0.0,0.0,0.0,0.0,0.0,0.0,0.0,0.0,0.0,0.0,0.0,0.0,0.0,0.0,0.0,0.0,0.0,0.0,0.0,0.0,0.0,0.0,0.0,0.0,0.0,0.0,0.0,0.0,0.0,0.0,0.0,1.0,0.0,0.0,0.0,0.0,0.0,0.0,0.0,0.0,0.0,0.0,0.0,0.0,0.0,0.0,0.0,0.0,0.0,0.0,0.0,0.0,0.0,0.0,0.0,0.0,0.0,0.0,0.0,0.0,0.0,0.0,0.0,0.0,0.0,0.0,0.0,0.0,0.0,0.0,0.0,0.0
103298,0,0.0,0.0,0.0,1.0,0.0,36000.0,360000.0,15264.0,360000.0,0.0105,46.59178082191781,-2764.0,-3075.0,-547.0,,2.0,3.0,3.0,15.0,0.4416397634406712,0.678057934536223,0.6092756673894402,,,,,,,,,,,,,,,,,,,,,,,,,,,,,,,,,,,,,,,,,,,,,2.0,0.0,2.0,0.0,-1879.0,0.0,0.0,0.0,0.0,0.0,1.0,1.0,1.0,1.0,1.0,1.0,0.0,0.0,0.0,0.0,0.0,1.0,1.0,0.0,1.0,0.0,0.0,0.0,0.0,0.0,0.0,0.0,0.0,0.0,0.0,0.0,0.0,0.0,0.0,0.0,0.0,0.0,0.0,3.0,3287.25,,135000.0,111804.75,0.0,0.0,0.0,0.0,-968.0,400.0,-193.0,-1199.0,109.0,-18.0,6.0,3865.005,28077.75,27272.25,0.0,28077.75,12.0,-1337.0,365243.0,-1306.0,-1186.0,-1186.0,-1178.5,9.5,0.0,0.0,30.0,68.0,12.0,4.5,-51.0,0.0,0.0,59.0,3960.675,3960.675,-1650.0,-1638.0,5.0,1.0,0.0,,,,,,,,,,,,,,,,,,,,,8348886603.0,184433940099.0,165616019064.0,51984232507.935,1863.0,1705.0,71125.0,70845.0,9140.0,506184.0,,,,,,,128457.0,662999.0,,,,13530910.293150283,-602082706.0,-922145056.0,-296588295.0,-1535476769.0416667,44025.0,30709.0,,,,,,,67487.25247634486,158079.65411303914,126139.74543224517,,,,,,,3715102.0,,,,,,,,,,,,,,,,436568.0,431362.0,,6426.641911002898,632118.0,625669.0,,,,,,,,,32.0,52248153.86999998,,5478737172.525003,1815151540.635,60130951.91999996,709847.0099999999,98.0,12039.0,-17726508.0,8008735.0,-9169264.0,-9944571.0,-15.5,0.0,,135000.0,44559.0,0.0,0.0,0.0,0.0,-968.0,400.0,-193.0,-1199.0,194038702.875,2762283137.940001,3112497591.6600003,44667582.02999998,2762283137.940001,199513.0,-13673487.5,3171031681.5,139246307.0,712672848.0,313255767.0,743585738.5,199190.5,3100.0,558.4343302374258,4607063.0,1633510.0,1003767.5,-3278415.5,1182874.0,99818.0,2176754467.095093,2195847617.445044,-133126125.0,-132045430.0,2378106.0,108072.0,,,,,,,,,,,,,,,,,,,,,1467822.0,14795564.0,3233441.0,8557352.0,11610573.0,1416092.0,1059295893.6645012,,72122204031.77213,21678797717.572617,582516033.7994988,5792665.7475,689.5,94245.0,-277000072.0,21962134.5,-123821102.5,-218762967.0,-2019995.5,,,,,,,,,,,,,,,,,,,,,4274153.0,2479928.0,-9005951.5,921269.0,37582.5,3734775967.544962,3659487766.064961,-260695659.5,-257383661.0,2527111.5,269272.5,3927262146.277456,33262407589.29842,36691714181.115135,1729896880.0050497,48096902148.14321,3989056.0,-247655104.0,103113970009.5,1054651162.5,17278368179.5,3504382710.0,18892024166.0,3673023.5,71943.0,20875.92243726472,89803867.0,-59.32376808185346,10.0,2.358490566037736,109.88627552339103,23.58490566037736,1098.8627552339103,18000.0,-0.2225209339563143,0.9749279121818236,0.0,1.0,0.0,0.0,0.0,0.0,0.0,0.0,0.0,0.0,0.0,0.0,0.0,1.0,0.0,0.0,0.0,0.0,1.0,0.0,1.0,0.0,0.0,0.0,0.0,1.0,0.0,0.0,0.0,0.0,0.0,0.0,0.0,0.0,0.0,0.0,0.0,0.0,1.0,0.0,0.0,0.0,0.0,0.0,0.0,0.0,0.0,0.0,0.0,0.0,0.0,0.0,0.0,0.0,0.0,0.0,0.0,0.0,0.0,0.0,0.0,0.0,0.0,0.0,0.0,0.0,0.0,0.0,0.0,0.0,0.0,0.0,0.0,0.0,0.0,0.0,1.0,0.0,0.0,0.0,0.0,0.0,0.0,0.0,0.0,0.0,0.0,0.0,0.0,0.0,0.0,0.0,0.0,0.0,0.0,0.0,0.0,0.0,0.0,0.0,0.0,0.0,0.0,0.0,0.0,0.0,0.0,0.0,0.0,0.0,0.0,0.0,0.0,0.0,0.0,0.0,0.0,0.0,0.0,0.0
103315,0,0.0,0.0,1.0,1.0,0.0,117000.0,547344.0,24237.0,472500.0,0.030755,64.87945205479453,,-14339.0,-4336.0,1.0,2.0,2.0,2.0,10.0,0.8496588596873386,0.7238075448165979,0.5620604831738043,0.0722,0.0811,0.9776,0.6940000000000001,0.0079,0.0,0.1379,0.1667,0.2083,0.0766,0.0588,0.0628,0.0,0.0,0.0735,0.0842,0.9777,0.706,0.008,0.0,0.1379,0.1667,0.2083,0.0783,0.0643,0.0655,0.0,0.0,0.0729,0.0811,0.9776,0.6981,0.008,0.0,0.1379,0.1667,0.2083,0.0779,0.0599,0.064,0.0,0.0,0.0537,1.0,0.0,0.0,0.0,0.0,-2933.0,0.0,0.0,0.0,0.0,0.0,6.0,1.0,0.0,0.0,1.0,0.0,1.0,0.0,0.0,0.0,0.0,0.0,0.0,0.0,0.0,0.0,0.0,1.0,0.0,0.0,0.0,0.0,0.0,0.0,0.0,0.0,0.0,0.0,0.0,0.0,0.0,0.0,0.0,12.0,0.0,,96412.5,0.0,0.0,0.0,0.0,0.0,-1651.5,-1032.5,-555.5,-1194.0,609.0,-25.0,7.0,14248.1475,46080.0,35374.5,12375.0,102580.875,8.0,-675.0,365243.0,-1304.0,-1094.0,-1094.0,-1089.5,12.0,0.0,0.2035004469158925,-1.0,30.0,6.0,4.0,-40.5,0.0,0.0,184.0,5625.0,5625.0,-1384.5,-1376.5,66.5,0.0,96.0,103305.2625,112500.0,0.0,0.0,0.0,0.0,5625.0,6750.0,6750.0,99948.33,103305.2625,103305.2625,0.0,0.0,0.0,0.0,48.0,-48.5,0.0,0.0,8348910840.0,184434487443.0,165616491564.0,51984349507.935,1863.0,1705.0,71125.0,70845.0,9140.0,506190.0,17812.44000000229,17874.632499999105,17325.973499998032,11298.847000000089,11236.618500000091,11183.970600000055,128457.0,663001.0,4139.038100000117,4136.707000000017,3947.277400000093,13530975.17260234,,-922149392.0,-296591228.0,-1535491108.0416667,44025.0,30709.0,11352.288399999186,11228.23999999898,10712.434999997293,22893.14310000972,22814.99500000968,22200.38040000824,67488.10213520454,158080.37792058394,126140.30749272832,35010.92770002795,34951.15850002838,34396.592600028795,22961.609799995906,22934.733799995483,22581.49789999572,3715112.0,8297.549500000165,8402.097700000075,8125.621400000231,9819.968500000718,9934.955900002162,10294.756399999646,16471.82679999976,16657.119299999693,16253.849899999705,828.8096000001764,813.9848000000459,759.9074000000132,3914.623700000124,3897.803500000164,3730.40100000016,436568.0,431362.0,1263507.0,6426.672666002898,632120.0,625671.0,,16336.059899999802,154219.05339999063,154221.7984999902,154113.53159998715,77633.47719999628,77971.36740000657,78372.84070000655,55.0,52335498.86999998,,5508398702.295002,1825395144.2100005,60649146.35999996,709847.0099999999,99.0,12039.0,-17810444.5,8025318.0,-9210009.0,-9987783.5,-27.0,0.0,,85500.0,0.0,0.0,0.0,0.0,0.0,-2144.0,-1492.0,-1191.0,-1194.0,195010330.00499988,2777417227.440001,3130270046.9100003,44815650.02999998,2777440267.440001,200436.0,-13708575.0,3182718807.5,139219756.5,715575124.5,313976572.5,746488897.0,199956.0,3113.0,560.5470212703665,4620980.0,1639639.0,1007989.5,-3289876.0,1182874.0,99818.0,2189603296.800111,2210845989.2400603,-133684887.5,-132599379.5,2394695.0,108447.0,2097389374.7624872,5595342750.0,177194743.55999997,272330375.80499953,10245378.6,84652123.54499994,119295177.74999964,298414949.1299991,275497448.80499977,2012755429.034994,2089313688.8024845,2089394060.7374845,9141.0,22789.0,137.0,13511.0,691627.0,-1225466.5,554753.0,1196.0,1467834.0,14796173.0,3233537.0,8557382.0,11610757.0,1416099.0,1059295893.6645012,,72122300444.27213,21678797717.572617,582516033.7994988,5792665.7475,689.5,94245.0,-277001723.5,21961102.0,-123821658.0,-218764161.0,-2020020.5,5923959840.629961,18725976000.0,198810057.825,447987579.2549976,1948107.735,256782765.80250075,309174063.97499865,636629885.9999981,459217582.1999993,5709072648.577533,5887237632.097499,5887480814.8425,13384.5,80841.0,44.0,70351.5,971715.0,-1698961.0,177364.0,6755.0,4274159.0,2479932.0,-9005992.0,921269.0,37582.5,3734781592.544962,3659493391.064961,-260697044.0,-257385037.5,2527178.0,269272.5,3927276394.424956,33262453669.29842,36691749555.615135,1729909255.0050497,48097004729.01821,3989064.0,-247655779.0,103114335252.5,1054649858.5,17278367085.5,3504381616.0,18892023076.5,3673035.5,71943.0,20876.12593771164,89803866.0,,4.678153846153847,4.827330115113257,313.1945327561562,22.58299294467137,1465.1722080075692,58500.0,-0.9009688679024191,-0.433883739117558,0.0,1.0,0.0,0.0,0.0,0.0,0.0,0.0,0.0,1.0,0.0,0.0,0.0,0.0,0.0,0.0,0.0,0.0,1.0,0.0,1.0,0.0,0.0,0.0,0.0,1.0,0.0,0.0,0.0,0.0,0.0,0.0,0.0,0.0,0.0,0.0,0.0,0.0,0.0,0.0,0.0,0.0,0.0,0.0,0.0,0.0,0.0,0.0,0.0,0.0,0.0,0.0,0.0,0.0,0.0,0.0,0.0,0.0,0.0,0.0,0.0,0.0,0.0,0.0,0.0,0.0,0.0,0.0,0.0,0.0,0.0,0.0,0.0,0.0,0.0,0.0,0.0,0.0,0.0,0.0,0.0,0.0,0.0,0.0,0.0,0.0,0.0,0.0,0.0,0.0,0.0,0.0,0.0,0.0,0.0,0.0,0.0,0.0,0.0,0.0,0.0,0.0,0.0,0.0,0.0,1.0,0.0,0.0,1.0,0.0,1.0,0.0,0.0,0.0,0.0,0.0,0.0,0.0,1.0,0.0
103319,0,0.0,0.0,0.0,0.0,1.0,270000.0,550980.0,35343.0,450000.0,0.032561,48.6,-7267.0,-7160.0,-1238.0,,3.0,1.0,1.0,15.0,,0.7219326066696946,0.3523399726917038,0.0722,,0.9757,,,,0.2414,0.1667,,0.088,,0.0633,,0.0031,0.0735,,0.9757,,,,0.2414,0.1667,,0.09,,0.066,,0.0033,0.0729,,0.9757,,,,0.2414,0.1667,,0.0896,,0.0645,,0.0032,0.0504,1.0,0.0,0.0,0.0,0.0,-2185.0,0.0,0.0,0.0,0.0,0.0,3.0,1.0,1.0,0.0,1.0,1.0,0.0,0.0,0.0,0.0,0.0,0.0,0.0,0.0,0.0,0.0,0.0,0.0,0.0,0.0,1.0,0.0,0.0,0.0,0.0,0.0,0.0,0.0,0.0,0.0,0.0,0.0,0.0,0.0,,,,,,,,,,,,,0.0,,4.0,22500.0,287730.0,266994.0,58500.0,450000.0,12.0,-798.0,365243.0,-768.0,-78.0,-78.0,-73.0,16.5,0.0,0.4471381322063484,-1.0,38.0,24.0,8.5,-20.5,0.0,0.0,43.0,31406.31,25407.27,-527.0,-528.0,11.0,1.0,26.0,0.0,450000.0,,0.0,,,0.0,,0.0,0.0,0.0,0.0,,0.0,,,0.0,-13.5,0.0,0.0,8348946183.0,184435038423.0,165616941564.0,51984619507.935,1863.0,1705.0,71125.0,70845.0,9140.0,506193.0,17812.51220000229,17874.705399999104,17326.04699999803,,,,128458.0,663004.0,,,,13531023.77260234,-602089973.0,-922150630.0,-296593413.0,-1535498268.0416667,44025.0,30709.0,,,,22893.38450000972,22815.23640000968,22200.62180000824,,158081.09985319062,126140.659832701,35011.09440002795,34951.325200028376,34396.7593000288,,,,3715127.0,8297.637500000164,8402.187300000074,8125.711400000231,,,,16471.890099999757,16657.183799999693,16253.915899999703,,,,3914.626800000124,3897.806700000164,3730.40430000016,436568.0,431362.0,,6426.705227002898,632121.0,625672.0,,16336.110299999802,154220.02909999064,154222.7741999902,154114.50729998716,,,,,,,,,,,,,,,,,,,,,,,,,,,,,,195280059.37499988,2783100675.690001,3136475209.4100003,44898879.77999998,2783037945.690001,200721.0,-13722434.5,3185823373.0,139577360.0,716666411.0,314338901.0,747580211.0,200273.5,3113.0,561.2963623093468,4624477.0,1642886.0,1010027.5,-3292666.5,1182876.0,99820.0,2193868210.365109,2215746557.595059,-133879003.0,-132792046.0,2402737.0,108642.0,2101996578.3749871,5607976500.0,,272598125.80499953,,,119607927.74999964,,275970286.30499977,2017171144.9349933,2093920892.4149845,2094001264.349985,,22809.0,,,693859.0,-1227892.5,554753.0,1196.0,1467834.0,14796173.0,3233563.0,8557420.0,11610800.0,1416103.0,,,,,,,,,,,,,,5923959840.629961,18726426000.0,,447987579.2549976,,,309174063.97499865,,459217582.1999993,5709072648.577533,5887237632.097499,5887480814.8425,,80841.0,,,971715.0,-1698974.5,177364.0,6755.0,4274183.0,2479940.5,-9006012.5,921269.0,37582.5,3734812998.854962,3659518798.334961,-260697571.0,-257385565.5,2527189.0,269273.5,3927298894.424956,33262741399.29842,36692016549.615135,1729967755.0050497,48097454729.01821,3989076.0,-247656577.0,103114700495.5,1054649090.5,17278367007.5,3504381538.0,18892023003.5,3673052.0,71943.0,20876.573075843844,89803865.0,-149.5267489711934,2.040666666666666,7.639419404125286,371.2757830404889,15.589508530685002,757.6501145912912,90000.0,-0.2225209339563143,0.9749279121818236,0.0,0.0,0.0,0.0,0.0,0.0,1.0,0.0,0.0,0.0,0.0,0.0,0.0,1.0,0.0,0.0,0.0,0.0,1.0,0.0,1.0,0.0,0.0,0.0,0.0,0.0,1.0,0.0,0.0,0.0,0.0,0.0,0.0,0.0,0.0,0.0,0.0,0.0,0.0,0.0,0.0,1.0,0.0,0.0,0.0,0.0,0.0,0.0,0.0,0.0,0.0,0.0,0.0,0.0,0.0,0.0,0.0,0.0,0.0,0.0,0.0,0.0,0.0,0.0,0.0,0.0,0.0,0.0,0.0,0.0,0.0,0.0,0.0,0.0,0.0,0.0,0.0,0.0,1.0,0.0,0.0,0.0,0.0,0.0,0.0,0.0,0.0,0.0,0.0,0.0,0.0,0.0,0.0,0.0,0.0,0.0,0.0,0.0,0.0,0.0,0.0,0.0,0.0,0.0,0.0,0.0,0.0,0.0,0.0,0.0,1.0,0.0,0.0,0.0,0.0,0.0,0.0,1.0,0.0,0.0
103334,0,0.0,1.0,1.0,1.0,0.0,180000.0,454500.0,36040.5,454500.0,0.0145199999999999,38.293150684931504,-1662.0,-1456.0,-2849.0,17.0,2.0,2.0,2.0,12.0,,0.6695220807726824,0.3774042489507649,,,,,,,,,,,,,,,,,,,,,,,,,,,,,,,,,,,,,,,,,,,,,1.0,0.0,1.0,0.0,-1431.0,0.0,0.0,0.0,0.0,0.0,4.0,1.0,1.0,0.0,1.0,0.0,0.0,0.0,0.0,0.0,1.0,1.0,0.0,0.0,1.0,0.0,0.0,0.0,0.0,0.0,0.0,0.0,0.0,0.0,0.0,0.0,0.0,0.0,0.0,0.0,0.0,0.0,0.0,12.0,4014.945,0.0,194805.0,12737.25,0.0,0.0,0.0,0.0,-865.0,226.0,-123.0,-867.5,341.0,-15.0,22.0,16164.0,270000.0,270000.0,1327.5,360000.0,36.0,-400.0,365243.0,-1905.0,-1650.0,-1575.0,-1645.0,10.0,1.0,0.0521561393152302,-1.0,42.0,12.0,6.5,-53.5,0.0,0.0,39.0,12178.125,12178.125,-1648.0,-1623.0,5.0,1.0,0.0,,,,,,,,,,,,,,,,,,,,,8348982223.5,184435492923.0,165617396064.0,51984799507.935,1863.0,1705.0,71125.0,70845.0,9140.0,506197.0,,,,,,,128458.0,663006.0,,,,13531062.065753024,-602091635.0,-922153479.0,-296594844.0,-1535499724.0416667,44025.0,30709.0,,,,,,,,158081.7693752714,126141.03723694994,,,,,,,3715139.0,,,,,,,,,,,,,,,,436569.0,431363.0,1263524.0,6426.719747002898,632123.0,625674.0,,,,,,,,,29.0,53300700.13499998,21607622.86500001,5542895571.435,1838805440.3550005,61479879.47999995,709847.0099999999,99.0,12039.0,-17920020.5,8032480.0,-9264192.5,-10048312.0,-14.0,1350.0,0.0,164610.0,0.0,0.0,0.0,0.0,0.0,-1158.0,-10.0,-524.0,-875.0,195872985.8549999,2791292512.230001,3145584596.3100004,44947632.41999998,2792687512.230001,201463.0,-13766347.0,3195867555.5,139905178.0,718462446.0,314677036.5,749377148.0,200929.5,3121.5,562.4251459146201,4633607.5,1648210.0,1012665.0,-3306783.0,1182898.0,99842.0,2199982306.3651147,2221277364.630065,-134246112.0,-133155819.0,2405267.0,108964.0,,,,,,,,,,,,,,,,,,,,,1467846.0,14796514.0,3233563.0,8557462.0,11610839.0,1416125.0,1059299908.6095012,801776896.6724951,72122495249.27213,21678810454.822617,582516033.7994988,5792665.7475,689.5,94245.0,-277002588.5,21961328.0,-123821781.0,-218765028.5,-2020035.5,,,,,,,,,,,,,,,,,,,,,4274195.0,2479947.0,-9006066.0,921269.0,37582.5,3734825176.979962,3659530976.459961,-260699219.0,-257387188.5,2527194.0,269274.5,3927315058.424956,33263011399.29842,36692286549.615135,1729969082.5050497,48097814729.01821,3989112.0,-247656977.0,103115065738.5,1054647185.5,17278365357.5,3504379963.0,18892021358.5,3673062.0,71944.0,20876.62523198316,89803864.0,-43.40201760034343,2.525,4.99438132101386,191.250596503591,12.610812835559996,482.90775617156726,90000.0,-0.9009688679024191,0.4338837391175582,0.0,0.0,0.0,0.0,0.0,0.0,1.0,0.0,0.0,0.0,0.0,0.0,0.0,1.0,0.0,0.0,0.0,0.0,1.0,0.0,1.0,0.0,0.0,0.0,0.0,1.0,0.0,0.0,0.0,0.0,0.0,0.0,0.0,0.0,1.0,0.0,0.0,0.0,0.0,0.0,0.0,0.0,0.0,0.0,0.0,0.0,0.0,0.0,0.0,0.0,0.0,0.0,0.0,1.0,0.0,0.0,0.0,0.0,0.0,0.0,0.0,0.0,0.0,0.0,0.0,0.0,0.0,0.0,0.0,0.0,0.0,0.0,0.0,0.0,0.0,0.0,0.0,0.0,0.0,0.0,0.0,0.0,0.0,0.0,0.0,0.0,0.0,0.0,0.0,0.0,0.0,0.0,0.0,0.0,0.0,0.0,0.0,0.0,0.0,0.0,0.0,0.0,0.0,0.0,0.0,0.0,0.0,0.0,0.0,0.0,0.0,0.0,0.0,0.0,0.0,0.0,0.0,0.0,0.0,0.0
103336,0,0.0,1.0,0.0,0.0,0.0,67500.0,67500.0,5220.0,67500.0,0.026392,38.40821917808219,,-6244.0,-4463.0,,1.0,2.0,2.0,17.0,0.3338794902152114,0.4271153275575848,,,,,,,,,,,,,,,,,,,,,,,,,,,,,,,,,,,,,,,,,,,,,,0.0,0.0,0.0,0.0,-614.0,,,,,,,1.0,0.0,0.0,1.0,0.0,0.0,0.0,0.0,0.0,0.0,0.0,0.0,0.0,1.0,0.0,0.0,0.0,0.0,0.0,0.0,0.0,0.0,0.0,0.0,0.0,0.0,0.0,0.0,0.0,0.0,0.0,0.0,0.0,,,,,,,,,,,,,0.0,,10.0,5607.4725,44752.5,38520.0,4.275,51007.5,12.0,-803.5,365243.0,-1474.0,-1204.0,-1204.0,-1198.5,10.0,0.0,6.569140623534444e-05,40.5,71.0,12.0,6.0,-31.0,0.0,0.0,69.0,5405.265,5405.265,-959.0,-947.0,6.0,1.0,0.0,,,,,,,,,,,,,,,,,,,,,8348987443.5,184435560423.0,165617463564.0,51984867007.935,,,,,,,,,,,,,128458.0,663007.0,,,,13531100.473972203,,-922157942.0,-296595458.0,-1535505968.0416667,44025.0,30709.0,,,,,,,67488.43601469473,158082.19649059896,,,,,,,,3715156.0,,,,,,,,,,,,,,,,436569.0,431363.0,,6426.7461390028975,632125.0,625676.0,,,,,,,,,,,,,,,,,,,,,,,,,,,,,,,,,,,196021964.385,2795941943.730001,3150307260.8100004,44974609.91999998,2795974191.7425013,201783.0,-13782302.5,3198059013.5,139895343.5,718454426.5,314669769.5,749734408.5,201114.0,3123.5,563.1324687744253,4637883.5,1649469.0,1013548.0,-3310258.0,1182898.0,99842.0,2201080657.725114,2222369921.790065,-134348999.0,-133257936.0,2405683.0,109031.0,,,,,,,,,,,,,,,,,,,,,1467846.0,14796514.0,3233563.0,8557533.0,11610908.0,1416135.0,,,,,,,,,,,,,,,,,,,,,,,,,,,,,,,,,,4274207.0,2479953.0,-9006097.0,921269.0,37582.5,3734830582.244961,3659536381.724961,-260700178.0,-257388135.5,2527200.0,269275.5,3927320665.897456,33263056151.79842,36692325069.615135,1729969086.780049,48097865736.51821,3989124.0,-247657780.5,103115430981.5,1054645711.5,17278364153.5,3504378759.0,18892020160.0,3673072.0,71944.0,20876.625297674564,89803904.5,,1.0,12.93103448275862,496.6580066131318,12.93103448275862,496.6580066131318,67500.0,-0.9009688679024191,0.4338837391175582,0.0,0.0,0.0,0.0,0.0,0.0,1.0,0.0,0.0,1.0,0.0,0.0,0.0,0.0,0.0,0.0,1.0,0.0,0.0,0.0,0.0,0.0,1.0,0.0,0.0,1.0,0.0,0.0,0.0,0.0,0.0,0.0,0.0,0.0,0.0,0.0,0.0,0.0,0.0,0.0,0.0,0.0,0.0,0.0,0.0,0.0,0.0,0.0,0.0,0.0,0.0,0.0,0.0,0.0,0.0,0.0,0.0,0.0,0.0,0.0,0.0,0.0,0.0,0.0,0.0,0.0,0.0,0.0,0.0,0.0,0.0,0.0,0.0,0.0,0.0,0.0,0.0,0.0,0.0,0.0,0.0,0.0,0.0,0.0,0.0,0.0,0.0,0.0,0.0,0.0,0.0,0.0,0.0,0.0,0.0,0.0,0.0,0.0,0.0,0.0,0.0,0.0,0.0,0.0,0.0,1.0,0.0,0.0,0.0,0.0,0.0,0.0,0.0,0.0,0.0,0.0,0.0,0.0,0.0,0.0
103345,0,0.0,1.0,1.0,1.0,0.0,360000.0,690313.5,35374.5,549000.0,0.01885,45.48219178082192,-3355.0,-4639.0,-125.0,4.0,2.0,2.0,2.0,12.0,,0.5195306261281211,0.5726825047161584,,,,,,,,,,,,,,,,,,,,,,,,,,,,,,,,,,,,,,,,,,,,,0.0,0.0,0.0,0.0,-1807.0,0.0,0.0,0.0,0.0,1.0,4.0,1.0,1.0,0.0,1.0,1.0,0.0,0.0,0.0,0.0,0.0,1.0,1.0,0.0,1.0,0.0,0.0,0.0,0.0,0.0,0.0,0.0,0.0,0.0,0.0,0.0,0.0,0.0,0.0,0.0,0.0,0.0,0.0,7.0,0.0,0.0,733500.0,0.0,0.0,0.0,0.0,0.0,-575.0,303.0,-147.0,-188.0,207.0,-19.0,8.0,13548.5325,112500.0,130828.5,1590.75,149492.25,15.0,-576.0,365243.0,-1010.5,-830.5,-590.5,-823.0,10.5,1.0,0.0514010195412064,-1.0,69.0,12.0,7.0,-46.0,0.0,0.0,65.0,8703.9,8703.9,-1328.0,-1326.0,7.0,1.0,0.0,,,,,,,,,,,,,,,,,,,,,8349022818.0,184436250736.5,165618012564.0,51985227007.935,1863.0,1705.0,71125.0,70846.0,9140.0,506201.0,,,,,,,128458.0,663009.0,,,,13531145.956163986,-602094990.0,-922158067.0,-296597265.0,-1535510607.0416667,44025.0,30709.0,,,,,,,,158082.7160212251,126141.60991945468,,,,,,,3715168.0,,,,,,,,,,,,,,,,436569.0,431363.0,1263528.0,6426.764989002898,632127.0,625678.0,,,,,,,,,19.0,53358316.06499998,21607622.86500001,5558534053.02,1846974815.8650005,61479879.47999995,709847.0099999999,99.0,12039.0,-17944606.0,8034815.0,-9273967.0,-10060120.0,-9.0,0.0,0.0,733500.0,0.0,0.0,0.0,0.0,0.0,-1524.0,-532.0,-181.0,-530.0,196607508.3674999,2804094162.315001,3159183410.9100003,45084818.65499998,2804078254.815001,202507.0,-13833677.0,3209381546.5,140224244.0,719888813.5,315012826.0,751168945.0,201877.5,3136.5,565.186282122925,4655133.5,1654364.0,1016445.0,-3322082.0,1182935.0,99847.0,2206310306.7600985,2227502144.160052,-134689545.0,-133594408.0,2407924.0,109346.0,,,,,,,,,,,,,,,,,,,,,1467853.0,14796721.0,3233563.0,8557602.0,11610973.0,1416143.0,1059299908.6095012,801776896.6724951,72123228749.27213,21678810454.822617,582516033.7994988,5792665.7475,689.5,94245.0,-277003163.5,21961631.0,-123821928.0,-218765216.5,-2020054.5,,,,,,,,,,,,,,,,,,,,,4274219.0,2479960.0,-9006143.0,921269.0,37582.5,3734839286.144962,3659545085.624961,-260701506.0,-257389461.5,2527207.0,269276.5,3927334214.429957,33263168651.79842,36692455898.115135,1729970677.530049,48098015228.76821,3989139.0,-247658356.5,103115796224.5,1054644701.0,17278363323.0,3504378168.5,18892019337.0,3673082.5,71945.0,20876.676698694104,89803903.5,-73.76513463044394,1.9175375,10.176822287240809,462.8641829876293,19.514438366620023,887.5594282856412,180000.0,1.0,0.0,0.0,0.0,0.0,0.0,0.0,0.0,1.0,0.0,0.0,0.0,0.0,0.0,0.0,1.0,0.0,1.0,0.0,0.0,0.0,0.0,1.0,0.0,0.0,0.0,0.0,1.0,0.0,0.0,0.0,0.0,0.0,0.0,0.0,0.0,0.0,0.0,0.0,0.0,1.0,0.0,0.0,0.0,0.0,0.0,0.0,0.0,0.0,0.0,0.0,0.0,0.0,0.0,0.0,0.0,0.0,0.0,0.0,0.0,0.0,0.0,0.0,0.0,0.0,0.0,0.0,0.0,0.0,0.0,0.0,0.0,0.0,0.0,0.0,0.0,0.0,0.0,0.0,0.0,0.0,0.0,0.0,0.0,0.0,0.0,0.0,0.0,0.0,0.0,0.0,0.0,0.0,0.0,0.0,0.0,0.0,0.0,0.0,0.0,0.0,0.0,0.0,0.0,0.0,1.0,0.0,0.0,0.0,0.0,0.0,0.0,0.0,0.0,0.0,0.0,0.0,0.0,0.0,0.0,0.0,0.0
103368,0,0.0,0.0,0.0,1.0,0.0,117000.0,450000.0,21649.5,450000.0,0.035792,48.46849315068493,-10729.0,-2858.0,-1247.0,,2.0,2.0,2.0,10.0,0.5888843138729853,0.7130235811754986,0.6092756673894402,,,,,,,,,,,,,,,,,,,,,,,,,,,,,,,,,,,,,,,,,,,,,6.0,0.0,6.0,0.0,0.0,0.0,0.0,0.0,0.0,0.0,1.0,1.0,1.0,1.0,1.0,1.0,0.0,0.0,0.0,0.0,0.0,0.0,0.0,0.0,1.0,0.0,0.0,0.0,0.0,0.0,0.0,0.0,0.0,0.0,0.0,0.0,0.0,0.0,0.0,0.0,0.0,0.0,0.0,12.0,0.0,0.0,158820.75,0.0,0.0,0.0,0.0,0.0,-1591.5,-905.5,-893.0,-1129.5,622.0,-28.0,8.0,16487.8425,164222.4375,164220.75,3.3975,164222.4375,20.0,-980.5,365243.0,-2120.0,-1850.0,-1850.0,-1565.0,11.5,0.0,3.603184554803395e-05,1270.0,21.0,10.0,0.0,-61.0,0.0,0.0,11.0,5063.22,5063.22,-1995.0,-1970.0,6.0,1.0,0.0,,,,,,,,,,,,,,,,,,,,,8349044467.5,184436700736.5,165618462564.0,51985344007.935,1863.0,1705.0,71125.0,70846.0,9140.0,506202.0,,,,,,,128458.0,663011.0,,,,13531194.424657134,-602105719.0,-922159314.0,-296597265.0,-1535513465.0416667,44025.0,30709.0,,,,,,,67489.02489900861,158083.42904480625,126142.21919512207,,,,,,,3715178.0,,,,,,,,,,,,,,,,436575.0,431369.0,,6426.800781002898,632129.0,625680.0,,,,,,,,,52.5,53647292.56499998,21625032.24000001,5594459898.780004,1860175456.7400005,61490152.84499995,709847.0099999999,100.0,12039.0,-18024891.0,8047374.0,-9310058.0,-10105799.0,-25.75,0.0,0.0,158820.75,0.0,0.0,0.0,0.0,0.0,-2095.0,-999.0,-893.0,-1221.0,197490094.26749992,2816494504.4250016,3172185071.4600005,45299883.46499998,2816494504.4250016,203339.0,-13890038.5,3226364656.0,140541114.0,725330046.0,315713848.0,756610683.0,202792.0,3150.0,568.0928169716135,4681690.0,1662921.0,1021881.0,-3339557.0,1183516.0,99880.0,2217356574.9751296,2240229774.9600806,-135337057.0,-134236068.0,2418514.0,109977.0,,,,,,,,,,,,,,,,,,,,,1467865.0,14797343.0,3233563.0,8557623.0,11610984.0,1416151.0,1059299908.6095012,801776896.6724951,72123387570.02213,21678810454.822617,582516033.7994988,5792665.7475,689.5,94245.0,-277004755.0,21960725.5,-123822821.0,-218766346.0,-2020082.5,,,,,,,,,,,,,,,,,,,,,4274229.0,2479960.0,-9006204.0,921269.0,37582.5,3734844349.364961,3659550148.844961,-260703501.0,-257391431.5,2527213.0,269277.5,3927350702.272456,33263332874.23592,36692620118.865135,1729970680.9275494,48098179451.20571,3989159.0,-247659337.0,103116161467.5,1054642581.0,17278361473.0,3504376318.5,18892017772.0,3673094.0,71945.0,20876.67673472595,89805173.5,-221.36029619580583,3.8461538461538463,5.404281854084389,261.9373980290601,20.785699438786114,1007.4515308810004,58500.0,-0.9009688679024191,0.4338837391175582,0.0,0.0,0.0,0.0,0.0,0.0,1.0,0.0,0.0,0.0,0.0,0.0,0.0,1.0,0.0,0.0,0.0,0.0,1.0,0.0,1.0,0.0,0.0,0.0,0.0,1.0,0.0,0.0,0.0,0.0,0.0,0.0,0.0,1.0,0.0,0.0,0.0,0.0,0.0,0.0,0.0,0.0,0.0,0.0,0.0,0.0,0.0,0.0,0.0,0.0,0.0,0.0,0.0,0.0,0.0,0.0,0.0,0.0,0.0,0.0,0.0,0.0,0.0,0.0,0.0,0.0,0.0,0.0,0.0,0.0,0.0,0.0,0.0,0.0,0.0,0.0,0.0,0.0,0.0,0.0,0.0,0.0,0.0,1.0,0.0,0.0,0.0,0.0,0.0,0.0,0.0,0.0,0.0,0.0,0.0,0.0,0.0,0.0,0.0,0.0,0.0,0.0,0.0,0.0,0.0,0.0,0.0,0.0,0.0,0.0,0.0,0.0,0.0,0.0,0.0,0.0,0.0,0.0,0.0,0.0
103371,0,0.0,1.0,0.0,1.0,2.0,405000.0,450000.0,35685.0,450000.0,0.028663,39.2054794520548,-6002.0,-8403.0,-4378.0,,4.0,2.0,2.0,10.0,,0.390847469888466,0.1614630800057724,0.2619,0.1639,0.9831,0.7688,0.5949,0.28,0.2414,0.3333,0.375,0.1837,0.2135,0.1681,0.0,0.0127,0.2668,0.1701,0.9831,0.7779,0.6004,0.282,0.2414,0.3333,0.375,0.1878,0.2332,0.1751,0.0,0.0135,0.2644,0.1639,0.9831,0.7719,0.5987,0.28,0.2414,0.3333,0.375,0.1869,0.2172,0.1711,0.0,0.013,0.3166,1.0,1.0,0.0,1.0,0.0,-1502.0,0.0,0.0,0.0,0.0,1.0,2.0,1.0,1.0,0.0,1.0,0.0,0.0,0.0,1.0,1.0,0.0,1.0,1.0,0.0,1.0,0.0,0.0,0.0,0.0,0.0,0.0,0.0,0.0,0.0,0.0,0.0,0.0,0.0,0.0,0.0,0.0,0.0,0.0,11.0,0.0,,405000.0,0.0,0.0,0.0,0.0,0.0,-826.0,-228.0,-240.0,-779.0,404.0,-21.0,7.0,16849.957499999997,144135.0,225000.0,32962.5,180000.0,19.0,-849.0,365243.0,-1210.0,-954.5,-425.0,-946.0,10.0,0.0,0.30309276320613,-1.0,18.0,11.0,6.5,-42.0,0.0,0.0,97.0,10478.475,5265.0,-716.0,-716.0,33.0,0.0,39.0,223589.925,225000.0,4500.0,4500.0,0.0,0.0,11137.1625,11700.0,11700.0,214823.43,221939.595,221939.595,1.0,1.0,0.0,0.0,19.5,-21.0,0.0,0.0,8349080152.5,184437150736.5,165618912564.0,51985749007.935,1863.0,1705.0,71125.0,70847.0,9140.0,506204.0,17812.77410000229,17874.969799999104,17326.31379999803,11299.010900000088,11236.782400000093,11184.140700000056,128460.0,663015.0,4139.633000000117,4137.305700000016,3947.877800000093,13531233.630136589,-602111721.0,-922163692.0,-296598767.0,-1535521868.0416667,44025.0,30709.0,11352.568399999189,11228.51999999898,10712.71699999729,22893.625900009712,22815.47780000968,22200.863200008243,,158083.81989227617,126142.38065820208,35011.42770002795,34951.65850002838,34397.092600028795,22961.984799995906,22935.108799995483,22581.87289999572,3715188.0,8297.821200000164,8402.374200000075,8125.899200000231,9820.182000000716,9935.17310000216,10294.989599999646,16472.05819999976,16657.354899999693,16254.090999999704,828.8096000001764,813.9848000000459,759.9074000000132,3914.639500000125,3897.819700000164,3730.41780000016,436576.0,431370.0,,6426.829444002898,632131.0,625682.0,,16336.426899999802,154221.01219999066,154223.75729999025,154115.49039998715,77634.24599999629,77972.13930000659,78373.61860000655,28.0,53672996.56499998,,5600228633.550003,1862600698.2600005,61490152.84499995,709847.0099999999,100.0,12039.0,-18051846.0,8069633.0,-9321744.0,-10119375.0,-13.5,0.0,,225000.0,0.0,0.0,0.0,0.0,0.0,-1550.0,-443.0,-563.0,-1284.0,197829095.44499987,2823085680.8850017,3179360931.2100005,45366597.67499998,2823450180.8850017,203877.0,-13907249.0,3228007039.5,140535923.0,726057168.0,316077799.5,757337826.5,203061.0,3152.0,568.7279709163993,4687276.0,1663592.0,1022333.0,-3341264.0,1184193.0,99880.0,2219526252.720128,2242325286.8550787,-135624542.0,-134522782.0,2434733.0,110005.0,2121215825.2499888,5655631500.0,178775818.55999997,274120813.66499954,10265426.1,84837844.34999992,120810386.0249996,300886823.34,277721778.1049997,2035523789.1899948,2113075972.844987,2113159494.7799864,9251.0,22914.0,145.0,13518.0,703737.5,-1243098.0,554778.0,1203.0,1467876.0,14797747.0,3233602.0,8557641.0,11611081.0,1416158.0,1059299908.6095012,,72123792570.02213,21678810454.822617,582516033.7994988,5792665.7475,689.5,94245.0,-277005581.0,21960497.5,-123823061.0,-218767125.0,-2020103.5,5924183430.554961,18726651000.0,198814557.825,447992079.2549976,1948107.735,256782765.80250075,309185201.1374987,636641585.9999981,459229282.1999993,5709287472.007533,5887459571.692499,5887702754.4375,13385.5,80842.0,44.0,70351.5,971734.5,-1698995.5,177364.0,6755.0,4274240.0,2479966.5,-9006246.0,921269.0,37582.5,3734854827.839961,3659555413.844961,-260704217.0,-257392147.5,2527246.0,269277.5,3927367552.229956,33263477009.23592,36692845118.865135,1730003643.4275494,48098359451.20571,3989178.0,-247660186.0,103116526710.5,1054641371.0,17278360518.5,3504375893.5,18892016826.0,3673104.0,71945.0,20876.979827489155,89805172.5,-153.09084556254368,1.1111111111111112,11.349306431273645,444.9550000863722,12.61034047919294,494.3944445404136,101250.0,-0.9009688679024191,-0.433883739117558,0.0,0.0,0.0,0.0,0.0,0.0,1.0,0.0,0.0,0.0,0.0,0.0,0.0,1.0,0.0,0.0,0.0,0.0,1.0,0.0,1.0,0.0,0.0,0.0,0.0,1.0,0.0,0.0,0.0,0.0,0.0,0.0,0.0,0.0,0.0,0.0,0.0,0.0,1.0,0.0,0.0,0.0,0.0,0.0,0.0,0.0,0.0,0.0,0.0,0.0,0.0,0.0,0.0,0.0,0.0,0.0,0.0,0.0,0.0,0.0,0.0,0.0,0.0,0.0,0.0,0.0,0.0,0.0,0.0,0.0,0.0,0.0,0.0,0.0,1.0,0.0,0.0,0.0,0.0,0.0,0.0,0.0,0.0,0.0,0.0,0.0,0.0,0.0,0.0,0.0,0.0,0.0,0.0,0.0,0.0,0.0,0.0,0.0,0.0,0.0,0.0,0.0,0.0,0.0,0.0,0.0,0.0,0.0,1.0,0.0,1.0,0.0,0.0,0.0,0.0,0.0,0.0,1.0,0.0,0.0
103377,0,0.0,0.0,1.0,1.0,1.0,202500.0,543037.5,31302.0,463500.0,0.006629,30.93424657534247,-1015.0,-2094.0,-2091.0,21.0,3.0,2.0,2.0,7.0,0.7667607519213029,0.6353876130844349,0.3723336657058204,0.0041,,0.9737,,,,0.1379,0.0,,,,0.0029,,,0.0042,,0.9737,,,,0.1379,0.0,,,,0.0031,,,0.0042,,0.9737,,,,0.1379,0.0,,,,0.003,,,0.0023,1.0,2.0,0.0,2.0,0.0,-407.0,0.0,0.0,0.0,0.0,2.0,2.0,1.0,1.0,0.0,1.0,0.0,0.0,0.0,0.0,0.0,0.0,0.0,0.0,0.0,1.0,0.0,0.0,0.0,0.0,0.0,0.0,0.0,0.0,0.0,0.0,0.0,0.0,0.0,0.0,0.0,0.0,0.0,0.0,3.0,450.0,0.0,235723.5,13133.745,50473.755,0.0,0.0,0.0,-1113.0,-18.0,-113.0,-629.5,94.0,-16.5,9.0,10670.175,85455.0,97861.5,7373.25,90121.5,12.0,-407.0,365243.0,-337.0,-157.0,21.0,-150.0,7.0,0.0,0.0933929529674464,42.0,43.0,12.0,8.0,-14.0,0.0,0.0,46.0,11209.995,12726.0225,-436.0,-429.0,4.0,2.0,13.0,0.0,180000.0,,0.0,,,0.0,,0.0,0.0,0.0,0.0,,0.0,,,0.0,-7.0,0.0,0.0,8349111454.5,184437693774.0,165619376064.0,51985951507.935,1863.0,1705.0,71125.0,70849.0,9140.0,506206.0,17812.77820000229,17874.973999999103,17326.31799999803,,,,128461.0,663018.0,,,,13531264.564383162,-602112736.0,-922165783.0,-296599174.0,-1535523962.0416667,44025.0,30709.0,,,,22893.76380000972,22815.61570000968,22201.00110000824,67489.79165976054,158084.45527988923,126142.7529918678,35011.42770002795,34951.65850002838,34397.092600028795,,,,3715195.0,,,,,,,16472.06109999976,16657.357899999693,16254.094099999704,,,,,,,436578.0,431372.0,1263549.0,6426.836073002898,632133.0,625684.0,,16336.429199999802,154221.98589999066,154224.73099999022,154116.46409998718,,,,37.0,53859026.56499998,21696651.90000001,5613875403.615003,1864919209.1400003,61540848.26999995,709847.0099999999,100.0,12039.0,-18130070.0,8072627.0,-9367601.0,-10169894.0,-18.0,450.0,0.0,235723.5,0.0,0.0,0.0,0.0,0.0,-1113.0,-18.0,-113.0,-1113.0,198183159.76499984,2827617684.8850017,3184498324.7100005,45423954.67499998,2827617684.8850017,204241.0,-13934213.0,3234398792.0,140513702.0,726768449.0,316062528.0,758049263.0,203354.0,3161.0,569.6513404188884,4693735.0,1667404.0,1024893.0,-3348285.0,1184245.0,99932.0,2224795892.9401226,2247246742.275075,-135849219.5,-134745293.5,2437571.5,110248.5,2125005645.5999887,5661166500.0,,274868518.94999963,,,120986610.34499958,,278574389.0999997,2039141513.2949948,2116833891.5249865,2116917413.4599864,,22939.0,,,704061.0,-1243553.0,554814.0,1221.0,1467879.0,14797841.0,3233615.0,8557684.0,11611127.0,1416167.0,1059300358.6095012,801776896.6724951,72124028293.52213,21678823588.567616,582566507.5544988,5792665.7475,689.5,94245.0,-277006694.0,21960479.5,-123823174.0,-218767754.5,-2020120.0,5924183430.554961,18726831000.0,,447992079.2549976,,,309185201.1374987,,459229282.1999993,5709287472.007533,5887459571.692499,5887702754.4375,,80842.0,,,971734.5,-1699002.5,177364.0,6755.0,4274252.0,2479974.5,-9006260.0,921269.0,37582.5,3734866037.834961,3659568139.8674607,-260704653.0,-257392576.5,2527250.0,269279.5,3927378222.404956,33263562464.23592,36692942980.365135,1730011016.6775494,48098449572.70571,3989190.0,-247660593.0,103116891953.5,1054641034.0,17278360361.5,3504375914.5,18892016676.0,3673111.0,71945.0,20877.07322044212,89805214.5,-32.81153130812151,2.681666666666666,6.469235192639448,200.12091660299183,17.34833237492812,536.6575913570232,67500.0,-0.2225209339563143,0.9749279121818236,0.0,0.0,0.0,0.0,0.0,0.0,1.0,0.0,1.0,0.0,0.0,0.0,0.0,0.0,0.0,0.0,0.0,0.0,1.0,0.0,1.0,0.0,0.0,0.0,0.0,1.0,0.0,0.0,0.0,0.0,0.0,0.0,0.0,0.0,0.0,0.0,0.0,0.0,0.0,0.0,0.0,0.0,0.0,0.0,0.0,0.0,0.0,0.0,0.0,0.0,0.0,0.0,0.0,1.0,0.0,0.0,0.0,0.0,0.0,0.0,0.0,0.0,0.0,0.0,0.0,0.0,0.0,0.0,0.0,0.0,0.0,0.0,0.0,0.0,0.0,0.0,0.0,0.0,0.0,0.0,0.0,0.0,0.0,0.0,0.0,0.0,0.0,0.0,0.0,0.0,0.0,0.0,0.0,0.0,0.0,0.0,0.0,0.0,0.0,0.0,0.0,0.0,0.0,0.0,0.0,0.0,0.0,0.0,0.0,0.0,1.0,0.0,0.0,0.0,0.0,0.0,0.0,0.0,0.0,1.0
103398,0,0.0,0.0,0.0,1.0,0.0,157500.0,454500.0,23337.0,454500.0,0.026392,56.67671232876712,-5100.0,-3436.0,-3966.0,,2.0,2.0,2.0,14.0,,0.6609368110041745,0.7032033049040319,0.1464,,0.9786,,,0.16,0.1379,0.3333,,0.1111,,0.138,,0.0068,0.1492,,0.9786,,,0.1611,0.1379,0.3333,,0.1136,,0.1438,,0.0072,0.1478,,0.9786,,,0.16,0.1379,0.3333,,0.113,,0.1405,,0.0069,0.1101,1.0,0.0,0.0,0.0,0.0,-263.0,0.0,0.0,0.0,0.0,0.0,3.0,1.0,1.0,0.0,1.0,0.0,1.0,0.0,0.0,0.0,0.0,0.0,0.0,0.0,1.0,0.0,0.0,0.0,0.0,0.0,0.0,0.0,0.0,0.0,0.0,0.0,0.0,0.0,0.0,0.0,0.0,0.0,0.0,5.0,33600.015,0.0,2419200.0,3825792.0,0.0,0.0,0.0,0.0,-774.0,1844.0,-155.0,-255.0,154.0,-22.0,5.0,14135.13,25560.0,21060.0,2251.575,310872.15,24.0,-262.0,365243.0,-1537.0,181323.5,-1117.0,181325.5,17.0,0.0,0.0958761963780177,-1.0,18.0,24.0,15.5,-10.5,0.0,0.0,17.0,14135.13,14135.13,-276.0,-268.0,5.0,1.0,0.0,,,,,,,,,,,,,,,,,,,,,8349134791.5,184438148274.0,165619830564.0,51986109007.935,1863.0,1705.0,71125.0,70849.0,9140.0,506209.0,17812.92460000229,17875.121799999102,17326.46719999803,,,,128461.0,663020.0,,,,13531321.24109549,-602117836.0,-922169749.0,-296599437.0,-1535527398.0416667,44025.0,30709.0,11352.728399999189,11228.67999999898,10712.87809999729,22893.901700009723,22815.75360000968,22201.139000008243,,158085.11621670026,126143.4561951727,35011.761000027946,34951.99180002838,34397.425900028786,,,,3715209.0,8297.932300000164,8402.487200000074,8126.01280000023,,,,16472.199099999758,16657.498399999695,16254.237899999704,,,,3914.646300000125,3897.826600000164,3730.42500000016,436578.0,431372.0,,6426.862465002898,632135.0,625686.0,,16336.539299999802,154222.96449999063,154225.70959999022,154117.44269998718,,,,26.0,54181629.53999998,21784798.26000001,5656625522.505001,1877774005.8000004,61767790.28999995,709847.0099999999,100.0,12039.0,-18315269.0,8068496.0,-9474414.0,-10292185.0,-12.5,0.0,0.0,46804.5,3825792.0,0.0,0.0,0.0,0.0,-2776.0,-2650.0,-2548.0,-2548.0,199248202.52999985,2840242480.920002,3199291210.0350013,45677993.30999999,2840242480.920002,205365.0,-14046552.0,3259410999.5,141148293.0,730528060.5,317825798.0,762908834.5,204465.0,3184.0,573.4644647608236,4778959.0,1679258.0,1032554.0,-3379005.0,1184314.0,99957.0,2236338243.225139,2259365658.8400874,-137069339.0,-135956959.0,2454402.0,111121.0,,,,,,,,,,,,,,,,,,,,,1467884.0,14797995.0,3233615.0,8557702.0,11611144.0,1416172.0,1059333958.6245012,801776896.6724951,72126447493.52213,21682649380.567616,582566507.5544988,5792665.7475,689.5,94245.0,-277007468.0,21962323.5,-123823329.0,-218768009.5,-2020142.0,,,,,,,,,,,,,,,,,,,,,4274276.0,2479990.0,-9006270.5,921269.0,37582.5,3734880172.964961,3659582274.997461,-260704929.0,-257392844.5,2527255.0,269280.5,3927392357.534957,33263588024.23592,36692964040.365135,1730013268.2525494,48098760444.85571,3989214.0,-247660855.0,103117257196.5,1054639497.0,17278541685.0,3504374797.5,18892198001.5,3673128.0,71945.0,20877.1690966385,89805213.5,-89.98404795282063,2.8857142857142857,6.7489394523717685,382.507699866342,19.47551099112997,1103.807933900015,78750.0,0.6234898018587336,0.7818314824680298,0.0,0.0,0.0,0.0,0.0,0.0,1.0,0.0,0.0,0.0,0.0,0.0,0.0,1.0,0.0,0.0,0.0,0.0,1.0,0.0,1.0,0.0,0.0,0.0,0.0,1.0,0.0,0.0,0.0,0.0,0.0,0.0,0.0,1.0,0.0,0.0,0.0,0.0,0.0,0.0,0.0,0.0,0.0,0.0,0.0,0.0,0.0,0.0,0.0,0.0,0.0,0.0,0.0,0.0,0.0,0.0,0.0,0.0,0.0,0.0,0.0,0.0,0.0,0.0,0.0,0.0,0.0,0.0,0.0,0.0,0.0,0.0,0.0,0.0,0.0,0.0,1.0,0.0,0.0,0.0,0.0,0.0,0.0,0.0,0.0,0.0,0.0,0.0,0.0,0.0,0.0,0.0,0.0,0.0,0.0,0.0,0.0,0.0,0.0,0.0,0.0,0.0,0.0,0.0,0.0,0.0,0.0,0.0,0.0,0.0,1.0,0.0,0.0,0.0,0.0,0.0,0.0,1.0,0.0,0.0
103404,0,0.0,0.0,0.0,1.0,0.0,112500.0,479799.0,24628.5,400500.0,0.018634,54.98630136986301,,-3892.0,-2026.0,,2.0,2.0,2.0,17.0,,0.7816081373047524,0.324891229465852,0.2536,0.0791,0.9836,0.7756,0.0292,0.08,0.069,0.3333,0.0417,0.0178,0.2017,0.0817,0.0232,0.0333,0.2584,0.0821,0.9836,0.7844,0.0295,0.0806,0.069,0.3333,0.0417,0.0182,0.2204,0.0852,0.0233,0.0352,0.2561,0.0791,0.9836,0.7786,0.0294,0.08,0.069,0.3333,0.0417,0.0181,0.2052,0.0832,0.0233,0.034,0.118,1.0,1.0,1.0,1.0,1.0,-627.0,0.0,0.0,0.0,0.0,1.0,1.0,1.0,0.0,0.0,1.0,0.0,0.0,0.0,0.0,0.0,0.0,0.0,0.0,0.0,1.0,0.0,0.0,0.0,0.0,0.0,0.0,0.0,0.0,0.0,0.0,0.0,0.0,0.0,0.0,0.0,0.0,0.0,0.0,3.0,2250.0,0.0,67500.0,0.0,0.0,0.0,0.0,0.0,-504.0,107.0,-175.0,-199.0,42.0,-6.5,6.0,15606.0675,0.0,0.0,4.23,287504.865,27.0,-151.0,365243.0,-357.0,182563.5,423.0,182565.0,15.0,0.0,4.057661074681328e-05,-1.0,22.0,18.0,11.5,-10.5,0.0,0.0,24.0,7573.545,7573.545,-311.5,-296.0,8.0,1.0,0.0,,,,,,,,,,,,,,,,,,,,,8349159420.0,184438628073.0,165620231064.0,51986221507.935,1863.0,1705.0,71125.0,70850.0,9140.0,506210.0,17813.17820000229,17875.3778999991,17326.725599998033,11299.090000000091,11236.861500000094,11184.222800000056,128461.0,663022.0,4139.662200000117,4137.3351000000175,3947.9073000000935,13531376.22739686,,-922171775.0,-296600064.0,-1535531290.0416667,44026.0,30710.0,11352.808399999189,11228.75999999898,10712.958699997287,22893.970700009715,22815.82260000968,22201.20800000824,,158085.89782483756,126143.78108640214,35012.094300027944,34952.32510002838,34397.75920002879,22962.026499995907,22935.150499995485,22581.91459999572,3715226.0,8297.950100000164,8402.505300000073,8126.031000000231,9820.383700000715,9935.37830000216,10295.209999999646,16472.280799999757,16657.581599999696,16254.323099999703,828.8328000001762,814.0081000000459,759.9307000000133,3914.679600000125,3897.860600000164,3730.46020000016,436579.0,431373.0,,6426.881099002898,632137.0,625688.0,,16336.657299999802,154223.9480999907,154226.69319999026,154118.42629998722,77635.02159999628,77972.91790000659,78374.40300000655,17.0,54217479.55499998,21784798.26000001,5662853650.215001,1878329912.2200005,61792329.86999995,709847.0099999999,102.0,12039.0,-18345741.0,8078531.0,-9495305.0,-10315562.0,-8.0,2250.0,0.0,67500.0,0.0,0.0,0.0,0.0,0.0,-504.0,107.0,-175.0,-199.0,199607256.0899998,2846376565.020002,3206407960.0350013,45773834.98499998,2846138065.020002,205924.0,-14079628.5,3267080052.5,141124729.0,731972393.5,318180662.0,764353278.5,205055.0,3194.0,574.7498711847022,4789272.5,1683460.0,1035450.5,-3385783.0,1184341.0,99960.0,2243189702.5876207,2266480838.74507,-137468489.5,-136352172.0,2465968.0,111418.5,,,,,,,,,,,,,,,,,,,,,1467887.0,14798037.0,3233615.0,8557724.0,11611168.0,1416178.0,1059336208.6245012,801776896.6724951,72126514993.52213,21682649380.567616,582566507.5544988,5792665.7475,689.5,94245.0,-277007972.0,21962430.5,-123823504.0,-218768208.5,-2020148.5,,,,,,,,,,,,,,,,,,,,,4274294.0,2480001.5,-9006281.0,921269.0,37582.5,3734887746.509961,3659589848.542461,-260705240.5,-257393140.5,2527263.0,269281.5,3927407963.602456,33263588024.23592,36692964040.365135,1730013272.4825494,48099047949.72071,3989241.0,-247661006.0,103117622439.5,1054639140.0,17278724248.5,3504375220.5,18892380566.5,3673143.0,71945.0,20877.16913721511,89805212.5,,4.264880000000001,4.567878677142335,251.17075356231965,19.4814544125708,1071.2131234528658,56250.0,1.0,0.0,0.0,0.0,0.0,0.0,0.0,0.0,0.0,0.0,0.0,1.0,0.0,0.0,0.0,0.0,0.0,0.0,0.0,0.0,1.0,0.0,1.0,0.0,0.0,0.0,0.0,1.0,0.0,0.0,0.0,0.0,0.0,0.0,0.0,0.0,0.0,0.0,0.0,0.0,0.0,0.0,0.0,0.0,0.0,0.0,0.0,0.0,0.0,0.0,0.0,0.0,0.0,0.0,0.0,0.0,0.0,0.0,0.0,0.0,0.0,0.0,0.0,0.0,0.0,0.0,0.0,0.0,0.0,0.0,0.0,0.0,0.0,0.0,0.0,0.0,0.0,0.0,0.0,0.0,0.0,0.0,0.0,0.0,0.0,0.0,0.0,0.0,0.0,0.0,0.0,0.0,0.0,0.0,0.0,0.0,0.0,0.0,0.0,0.0,0.0,0.0,0.0,0.0,0.0,0.0,0.0,1.0,0.0,0.0,1.0,0.0,1.0,0.0,0.0,0.0,0.0,0.0,0.0,0.0,1.0,0.0
103408,0,0.0,0.0,1.0,0.0,0.0,90000.0,331920.0,17077.5,225000.0,0.010556,24.43013698630137,-319.0,-5234.0,-1575.0,4.0,1.0,3.0,3.0,16.0,0.141056063764637,0.3162250658795184,0.1595195404777181,0.0124,0.0,0.9712,,,0.0,0.069,0.0417,,0.057,,0.0103,,0.0,0.0126,0.0,0.9712,,,0.0,0.069,0.0417,,0.0583,,0.0107,,0.0,0.0125,0.0,0.9712,,,0.0,0.069,0.0417,,0.058,,0.0105,,0.0,0.0087,1.0,0.0,0.0,0.0,0.0,-1304.0,0.0,0.0,0.0,0.0,1.0,9.0,1.0,1.0,0.0,1.0,0.0,1.0,0.0,0.0,0.0,0.0,1.0,1.0,0.0,0.0,0.0,0.0,0.0,0.0,1.0,0.0,0.0,0.0,0.0,0.0,0.0,0.0,0.0,0.0,0.0,0.0,0.0,0.0,5.0,10523.25,,43367.4,28015.47,0.0,0.0,0.0,0.0,-799.0,989.5,-5.0,-62.0,104.0,-12.0,9.0,17694.045,55305.0,43866.0,10347.75,90000.0,6.0,-433.0,365243.0,-403.0,-300.0,-150.0,-296.0,16.0,0.0,0.2101292521358269,-1.0,22.0,6.0,4.5,-17.5,0.0,0.0,19.0,17694.045,17694.045,-547.0,-545.0,3.0,1.0,9.0,0.0,0.0,,0.0,,,0.0,,0.0,0.0,0.0,0.0,,0.0,,,0.0,-7.0,0.0,0.0,8349176497.5,184438959993.0,165620456064.0,51986311507.935,1863.0,1705.0,71125.0,70851.0,9140.0,506219.0,17813.19060000229,17875.390399999098,17326.738199998028,11299.090000000091,11236.861500000094,11184.222800000056,128461.0,663023.0,,,,13531400.657533849,-602118155.0,-922173350.0,-296601368.0,-1535536524.0416667,44026.0,30710.0,11352.808399999189,11228.75999999898,10712.958699997287,22894.03970000972,22815.89160000968,22201.27700000824,67489.9327158243,158086.21404990338,126143.94060594264,35012.136000027946,34952.36680002838,34397.800900028786,,,,3715242.0,8298.007100000164,8402.563300000074,8126.089300000231,,,,16472.29109999976,16657.592099999696,16254.333799999704,,,,3914.679600000125,3897.860600000164,3730.46020000016,436579.0,431373.0,1263553.0,6426.891655002898,632140.0,625691.0,,16336.665999999805,154224.9192999907,154227.66439999026,154119.39749998722,,,,27.0,54396317.92499998,,5673353245.875001,1879771975.425001,61860772.66499995,709847.0099999999,102.0,12039.0,-18365102.0,8195966.0,-9499447.0,-10319091.0,-13.0,4657.5,,36000.0,28015.47,0.0,0.0,0.0,0.0,-820.0,960.0,-5.0,-62.0,199796179.4999998,2847725548.020002,3207742264.0350013,45879443.23499998,2847950548.020002,206104.0,-14091245.0,3271279496.0,141482046.0,732879439.0,318541797.0,765626315.0,205349.0,3198.0,575.8565761599529,4791315.0,1684486.5,1036071.0,-3387896.5,1184370.0,99989.0,2244776975.3701253,2268005761.620075,-137542472.0,-136425484.0,2466510.0,111505.0,2139411748.634988,5726169000.0,,277481526.9749995,,,121785785.18999957,,281175783.52500063,2053119663.854996,2131202355.4799848,2131285877.4149847,,23200.0,,,711052.0,-1259966.0,554814.0,1221.0,1467892.0,14798141.0,3233624.0,8557746.0,11611187.0,1416187.0,1059346731.8745012,,72126558360.92212,21682677396.037617,582566507.5544988,5792665.7475,689.5,94245.0,-277008771.0,21963420.0,-123823509.0,-218768270.5,-2020160.5,5924183430.554961,18726831000.0,,447992079.2549976,,,309185201.1374987,,459229282.1999993,5709287472.007533,5887459571.692499,5887702754.4375,,80842.0,,,971734.5,-1699009.5,177364.0,6755.0,4274300.0,2480006.0,-9006298.5,921269.0,37582.5,3734905440.5549607,3659607542.587461,-260705787.5,-257393685.5,2527266.0,269282.5,3927425657.647456,33263643329.23592,36693007906.365135,1730023620.2325494,48099137949.72071,3989247.0,-247661439.0,103117987682.5,1054638737.0,17278723948.5,3504375070.5,18892380270.5,3673159.0,71945.0,20877.379266467247,89805211.5,-13.057642704945607,3.688,5.270092226613966,128.7490750266212,19.436100131752305,474.82658869817885,90000.0,0.6234898018587336,0.7818314824680298,0.0,0.0,0.0,0.0,0.0,0.0,1.0,0.0,0.0,0.0,0.0,0.0,0.0,1.0,0.0,1.0,0.0,0.0,0.0,0.0,0.0,0.0,1.0,0.0,0.0,0.0,0.0,0.0,0.0,1.0,0.0,0.0,0.0,1.0,0.0,0.0,0.0,0.0,0.0,0.0,0.0,0.0,0.0,0.0,0.0,0.0,0.0,0.0,0.0,0.0,0.0,0.0,0.0,0.0,0.0,0.0,0.0,0.0,0.0,0.0,0.0,0.0,0.0,0.0,0.0,0.0,0.0,0.0,0.0,0.0,0.0,0.0,0.0,0.0,0.0,0.0,0.0,0.0,0.0,0.0,0.0,0.0,0.0,0.0,0.0,0.0,0.0,1.0,0.0,0.0,0.0,0.0,0.0,0.0,0.0,0.0,0.0,0.0,0.0,0.0,0.0,0.0,0.0,0.0,0.0,0.0,0.0,0.0,0.0,0.0,1.0,0.0,0.0,0.0,0.0,0.0,0.0,0.0,1.0,0.0
103410,0,0.0,0.0,0.0,0.0,1.0,121500.0,296280.0,19930.5,225000.0,0.019101,32.816438356164376,-3019.0,-2419.0,-3056.0,,2.0,2.0,2.0,12.0,,0.6875533361991095,0.2910973802776635,0.1155,0.0741,0.9781,0.7008,0.008,0.0,0.2414,0.1667,0.0417,0.153,,0.0964,,0.1322,0.1176,0.0769,0.9782,0.7125,0.0081,0.0,0.2414,0.1667,0.0417,0.1565,,0.1004,,0.14,0.1166,0.0741,0.9781,0.7048,0.0081,0.0,0.2414,0.1667,0.0417,0.1557,,0.0981,,0.135,0.1623,1.0,0.0,0.0,0.0,0.0,-803.0,0.0,0.0,0.0,0.0,1.0,1.0,1.0,1.0,0.0,1.0,1.0,0.0,0.0,0.0,0.0,0.0,0.0,0.0,0.0,1.0,0.0,0.0,0.0,0.0,0.0,0.0,0.0,0.0,0.0,0.0,0.0,0.0,0.0,0.0,0.0,0.0,0.0,0.0,2.0,4776.75,,126225.0,18312.75,0.0,0.0,0.0,0.0,-419.0,41.0,-17.5,-15.0,28.0,-6.5,1.0,6747.075,68791.5,68791.5,0.0,68791.5,12.0,-803.0,365243.0,-728.0,-458.0,-398.0,-454.0,12.0,0.0,0.0,50.0,13.0,12.0,7.0,-21.0,0.0,0.0,10.0,6747.075,6747.075,-626.0,-593.0,5.5,1.0,0.0,,,,,,,,,,,,,,,,,,,,,8349196428.0,184439256273.0,165620681064.0,51986433007.935,1863.0,1705.0,71125.0,70852.0,9140.0,506220.0,17813.30610000229,17875.506999999103,17326.855799998033,11299.164100000093,11236.935600000092,11184.299700000056,128462.0,663025.0,4139.670200000117,4137.3432000000175,3947.9154000000935,13531433.473972203,-602121174.0,-922176406.0,-296602171.0,-1535538943.0416667,44026.0,30710.0,11352.808399999189,11228.75999999898,10712.958699997287,22894.28110000972,22816.13300000968,22201.51840000824,,158086.90160323962,126144.23170332292,35012.30270002795,34952.53350002838,34397.967600028795,22962.06819999591,22935.192199995487,22581.95629999572,3715254.0,8298.160100000165,8402.719000000074,8126.245800000231,,,,16472.387499999757,16657.690199999695,16254.434199999703,,,,3914.811800000125,3897.995600000165,3730.60020000016,436579.0,431373.0,,6426.910756002898,632142.0,625693.0,,16336.828299999805,154225.89739999067,154228.64249999027,154120.3756999872,77635.72239999629,77973.6227000066,78375.11550000655,14.0,54403423.42499998,,5679799531.875001,1880355210.6600008,62766022.67999996,709847.0099999999,103.0,12039.0,-18395752.0,8242502.0,-9514905.5,-10334771.0,-6.5,9553.5,,225000.0,36625.5,0.0,0.0,0.0,0.0,-632.0,98.0,-23.0,-15.0,200013347.15999985,2850962353.020002,3211700293.0350013,45883040.98499998,2850962353.020002,206296.0,-14104036.0,3274565634.0,141834933.0,733599124.0,319264597.0,766346851.0,205567.0,3202.0,576.0439644974095,4797385.0,1685091.0,1036468.0,-3390328.0,1184370.0,99989.0,2246850202.207623,2270501040.9375725,-137632656.0,-136515039.0,2467424.0,111570.5,,,,,,,,,,,,,,,,,,,,,1467894.0,14798169.0,3233624.0,8557759.0,11611197.0,1416188.0,1059351508.6245012,,72126684585.92212,21682695708.787617,582566507.5544988,5792665.7475,689.5,94245.0,-277009190.0,21963461.0,-123823526.5,-218768285.5,-2020167.0,,,,,,,,,,,,,,,,,,,,,4274312.0,2480013.0,-9006319.5,921269.0,37582.5,3734912187.629961,3659614289.662461,-260706413.5,-257394278.5,2527271.5,269283.5,3927432404.722457,33263712120.73592,36693076697.865135,1730023620.2325494,48099206741.22071,3989259.0,-247662242.0,103118352925.5,1054638009.0,17278723490.5,3504374672.5,18892379816.5,3673171.0,71945.0,20877.379266467247,89805261.5,-91.99657705793956,2.4385185185185185,6.096184240234816,200.0550543274866,14.865658162113345,487.8379547008045,60750.0,-0.9009688679024191,-0.433883739117558,0.0,0.0,0.0,0.0,0.0,0.0,1.0,0.0,0.0,0.0,0.0,0.0,0.0,1.0,0.0,1.0,0.0,0.0,0.0,0.0,0.0,0.0,1.0,0.0,0.0,1.0,0.0,0.0,0.0,0.0,0.0,0.0,0.0,1.0,0.0,0.0,0.0,0.0,0.0,0.0,0.0,0.0,0.0,0.0,0.0,0.0,0.0,0.0,0.0,0.0,0.0,0.0,0.0,0.0,0.0,0.0,0.0,0.0,0.0,1.0,0.0,0.0,0.0,0.0,0.0,0.0,0.0,0.0,0.0,0.0,0.0,0.0,0.0,0.0,0.0,0.0,0.0,0.0,0.0,0.0,0.0,0.0,0.0,0.0,0.0,0.0,0.0,0.0,0.0,0.0,0.0,0.0,0.0,0.0,0.0,0.0,0.0,0.0,0.0,0.0,0.0,0.0,0.0,0.0,0.0,0.0,0.0,1.0,0.0,0.0,1.0,0.0,0.0,0.0,0.0,0.0,0.0,0.0,1.0,0.0
103418,0,0.0,0.0,0.0,0.0,0.0,202500.0,568800.0,20560.5,450000.0,0.035792,55.83013698630136,-12863.0,-11633.0,-3856.0,,1.0,2.0,2.0,11.0,0.5289022852117278,0.6225746857008014,0.5954562029091491,0.1485,0.0516,0.9826,0.762,0.0,0.0,0.1724,0.1667,0.2083,0.0869,0.121,0.1175,0.0,0.0,0.1513,0.0536,0.9826,0.7713,0.0,0.0,0.1724,0.1667,0.2083,0.0889,0.1322,0.1224,0.0,0.0,0.1499,0.0516,0.9826,0.7652,0.0,0.0,0.1724,0.1667,0.2083,0.0884,0.1231,0.1196,0.0,0.0,0.1786,1.0,5.0,0.0,5.0,0.0,-2173.0,0.0,0.0,0.0,0.0,0.0,4.0,1.0,1.0,0.0,1.0,0.0,1.0,0.0,0.0,0.0,0.0,0.0,0.0,0.0,1.0,0.0,0.0,0.0,0.0,0.0,0.0,0.0,0.0,0.0,0.0,0.0,0.0,0.0,0.0,0.0,0.0,0.0,0.0,9.0,0.0,0.0,225000.0,0.0,0.0,0.0,0.0,0.0,-1498.0,-947.0,-580.0,-1175.0,400.0,-22.0,5.0,12434.8725,75550.5,76221.0,7555.5,75550.5,11.0,-547.0,365243.0,-517.0,-101.0,139.0,-94.0,13.0,1.0,0.0982211761488765,115.0,32.0,36.0,20.5,-13.5,0.0,0.0,146.0,2557.71,2557.71,-1615.5,-1615.5,78.5,0.0,96.0,0.0,67500.0,0.0,0.0,0.0,0.0,0.0,2557.71,0.0,0.0,0.0,0.0,0.0,0.0,0.0,0.0,35.0,-48.5,0.0,0.0,8349216988.5,184439825073.0,165621131064.0,51986635507.935,1863.0,1705.0,71125.0,70852.0,9140.0,506224.0,17813.45460000229,17875.656899999103,17327.00709999803,11299.21570000009,11236.987200000092,11184.353300000055,128462.0,663026.0,4139.670200000117,4137.3432000000175,3947.9154000000935,13531489.30410919,-602134037.0,-922180262.0,-296604344.0,-1535550576.0416667,44026.0,30710.0,11352.808399999189,11228.75999999898,10712.958699997287,22894.45350000972,22816.30540000968,22201.690800008244,67490.4616181095,158087.52417792528,126144.82715952586,35012.46940002795,34952.700200028376,34398.1343000288,22962.276499995907,22935.400499995485,22582.16459999572,3715265.0,8298.247000000165,8402.807400000074,8126.334700000229,9820.504700000716,9935.501400002162,10295.342199999646,16472.504999999757,16657.809799999693,16254.556599999703,828.8328000001762,814.0081000000459,759.9307000000133,3914.811800000125,3897.995600000165,3730.60020000016,436584.0,431378.0,,6426.9465480028975,632144.0,625695.0,,16337.006899999802,154226.87999999063,154229.62509999023,154121.35829998722,77636.48439999629,77974.38790000661,78375.88680000653,50.0,54576396.67499998,21851669.070000008,5691647222.7300005,1884451676.3550005,62827152.97499995,709847.0099999999,104.0,12039.0,-18430989.0,8325464.0,-9531083.0,-10351839.0,-24.5,0.0,0.0,90966.78,0.0,0.0,0.0,0.0,0.0,-1499.0,-947.0,-899.0,-1358.0,200428247.7449998,2857750004.520002,3219128537.5350013,45959567.98499998,2857787779.770002,206717.0,-14125636.0,3280409156.0,141818714.0,734684030.0,319623042.0,767797339.0,205835.0,3209.0,576.9259981505786,4800852.0,1689510.0,1039109.0,-3396995.0,1184371.0,99990.0,2255432328.450139,2279227570.020086,-138312462.5,-137191327.0,2494575.5,111791.0,2159206513.199986,5781719250.0,182980168.56,279890461.2599995,10265426.1,86402956.94999994,123278954.12999956,308220719.12999976,284192642.38500047,2072175322.454998,2150952840.4049826,2151036362.3399825,9421.0,23345.0,145.0,13779.0,719351.5,-1272411.5,554818.0,1224.0,1467903.0,14798569.0,3233720.0,8557791.0,11611343.0,1416193.0,1059351508.6245012,801776896.6724951,72126909585.92212,21682695708.787617,582566507.5544988,5792665.7475,689.5,94245.0,-277010688.0,21962514.0,-123824106.5,-218769460.5,-2020189.0,5924183430.554961,18726898500.0,198814557.825,447992079.2549976,1948107.735,256782765.80250075,309185201.1374987,636644143.7099981,459229282.1999993,5709287472.007533,5887459571.692499,5887702754.4375,13385.5,80842.0,44.0,70351.5,971769.5,-1699058.0,177364.0,6755.0,4274348.0,2480033.5,-9006333.0,921269.0,37582.5,3734914745.339961,3659616847.372461,-260708029.0,-257395894.0,2527350.0,269283.5,3927444839.594957,33263787671.23592,36693152918.865135,1730031175.7325494,48099282291.72071,3989270.0,-247662789.0,103118718168.5,1054637492.0,17278723389.5,3504374811.5,18892379722.5,3673184.0,71946.0,20877.477487643395,89805376.5,-230.3952792226912,2.8088888888888888,9.848982271831913,549.8700294120292,27.664696870212303,1544.5238159484554,202500.0,-0.9009688679024191,-0.433883739117558,0.0,0.0,0.0,0.0,0.0,0.0,1.0,0.0,0.0,0.0,0.0,0.0,0.0,1.0,0.0,1.0,0.0,0.0,0.0,0.0,0.0,0.0,1.0,0.0,0.0,1.0,0.0,0.0,0.0,0.0,0.0,0.0,0.0,0.0,0.0,0.0,0.0,0.0,0.0,0.0,1.0,0.0,0.0,0.0,0.0,0.0,0.0,0.0,0.0,0.0,0.0,0.0,0.0,0.0,0.0,0.0,0.0,0.0,0.0,0.0,0.0,0.0,0.0,0.0,0.0,0.0,0.0,0.0,0.0,0.0,0.0,0.0,0.0,0.0,0.0,0.0,0.0,0.0,0.0,0.0,0.0,0.0,0.0,0.0,0.0,0.0,0.0,0.0,0.0,0.0,0.0,0.0,0.0,0.0,0.0,0.0,0.0,0.0,0.0,0.0,0.0,1.0,0.0,0.0,0.0,0.0,0.0,0.0,0.0,1.0,1.0,0.0,0.0,0.0,0.0,0.0,0.0,0.0,1.0,0.0
103420,0,0.0,0.0,0.0,1.0,0.0,47250.0,431280.0,22149.0,360000.0,0.020713,27.72054794520548,-2492.0,-4907.0,-1617.0,,2.0,3.0,3.0,9.0,0.1335063632475464,0.210250097897332,,,,,,,,,,,,,,,,,,,,,,,,,,,,,,,,,,,,,,,,,,,,,,2.0,0.0,2.0,0.0,-1156.0,0.0,0.0,0.0,0.0,0.0,3.0,1.0,1.0,0.0,1.0,0.0,0.0,0.0,0.0,0.0,0.0,1.0,1.0,0.0,1.0,0.0,0.0,0.0,0.0,0.0,0.0,0.0,0.0,0.0,0.0,0.0,0.0,0.0,0.0,0.0,0.0,0.0,0.0,1.0,63265.5,,5400000.0,5349811.5,0.0,0.0,0.0,0.0,-335.0,6970.0,-27.0,,12.0,-5.5,4.0,13289.715,86751.0,201802.5,0.0,108607.5,12.0,-913.5,365243.0,-883.0,-703.0,-13.0,-697.5,10.0,0.0,0.0,140.0,22.0,12.0,7.5,-28.5,0.0,0.0,18.0,11804.85,11804.85,-864.5,-860.0,4.0,1.0,24.0,0.0,0.0,,0.0,,,0.0,,0.0,0.0,0.0,0.0,,0.0,,,0.0,-14.5,0.0,0.0,8349239137.5,184440256353.0,165621491064.0,51986682757.935,1863.0,1705.0,71125.0,70852.0,9140.0,506227.0,,,,,,,128462.0,663028.0,,,,13531517.024657136,-602136529.0,-922181879.0,-296605500.0,-1535555483.0416667,44026.0,30710.0,,,,,,,67490.59512447275,158087.73442802322,,,,,,,,3715274.0,,,,,,,,,,,,,,,,436586.0,431380.0,,6426.9672610028965,632147.0,625698.0,,,,,,,,,12.0,54691249.13999999,,5700141022.320001,1890623513.7450008,62834972.08499995,709847.0099999999,104.0,12039.0,-18442001.0,8337872.0,-9537781.0,,-5.5,63265.5,,5400000.0,5349811.5,0.0,0.0,0.0,0.0,-335.0,6970.0,-27.0,,200492199.5624998,2858388484.320002,3219846597.585001,45959567.98499998,2858356037.070002,206804.0,-14128597.0,3282052749.5,141817002.5,735048136.5,319622766.5,768160578.0,205899.0,3211.0,576.9259981505786,4803993.5,1689904.0,1039339.5,-3398090.0,1184371.0,99990.0,2256024753.36014,2279818194.930086,-138444194.0,-137322642.5,2500327.0,111821.5,2159575073.819986,5788323000.0,,279917461.2599995,,,123303254.12999956,,284233142.38500047,2072524798.3499985,2151310900.1849823,2151394422.1199822,,23352.0,,,720934.0,-1274880.5,554818.0,1224.0,1467904.0,14798581.0,3233744.0,8557813.0,11611361.0,1416197.0,1059414774.1245012,,72132309585.92212,21688045520.287617,582566507.5544988,5792665.7475,689.5,94245.0,-277011023.0,21969484.0,-123824133.5,,-2020194.5,5924183430.554961,18726898500.0,,447992079.2549976,,,309185201.1374987,,459229282.1999993,5709287472.007533,5887459571.692499,5887702754.4375,,80842.0,,,971769.5,-1699072.5,177364.0,6755.0,4274360.0,2480041.0,-9006361.5,921269.0,37582.5,3734926550.189961,3659628652.2224607,-260708893.5,-257396754.0,2527354.0,269284.5,3927458129.309956,33263874422.23592,36693354721.365135,1730031175.7325494,48099390899.22071,3989282.0,-247663702.5,103119083411.5,1054636609.0,17278722686.5,3504374798.5,18892379025.0,3673194.0,71946.0,20877.477487643395,89805516.5,-89.89721288792252,9.127619047619048,2.133279154815116,59.13566709155984,19.471759447379117,539.7678413385804,23625.0,1.0,0.0,0.0,0.0,0.0,0.0,0.0,0.0,1.0,0.0,0.0,0.0,0.0,0.0,0.0,1.0,0.0,0.0,0.0,0.0,1.0,0.0,1.0,0.0,0.0,0.0,0.0,1.0,0.0,0.0,0.0,0.0,0.0,0.0,0.0,0.0,0.0,0.0,0.0,0.0,0.0,0.0,0.0,1.0,0.0,0.0,0.0,0.0,0.0,0.0,0.0,0.0,0.0,0.0,0.0,0.0,0.0,0.0,0.0,0.0,0.0,0.0,0.0,0.0,0.0,0.0,0.0,0.0,0.0,0.0,0.0,0.0,0.0,0.0,0.0,0.0,0.0,0.0,0.0,0.0,1.0,0.0,0.0,0.0,0.0,0.0,0.0,0.0,0.0,0.0,0.0,0.0,0.0,0.0,0.0,0.0,0.0,0.0,0.0,0.0,0.0,0.0,0.0,0.0,0.0,0.0,0.0,0.0,0.0,0.0,0.0,0.0,0.0,0.0,0.0,0.0,0.0,0.0,0.0,0.0,0.0,0.0
103432,0,0.0,1.0,0.0,0.0,1.0,135000.0,1066320.0,38430.0,900000.0,0.005144,41.8,-5574.0,-9388.0,-4343.0,,3.0,2.0,2.0,10.0,,0.2445245260878889,0.6279908192952864,0.0825,0.0781,0.9752,0.66,0.0079,0.0,0.1379,0.1667,0.2083,0.0379,0.0672,0.0706,0.0,0.0,0.084,0.081,0.9752,0.6733,0.008,0.0,0.1379,0.1667,0.2083,0.0387,0.0735,0.0735,0.0,0.0,0.0833,0.0781,0.9752,0.6645,0.008,0.0,0.1379,0.1667,0.2083,0.0385,0.0684,0.0719,0.0,0.0,0.0598,1.0,0.0,0.0,0.0,0.0,-1.0,0.0,0.0,0.0,0.0,0.0,1.0,1.0,1.0,0.0,1.0,1.0,0.0,0.0,0.0,0.0,0.0,0.0,0.0,0.0,1.0,0.0,0.0,0.0,0.0,0.0,0.0,0.0,0.0,0.0,0.0,0.0,0.0,0.0,0.0,0.0,0.0,0.0,0.0,6.0,13473.0,,421200.0,0.0,0.0,0.0,0.0,0.0,-832.0,456.5,-265.0,-2435.5,273.0,-26.0,2.0,22690.71,175018.5,175745.25,11250.0,175018.5,10.0,-2575.5,365243.0,-2544.5,-2289.5,-2274.5,-2282.5,13.5,1.0,0.0604875763163368,70.0,20.0,12.0,5.0,-79.5,0.0,0.0,21.0,20263.275,20263.275,-2344.0,-2330.0,6.0,1.0,0.0,,,,,,,,,,,,,,,,,,,,,8349277567.5,184441322673.0,165622391064.0,51986817757.935,1863.0,1705.0,71125.0,70852.0,9140.0,506228.0,17813.53710000229,17875.740199999098,17327.091099998033,11299.29380000009,11237.065300000091,11184.434300000055,128463.0,663031.0,4139.678100000117,4137.351200000016,3947.923400000093,13531558.824657137,-602142103.0,-922186222.0,-296605501.0,-1535564871.0416667,44026.0,30710.0,11352.808399999189,11228.75999999898,10712.958699997287,22894.59140000972,22816.44330000968,22201.82870000824,,158087.9789525493,126145.45515034512,35012.63610002795,34952.866900028384,34398.3010000288,22962.484799995906,22935.608799995483,22582.37289999572,3715284.0,8298.284900000164,8402.845900000075,8126.37340000023,9820.571900000716,9935.569800002162,10295.415699999648,16472.575599999756,16657.881699999696,16254.630099999704,828.8328000001762,814.0081000000459,759.9307000000133,3914.811800000125,3897.995600000165,3730.60020000016,436586.0,431380.0,,6426.972405002897,632149.0,625700.0,,16337.066699999805,154227.85519999065,154230.60029999018,154122.33349998714,77637.1443999963,77975.05240000659,78376.56010000654,28.0,54793567.88999999,,5710241796.93,1893065836.5000007,62834972.08499995,709847.0099999999,104.0,12039.0,-18490685.5,8320083.5,-9561659.5,-10388854.5,-13.5,15016.5,,482400.0,0.0,0.0,0.0,0.0,0.0,-2525.0,-1946.0,-895.0,-2681.0,201250875.30749977,2867122582.470002,3230679902.085001,46217403.13499998,2867122582.470002,207267.0,-14180662.5,3292643259.5,142510501.0,736845229.0,321059348.0,769959212.5,206522.5,3217.5,579.4439789175888,4814471.0,1694588.0,1042149.5,-3408842.0,1184371.0,99990.0,2263650912.0451326,2288679783.030079,-138789267.0,-137663886.0,2503593.0,112157.0,,,,,,,,,,,,,,,,,,,,,1467910.0,14798854.0,3233744.0,8557833.0,11611382.0,1416199.0,1059428247.1245012,,72132730785.92212,21688045520.287617,582566507.5544988,5792665.7475,689.5,94245.0,-277011855.0,21969940.5,-123824398.5,-218771896.0,-2020220.5,,,,,,,,,,,,,,,,,,,,,4274372.0,2480046.0,-9006441.0,921269.0,37582.5,3734946813.464961,3659648915.497461,-260711237.5,-257399084.0,2527360.0,269285.5,3927480820.019956,33264049440.73592,36693530466.615135,1730042425.7325494,48099565917.72071,3989292.0,-247666278.0,103119448654.5,1054634064.5,17278720397.0,3504372524.0,18892376742.5,3673207.5,71947.0,20877.537975219708,89805586.5,-133.34928229665073,7.898666666666666,3.5128805620608903,146.83840749414517,27.747072599531613,1159.8276346604214,45000.0,-0.9009688679024191,0.4338837391175582,0.0,0.0,0.0,0.0,0.0,0.0,1.0,0.0,0.0,0.0,0.0,0.0,0.0,1.0,0.0,0.0,0.0,0.0,1.0,0.0,1.0,0.0,0.0,0.0,0.0,1.0,0.0,0.0,0.0,0.0,0.0,0.0,0.0,0.0,0.0,0.0,0.0,0.0,1.0,0.0,0.0,0.0,0.0,0.0,0.0,0.0,0.0,0.0,0.0,0.0,0.0,0.0,1.0,0.0,0.0,0.0,0.0,0.0,0.0,0.0,0.0,0.0,0.0,0.0,0.0,0.0,0.0,0.0,0.0,0.0,0.0,0.0,0.0,0.0,0.0,0.0,0.0,0.0,0.0,0.0,0.0,0.0,0.0,0.0,0.0,0.0,0.0,0.0,0.0,0.0,0.0,0.0,0.0,0.0,0.0,0.0,0.0,0.0,0.0,0.0,0.0,0.0,0.0,0.0,0.0,0.0,0.0,0.0,1.0,0.0,1.0,0.0,0.0,0.0,0.0,0.0,0.0,1.0,0.0,0.0
103433,0,0.0,0.0,0.0,1.0,0.0,81000.0,225000.0,11619.0,225000.0,0.035792,60.07671232876712,-747.0,-13854.0,-1977.0,,2.0,2.0,2.0,17.0,,0.7036133784317714,0.5867400085415683,,,,,,,,,,,,,,,,,,,,,,,,,,,,,,,,,,,,,,,,,,,,,0.0,0.0,0.0,0.0,-2178.0,0.0,0.0,0.0,0.0,2.0,5.0,1.0,1.0,0.0,1.0,1.0,0.0,0.0,0.0,0.0,0.0,0.0,0.0,0.0,1.0,0.0,0.0,0.0,0.0,0.0,0.0,0.0,0.0,0.0,0.0,0.0,0.0,0.0,0.0,0.0,0.0,0.0,0.0,7.0,0.0,0.0,189000.0,0.0,0.0,0.0,0.0,0.0,-682.0,-651.0,-216.0,-679.0,247.0,-22.0,12.0,13619.25,0.0,0.0,10066.5,270000.0,24.0,-169.0,365243.0,181555.0,181720.0,181720.0,-969.5,17.0,0.0,0.1000121659949246,-1.0,13.0,12.0,6.0,-65.0,0.0,0.0,12.0,10622.34,10622.34,-1991.5,-1968.0,6.5,1.0,4.0,0.0,315000.0,,0.0,,,0.0,,0.0,0.0,0.0,0.0,,0.0,,,0.0,-4.5,0.0,0.0,8349289186.5,184441547673.0,165622616064.0,51986898757.935,1863.0,1705.0,71125.0,70854.0,9140.0,506233.0,,,,,,,128463.0,663033.0,,,,13531618.901369466,-602142850.0,-922188199.0,-296607679.0,-1535578725.0416667,44026.0,30710.0,,,,,,,,158088.68256592777,126146.04189035363,,,,,,,3715301.0,,,,,,,,,,,,,,,,436586.0,431380.0,,6427.008197002897,632151.0,625702.0,,,,,,,,,23.0,54807785.63999999,21858603.570000008,5713042056.93,1893663562.5000007,62834972.08499995,709847.0099999999,104.0,12039.0,-18496535.0,8321098.0,-9563774.0,-10392707.0,-11.0,0.0,0.0,95805.0,0.0,0.0,0.0,0.0,0.0,-1703.0,-1183.0,-1182.0,-1182.0,201301370.2799998,2867913986.220002,3231477171.585001,46227469.63499998,2867913986.220002,207321.0,-14184971.0,3293373745.5,142689779.5,737025002.5,321239121.5,769956303.5,206631.0,3218.0,579.5439910835837,4814788.5,1694786.0,1042252.0,-3410013.0,1184371.0,99990.0,2263922128.350136,2288930130.6750803,-138824468.5,-137698830.5,2503713.5,112173.5,2164871692.889986,5824210500.0,,280770526.2599995,,,123578889.92999956,,285140979.58500093,2077602487.469998,2156579193.9149823,2156662715.8499823,,23383.0,,,721291.0,-1276910.5,554818.0,1224.0,1467917.0,14799101.0,3233748.0,8557846.0,11611394.0,1416211.0,1059428247.1245012,801776896.6724951,72132919785.92212,21688045520.287617,582566507.5544988,5792665.7475,689.5,94245.0,-277012537.0,21969289.5,-123824614.5,-218772575.0,-2020242.5,5924183430.554961,18727213500.0,,447992079.2549976,,,309185201.1374987,,459229282.1999993,5709287472.007533,5887459571.692499,5887702754.4375,,80842.0,,,971769.5,-1699077.0,177364.0,6755.0,4274384.0,2480052.0,-9006506.0,921269.0,37582.5,3734957435.8049607,3659659537.837461,-260713229.0,-257401052.0,2527366.5,269286.5,3927494439.269956,33264049440.73592,36693530466.615135,1730052492.2325494,48099835917.72071,3989316.0,-247666447.0,103119813897.5,1054815619.5,17278902117.0,3504554244.0,18892375773.0,3673224.5,71947.0,20877.637987385708,89805585.5,-12.434102517329444,2.7777777777777777,6.9713400464756,418.8151905181288,19.364833462432227,1163.375529217024,40500.0,-0.9009688679024191,0.4338837391175582,0.0,0.0,0.0,0.0,0.0,0.0,1.0,0.0,1.0,0.0,0.0,0.0,0.0,0.0,0.0,0.0,0.0,0.0,1.0,0.0,1.0,0.0,0.0,0.0,0.0,1.0,0.0,0.0,0.0,0.0,0.0,0.0,0.0,0.0,0.0,0.0,0.0,0.0,0.0,0.0,0.0,0.0,0.0,0.0,0.0,0.0,0.0,0.0,0.0,0.0,1.0,0.0,0.0,0.0,0.0,0.0,0.0,0.0,0.0,0.0,0.0,0.0,0.0,0.0,0.0,0.0,0.0,0.0,0.0,0.0,0.0,0.0,0.0,0.0,0.0,0.0,0.0,0.0,0.0,0.0,0.0,0.0,0.0,0.0,0.0,0.0,0.0,0.0,0.0,0.0,0.0,0.0,0.0,0.0,0.0,0.0,0.0,0.0,0.0,0.0,0.0,0.0,0.0,0.0,0.0,0.0,0.0,0.0,0.0,0.0,0.0,0.0,0.0,0.0,0.0,0.0,0.0,0.0,0.0,0.0
103436,0,0.0,0.0,1.0,1.0,0.0,187398.0,1125000.0,47794.5,1125000.0,0.030755,53.09041095890412,-5071.0,-7379.0,-2914.0,11.0,1.0,2.0,2.0,14.0,,0.5770406261524078,0.5656079814115492,,,,,,,,,,,,,,,,,,,,,,,,,,,,,,,,,,,,,,,,,,,,,0.0,0.0,0.0,0.0,-443.0,0.0,0.0,0.0,0.0,0.0,0.0,1.0,1.0,1.0,1.0,1.0,0.0,0.0,0.0,0.0,0.0,0.0,0.0,0.0,0.0,0.0,0.0,0.0,0.0,0.0,0.0,0.0,0.0,0.0,0.0,0.0,0.0,0.0,0.0,1.0,0.0,0.0,0.0,5.0,12537.0,0.0,177588.0,0.0,0.0,0.0,0.0,0.0,-2625.0,-362.0,-362.0,-1329.5,376.0,-39.5,1.0,15324.975,169416.0,147519.0,33885.0,169416.0,12.0,-1739.0,365243.0,-1708.0,-1378.0,-1378.0,-1375.0,18.0,0.0,0.2034345739594796,2001.0,13.0,12.0,6.0,-51.0,0.0,0.0,12.0,15324.975,15324.975,-1547.0,-1543.0,6.5,1.0,0.0,,,,,,,,,,,,,,,,,,,,,8349336981.0,184442672673.0,165623741064.0,51987086155.935,1863.0,1705.0,71125.0,70854.0,9140.0,506233.0,,,,,,,128463.0,663034.0,,,,13531671.991780424,-602147921.0,-922191113.0,-296608122.0,-1535586104.0416667,44026.0,30710.0,,,,,,,,158089.25960655385,126146.60749833508,,,,,,,3715315.0,,,,,,,,,,,,,,,,436586.0,431380.0,1263564.0,6427.038952002897,632153.0,625704.0,,,,,,,,,87.0,54829751.44499999,21858603.570000008,5714611278.93,1894464946.0350008,62902472.08499995,709847.0099999999,104.0,12039.0,-18510222.0,8345001.0,-9571631.0,-10399447.0,-43.0,12537.0,0.0,177588.0,0.0,0.0,0.0,0.0,0.0,-2625.0,-362.0,-362.0,-1329.5,201352698.85499972,2868840671.220002,3232387598.085001,46272604.63499998,2868840671.220002,207395.0,-14192945.0,3294652096.0,142868536.0,737204809.0,321418928.0,769953430.0,206783.0,3218.0,580.0107964519643,4816931.0,1695308.0,1042505.0,-3411640.0,1184392.0,100011.0,2264327455.612641,2289296576.0475845,-138879695.0,-137753507.0,2504150.0,112221.5,,,,,,,,,,,,,,,,,,,,,1467922.0,14799477.0,3233748.0,8557859.0,11611406.0,1416212.0,1059440784.1245012,801776896.6724951,72133097373.92212,21688045520.287617,582566507.5544988,5792665.7475,689.5,94245.0,-277015162.0,21968927.5,-123824976.5,-218773904.5,-2020282.0,,,,,,,,,,,,,,,,,,,,,4274396.0,2480058.0,-9006557.0,921269.0,37582.5,3734972760.779961,3659674862.812461,-260714776.0,-257402595.0,2527373.0,269287.5,3927509764.244956,33264218856.73592,36693677985.615135,1730086377.2325494,48100005333.72071,3989328.0,-247668186.0,103120179140.5,1054813911.5,17278900739.0,3504552866.0,18892374398.0,3673242.5,71947.0,20877.841421959667,89807586.5,-95.51630715244092,6.00326577658246,3.9209114019395535,208.1627976624237,23.53827323227568,1249.6565991644882,187398.0,-0.2225209339563143,0.9749279121818236,0.0,0.0,0.0,0.0,0.0,0.0,1.0,0.0,1.0,0.0,0.0,0.0,0.0,0.0,0.0,1.0,0.0,0.0,0.0,0.0,0.0,1.0,0.0,0.0,0.0,1.0,0.0,0.0,0.0,0.0,0.0,0.0,0.0,0.0,0.0,0.0,0.0,0.0,0.0,0.0,1.0,0.0,0.0,0.0,0.0,0.0,0.0,0.0,0.0,0.0,0.0,0.0,0.0,0.0,0.0,0.0,0.0,0.0,0.0,0.0,0.0,0.0,0.0,0.0,0.0,0.0,0.0,0.0,0.0,0.0,0.0,0.0,0.0,0.0,0.0,0.0,0.0,0.0,0.0,0.0,0.0,0.0,0.0,0.0,0.0,0.0,0.0,0.0,0.0,0.0,0.0,0.0,0.0,0.0,0.0,1.0,0.0,0.0,0.0,0.0,0.0,0.0,0.0,0.0,0.0,0.0,0.0,0.0,0.0,0.0,0.0,0.0,0.0,0.0,0.0,0.0,0.0,0.0,0.0,0.0
103440,0,0.0,0.0,1.0,1.0,0.0,135000.0,885046.5,33493.5,747000.0,0.018801,42.61643835616439,-1303.0,-2443.0,-821.0,4.0,2.0,2.0,2.0,8.0,0.5540826886942769,0.497137261524917,0.633031641417419,,,,,,,,,,,,,,,,,,,,,,,,,,,,,,,,,,,,,,,,,,,,,3.0,0.0,3.0,0.0,-1171.0,0.0,0.0,0.0,0.0,1.0,2.0,1.0,1.0,0.0,1.0,0.0,1.0,0.0,0.0,0.0,0.0,1.0,1.0,0.0,1.0,0.0,0.0,0.0,0.0,0.0,0.0,0.0,0.0,0.0,0.0,0.0,0.0,0.0,0.0,0.0,0.0,0.0,0.0,2.0,0.0,0.0,1203084.0,0.0,0.0,0.0,0.0,0.0,-658.5,-431.5,-422.0,-431.5,42.0,-11.0,14.0,10481.265,81670.5,86528.25,3777.75,84253.5,10.0,-1097.0,365243.0,-1323.5,-1143.5,-1053.5,-1135.0,10.0,0.0,0.0977493006279302,10.0,87.0,8.0,5.0,-58.0,0.0,0.0,75.0,8419.59,8419.59,-1751.0,-1712.0,5.0,1.0,1.0,0.0,135000.0,,0.0,,,0.0,,0.0,0.0,0.0,0.0,,0.0,,,0.0,-1.0,0.0,0.0,8349370474.5,184443557719.5,165624488064.0,51987221155.935,1863.0,1705.0,71125.0,70855.0,9140.0,506235.0,,,,,,,128463.0,663036.0,,,,13531714.608218778,-602149224.0,-922191934.0,-296609293.0,-1535588547.0416667,44026.0,30710.0,,,,,,,67491.14920716145,158089.75674381538,126147.24052997652,,,,,,,3715323.0,,,,,,,,,,,,,,,,436589.0,431383.0,1263568.0,6427.057753002897,632155.0,625706.0,,,,,,,,,21.0,54829751.44499999,21858783.570000008,5727320105.265,1899479525.5350008,62902472.08499995,709847.0099999999,104.0,12039.0,-18537658.0,8347311.5,-9581888.5,-10408875.5,-11.0,0.0,0.0,2181168.0,0.0,0.0,0.0,0.0,0.0,-683.0,-294.0,-275.0,-294.0,201540605.7599997,2872057737.6450024,3235883894.010001,46302304.63499998,2872015610.8950024,207571.0,-14207908.0,3297756661.5,142860233.0,737559463.0,321412579.0,770308135.0,206926.0,3220.0,580.4477959227758,4817350.5,1696364.0,1043221.0,-3415251.0,1184392.0,100011.0,2266525875.375139,2291480371.125082,-138982142.0,-137855110.0,2504508.0,112290.0,2164871692.889986,5824818000.0,,280770526.2599995,,,123578889.92999956,,285140979.58500093,2077602487.469998,2156579193.9149823,2156662715.8499823,,23383.0,,,721291.0,-1276917.0,554818.0,1224.0,1467924.0,14799519.0,3233749.0,8557946.0,11611481.0,1416226.0,1059440784.1245012,801776896.6724951,72134300457.92212,21688045520.287617,582566507.5544988,5792665.7475,689.5,94245.0,-277015820.5,21968496.0,-123825398.5,-218774336.0,-2020293.0,5924183430.554961,18727348500.0,,447992079.2549976,,,309185201.1374987,,459229282.1999993,5709287472.007533,5887459571.692499,5887702754.4375,,80842.0,,,971769.5,-1699078.0,177364.0,6755.0,4274404.0,2480063.0,-9006615.0,921269.0,37582.5,3734981180.369961,3659683282.402461,-260716527.0,-257404307.0,2527378.0,269288.5,3927520245.509957,33264300527.23592,36693764513.865135,1730090154.9825494,48100089587.22071,3989338.0,-247669283.0,103120544383.5,1054812588.0,17278899595.5,3504551812.5,18892373263.0,3673252.5,71947.0,20877.939171260296,89807596.5,-30.575056252009,6.5559,4.030632809351068,171.77121465604344,26.424425634824672,1126.1149061635554,67500.0,-0.9009688679024191,-0.433883739117558,0.0,0.0,0.0,0.0,0.0,0.0,1.0,0.0,0.0,0.0,0.0,0.0,0.0,1.0,0.0,0.0,0.0,0.0,1.0,0.0,1.0,0.0,0.0,0.0,0.0,1.0,0.0,0.0,0.0,0.0,0.0,0.0,0.0,0.0,0.0,0.0,0.0,0.0,0.0,0.0,0.0,0.0,0.0,1.0,0.0,0.0,0.0,0.0,0.0,0.0,0.0,0.0,0.0,0.0,0.0,0.0,0.0,0.0,0.0,0.0,0.0,0.0,0.0,0.0,0.0,0.0,0.0,0.0,0.0,0.0,0.0,0.0,0.0,0.0,0.0,0.0,0.0,0.0,0.0,0.0,0.0,0.0,0.0,0.0,0.0,0.0,0.0,0.0,0.0,0.0,0.0,1.0,0.0,0.0,0.0,0.0,0.0,0.0,0.0,0.0,0.0,0.0,0.0,0.0,0.0,0.0,0.0,0.0,0.0,0.0,0.0,0.0,0.0,0.0,0.0,0.0,0.0,0.0,0.0,0.0
103453,0,0.0,0.0,1.0,0.0,0.0,135000.0,360000.0,18378.0,360000.0,0.0072739999999999,43.3041095890411,-1028.0,-6687.0,-1779.0,12.0,2.0,2.0,2.0,15.0,,0.5562089827597436,0.5549467685334323,,,,,,,,,,,,,,,,,,,,,,,,,,,,,,,,,,,,,,,,,,,,,0.0,0.0,0.0,0.0,-522.0,0.0,0.0,0.0,0.0,0.0,2.0,1.0,1.0,1.0,1.0,1.0,0.0,0.0,0.0,0.0,0.0,1.0,1.0,0.0,1.0,0.0,0.0,0.0,0.0,0.0,0.0,0.0,0.0,0.0,0.0,0.0,0.0,0.0,0.0,0.0,0.0,0.0,0.0,6.0,10624.5,0.0,133875.0,80358.75,0.0,0.0,0.0,0.0,-607.5,508.0,-28.0,-648.0,151.0,-13.0,2.0,7499.475,96468.75,105988.5,0.0,96468.75,9.0,-522.0,365243.0,182375.5,182615.5,182630.5,182619.0,11.0,0.5,0.0,1073.0,17.0,18.0,10.0,-9.0,0.0,0.0,17.0,12748.95,12748.95,-263.0,-252.0,9.0,1.0,17.0,0.0,135000.0,,0.0,,,0.0,,0.0,0.0,0.0,0.0,,0.0,,,0.0,-9.0,0.0,0.0,8349388852.5,184443917719.5,165624848064.0,51987356155.935,1863.0,1705.0,71125.0,70855.0,9140.0,506237.0,,,,,,,128463.0,663038.0,,,,13531757.912328364,-602150252.0,-922193713.0,-296609815.0,-1535595234.0416667,44026.0,30710.0,,,,,,,,158090.31295279818,126147.79547674506,,,,,,,3715338.0,,,,,,,,,,,,,,,,436589.0,431383.0,1263580.0,6427.065027002896,632157.0,625708.0,,,,,,,,,20.5,55118829.95999999,21872444.535000008,5757653343.240001,1909762842.3300009,63047624.08499995,709847.0099999999,104.0,12039.0,-18575089.5,8373100.0,-9601498.0,-10426886.0,-9.75,10624.5,0.0,65250.0,0.0,0.0,0.0,0.0,0.0,-952.0,-648.0,-28.0,-1366.0,202208678.9549997,2880914667.7950025,3245756492.1600013,46410403.63499998,2880914667.7950025,208214.0,-14257565.0,3309806360.5,143369843.5,741006427.5,323037664.5,774122378.5,207732.5,3234.0,581.8738906163874,4843437.5,1704531.0,1048446.0,-3427557.0,1185037.0,100014.0,2275164245.56514,2300175916.6050787,-139491755.0,-138360178.0,2514983.0,112925.0,2169483923.3399854,5841067500.0,,281302061.3999995,,,123927823.48499957,,285772208.13000095,2082039157.2149985,2161181434.859982,2161264956.794982,,23475.0,,,723748.0,-1281023.0,554827.0,1225.0,1467930.0,14799670.0,3233766.0,8557963.0,11611498.0,1416228.0,1059451408.6245012,801776896.6724951,72134434332.92212,21688125879.037617,582566507.5544988,5792665.7475,689.5,94245.0,-277016428.0,21969004.0,-123825426.5,-218774984.0,-2020306.0,5924183430.554961,18727483500.0,,447992079.2549976,,,309185201.1374987,,459229282.1999993,5709287472.007533,5887459571.692499,5887702754.4375,,80842.0,,,971769.5,-1699087.0,177364.0,6755.0,4274422.0,2480073.0,-9006624.0,921269.0,37582.5,3734993929.319961,3659696031.352461,-260716790.0,-257404559.0,2527387.0,269289.5,3927527744.984956,33264396995.98592,36693870502.365135,1730090154.9825494,48100186055.97071,3989347.0,-247669805.0,103120909626.5,1054994963.5,17279082211.0,3504734443.0,18892555882.0,3673263.5,71947.5,20877.939171260296,89808669.5,-23.739086422877392,2.6666666666666665,7.345739471106758,318.1007070693518,19.58863858961802,848.2685521849382,67500.0,-0.9009688679024191,0.4338837391175582,0.0,0.0,0.0,0.0,0.0,0.0,1.0,0.0,1.0,0.0,0.0,0.0,0.0,0.0,0.0,0.0,0.0,0.0,1.0,0.0,1.0,0.0,0.0,0.0,0.0,1.0,0.0,0.0,0.0,0.0,0.0,0.0,0.0,0.0,0.0,0.0,0.0,0.0,0.0,0.0,0.0,1.0,0.0,0.0,0.0,0.0,0.0,0.0,0.0,0.0,0.0,0.0,0.0,0.0,0.0,0.0,0.0,0.0,0.0,0.0,0.0,0.0,0.0,0.0,0.0,0.0,0.0,0.0,0.0,0.0,0.0,0.0,0.0,0.0,0.0,0.0,1.0,0.0,0.0,0.0,0.0,0.0,0.0,0.0,0.0,0.0,0.0,0.0,0.0,0.0,0.0,0.0,0.0,0.0,0.0,0.0,0.0,0.0,0.0,0.0,0.0,0.0,0.0,0.0,0.0,0.0,0.0,0.0,0.0,0.0,0.0,0.0,0.0,0.0,0.0,0.0,0.0,0.0,0.0,0.0
103459,0,0.0,1.0,1.0,0.0,0.0,247500.0,1800000.0,56002.5,1800000.0,0.010006,25.76986301369863,-2072.0,-5816.0,-2059.0,8.0,2.0,2.0,2.0,15.0,0.2285108959670132,0.4187843720674378,0.6528965519806539,0.0165,0.0,0.9826,0.762,,0.0,0.069,0.0417,0.0833,0.061,0.0134,0.0094,0.0,0.0,0.0168,0.0,0.9826,0.7713,,0.0,0.069,0.0417,0.0833,0.0624,0.0147,0.0098,0.0,0.0,0.0167,0.0,0.9826,0.7652,,0.0,0.069,0.0417,0.0833,0.0621,0.0137,0.0096,0.0,0.0,0.0115,1.0,4.0,0.0,4.0,0.0,-1851.0,0.0,0.0,0.0,0.0,0.0,0.0,1.0,1.0,1.0,1.0,0.0,0.0,0.0,0.0,0.0,0.0,0.0,0.0,0.0,1.0,0.0,0.0,0.0,0.0,0.0,0.0,0.0,0.0,0.0,0.0,0.0,0.0,0.0,0.0,0.0,0.0,0.0,0.0,3.0,22500.0,0.0,157500.0,0.0,225000.0,0.0,0.0,0.0,-522.0,15220.0,-32.0,-451.0,61.0,-10.0,3.0,5711.175,45000.0,47475.0,0.0,45000.0,10.0,-504.0,365243.0,-243.0,-63.0,27.0,-60.0,11.0,0.0,0.0,50.0,17.0,10.0,6.0,-15.0,0.0,0.0,15.0,6139.485,6139.485,-444.0,-433.0,4.0,1.0,17.0,0.0,0.0,,0.0,,,0.0,,0.0,0.0,0.0,0.0,,0.0,,,0.0,-9.0,0.0,0.0,8349444855.0,184445717719.5,165626648064.0,51987603655.935,1863.0,1705.0,71125.0,70855.0,9140.0,506237.0,17813.55360000229,17875.756899999098,17327.10789999803,11299.29380000009,11237.065300000091,11184.434300000055,128463.0,663040.0,,,,13531783.68219138,-602152324.0,-922195772.0,-296611666.0,-1535601050.0416667,44026.0,30710.0,11352.808399999189,11228.75999999898,10712.958699997287,22894.66040000972,22816.51230000968,22201.89770000824,67491.37771805741,158090.73173717025,126148.448373297,35012.67780002795,34952.908600028386,34398.3427000288,22962.568099995904,22935.69209999548,22582.45619999572,3715353.0,8298.345900000164,8402.908000000074,8126.435800000229,9820.585300000716,9935.583500002162,10295.430399999646,16472.584999999755,16657.891299999694,16254.639899999704,828.8328000001762,814.0081000000459,759.9307000000133,3914.811800000125,3897.995600000165,3730.60020000016,436593.0,431387.0,1263588.0,6427.075033002897,632159.0,625710.0,,16337.078199999803,154228.83779999064,154231.5828999902,154123.31609998716,77637.9063999963,77975.81760000659,78377.33140000653,18.0,55160173.34999999,21894404.535000008,5764679364.240001,1911409022.8800008,63604735.78499995,709847.0099999999,107.0,12039.0,-18592521.0,8472991.5,-9606547.0,-10431995.0,-8.5,22500.0,0.0,157500.0,0.0,0.0,0.0,0.0,0.0,-522.0,-451.0,-32.0,-451.0,202558924.4849998,2884656946.995003,3250246749.6600013,46479580.33499997,2884656946.995003,208676.0,-14287838.0,3315832682.0,144265522.0,743366150.0,324303701.0,776482216.0,208219.0,3238.0,583.0503582892397,4845414.0,1706287.0,1049617.0,-3432625.0,1185082.0,100022.0,2277059604.750139,2302228346.8950768,-139840723.0,-138707687.0,2520182.0,113090.0,2172472979.1299853,5850693000.0,,281631551.3999995,,,124105208.30999956,,286006457.83500093,2084896722.7799988,2164157288.279983,2164244590.214983,,23497.0,,,726481.0,-1285938.0,554836.0,1234.0,1467933.0,14799731.0,3233783.0,8557980.0,11611513.0,1416231.0,1059473908.6245012,801776896.6724951,72134591832.92212,21688125879.037617,582791507.5544988,5792665.7475,689.5,94245.0,-277016950.0,21984224.0,-123825458.5,-218775435.0,-2020316.0,5924183430.554961,18727483500.0,,447992079.2549976,,,309185201.1374987,,459229282.1999993,5709287472.007533,5887459571.692499,5887702754.4375,,80842.0,,,971769.5,-1699096.0,177364.0,6755.0,4274432.0,2480079.0,-9006639.0,921269.0,37582.5,3735000068.8049607,3659702170.837461,-260717234.0,-257404992.0,2527391.0,269290.5,3927533456.159957,33264441995.98592,36693917977.365135,1730090154.9825494,48100231055.97071,3989357.0,-247670309.0,103121274869.5,1054994720.5,17279082148.0,3504734470.0,18892555822.0,3673274.5,71947.5,20877.939171260296,89808719.5,-80.40399744843718,7.272727272727272,4.41944556046605,113.88850668970868,32.141422257934906,828.2800486524268,123750.0,-0.2225209339563143,0.9749279121818236,0.0,0.0,0.0,0.0,0.0,0.0,1.0,0.0,0.0,0.0,0.0,0.0,0.0,1.0,0.0,0.0,0.0,1.0,0.0,0.0,1.0,0.0,0.0,0.0,0.0,1.0,0.0,0.0,0.0,0.0,0.0,0.0,0.0,0.0,1.0,0.0,0.0,0.0,0.0,0.0,0.0,0.0,0.0,0.0,0.0,0.0,0.0,0.0,0.0,0.0,0.0,0.0,0.0,1.0,0.0,0.0,0.0,0.0,0.0,0.0,0.0,0.0,0.0,0.0,0.0,0.0,0.0,0.0,0.0,0.0,0.0,0.0,0.0,0.0,0.0,0.0,0.0,0.0,0.0,0.0,0.0,0.0,0.0,0.0,0.0,0.0,0.0,0.0,0.0,0.0,0.0,0.0,0.0,0.0,0.0,0.0,0.0,0.0,0.0,0.0,0.0,0.0,0.0,0.0,0.0,0.0,0.0,0.0,1.0,0.0,1.0,0.0,0.0,1.0,0.0,0.0,0.0,0.0,0.0,0.0
103460,0,0.0,0.0,0.0,1.0,0.0,360000.0,295776.0,18225.0,234000.0,0.020246,62.65479452054793,,-1968.0,-4649.0,,2.0,3.0,3.0,7.0,,0.5491269376582898,0.6195277080511546,,,,,,,,,,,,,,,,,,,,,,,,,,,,,,,,,,,,,,,,,,,,,5.0,0.0,5.0,0.0,-936.0,0.0,0.0,0.0,0.0,0.0,0.0,1.0,0.0,0.0,1.0,0.0,0.0,0.0,0.0,0.0,0.0,0.0,0.0,0.0,0.0,0.0,0.0,1.0,0.0,0.0,0.0,0.0,0.0,0.0,0.0,0.0,0.0,0.0,0.0,0.0,0.0,0.0,0.0,10.0,0.0,0.0,130500.0,0.0,0.0,0.0,0.0,0.0,-1092.0,-659.0,-736.0,-1407.0,483.0,-28.0,9.0,28438.38,27000.0,25582.5,2700.0,270000.0,12.0,-497.0,365243.0,-541.0,-436.0,-211.0,-432.5,9.0,1.0,0.1039704925146453,-1.0,30.0,12.0,11.0,-15.5,0.0,0.0,32.0,14598.54,18000.0,-371.0,-361.0,4.0,2.0,0.0,,,,,,,,,,,,,,,,,,,,,8349463080.0,184446013495.5,165626882064.0,51987963655.935,1863.0,1705.0,71125.0,70855.0,9140.0,506237.0,,,,,,,128463.0,663042.0,,,,13531846.3369859,,-922200421.0,-296612602.0,-1535603018.0416667,44026.0,30710.0,,,,,,,,158091.28086410792,126149.06790100508,,,,,,,3715360.0,,,,,,,,,,,,,,,,436598.0,431392.0,,6427.095279002897,632162.0,625713.0,,,,,,,,,36.0,55182673.34999999,21902409.99000001,5765843722.725,1911764983.5000005,63604735.78499995,709847.0099999999,107.0,12039.0,-18599950.5,8500943.0,-9610879.5,-10437193.5,-17.5,0.0,0.0,126000.0,0.0,0.0,0.0,0.0,0.0,-2468.0,-2164.0,-1976.0,-2115.0,202613988.37499985,2885442646.995003,3251144891.1600013,46482280.33499997,2885469646.995003,208764.0,-14290534.0,3317111032.5,144263856.5,743729903.5,324304013.5,776845983.5,208277.0,3240.0,583.1543287817544,4845463.0,1706999.0,1050231.0,-3432854.5,1185082.0,100022.0,2277580977.225141,2302819832.2950788,-139846801.5,-138713584.5,2520306.5,113183.0,,,,,,,,,,,,,,,,,,,,,1467943.0,14800214.0,3233783.0,8558010.0,11611545.0,1416240.0,1059473908.6245012,801776896.6724951,72134722332.92212,21688125879.037617,582791507.5544988,5792665.7475,689.5,94245.0,-277018042.0,21983565.0,-123826194.5,-218776842.0,-2020344.0,,,,,,,,,,,,,,,,,,,,,4274444.0,2480090.0,-9006654.5,921269.0,37582.5,3735014667.344961,3659720170.837461,-260717605.0,-257405353.0,2527395.0,269292.5,3927561894.539956,33264468995.98592,36693943559.865135,1730092854.9825494,48100501055.97071,3989369.0,-247670806.0,103121640112.5,1054994179.5,17279081712.0,3504734259.0,18892555389.5,3673283.5,71948.5,20878.04314175281,89808718.5,,0.8216,19.753086419753085,1237.6255707762557,16.229135802469134,1016.8331689497716,180000.0,0.6234898018587336,0.7818314824680298,0.0,1.0,0.0,0.0,0.0,0.0,0.0,0.0,0.0,1.0,0.0,0.0,0.0,0.0,0.0,0.0,0.0,0.0,1.0,1.0,0.0,0.0,0.0,0.0,0.0,1.0,0.0,0.0,0.0,0.0,0.0,0.0,0.0,0.0,0.0,0.0,0.0,0.0,0.0,0.0,0.0,0.0,0.0,0.0,0.0,0.0,0.0,0.0,0.0,0.0,0.0,0.0,0.0,0.0,0.0,0.0,0.0,0.0,0.0,0.0,0.0,0.0,0.0,0.0,0.0,0.0,0.0,0.0,0.0,0.0,0.0,0.0,0.0,0.0,0.0,0.0,0.0,0.0,0.0,0.0,0.0,0.0,0.0,0.0,0.0,0.0,0.0,0.0,0.0,0.0,0.0,0.0,0.0,0.0,0.0,0.0,0.0,0.0,0.0,0.0,0.0,0.0,0.0,0.0,0.0,1.0,0.0,0.0,0.0,0.0,0.0,0.0,0.0,0.0,0.0,0.0,0.0,0.0,0.0,0.0
103461,0,0.0,0.0,0.0,0.0,1.0,247500.0,203301.0,21892.5,175500.0,0.04622,44.175342465753424,-1466.0,-12437.0,-4206.0,,3.0,1.0,1.0,10.0,0.6936937396281344,0.7264097216083253,,0.2227,,0.9796,,,0.16,0.1379,0.3333,,,0.1816,0.1196,,,0.2269,,0.9796,,,0.1611,0.1379,0.3333,,,0.1983,0.1246,,,0.2248,,0.9796,,,0.16,0.1379,0.3333,,,0.1847,0.1217,,,0.1561,1.0,0.0,0.0,0.0,0.0,-285.0,0.0,0.0,0.0,0.0,1.0,2.0,1.0,1.0,0.0,1.0,0.0,0.0,0.0,0.0,0.0,0.0,1.0,1.0,0.0,1.0,0.0,0.0,0.0,0.0,0.0,0.0,0.0,0.0,0.0,0.0,0.0,0.0,0.0,0.0,0.0,0.0,0.0,0.0,1.0,56767.5,0.0,1350000.0,,,0.0,0.0,0.0,-834.0,261.0,-14.0,,28.0,-13.5,4.0,24951.24,49432.5,48159.0,9886.5,389182.5,17.0,-285.0,365243.0,-1514.5,181369.5,-1034.5,181374.0,16.0,1.0,0.1013826840927387,-1.0,21.0,10.0,10.0,-83.0,0.0,0.0,19.0,10700.91,10700.91,-2504.0,-2504.0,5.0,1.0,95.0,0.0,0.0,,0.0,,,0.0,,0.0,0.0,0.0,0.0,,0.0,,,0.0,-49.0,0.0,0.0,8349484972.5,184446216796.5,165627057564.0,51988211155.935,1863.0,1705.0,71125.0,70856.0,9140.0,506239.0,17813.77630000229,17875.981699999098,17327.334799998032,,,,128464.0,663045.0,,,,13531890.512328366,-602153790.0,-922204627.0,-296612887.0,-1535615455.0416667,44026.0,30710.0,11352.968399999188,11228.91999999898,10713.119799997288,22894.798300009723,22816.65020000968,22202.035600008243,67492.07141179702,158092.00727382948,,35013.01110002795,34953.241900028384,34398.6760000288,,,,3715370.0,,,,9820.766900000715,9935.76820000216,10295.628699999646,16472.704599999757,16658.012999999693,16254.764499999705,,,,,,,436598.0,431392.0,,6427.141499002897,632163.0,625714.0,,16337.234299999804,154229.81739999066,154232.5624999902,154124.29569998715,,,,28.0,55258908.79499999,21902575.725000005,5767626521.97,,,709847.0099999999,107.0,12039.0,-18608684.0,8495706.0,-9616299.0,,-13.5,56767.5,0.0,1350000.0,,,0.0,0.0,0.0,-834.0,261.0,-14.0,,202706306.3699998,2886311011.995003,3252051969.6600013,46492166.83499997,2886650761.995003,208816.0,-14295982.5,3318206761.5,144260041.5,743909832.5,324301658.5,777025923.5,208350.0,3242.5,583.2557114658473,4846216.5,1707353.0,1050479.0,-3434105.0,1185082.0,100022.0,2278117530.9901395,2303410102.380079,-139881266.0,-138747836.0,2520422.0,113231.0,2172472979.1299853,5851908000.0,,281631551.3999995,,,124105208.30999956,,286006457.83500093,2084896722.7799988,2164157288.279983,2164244590.214983,,23497.0,,,726481.0,-1288364.0,554836.0,1234.0,1467944.0,14800242.0,3233878.0,8558031.0,11611564.0,1416244.0,1059530676.1245012,801776896.6724951,72136072332.92212,,,5792665.7475,689.5,94245.0,-277018876.0,21983826.0,-123826208.5,,-2020357.5,5924183430.554961,18727483500.0,,447992079.2549976,,,309185201.1374987,,459229282.1999993,5709287472.007533,5887459571.692499,5887702754.4375,,80842.0,,,971769.5,-1699145.0,177364.0,6755.0,4274454.0,2480100.0,-9006737.5,921269.0,37582.5,3735025368.254961,3659730871.747461,-260720109.0,-257407857.0,2527400.0,269293.5,3927586845.779956,33264518428.48592,36693991718.865135,1730102741.4825494,48100890238.47071,3989386.0,-247671091.0,103122005355.5,1054992665.0,17279263081.5,3504733224.5,18892736763.5,3673299.5,71949.5,20878.144524436902,89808717.5,-33.185934011411554,0.8214181818181818,11.30524152106886,499.412915851272,9.2863309352518,410.2268493150685,82500.0,-0.2225209339563143,0.9749279121818236,0.0,0.0,0.0,0.0,0.0,0.0,1.0,0.0,0.0,0.0,1.0,0.0,0.0,0.0,0.0,0.0,0.0,0.0,1.0,0.0,1.0,0.0,0.0,0.0,0.0,1.0,0.0,0.0,0.0,0.0,0.0,0.0,0.0,0.0,0.0,0.0,0.0,0.0,0.0,0.0,0.0,1.0,0.0,0.0,0.0,0.0,0.0,0.0,0.0,0.0,0.0,0.0,0.0,0.0,0.0,0.0,0.0,0.0,0.0,0.0,0.0,0.0,0.0,0.0,0.0,0.0,0.0,0.0,0.0,0.0,0.0,0.0,0.0,0.0,0.0,0.0,0.0,0.0,1.0,0.0,0.0,0.0,0.0,0.0,0.0,0.0,0.0,0.0,0.0,0.0,0.0,0.0,0.0,0.0,0.0,0.0,0.0,0.0,0.0,0.0,0.0,0.0,0.0,0.0,0.0,0.0,0.0,0.0,1.0,0.0,1.0,0.0,0.0,0.0,0.0,0.0,0.0,1.0,0.0,0.0
103462,0,0.0,0.0,0.0,0.0,0.0,54000.0,450000.0,19066.5,450000.0,0.019101,47.38356164383562,-1762.0,-8710.0,-828.0,,2.0,2.0,2.0,19.0,0.5887687467020472,0.3991877448641361,0.7352209993926424,,,0.9707,,,,0.0345,0.0417,,,,,,,,,0.9707,,,,0.0345,0.0417,,,,,,,,,0.9707,,,,0.0345,0.0417,,,,,,,0.0061,1.0,4.0,0.0,4.0,0.0,-687.0,0.0,0.0,0.0,0.0,1.0,0.0,1.0,1.0,1.0,1.0,0.0,0.0,0.0,0.0,0.0,1.0,1.0,0.0,0.0,1.0,0.0,0.0,0.0,0.0,0.0,0.0,0.0,0.0,0.0,0.0,0.0,0.0,0.0,0.0,0.0,0.0,0.0,0.0,7.0,0.0,,60210.0,0.0,0.0,0.0,0.0,0.0,-1807.0,-1621.0,-1198.0,-1405.5,449.0,-32.0,1.0,11760.84,126000.0,126000.0,0.0,126000.0,12.0,-687.0,365243.0,-656.0,-326.0,-326.0,-320.0,12.0,0.0,0.0,40.0,13.0,12.0,6.0,-16.0,0.0,0.0,12.0,11760.84,11760.84,-491.0,-491.0,6.5,1.0,0.0,,,,,,,,,,,,,,,,,,,,,8349504039.0,184446666796.5,165627507564.0,51988265155.935,1863.0,1705.0,71125.0,70857.0,9140.0,506239.0,,,,,,,128464.0,663047.0,,,,13531937.89589001,-602155552.0,-922205455.0,-296613574.0,-1535624165.0416667,44026.0,30710.0,,,,22894.83280000972,22816.68470000968,22202.07010000824,67492.66018054374,158092.40646157434,126149.80312200444,35013.05280002795,34953.283600028386,34398.7177000288,,,,3715389.0,,,,,,,,,,,,,,,,436602.0,431396.0,,6427.160600002897,632165.0,625716.0,,16337.240399999804,154230.78809999063,154233.5331999902,154125.26639998716,,,,60.0,55269744.79499999,,5768175994.47,1911780929.2500005,63604735.78499995,709847.0099999999,107.0,12039.0,-18616069.0,8490697.0,-9620286.0,-10448233.5,-29.5,0.0,,60210.0,0.0,0.0,0.0,0.0,0.0,-1807.0,-1621.0,-1198.0,-1201.0,202737667.9949998,2887116511.995003,3252911285.1600013,46492166.83499997,2887116511.995003,208840.0,-14297097.0,3318754626.0,144259258.0,744092128.0,324301550.0,777208225.0,208386.0,3243.0,583.2557114658473,4846255.0,1707663.0,1050715.0,-3434367.0,1185082.0,100022.0,2278546787.9251423,2303839359.3150806,-139885409.5,-138751950.0,2520519.0,113246.5,,,,,,,,,,,,,,,,,,,,,1467951.0,14800691.0,3233878.0,8558044.0,11611576.0,1416245.0,1059530676.1245012,,72136132542.92212,21688125879.037617,582791507.5544988,5792665.7475,689.5,94245.0,-277020683.0,21982205.0,-123827406.5,-218778247.5,-2020389.5,,,,,,,,,,,,,,,,,,,,,4274466.0,2480106.0,-9006753.5,921269.0,37582.5,3735037129.094961,3659742632.587461,-260720600.0,-257408348.0,2527406.5,269294.5,3927598606.619956,33264644428.48592,36694117718.865135,1730102741.4825494,48101016238.47071,3989398.0,-247671778.0,103122370598.5,1054992009.0,17279262755.5,3504732898.5,18892736443.5,3673311.5,71949.5,20878.144524436902,89808757.5,-37.18589187626481,8.333333333333334,2.832192589096058,134.19937213264748,23.601604909133822,1118.328101105396,27000.0,-0.2225209339563143,0.9749279121818236,0.0,0.0,0.0,0.0,0.0,0.0,1.0,0.0,0.0,0.0,0.0,0.0,0.0,1.0,0.0,0.0,0.0,0.0,1.0,0.0,1.0,0.0,0.0,0.0,0.0,1.0,0.0,0.0,0.0,0.0,0.0,0.0,0.0,0.0,0.0,0.0,0.0,0.0,0.0,0.0,0.0,0.0,0.0,0.0,1.0,0.0,0.0,0.0,0.0,0.0,0.0,0.0,0.0,0.0,0.0,0.0,0.0,0.0,0.0,0.0,0.0,0.0,0.0,0.0,0.0,0.0,0.0,0.0,0.0,0.0,0.0,0.0,0.0,0.0,0.0,0.0,0.0,0.0,0.0,0.0,0.0,0.0,0.0,0.0,0.0,0.0,0.0,0.0,0.0,0.0,1.0,0.0,0.0,0.0,0.0,0.0,0.0,0.0,0.0,0.0,0.0,0.0,0.0,0.0,0.0,0.0,0.0,0.0,0.0,0.0,1.0,0.0,0.0,0.0,0.0,0.0,0.0,0.0,1.0,0.0
103473,0,0.0,0.0,0.0,0.0,1.0,90000.0,66829.5,6259.5,54000.0,0.01885,27.884931506849323,-839.0,-4826.0,-2849.0,,3.0,2.0,2.0,12.0,0.1209918189494072,0.5187991385116537,0.4241303111942548,0.2412,,0.993,,,0.16,0.1379,0.375,,,,0.1326,,0.5099,0.2458,,0.993,,,0.1611,0.1379,0.375,,,,0.1382,,0.5398,0.2436,,0.993,,,0.16,0.1379,0.375,,,,0.135,,0.5206,0.2152,1.0,1.0,1.0,1.0,1.0,-427.0,0.0,0.0,0.0,0.0,0.0,2.0,1.0,1.0,0.0,1.0,0.0,1.0,0.0,0.0,0.0,0.0,0.0,0.0,0.0,1.0,0.0,0.0,0.0,0.0,0.0,0.0,0.0,0.0,0.0,0.0,0.0,0.0,0.0,0.0,0.0,0.0,0.0,0.0,3.0,9900.0,,180000.0,161874.0,0.0,0.0,0.0,0.0,-367.0,529.0,-48.0,-175.0,35.0,-5.0,7.0,16427.6775,45000.0,45000.0,0.0,436527.0,42.0,-234.0,365243.0,-382.0,-171.0,1569.0,-165.0,17.0,0.0,0.0,-1.0,28.0,24.0,11.5,-20.5,0.0,0.0,72.0,6057.765,6057.765,-304.0,-302.0,17.0,0.0,15.0,0.0,90000.0,0.0,60619.995,0.0,60619.995,2324.7,54524.925,51612.255,0.0,0.0,0.0,0.0,23.0,0.0,23.0,5.0,-8.0,0.0,0.0,8349510298.5,184446733626.0,165627561564.0,51988355155.935,1863.0,1705.0,71125.0,70857.0,9140.0,506241.0,17814.01750000229,17876.225299999103,17327.580599998033,,,,128465.0,663050.0,,,,13531965.780821515,-602156391.0,-922208304.0,-296614001.0,-1535628991.0416667,44027.0,30711.0,11353.128399999188,11229.07999999898,10713.280899997288,22894.970700009715,22816.822600009684,22202.20800000824,67492.7811723627,158092.9252607129,126150.22725231564,35013.42780002795,34953.658600028386,34399.0927000288,,,,3715401.0,,,,,,,16472.837199999758,16658.147999999695,16254.902699999702,,,,3915.321700000125,3898.516200000164,3731.14000000016,436603.0,431397.0,,6427.179450002896,632167.0,625718.0,,16337.455599999805,154231.78109999062,154234.52619999018,154126.25939998715,,,,13.0,55740915.76499999,,5782140619.65,1915949586.6900003,64929655.21499996,709847.0099999999,107.0,12039.0,-18686886.0,8517213.0,-9652601.0,-10491560.0,-6.0,9900.0,,180000.0,161874.0,0.0,0.0,0.0,0.0,-367.0,529.0,-48.0,-175.0,203509550.78999972,2900601774.270004,3267780212.1600013,46604212.10999997,2900100024.270004,209633.0,-14350385.0,3331172244.0,144947539.0,745520343.0,325005971.0,778636638.0,209091.0,3254.0,585.5636050953938,4857449.0,1713781.0,1054516.5,-3448792.5,1185102.0,100042.0,2290276084.1176314,2315549995.1325693,-140327858.5,-139189705.5,2523482.0,113639.0,2172563717.534985,5864058000.0,184831918.56,282454950.2849995,10265426.1,87115695.97499995,124128430.06499957,311043535.8749992,286846082.91000086,2084986111.7249987,2164246677.2249827,2164333979.1599827,9493.0,23677.0,145.0,14039.0,726535.0,-1291494.0,554836.0,1234.0,1467954.0,14800726.0,3233893.0,8558072.0,11611648.0,1416252.0,1059540576.1245012,,72136312542.92212,21688287753.037617,582791507.5544988,5792665.7475,689.5,94245.0,-277021050.0,21982734.0,-123827454.5,-218778422.5,-2020394.5,5924183430.554961,18727573500.0,198814557.825,448052699.2499976,1948107.735,256843385.7975008,309187525.83749866,636698668.6349982,459280894.4549993,5709287472.007533,5887459571.692499,5887702754.4375,13385.5,80865.0,44.0,70374.5,971774.5,-1699153.0,177364.0,6755.0,4274490.0,2480117.5,-9006774.0,921269.0,37582.5,3735043186.859961,3659748690.352461,-260720904.0,-257408650.0,2527423.5,269294.5,3927615034.297456,33264689428.48592,36694162718.865135,1730102741.4825494,48101452765.47071,3989440.0,-247672012.0,103122735841.5,1054991627.0,17279262584.5,3504734467.5,18892736278.5,3673328.5,71949.5,20878.144524436902,89808756.5,-30.087934761249752,0.74255,14.378145219266717,400.9335946347852,10.6764917325665,297.7132406960598,30000.0,-0.9009688679024191,0.4338837391175582,0.0,0.0,0.0,0.0,0.0,0.0,1.0,0.0,1.0,0.0,0.0,0.0,0.0,0.0,0.0,0.0,0.0,0.0,1.0,0.0,1.0,0.0,0.0,0.0,0.0,0.0,0.0,0.0,0.0,1.0,0.0,0.0,0.0,0.0,0.0,0.0,0.0,0.0,1.0,0.0,0.0,0.0,0.0,0.0,0.0,0.0,0.0,0.0,0.0,0.0,0.0,0.0,0.0,1.0,0.0,0.0,0.0,0.0,0.0,0.0,0.0,0.0,0.0,0.0,0.0,0.0,0.0,0.0,0.0,0.0,0.0,0.0,0.0,0.0,0.0,0.0,0.0,0.0,0.0,0.0,0.0,0.0,0.0,0.0,0.0,0.0,0.0,0.0,0.0,0.0,0.0,0.0,0.0,0.0,0.0,0.0,0.0,0.0,0.0,0.0,0.0,0.0,0.0,0.0,0.0,0.0,0.0,0.0,0.0,0.0,1.0,0.0,0.0,0.0,0.0,0.0,0.0,1.0,0.0,0.0
103474,0,0.0,0.0,0.0,1.0,2.0,157500.0,1107900.0,35739.0,900000.0,0.009549,35.76164383561644,-2489.0,-312.0,-435.0,,4.0,2.0,2.0,10.0,0.6357719205281529,0.6110443737824971,0.6971469077844458,0.2381,0.1725,0.9866,0.8164,0.0419,0.2532,0.2183,0.3333,0.375,0.1259,0.1888,0.2417,0.0244,0.0497,0.3036,0.2263,0.9871,0.8301,0.0531,0.3222,0.2759,0.3333,0.375,0.1581,0.2599,0.3179,0.0233,0.0754,0.3008,0.2181,0.9871,0.8256,0.0529,0.32,0.2759,0.3333,0.375,0.1572,0.242,0.3106,0.0233,0.0727,0.2717,1.0,0.0,0.0,0.0,0.0,-717.0,0.0,0.0,0.0,0.0,1.0,1.0,1.0,1.0,0.0,1.0,0.0,0.0,0.0,0.0,0.0,0.0,0.0,0.0,0.0,1.0,0.0,0.0,0.0,0.0,0.0,0.0,0.0,0.0,0.0,0.0,0.0,0.0,0.0,0.0,0.0,0.0,0.0,0.0,11.0,0.0,0.0,360000.0,0.0,0.0,0.0,0.0,0.0,-1450.0,-291.0,-1089.0,-1123.0,589.0,-30.0,1.0,8698.005,192051.0,192051.0,0.0,192051.0,24.0,-717.0,365243.0,-686.0,-146.0,4.0,-142.0,19.0,0.0,0.0,3540.0,20.0,24.0,14.5,-13.5,0.0,0.0,19.0,8698.005,8698.005,-587.0,-416.0,10.0,1.0,0.0,,,,,,,,,,,,,,,,,,,,,8349546037.5,184447841526.0,165628461564.0,51988512655.935,1863.0,1705.0,71125.0,70858.0,9140.0,506242.0,17814.25560000229,17876.526099999104,17327.884199998032,11299.466300000093,11237.283400000091,11184.660600000056,128467.0,663054.0,4139.720000000118,4137.404100000016,3947.976500000093,13532001.542465352,-602158880.0,-922208739.0,-296614718.0,-1535629303.0416667,44027.0,30711.0,11353.381599999188,11229.39999999898,10713.603099997288,22895.18900000972,22817.098500009684,22202.483900008243,67493.41694428322,158093.53630508663,126150.92439922346,35013.76110002795,34953.991900028384,34399.4260000288,22962.943099995904,22936.06709999548,22582.83119999572,3715411.0,8298.471800000163,8403.065200000074,8126.593900000229,9820.955700000715,9936.010200002162,10295.888599999646,16473.078899999757,16658.458599999696,16255.220599999702,828.8572000001764,814.0314000000459,759.9540000000131,3915.371400000125,3898.588900000165,3731.21540000016,436603.0,431397.0,,6427.188999002898,632169.0,625720.0,,16337.727299999804,154232.76769999065,154235.51329999018,154127.24649998714,77638.72279999629,77976.64320000657,78378.16150000654,48.0,55753488.76499999,21972849.930000003,5785013644.65,1917162293.9400003,64929655.21499996,709847.0099999999,107.0,12039.0,-18695537.0,8545918.0,-9657745.0,-10498353.0,-23.5,0.0,0.0,108000.0,0.0,0.0,0.0,0.0,0.0,-2204.0,-379.0,-1513.0,-1513.0,203535793.39499977,2900793825.270004,3267972263.1600013,46604212.10999997,2900793825.270004,209687.0,-14352024.0,3331537487.0,144946471.0,745885269.0,325371218.0,779001574.0,209160.0,3254.0,585.5636050953938,4860986.0,1714349.0,1054883.0,-3449210.5,1185102.0,100042.0,2290965924.645133,2316239835.6600714,-140342006.0,-139201271.0,2524355.0,113649.0,,,,,,,,,,,,,,,,,,,,,1467965.0,14801315.0,3233893.0,8558092.0,11611667.0,1416253.0,1059540576.1245012,801776896.6724951,72136672542.92212,21688287753.037617,582791507.5544988,5792665.7475,689.5,94245.0,-277022500.0,21982443.0,-123828543.5,-218779545.5,-2020424.5,,,,,,,,,,,,,,,,,,,,,4274514.0,2480132.0,-9006787.5,921269.0,37582.5,3735051884.864961,3659757388.357461,-260721491.0,-257409066.0,2527433.5,269295.5,3927623732.302456,33264881479.48592,36694354769.865135,1730102741.4825494,48101644816.47071,3989464.0,-247672729.0,103123101084.5,1054990941.0,17279262438.5,3504734471.5,18892736136.5,3673347.5,71949.5,20878.144524436902,89812296.5,-69.59970887918486,7.034285714285715,4.406950390329891,157.59979026020844,30.99974817426341,1108.601953201809,39375.0,0.6234898018587336,0.7818314824680298,0.0,0.0,0.0,0.0,0.0,0.0,1.0,0.0,0.0,0.0,0.0,0.0,0.0,1.0,0.0,1.0,0.0,0.0,0.0,0.0,1.0,0.0,0.0,0.0,0.0,1.0,0.0,0.0,0.0,0.0,0.0,0.0,0.0,1.0,0.0,0.0,0.0,0.0,0.0,0.0,0.0,0.0,0.0,0.0,0.0,0.0,0.0,0.0,0.0,0.0,0.0,0.0,0.0,0.0,0.0,0.0,0.0,0.0,0.0,1.0,0.0,0.0,0.0,0.0,0.0,0.0,0.0,0.0,0.0,0.0,0.0,0.0,0.0,0.0,0.0,0.0,0.0,0.0,0.0,0.0,0.0,0.0,0.0,0.0,0.0,0.0,0.0,0.0,0.0,0.0,0.0,0.0,0.0,0.0,0.0,0.0,0.0,0.0,0.0,0.0,0.0,0.0,0.0,0.0,0.0,0.0,0.0,0.0,0.0,1.0,1.0,0.0,0.0,0.0,0.0,0.0,0.0,1.0,0.0,0.0
103475,0,0.0,1.0,1.0,0.0,0.0,90000.0,272520.0,18342.0,225000.0,0.0145199999999999,31.87397260273973,-1121.0,-6326.0,-4271.0,13.0,2.0,2.0,2.0,17.0,,0.2161482355045818,0.2431864804420123,,,,,,,,,,,,,,,,,,,,,,,,,,,,,,,,,,,,,,,,,,,,,0.0,0.0,0.0,0.0,-119.0,0.0,0.0,0.0,0.0,1.0,0.0,1.0,1.0,0.0,1.0,1.0,0.0,0.0,0.0,0.0,0.0,0.0,0.0,0.0,0.0,0.0,1.0,0.0,0.0,0.0,0.0,0.0,0.0,0.0,0.0,0.0,0.0,0.0,0.0,0.0,0.0,0.0,0.0,12.0,0.0,0.0,69975.0,0.0,0.0,0.0,0.0,0.0,-850.0,-348.0,-345.5,-499.0,409.0,-19.0,2.0,9391.6575,82563.75,89907.75,0.0,82563.75,11.0,-240.5,365243.0,-206.0,365243.0,94.0,365243.0,7.5,0.5,0.0,25.0,16.0,12.0,8.0,-4.5,0.0,0.0,14.0,15109.83,15109.83,-141.0,-137.0,4.5,1.0,0.0,,,,,,,,,,,,,,,,,,,,,8349564379.5,184448114046.0,165628686564.0,51988602655.935,1863.0,1705.0,71125.0,70859.0,9140.0,506242.0,,,,,,,128467.0,663056.0,,,,13532033.416437956,-602160001.0,-922213010.0,-296614837.0,-1535635629.0416667,44027.0,30711.0,,,,,,,,158093.75245332214,126151.16758570386,,,,,,,3715428.0,,,,,,,,,,,,,,,,436603.0,431397.0,1263601.0,6427.203519002896,632171.0,625722.0,,,,,,,,,28.5,55772600.26499999,21972854.700000007,5788865321.0999975,1917987533.1900003,64929655.21499996,709847.0099999999,107.0,12039.0,-18712966.0,8565353.5,-9667907.0,-10510508.5,-13.75,0.0,0.0,48069.45,0.0,0.0,0.0,0.0,0.0,-1803.0,-1499.0,-910.0,-1488.0,203547021.79499972,2900889416.520004,3268075198.4100013,46604212.10999997,2900889416.520004,209703.0,-14352324.0,3332085351.5,144946225.0,746433133.5,325371407.0,779549438.5,209171.0,3254.5,585.5636050953938,4861026.0,1714657.0,1055037.0,-3449345.5,1185102.0,100042.0,2291165832.6001344,2316439743.6150727,-140348620.0,-139206599.0,2524457.5,113666.5,,,,,,,,,,,,,,,,,,,,,1467977.0,14801724.0,3233893.0,8558108.0,11611681.0,1416255.0,1059540576.1245012,801776896.6724951,72136742517.92212,21688287753.037617,582791507.5544988,5792665.7475,689.5,94245.0,-277023350.0,21982095.0,-123828889.0,-218780044.5,-2020443.5,,,,,,,,,,,,,,,,,,,,,4274526.0,2480140.0,-9006792.0,921269.0,37582.5,3735066994.694961,3659772498.187461,-260721632.0,-257409203.0,2527438.0,269296.5,3927633123.959956,33264964043.23592,36694444677.615135,1730102741.4825494,48101727380.22071,3989475.0,-247672969.5,103123466327.5,1054990735.0,17279627681.5,3504734565.5,18893101379.5,3673355.0,71950.0,20878.144524436902,89812321.5,-35.169761045212304,3.028,4.906771344455349,156.39829540107814,14.857703631010796,473.5740384744647,45000.0,0.6234898018587336,0.7818314824680298,0.0,0.0,0.0,0.0,0.0,0.0,1.0,0.0,1.0,0.0,0.0,0.0,0.0,0.0,0.0,0.0,0.0,0.0,1.0,0.0,1.0,0.0,0.0,0.0,0.0,1.0,0.0,0.0,0.0,0.0,0.0,0.0,0.0,0.0,1.0,0.0,0.0,0.0,0.0,0.0,0.0,0.0,0.0,0.0,0.0,0.0,0.0,0.0,0.0,0.0,0.0,0.0,0.0,0.0,0.0,0.0,0.0,0.0,0.0,0.0,0.0,0.0,0.0,0.0,0.0,0.0,0.0,0.0,0.0,0.0,0.0,0.0,0.0,0.0,0.0,0.0,0.0,0.0,0.0,0.0,0.0,1.0,0.0,0.0,0.0,0.0,0.0,0.0,0.0,0.0,0.0,0.0,0.0,0.0,0.0,0.0,0.0,0.0,0.0,0.0,0.0,0.0,0.0,0.0,0.0,0.0,0.0,0.0,0.0,0.0,0.0,0.0,0.0,0.0,0.0,0.0,0.0,0.0,0.0,0.0
103478,0,0.0,0.0,0.0,1.0,1.0,90000.0,296280.0,14382.0,225000.0,0.0196889999999999,43.30684931506849,-237.0,-3514.0,-3563.0,,3.0,2.0,2.0,11.0,,0.1070457378393083,0.6512602186973006,,,,,,,,,,,,,,,,,,,,,,,,,,,,,,,,,,,,,,,,,,,,,1.0,1.0,1.0,1.0,0.0,0.0,0.0,0.0,0.0,0.0,3.0,1.0,1.0,0.0,1.0,0.0,0.0,0.0,0.0,0.0,0.0,1.0,1.0,0.0,1.0,0.0,0.0,0.0,0.0,0.0,0.0,0.0,0.0,0.0,0.0,0.0,0.0,0.0,0.0,0.0,0.0,0.0,0.0,2.0,5915.25,0.0,177687.135,22774.7925,0.0,0.0,0.0,0.0,-1380.0,-833.0,-580.5,-1832.0,92.0,-36.5,4.0,5126.6925,55237.5,55860.75,6547.5,55237.5,9.0,-1262.5,365243.0,-1232.0,-962.0,-962.0,-950.5,11.5,0.5,0.0941437305565156,347.5,36.0,10.0,4.0,-64.5,0.0,0.0,32.0,5126.6925,5126.6925,-1943.0,-1928.0,6.0,1.0,13.0,0.0,135000.0,,0.0,,,0.0,,0.0,0.0,0.0,0.0,,0.0,,,0.0,-8.0,0.0,0.0,8349578761.5,184448410326.0,165628911564.0,51988692655.935,1863.0,1705.0,71125.0,70859.0,9140.0,506245.0,,,,,,,128468.0,663059.0,,,,13532076.723287271,-602160238.0,-922216573.0,-296614837.0,-1535639143.0416667,44028.0,30712.0,,,,,,,,158093.85949906002,126151.81884592258,,,,,,,3715439.0,,,,,,,,,,,,,,,,436604.0,431398.0,,6427.223208002897,632173.0,625724.0,,,,,,,,,46.0,56033269.51499999,22009264.200000007,5820072413.579999,1925377887.9825008,64929655.21499996,709847.0099999999,107.0,12039.0,-18742472.0,8599327.0,-9680813.0,-10523480.0,-22.5,0.0,0.0,225000.0,0.0,0.0,0.0,0.0,0.0,-2500.0,-1770.0,-1155.0,-1832.0,203681409.05249977,2902610905.155002,3270265962.345001,46613244.50999997,2902610905.155002,209933.0,-14363562.0,3334641380.5,145302330.5,747704361.5,326097107.5,781186493.5,209326.5,3256.5,585.7500200704472,4863476.0,1715826.0,1055800.0,-3451824.0,1185108.0,100048.0,2291872899.2626324,2317143817.0125704,-140425889.0,-139283022.5,2525119.5,113726.5,2173476141.2249856,5867613000.0,,283091196.10499954,,,124179392.38499956,,287452579.63500124,2085874622.9549987,2165154312.914984,2165241614.8499827,,23852.0,,,726633.0,-1291860.0,554836.0,1234.0,1467979.0,14801816.0,3233906.0,8558144.0,11611713.0,1416259.0,1059546491.3745012,801776896.6724951,72136920205.05711,21688310527.83012,582791507.5544988,5792665.7475,689.5,94245.0,-277024730.0,21981262.0,-123829469.5,-218781876.5,-2020480.0,5924183430.554961,18727708500.0,,448052699.2499976,,,309187525.83749866,,459280894.4549993,5709287472.007533,5887459571.692499,5887702754.4375,,80865.0,,,971774.5,-1699161.0,177364.0,6755.0,4274536.0,2480144.0,-9006856.5,921269.0,37582.5,3735072121.3874607,3659777624.879961,-260723575.0,-257411131.0,2527444.0,269297.5,3927638250.652456,33265019280.73592,36694500538.365135,1730109288.9825494,48101782617.72071,3989484.0,-247674232.0,103123831570.5,1054989503.0,17279626719.5,3504733603.5,18893100429.0,3673366.5,71950.5,20878.23866816745,89812669.0,-5.472575441260202,3.292,6.257822277847309,271.0065664272121,20.600750938673343,892.1536166783823,30000.0,0.6234898018587336,0.7818314824680298,0.0,0.0,0.0,0.0,0.0,0.0,1.0,0.0,0.0,0.0,0.0,0.0,0.0,1.0,0.0,0.0,0.0,1.0,0.0,0.0,1.0,0.0,0.0,0.0,0.0,1.0,0.0,0.0,0.0,0.0,0.0,0.0,1.0,0.0,0.0,0.0,0.0,0.0,0.0,0.0,0.0,0.0,0.0,0.0,0.0,0.0,0.0,0.0,0.0,0.0,0.0,0.0,0.0,0.0,0.0,0.0,0.0,0.0,0.0,0.0,0.0,0.0,0.0,0.0,0.0,0.0,0.0,0.0,0.0,0.0,0.0,0.0,0.0,0.0,0.0,0.0,0.0,0.0,0.0,0.0,0.0,0.0,0.0,0.0,0.0,0.0,0.0,0.0,0.0,0.0,1.0,0.0,0.0,0.0,0.0,0.0,0.0,0.0,0.0,0.0,0.0,0.0,0.0,0.0,0.0,0.0,0.0,0.0,0.0,0.0,0.0,0.0,0.0,0.0,0.0,0.0,0.0,0.0,0.0,0.0
103480,0,0.0,0.0,0.0,1.0,1.0,225000.0,997110.0,32166.0,810000.0,0.026392,54.389041095890406,-3352.0,-8971.0,-3350.0,,2.0,2.0,2.0,23.0,0.7776068872322675,0.5609053020192524,0.1229554179088549,,,,,,,,,,,,,,,,,,,,,,,,,,,,,,,,,,,,,,,,,,,,,3.0,0.0,3.0,0.0,-1614.0,0.0,0.0,0.0,0.0,0.0,1.0,1.0,1.0,1.0,1.0,0.0,0.0,0.0,0.0,0.0,0.0,0.0,0.0,0.0,1.0,0.0,0.0,0.0,0.0,0.0,0.0,0.0,0.0,0.0,0.0,0.0,0.0,0.0,0.0,0.0,0.0,0.0,0.0,7.0,0.0,2344.5,110641.5,0.0,48223.305,0.0,0.0,0.0,-1394.0,-1323.5,-869.0,-1114.0,332.0,-25.0,2.0,23234.985,430737.5925,412089.75,37295.685,430737.5925,33.0,-950.5,365243.0,-1579.0,-1459.0,-1429.0,-1450.0,12.0,0.0,0.2178219664016859,1073.5,6.0,6.0,2.5,-50.5,0.0,0.0,5.0,26732.97,26732.97,-1553.0,-1519.0,3.0,1.0,0.0,,,,,,,,,,,,,,,,,,,,,8349610927.5,184449407436.0,165629721564.0,51988917655.935,1863.0,1705.0,71125.0,70859.0,9140.0,506246.0,,,,,,,128469.0,663061.0,,,,13532131.112328367,-602163590.0,-922219923.0,-296616451.0,-1535648114.0416667,44028.0,30712.0,,,,,,,67494.19455117045,158094.42040436206,126151.94180134052,,,,,,,3715462.0,,,,,,,,,,,,,,,,436607.0,431401.0,,6427.249600002897,632175.0,625726.0,,,,,,,,,46.0,56048571.76499999,22013604.450000007,5821326446.084999,1925705555.7750008,64977878.51999996,709847.0099999999,107.0,12039.0,-18762053.0,8585452.5,-9693547.0,-10538438.5,-22.5,0.0,697.5,110641.5,0.0,48223.305,0.0,0.0,0.0,-1597.0,-1537.0,-869.0,-1177.0,203770862.05499977,2904050336.197503,3271786341.345001,46657087.69499997,2904050336.197503,210090.0,-14374040.0,3336650217.0,145294158.0,747696744.0,326089730.0,781178903.0,209439.5,3260.0,586.0619857674054,4866947.0,1716097.0,1055928.0,-3454199.0,1185108.0,100048.0,2292271911.180132,2317535776.53007,-140490862.0,-139347381.0,2525256.0,113764.0,,,,,,,,,,,,,,,,,,,,,1467986.0,14802148.0,3233906.0,8558150.0,11611718.0,1416261.0,1059546491.3745012,801779241.1724951,72137030846.55711,21688310527.83012,582839730.8594989,5792665.7475,689.5,94245.0,-277026124.0,21979938.5,-123830338.5,-218782990.5,-2020505.0,,,,,,,,,,,,,,,,,,,,,4274542.0,2480146.5,-9006907.0,921269.0,37582.5,3735098854.357461,3659804357.849961,-260725128.0,-257412650.0,2527447.0,269298.5,3927661485.637456,33265450018.32841,36694912628.115135,1730146584.6675494,48102213355.31321,3989517.0,-247675182.5,103124196813.5,1054987924.0,17279625260.5,3504732174.5,18893098979.0,3673378.5,71950.5,20878.45649013386,89813742.5,-61.63006246222043,4.4316,6.994963626189144,380.44936412906,30.998880805819805,1685.999402074342,112500.0,1.0,0.0,0.0,0.0,0.0,0.0,0.0,0.0,1.0,0.0,1.0,0.0,0.0,0.0,0.0,0.0,0.0,0.0,0.0,0.0,1.0,0.0,0.0,0.0,0.0,1.0,0.0,1.0,0.0,0.0,0.0,0.0,0.0,0.0,0.0,0.0,0.0,0.0,0.0,0.0,0.0,0.0,0.0,0.0,0.0,0.0,0.0,0.0,0.0,0.0,0.0,0.0,0.0,0.0,0.0,1.0,0.0,0.0,0.0,0.0,0.0,0.0,0.0,0.0,0.0,0.0,0.0,0.0,0.0,0.0,0.0,0.0,0.0,0.0,0.0,0.0,0.0,0.0,0.0,0.0,0.0,0.0,0.0,0.0,0.0,0.0,0.0,0.0,0.0,0.0,0.0,0.0,0.0,0.0,0.0,0.0,0.0,0.0,0.0,0.0,0.0,0.0,0.0,0.0,0.0,0.0,0.0,0.0,0.0,0.0,0.0,0.0,0.0,0.0,0.0,0.0,0.0,0.0,0.0,0.0,0.0,0.0
103484,0,0.0,0.0,0.0,1.0,0.0,180000.0,1350000.0,42034.5,1350000.0,0.026392,32.06027397260274,-5044.0,-4416.0,-1365.0,,2.0,2.0,2.0,10.0,0.4567292191250386,0.7099937776371701,,0.2464,,0.9935,,,0.24,0.2069,0.375,,,,0.254,,0.0,0.2511,,0.9935,,,0.2417,0.2069,0.375,,,,0.2646,,0.0,0.2488,,0.9935,,,0.24,0.2069,0.375,,,,0.2585,,0.0,0.1997,1.0,1.0,0.0,1.0,0.0,-578.0,,,,,,,1.0,1.0,0.0,1.0,0.0,0.0,0.0,0.0,0.0,0.0,0.0,0.0,0.0,1.0,0.0,0.0,0.0,0.0,0.0,0.0,0.0,0.0,0.0,0.0,0.0,0.0,0.0,0.0,0.0,0.0,0.0,0.0,0.0,,,,,,,,,,,,,0.0,,1.0,18832.32,101250.0,106596.0,0.0,101250.0,6.0,-578.0,365243.0,-547.0,-397.0,-397.0,-395.0,16.0,0.0,0.0,100.0,18.0,10.0,4.0,-79.5,0.0,0.0,6.0,18832.32,18832.32,-486.0,-472.0,3.5,1.0,0.0,,,,,,,,,,,,,,,,,,,,,8349652962.0,184450757436.0,165631071564.0,51989097655.935,,,,,,,17814.50200000229,17876.774899999105,17328.135299998034,,,,128469.0,663063.0,,,,13532163.17260234,-602168634.0,-922221288.0,-296617029.0,-1535652530.0416667,44028.0,30712.0,11353.621599999184,11229.63999999898,10713.844799997289,22895.39590000972,22817.30540000968,22202.690800008244,67494.65128038957,158095.1303981397,,35014.13610002795,34954.366900028384,34399.8010000288,,,,3715472.0,,,,,,,16473.332899999758,16658.717099999696,16255.485199999704,,,,3915.371400000125,3898.588900000165,3731.21540000016,436608.0,431402.0,,6427.275992002897,632177.0,625728.0,,16337.926999999803,154233.76119999064,154236.5067999902,154128.23999998716,,,,,,,,,,,,,,,,,,,,,,,,,,,,,,203916363.1649997,2905067729.8800025,3273261687.045001,46714610.83499997,2905067729.8800025,210215.0,-14392484.0,3341763619.0,145645333.0,749145826.0,326444175.0,782628053.0,209680.0,3264.0,587.0994903470167,4873320.0,1717033.0,1056457.0,-3457685.0,1185108.0,100048.0,2293373402.347636,2318598144.877573,-140576183.0,-139431827.5,2525669.0,113856.5,,,,,,,,,,,,,,,,,,,,,1467986.0,14802148.0,3233906.0,8558168.0,11611724.0,1416262.0,,,,,,,,,,,,,,,,,,,,,,,,,,,,,,,,,,4274552.0,2480150.5,-9006986.5,921269.0,37582.5,3735117686.677461,3659823190.169961,-260725614.0,-257413122.0,2527450.5,269299.5,3927680317.957456,33265551268.32841,36695019224.115135,1730146584.6675494,48102314605.31321,3989523.0,-247675760.5,103124562056.5,1054987377.0,17279624863.5,3504731777.5,18893098584.0,3673394.5,71950.5,20878.45649013386,89813842.5,-157.3286617672193,7.5,4.282196766941441,137.28840155273627,32.11647575206081,1029.663011645522,90000.0,-0.2225209339563143,0.9749279121818236,0.0,0.0,0.0,0.0,0.0,1.0,0.0,0.0,0.0,0.0,0.0,0.0,0.0,1.0,0.0,1.0,0.0,0.0,0.0,0.0,1.0,0.0,0.0,0.0,0.0,1.0,0.0,0.0,0.0,0.0,0.0,0.0,0.0,0.0,0.0,0.0,0.0,0.0,0.0,0.0,0.0,0.0,0.0,0.0,0.0,0.0,0.0,0.0,0.0,0.0,0.0,0.0,0.0,0.0,0.0,0.0,0.0,0.0,0.0,0.0,0.0,0.0,0.0,0.0,0.0,0.0,0.0,0.0,0.0,0.0,0.0,0.0,0.0,0.0,0.0,0.0,0.0,0.0,0.0,0.0,0.0,1.0,0.0,0.0,0.0,0.0,0.0,0.0,0.0,0.0,0.0,0.0,0.0,0.0,0.0,0.0,0.0,0.0,0.0,0.0,0.0,0.0,0.0,0.0,0.0,0.0,0.0,0.0,0.0,0.0,1.0,0.0,0.0,0.0,0.0,0.0,0.0,1.0,0.0,0.0
103494,0,0.0,1.0,1.0,0.0,0.0,225000.0,450000.0,32877.0,450000.0,0.018634,31.252054794520543,-558.0,-11152.0,-3619.0,18.0,1.0,2.0,2.0,13.0,,0.6364407047177185,0.2837118826350007,0.1845,0.1025,0.9846,0.7892,0.2794,0.2,0.1724,0.3333,0.375,0.0573,0.1505,0.1939,0.0,0.0,0.188,0.1064,0.9846,0.7975,0.282,0.2014,0.1724,0.3333,0.375,0.0586,0.1644,0.202,0.0,0.0,0.1863,0.1025,0.9846,0.792,0.2812,0.2,0.1724,0.3333,0.375,0.0583,0.1531,0.1974,0.0,0.0,0.1913,1.0,0.0,0.0,0.0,0.0,-877.0,0.0,0.0,0.0,0.0,1.0,6.0,1.0,1.0,0.0,1.0,0.0,1.0,0.0,0.0,0.0,0.0,0.0,0.0,0.0,1.0,0.0,0.0,0.0,0.0,0.0,0.0,0.0,0.0,0.0,0.0,0.0,0.0,0.0,0.0,0.0,0.0,0.0,0.0,7.0,0.0,,67500.0,0.0,0.0,0.0,0.0,0.0,-671.0,1033.0,-61.0,-248.0,242.0,-23.5,12.0,15752.1825,93435.75,93435.75,0.0,225000.0,12.0,-326.0,182415.5,-604.0,-392.5,182724.5,-338.5,15.0,0.0,0.0,-1.0,11.0,36.0,31.0,-24.0,0.0,0.0,25.0,7994.385,7994.385,-335.0,-335.0,7.0,0.0,13.0,0.0,585000.0,0.0,0.0,0.0,0.0,0.0,523.395,523.395,0.0,0.0,0.0,0.0,0.0,0.0,0.0,5.0,-8.0,0.0,0.0,8349685839.0,184451207436.0,165631521564.0,51989322655.935,1863.0,1705.0,71125.0,70860.0,9140.0,506252.0,17814.686500002288,17876.96119999911,17328.323299998032,11299.568800000092,11237.385900000096,11184.767000000056,128469.0,663064.0,4139.999400000117,4137.685300000017,3948.2585000000936,13532194.424657134,-602169192.0,-922224907.0,-296617906.0,-1535663682.0416667,44028.0,30712.0,11353.821599999186,11229.83999999898,10714.046199997289,22895.56830000972,22817.47780000968,22202.863200008243,,158095.76683884446,126152.22551322312,35014.46940002795,34954.700200028376,34400.1343000288,22963.318099995904,22936.44209999548,22583.20619999572,3715485.0,8298.529100000163,8403.123500000074,8126.652500000229,9821.106200000717,9936.16330000216,10296.052999999643,16473.526799999756,16658.914499999693,16255.687199999702,828.8572000001764,814.0314000000459,759.9540000000131,3915.371400000125,3898.588900000165,3731.21540000016,436608.0,431402.0,1263619.0,6427.294626002897,632179.0,625730.0,,16338.118299999804,154234.74579999063,154237.4913999902,154129.22459998715,77639.51199999629,77977.43520000657,78378.95900000654,23.0,56181551.26499999,,5839791918.929997,1932694229.0250008,65483432.50499997,709847.0099999999,107.0,12039.0,-18827320.0,8568840.0,-9729553.0,-10579921.0,-11.0,0.0,,67500.0,0.0,0.0,0.0,0.0,0.0,-2522.0,-696.0,-149.0,-248.0,204342261.25499976,2911068671.760002,3280169077.875001,46853142.88499998,2911068671.760002,210690.0,-14436041.0,3352170134.5,146341601.0,752771966.0,327884638.0,786986300.0,210202.0,3272.0,589.6688290249597,4884165.5,1721356.0,1059195.0,-3468634.0,1187579.0,100127.0,2299883328.630141,2324998106.100077,-140967448.0,-139819691.0,2532373.0,114144.0,2174241403.2149844,5915781000.0,185146018.56,285382080.67499954,10265426.1,89728139.42999995,124320876.74999958,314661103.28999925,290306933.68500096,2086635100.2299988,2165918389.019982,2166005690.954982,9504.0,23894.0,145.0,14245.0,727460.0,-1295002.0,554853.0,1251.0,1467993.0,14802390.0,3233919.0,8558179.0,11611749.0,1416274.0,1059546491.3745012,,72137098346.55711,21688310527.83012,582839730.8594989,5792665.7475,689.5,94245.0,-277026795.0,21980971.5,-123830399.5,-218783238.5,-2020528.5,5924183430.554961,18728293500.0,198814557.825,448052699.2499976,1948107.735,256843385.7975008,309187525.83749866,636699192.0299982,459281417.8499993,5709287472.007533,5887459571.692499,5887702754.4375,13385.5,80865.0,44.0,70374.5,971779.5,-1699169.0,177364.0,6755.0,4274588.0,2480181.5,-9007010.5,921269.0,37582.5,3735125681.062461,3659831184.5549607,-260725949.0,-257413457.0,2527457.5,269299.5,3927696070.139957,33265644704.07841,36695112659.865135,1730146584.6675494,48102539605.31321,3989535.0,-247676086.5,103124744472.0,1054986773.0,17279624471.0,3504914502.0,18893098245.5,3673409.5,71950.5,20878.45649013386,89813841.5,-17.854825984044886,2.0,6.84369011771147,213.87937855543765,13.68738023542294,427.7587571108753,225000.0,-0.2225209339563143,0.9749279121818236,0.0,0.0,0.0,0.0,0.0,0.0,1.0,0.0,1.0,0.0,0.0,0.0,0.0,0.0,0.0,1.0,0.0,0.0,0.0,0.0,0.0,0.0,1.0,0.0,0.0,0.0,0.0,0.0,0.0,1.0,0.0,0.0,0.0,0.0,0.0,0.0,0.0,0.0,0.0,0.0,1.0,0.0,0.0,0.0,0.0,0.0,0.0,0.0,0.0,0.0,0.0,0.0,0.0,1.0,0.0,0.0,0.0,0.0,0.0,0.0,0.0,0.0,0.0,0.0,0.0,0.0,0.0,0.0,0.0,0.0,0.0,0.0,0.0,0.0,0.0,0.0,0.0,0.0,0.0,0.0,0.0,0.0,0.0,0.0,0.0,0.0,0.0,0.0,0.0,0.0,0.0,0.0,0.0,0.0,0.0,0.0,0.0,0.0,0.0,0.0,0.0,0.0,0.0,0.0,0.0,0.0,0.0,1.0,0.0,0.0,1.0,0.0,0.0,0.0,0.0,0.0,0.0,1.0,0.0,0.0
103513,0,0.0,1.0,0.0,1.0,0.0,234000.0,503266.5,57046.5,463500.0,0.006629,24.14794520547945,-940.0,-2845.0,-1464.0,,1.0,2.0,2.0,10.0,0.2618427745641451,0.6276122116946288,,0.0652,0.0,0.9955,0.9252,0.0078,0.0,0.1262,0.1075,0.0417,0.0329,0.0324,0.0663,0.0,0.0031,0.0336,0.0,0.9965,0.9216,0.0048,0.0,0.069,0.125,0.0417,0.0117,0.0294,0.0234,0.0,0.0,0.0729,0.0,0.9965,0.9329,0.0061,0.0,0.1207,0.125,0.0417,0.0127,0.0274,0.0771,0.0,0.0,0.0196,1.0,2.0,1.0,2.0,0.0,-635.0,0.0,0.0,0.0,0.0,1.0,0.0,1.0,1.0,0.0,1.0,0.0,1.0,0.0,0.0,0.0,0.0,0.0,0.0,0.0,1.0,0.0,0.0,0.0,0.0,0.0,0.0,0.0,0.0,0.0,0.0,0.0,0.0,0.0,0.0,0.0,0.0,0.0,0.0,1.0,0.0,,387000.0,296851.5,,0.0,0.0,0.0,-869.0,,-7.0,,29.0,-14.0,6.0,20872.71,110929.5,104397.75,18000.0,118404.0,6.0,-492.0,365243.0,-524.5,-284.5,-284.5,-279.0,9.0,0.5,0.1640320670368112,7.0,27.0,6.0,4.0,-15.0,0.0,0.0,25.0,20872.71,20872.71,-459.0,-444.0,4.0,1.0,0.0,,,,,,,,,,,,,,,,,,,,,8349742885.5,184451710702.5,165631985064.0,51989556655.935,1863.0,1705.0,71125.0,70861.0,9140.0,506252.0,17814.75170000229,17877.034099999106,17328.35689999803,11299.568800000092,11237.385900000096,11184.767000000056,128469.0,663065.0,4140.007200000117,4137.691400000016,3948.263300000093,13532218.57260234,-602170132.0,-922226371.0,-296618541.0,-1535666527.0416667,44029.0,30712.0,11353.821599999186,11229.83999999898,10714.046199997289,22895.69450000972,22817.598500009684,22202.932200008243,67494.91312316414,158096.39445105608,,35014.57690002795,34954.825200028376,34400.2593000288,22963.359799995906,22936.483799995483,22583.24789999572,3715495.0,8298.562000000164,8403.136200000074,8126.664200000229,9821.138600000717,9936.190700002162,10296.082399999645,16473.593099999754,16658.991599999696,16255.710599999702,828.8572000001764,814.0314000000459,759.9540000000131,3915.374500000125,3898.588900000165,3731.21540000016,436610.0,431404.0,,6427.301255002897,632181.0,625732.0,,16338.137899999803,154235.74129999062,154238.4878999902,154130.22109998716,77640.43719999629,77978.36810000657,78379.88060000654,29.0,56783039.26499999,,5862605116.949997,1938490273.4850008,,709847.0099999999,107.0,12039.0,-18904946.0,,-9769350.0,,-14.0,0.0,,387000.0,296851.5,,0.0,0.0,0.0,-869.0,,-7.0,,205644326.12999985,2928983581.260002,3300943384.125001,46959927.88499998,2929034183.760002,212032.0,-14506932.0,3368599662.5,146839083.0,757301205.0,329693216.5,791883606.5,211317.0,3294.0,591.4435744102415,4901272.0,1732051.0,1066832.5,-3485564.0,1238233.0,100146.0,2315701509.975154,2341912627.215086,-141560899.0,-140409015.0,2539058.0,114698.0,,,,,,,,,,,,,,,,,,,,,1467994.0,14802419.0,3233919.0,8558206.0,11611774.0,1416280.0,1059546491.3745012,,72137485346.55711,21688607379.33012,,5792665.7475,689.5,94245.0,-277027664.0,,-123830406.5,,-2020542.5,,,,,,,,,,,,,,,,,,,,,4274594.0,2480185.5,-9007025.5,921269.0,37582.5,3735146553.772461,3659852057.264961,-260726408.0,-257413901.0,2527461.5,269300.5,3927716942.849956,33265755633.57841,36695217057.615135,1730164584.6675494,48102658009.31321,3989541.0,-247676578.5,103125109715.0,1054986248.5,17279624186.5,3504914217.5,18893097966.5,3673418.5,71951.0,20878.620522200898,89813848.5,-38.92670751077832,2.1507115384615383,4.101916857300624,99.05286350752792,8.822039914806343,213.0341364632962,234000.0,-0.2225209339563146,-0.9749279121818236,0.0,0.0,0.0,0.0,0.0,0.0,1.0,0.0,0.0,0.0,0.0,0.0,0.0,1.0,0.0,0.0,0.0,0.0,1.0,0.0,0.0,0.0,1.0,0.0,0.0,1.0,0.0,0.0,0.0,0.0,0.0,0.0,0.0,0.0,0.0,0.0,1.0,0.0,0.0,0.0,0.0,0.0,0.0,0.0,0.0,0.0,0.0,0.0,0.0,0.0,0.0,0.0,0.0,0.0,0.0,0.0,0.0,0.0,0.0,0.0,0.0,0.0,0.0,0.0,0.0,0.0,0.0,0.0,0.0,0.0,0.0,0.0,0.0,0.0,0.0,0.0,0.0,0.0,0.0,0.0,0.0,0.0,0.0,0.0,0.0,0.0,0.0,0.0,0.0,1.0,0.0,0.0,0.0,0.0,0.0,0.0,0.0,0.0,0.0,0.0,0.0,0.0,0.0,0.0,0.0,0.0,0.0,0.0,0.0,1.0,1.0,0.0,0.0,1.0,0.0,0.0,0.0,0.0,0.0,0.0
103515,0,0.0,1.0,0.0,1.0,1.0,135000.0,539100.0,27652.5,450000.0,0.005084,33.36164383561644,-1395.0,-5911.0,-4198.0,,3.0,2.0,2.0,14.0,,0.5734768351362209,0.7076993447402619,0.2186,,0.9856,0.8028,,0.24,0.2069,0.3333,,0.0295,,0.158,,,0.2227,,0.9856,0.8105,,0.2417,0.2069,0.3333,,0.0301,,0.1646,,,0.2207,,0.9856,0.8054,,0.24,0.2069,0.3333,,0.03,,0.1608,,,0.2053,1.0,0.0,0.0,0.0,0.0,-1874.0,0.0,0.0,0.0,0.0,0.0,2.0,1.0,1.0,0.0,1.0,0.0,0.0,0.0,0.0,0.0,0.0,0.0,0.0,0.0,1.0,0.0,0.0,0.0,0.0,0.0,0.0,0.0,0.0,0.0,0.0,0.0,0.0,0.0,0.0,0.0,0.0,0.0,0.0,12.0,0.0,0.0,65209.7475,0.0,0.0,0.0,0.0,0.0,-1397.0,-627.0,-708.5,-1150.5,544.0,-22.0,7.0,7310.1825,61650.0,47326.5,15750.0,75507.75,12.0,-334.0,365243.0,-304.0,-214.0,5.0,-209.0,15.0,0.0,0.2289284993959572,25.0,29.0,11.0,7.0,-17.0,0.0,0.0,32.0,5620.365,5620.365,-430.0,-422.0,4.0,1.0,3.0,100132.245,180000.0,12150.0,35373.105,0.0,12856.5,0.0,6750.0,82.755,96710.535,97886.745,97886.745,3.0,15.0,0.0,12.0,0.0,-2.0,0.0,0.0,8349770538.0,184452249802.5,165632435064.0,51989691655.935,1863.0,1705.0,71125.0,70861.0,9140.0,506254.0,17814.97030000229,17877.254799999107,17328.579599998033,,,,128470.0,663068.0,,,,13532251.934246177,-602171527.0,-922230569.0,-296620415.0,-1535672438.0416667,44029.0,30712.0,11354.061599999188,11230.07999999898,10714.287899997287,22895.90140000972,22817.80540000968,22203.139100008244,,158096.96792789124,126152.93321256783,35014.910200027945,34955.15850002838,34400.592600028795,,,,3715509.0,8298.591500000164,8403.166200000074,8126.694300000229,,,,16473.751099999754,16659.152399999693,16255.875199999702,,,,,,,436610.0,431404.0,,6427.3063390028965,632183.0,625734.0,,16338.343199999805,154236.72689999064,154239.47349999018,154131.20669998715,77641.2399999963,77979.17350000657,78380.69110000653,46.5,56783039.26499999,22158162.765,5864485301.279997,1938774611.070001,66343640.03999997,709847.0099999999,107.0,12039.0,-18935400.0,8546345.0,-9788123.5,-10642026.5,-22.75,0.0,0.0,31419.495,0.0,0.0,0.0,0.0,0.0,-1468.0,-1116.0,-721.0,-1157.0,205803193.3874997,2930515372.260002,3302558958.375001,47006111.38499998,2930454622.260002,212168.0,-14515418.0,3371338172.0,147016781.0,758211876.0,330057016.0,792794297.0,211459.0,3297.0,592.0392703730266,4902112.0,1732982.0,1067404.0,-3486845.0,1238233.0,100146.0,2317651811.3026485,2343830599.732582,-141610384.5,-140457426.5,2540212.5,114763.0,2195984591.4149904,5966811000.0,187146268.56,287725702.81499946,10265426.1,90062202.23999994,125534079.85499956,317229273.35999936,292603545.36000115,2107539474.7499983,2187570939.5249887,2187658241.4599886,9580.0,24032.0,145.0,14307.0,732832.0,-1306919.0,576316.0,1254.0,1468006.0,14802963.0,3233922.0,8558235.0,11611806.0,1416287.0,1059546491.3745012,801779241.1724951,72137550556.30461,21688607379.33012,582839730.8594989,5792665.7475,689.5,94245.0,-277029061.0,21980344.5,-123831115.0,-218784389.0,-2020564.5,5924283562.799961,18728473500.0,198826707.825,448088072.3549976,1948107.735,256856242.2975008,309187525.83749866,636705942.0299982,459281500.6049993,5709384182.542533,5887557458.437499,5887800641.1825,13388.5,80880.0,44.0,70386.5,971779.5,-1699171.0,177364.0,6755.0,4274605.0,2480192.5,-9007042.5,921269.0,37582.5,3735152174.1374607,3659857677.629961,-260726838.0,-257414323.0,2527465.5,269301.5,3927724253.032456,33265817283.57841,36695264384.115135,1730180334.6675494,48102733517.06321,3989553.0,-247676912.5,103125474958.0,1054985944.5,17279623972.5,3504914222.5,18893097757.5,3673433.5,71951.0,20878.84945070029,89813873.5,-41.814486326681454,3.993333333333333,4.8820179007323015,162.8721424033349,19.49552481692433,650.402755330651,45000.0,-0.2225209339563146,-0.9749279121818236,0.0,1.0,0.0,0.0,0.0,0.0,0.0,0.0,0.0,0.0,0.0,0.0,0.0,1.0,0.0,0.0,0.0,0.0,1.0,0.0,1.0,0.0,0.0,0.0,0.0,1.0,0.0,0.0,0.0,0.0,0.0,0.0,0.0,0.0,0.0,0.0,0.0,0.0,0.0,1.0,0.0,0.0,0.0,0.0,0.0,0.0,0.0,0.0,0.0,0.0,0.0,1.0,0.0,0.0,0.0,0.0,0.0,0.0,0.0,0.0,0.0,0.0,0.0,0.0,0.0,0.0,0.0,0.0,0.0,0.0,0.0,0.0,0.0,0.0,0.0,0.0,0.0,0.0,0.0,0.0,0.0,0.0,0.0,0.0,0.0,0.0,0.0,0.0,0.0,0.0,0.0,0.0,0.0,0.0,0.0,0.0,0.0,0.0,0.0,0.0,0.0,0.0,0.0,0.0,0.0,0.0,0.0,0.0,1.0,0.0,1.0,0.0,0.0,0.0,0.0,0.0,0.0,1.0,0.0,0.0
103516,0,0.0,1.0,0.0,1.0,0.0,58500.0,55692.0,4594.5,45000.0,0.018634,28.810958904109587,-1771.0,-9307.0,-2734.0,,1.0,2.0,2.0,15.0,0.3471001274627168,0.0370069616530645,,,,,,,,,,,,,,,,,,,,,,,,,,,,,,,,,,,,,,,,,,,,,,0.0,0.0,0.0,0.0,-10.0,,,,,,,1.0,1.0,1.0,1.0,0.0,0.0,0.0,0.0,0.0,0.0,0.0,0.0,0.0,1.0,0.0,0.0,0.0,0.0,0.0,0.0,0.0,0.0,0.0,0.0,0.0,0.0,0.0,0.0,0.0,0.0,0.0,0.0,0.0,,,,,,,,,,,,,0.0,,6.0,5926.9275,60750.0,66096.0,0.0,60750.0,18.0,-747.5,365243.0,-765.0,-255.0,-255.0,-252.0,14.5,1.0,0.0,15.0,86.0,24.0,11.0,-22.5,0.0,0.0,88.0,7333.74,7187.4225,-669.5,-657.0,9.5,1.0,0.0,,,,,,,,,,,,,,,,,,,,,8349775132.5,184452305494.5,165632480064.0,51989750155.935,,,,,,,,,,,,,128470.0,663069.0,,,,13532280.745205078,-602173298.0,-922233303.0,-296620425.0,-1535681745.0416667,44029.0,30712.0,,,,,,,67495.2602232916,158097.00493485288,,,,,,,,3715524.0,,,,,,,,,,,,,,,,436610.0,431404.0,,6427.3249730028965,632185.0,625736.0,,,,,,,,,,,,,,,,,,,,,,,,,,,,,,,,,,,205842427.2674997,2931022067.760002,3303074752.875001,47042021.38499998,2931022067.760002,212240.0,-14518681.0,3372799144.0,147013320.0,758941716.0,330421349.0,793524156.0,211548.5,3299.0,592.6043385332367,4902375.5,1734050.0,1068010.0,-3487726.0,1238233.0,100146.0,2318108178.4876423,2344282913.700076,-141634774.5,-140481347.0,2540765.0,114818.5,,,,,,,,,,,,,,,,,,,,,1468006.0,14802963.0,3233922.0,8558321.0,11611894.0,1416293.0,,,,,,,,,,,,,,,,,,,,,,,,,,,,,,,,,,4274629.0,2480203.5,-9007065.0,921269.0,37582.5,3735159507.877461,3659864865.052461,-260727507.5,-257414980.0,2527475.0,269302.5,3927730179.959956,33265878033.57841,36695330480.115135,1730180334.6675494,48102794267.06321,3989571.0,-247677660.0,103125840201.0,1054985179.5,17279623717.5,3504913967.5,18893097505.5,3673448.0,71952.0,20878.84945070029,89813888.5,-61.46966527196653,0.952,12.732615083251714,366.8388499054112,12.121449559255634,349.23058510995133,58500.0,0.6234898018587334,-0.7818314824680299,0.0,1.0,0.0,0.0,0.0,0.0,0.0,0.0,0.0,0.0,1.0,0.0,0.0,0.0,0.0,0.0,0.0,0.0,1.0,0.0,0.0,0.0,1.0,0.0,0.0,1.0,0.0,0.0,0.0,0.0,0.0,0.0,0.0,0.0,0.0,0.0,0.0,0.0,1.0,0.0,0.0,0.0,0.0,0.0,0.0,0.0,0.0,0.0,0.0,0.0,0.0,0.0,0.0,0.0,0.0,0.0,0.0,0.0,0.0,1.0,0.0,0.0,0.0,0.0,0.0,0.0,0.0,0.0,0.0,0.0,0.0,0.0,0.0,0.0,0.0,0.0,0.0,0.0,0.0,0.0,0.0,0.0,0.0,0.0,0.0,0.0,0.0,0.0,0.0,0.0,0.0,0.0,0.0,0.0,0.0,0.0,0.0,0.0,0.0,0.0,0.0,0.0,0.0,0.0,0.0,0.0,0.0,0.0,0.0,0.0,0.0,0.0,0.0,0.0,0.0,0.0,0.0,0.0,0.0,0.0
103525,0,0.0,1.0,0.0,0.0,0.0,153000.0,450000.0,32877.0,450000.0,0.008019,36.76164383561644,-5975.0,-7385.0,-154.0,,2.0,2.0,2.0,11.0,0.3795900117769052,0.5515620943974302,0.326475210066026,0.0186,0.0586,0.9861,0.8096,0.0034,0.0,0.1034,0.0417,0.0833,,0.0151,0.0172,0.0,0.0,0.0189,0.0608,0.9861,0.8171,0.0035,0.0,0.1034,0.0417,0.0833,,0.0165,0.0179,0.0,0.0,0.0187,0.0586,0.9861,0.8121,0.0035,0.0,0.1034,0.0417,0.0833,,0.0154,0.0175,0.0,0.0,0.0154,1.0,0.0,0.0,0.0,0.0,-1613.0,0.0,0.0,0.0,0.0,3.0,2.0,1.0,1.0,0.0,1.0,0.0,0.0,1.0,1.0,0.0,1.0,1.0,0.0,0.0,1.0,0.0,0.0,0.0,0.0,0.0,0.0,0.0,0.0,0.0,0.0,0.0,0.0,0.0,0.0,0.0,0.0,0.0,0.0,2.0,14553.0,0.0,329625.0,281110.5,33747.255,0.0,0.0,0.0,-279.0,1615.0,-18.0,,19.0,-4.0,9.0,3332.295,0.0,0.0,6300.0,42770.25,6.0,-219.0,365243.0,-1235.0,-1145.0,-1085.0,-1143.0,12.0,0.0,0.1039775827009869,0.0,20.0,6.0,4.5,-39.5,0.0,0.0,17.0,3332.295,3332.295,-1188.0,-1175.0,3.0,1.0,0.0,,,,,,,,,,,,,,,,,,,,,8349808009.5,184452755494.5,165632930064.0,51989903155.935,1863.0,1705.0,71125.0,70864.0,9140.0,506256.0,17814.98890000229,17877.273499999108,17328.598499998032,11299.627400000092,11237.444500000096,11184.827800000056,128470.0,663071.0,4140.010600000117,4137.694900000016,3948.2668000000936,13532317.506848916,-602179273.0,-922233457.0,-296622038.0,-1535689130.0416667,44029.0,30712.0,11354.061599999188,11230.07999999898,10714.287899997287,22896.00480000972,22817.90880000968,22203.242500008244,67495.63981330338,158097.55649694728,126153.25968777791,35014.95190002795,34955.200200028376,34400.6343000288,22963.443099995904,22936.56709999548,22583.33119999572,3715535.0,,,,9821.153700000716,9936.206100002162,10296.098899999644,16473.768299999752,16659.1698999997,16255.893099999705,828.8572000001764,814.0314000000459,759.9540000000131,3915.374500000125,3898.588900000165,3731.21540000016,436610.0,431404.0,,6427.332992002896,632187.0,625738.0,,16338.358599999803,154237.71299999065,154240.45959999022,154132.19279998716,77642.04959999629,77979.98560000658,78381.50820000653,9.5,56886813.76499999,22160710.89,5877505532.834996,1941706065.8700008,66583892.74499998,709995.5099999999,107.0,12189.0,-18991795.5,8576949.0,-9815330.0,,-4.25,14850.0,0.0,148500.0,81004.5,67494.51,0.0,0.0,0.0,-347.0,1615.0,-12.0,,206409433.8599997,2938194655.5600023,3310501998.375001,47653172.68499997,2938163157.8100023,212790.0,-14564580.0,3385216658.0,147340729.0,761467258.0,331490461.0,796049878.0,212225.0,3310.0,595.6296868228013,4913267.0,1738770.0,1071022.5,-3497734.5,1238249.0,100152.0,2324577562.20012,2350631312.7300577,-141936173.0,-140776761.0,2543297.0,115382.0,,,,,,,,,,,,,,,,,,,,,1468008.0,14802982.0,3233922.0,8558341.0,11611911.0,1416302.0,1059561044.3745012,801779241.1724951,72137880181.30461,21688888489.83012,582873478.1144989,5792665.7475,689.5,94245.0,-277029340.0,21981959.5,-123831133.0,,-2020568.5,,,,,,,,,,,,,,,,,,,,,4274635.0,2480208.0,-9007104.5,921269.0,37582.5,3735162840.172461,3659868197.3474607,-260728695.5,-257416155.0,2527478.0,269303.5,3927733512.254956,33265878033.57841,36695330480.115135,1730186634.6675494,48102837037.31321,3989577.0,-247677879.0,103126205444.0,1054983944.5,17279622572.5,3504912882.5,18893096362.5,3673460.0,71952.0,20878.953428282995,89813888.5,-162.5335370397973,2.9411764705882355,4.6537092800438,171.07800306747316,13.68738023542294,503.1705972572741,76500.0,0.6234898018587336,0.7818314824680298,0.0,0.0,0.0,0.0,0.0,0.0,1.0,0.0,0.0,0.0,1.0,0.0,0.0,0.0,0.0,0.0,0.0,0.0,1.0,0.0,1.0,0.0,0.0,0.0,0.0,1.0,0.0,0.0,0.0,0.0,0.0,0.0,0.0,0.0,0.0,0.0,0.0,0.0,0.0,0.0,0.0,0.0,0.0,0.0,0.0,0.0,0.0,0.0,0.0,0.0,0.0,0.0,0.0,0.0,0.0,0.0,0.0,0.0,0.0,0.0,0.0,0.0,0.0,0.0,0.0,0.0,0.0,0.0,0.0,0.0,0.0,0.0,0.0,0.0,0.0,0.0,0.0,0.0,0.0,0.0,0.0,0.0,0.0,0.0,0.0,0.0,0.0,0.0,0.0,1.0,0.0,0.0,0.0,0.0,0.0,0.0,0.0,0.0,0.0,0.0,0.0,0.0,0.0,0.0,0.0,0.0,0.0,0.0,1.0,0.0,1.0,0.0,0.0,0.0,0.0,0.0,0.0,0.0,1.0,0.0
103541,0,0.0,0.0,0.0,1.0,0.0,315000.0,790830.0,62613.0,675000.0,0.0196889999999999,30.265753424657536,-3799.0,-5457.0,-3726.0,,2.0,2.0,2.0,11.0,,0.1614772500785027,,,,,,,,,,,,,,,,,,,,,,,,,,,,,,,,,,,,,,,,,,,,,,0.0,0.0,0.0,0.0,-703.0,,,,,,,1.0,1.0,1.0,1.0,1.0,0.0,0.0,0.0,0.0,1.0,1.0,0.0,0.0,1.0,0.0,0.0,0.0,0.0,0.0,0.0,0.0,0.0,0.0,0.0,0.0,0.0,0.0,0.0,0.0,0.0,0.0,0.0,0.0,,,,,,,,,,,,,0.0,,39.0,25450.47,111402.0,112500.0,0.0,252000.0,12.0,-303.0,365243.0,-750.5,-510.5,-510.5,-508.0,14.0,1.0,0.0,-1.0,53.0,12.0,5.0,-23.0,0.0,0.0,59.0,22454.595,22404.15,-751.0,-738.0,5.0,1.0,22.0,0.0,0.0,,0.0,,,0.0,,0.0,0.0,0.0,0.0,,0.0,,,0.0,-12.5,0.0,0.0,8349870622.5,184453546324.5,165633605064.0,51990218155.935,,,,,,,,,,,,,128470.0,663073.0,,,,13532347.772602338,-602183072.0,-922237183.0,-296622741.0,-1535694587.0416667,44029.0,30712.0,,,,,,,,158097.71797419735,,,,,,,,3715546.0,,,,,,,,,,,,,,,,436610.0,431404.0,,6427.352681002897,632189.0,625740.0,,,,,,,,,,,,,,,,,,,,,,,,,,,,,,,,,,,207615103.10999963,2958658297.740002,3332207460.375001,47902049.86499997,2956183297.740002,213812.0,-14640176.0,3403295533.5,149491087.0,766184614.0,334026986.0,800764780.0,213489.0,3324.5,598.5281929598606,4954726.0,1746845.0,1075625.0,-3514993.0,1238357.0,100153.0,2337786039.690125,2363409239.8500648,-142563530.0,-141399374.0,2557285.0,115813.0,2213279948.0699887,6003868500.0,,289956651.02999943,,,126591750.26999958,,294709159.48500115,2124064411.1999989,2204756578.4399858,2204843880.3749857,,24185.0,,,737443.0,-1312543.0,576342.0,1269.0,1468008.0,14802982.0,3233944.0,8558394.0,11611970.0,1416341.0,,,,,,,,,,,,,,5924283562.799961,18728473500.0,,448088072.3549976,,,309187525.83749866,,459281500.6049993,5709384182.542533,5887557458.437499,5887800641.1825,,80880.0,,,971779.5,-1699183.5,177364.0,6755.0,4274647.0,2480213.0,-9007127.5,921269.0,37582.5,3735185294.767461,3659890601.497461,-260729446.5,-257416893.0,2527483.0,269304.5,3927758962.724956,33265989435.57841,36695442980.115135,1730186634.6675494,48103089037.31321,3989589.0,-247678182.0,103126570687.0,1054983194.0,17279622062.0,3504912372.0,18893095854.5,3673474.0,71953.0,20878.953428282995,89813887.5,-125.52140852720194,2.5105714285714287,5.030904125341382,152.2641037606747,12.630444156964211,382.26990849858527,157500.0,-0.9009688679024191,0.4338837391175582,0.0,0.0,0.0,0.0,0.0,0.0,1.0,0.0,0.0,0.0,0.0,0.0,0.0,1.0,0.0,0.0,0.0,0.0,1.0,0.0,1.0,0.0,0.0,0.0,0.0,1.0,0.0,0.0,0.0,0.0,0.0,0.0,0.0,0.0,0.0,0.0,0.0,0.0,0.0,0.0,0.0,0.0,0.0,0.0,1.0,0.0,0.0,0.0,0.0,0.0,0.0,0.0,0.0,0.0,0.0,0.0,0.0,0.0,0.0,0.0,0.0,0.0,0.0,0.0,0.0,0.0,0.0,0.0,0.0,0.0,0.0,0.0,0.0,0.0,0.0,0.0,0.0,0.0,0.0,0.0,0.0,0.0,0.0,0.0,0.0,0.0,0.0,0.0,0.0,0.0,1.0,0.0,0.0,0.0,0.0,0.0,0.0,0.0,0.0,0.0,0.0,0.0,0.0,0.0,0.0,0.0,0.0,0.0,0.0,0.0,0.0,0.0,0.0,0.0,0.0,0.0,0.0,0.0,0.0,0.0
103544,0,0.0,1.0,1.0,1.0,0.0,202500.0,500211.0,35703.0,463500.0,0.016612,54.01917808219178,-7426.0,-10297.0,-3107.0,7.0,2.0,2.0,2.0,12.0,,0.6248892624913963,0.6092756673894402,0.0938,0.0805,0.9856,0.8028,0.012,0.0,0.2069,0.1667,0.0417,0.0595,0.0756,0.0867,0.0039,0.0034,0.0956,0.0835,0.9856,0.8105,0.0121,0.0,0.2069,0.1667,0.0417,0.0608,0.0826,0.0903,0.0039,0.0036,0.0947,0.0805,0.9856,0.8054,0.0121,0.0,0.2069,0.1667,0.0417,0.0605,0.077,0.0883,0.0039,0.0034,0.0893,1.0,1.0,0.0,1.0,0.0,-1565.0,0.0,0.0,0.0,0.0,0.0,0.0,1.0,1.0,0.0,1.0,1.0,0.0,0.0,0.0,0.0,0.0,0.0,0.0,0.0,0.0,0.0,1.0,0.0,0.0,0.0,0.0,0.0,0.0,0.0,0.0,0.0,0.0,0.0,0.0,0.0,0.0,0.0,0.0,8.0,0.0,0.0,80662.5,0.0,0.0,0.0,0.0,0.0,-1276.0,-158.0,-1094.5,-1258.0,385.0,-24.0,4.0,9518.085,58050.0,60630.75,0.0,58050.0,6.0,-456.0,365243.0,-361.0,-301.0,-121.0,-296.0,16.0,0.0,0.0,675.0,13.0,6.0,3.0,-14.0,0.0,0.0,12.0,13489.965,20362.95,-425.5,-411.0,2.0,2.0,13.0,0.0,225000.0,,0.0,,,0.0,,0.0,0.0,0.0,0.0,,0.0,,,0.0,-9.0,0.0,0.0,8349906325.5,184454046535.5,165634068564.0,51990420655.935,1863.0,1705.0,71125.0,70864.0,9140.0,506256.0,17815.082700002287,17877.36819999911,17328.694099998032,11299.707900000092,11237.525000000096,11184.911300000056,128470.0,663075.0,4140.022600000118,4137.707000000016,3948.2789000000935,13532401.79178042,-602190498.0,-922240290.0,-296624306.0,-1535704884.0416667,44029.0,30712.0,11354.061599999188,11230.07999999898,10714.287899997287,22896.21170000972,22818.115700009683,22203.44940000824,,158098.34286345984,126153.86896344532,35015.11860002795,34955.366900028384,34400.8010000288,22963.484799995906,22936.608799995483,22583.37289999572,3715558.0,8298.651000000164,8403.226700000074,8126.755100000229,9821.229300000716,9936.283100002162,10296.181499999644,16473.854999999752,16659.2581999997,16255.983399999704,828.8611000001764,814.0353000000459,759.9579000000133,3915.377900000125,3898.592300000164,3731.21900000016,436611.0,431405.0,1263626.0,6427.3692930028965,632191.0,625742.0,,16338.447899999805,154238.69859999063,154241.44519999027,154133.1783999872,77642.85239999629,77980.79100000657,78382.31870000655,42.5,56907024.02999999,22200604.38,5895892667.069997,1950011744.5350008,66811326.20999997,709995.5099999999,107.0,12189.0,-19054173.5,8658865.0,-9850029.0,-10703972.0,-20.75,0.0,0.0,89325.0,0.0,0.0,0.0,0.0,0.0,-1491.0,-854.0,-1337.0,-1337.0,208135798.06499967,2962286661.240002,3336158680.875001,47902049.86499997,2962286661.240002,214088.0,-14647922.0,3405852234.5,150031631.5,767457535.5,334570005.5,801674809.5,213808.0,3327.0,598.5281929598606,4957699.0,1747695.0,1076146.0,-3516153.0,1238386.0,100153.0,2339487053.1901283,2365372657.800068,-142606754.5,-141442240.0,2557757.5,115961.5,2213279948.0699887,6005443500.0,,289956651.02999943,,,126591750.26999958,,294709159.48500115,2124064411.1999989,2204756578.4399858,2204843880.3749857,,24185.0,,,737443.0,-1312747.0,576342.0,1269.0,1468016.0,14803367.0,3233957.0,8558407.0,11611982.0,1416345.0,1059561044.3745012,801779241.1724951,72137960843.80461,21688888489.83012,582873478.1144989,5792665.7475,689.5,94245.0,-277030616.0,21981801.5,-123832227.5,-218785647.0,-2020592.5,5924283562.799961,18728698500.0,,448088072.3549976,,,309187525.83749866,,459281500.6049993,5709384182.542533,5887557458.437499,5887800641.1825,,80880.0,,,971779.5,-1699192.5,177364.0,6755.0,4274653.0,2480216.0,-9007141.5,921269.0,37582.5,3735198784.732461,3659910964.447461,-260729872.0,-257417304.0,2527485.0,269306.5,3927768480.809956,33266047485.57841,36695503610.865135,1730186634.6675494,48103147087.31321,3989595.0,-247678638.0,103126935930.0,1054982833.0,17279621761.0,3504912251.0,18893095558.5,3673490.0,71953.0,20878.953428282995,89814562.5,-137.4696962012477,2.4701777777777782,5.671792286362491,306.385557562217,14.010335265944038,756.8267957222428,101250.0,0.6234898018587336,0.7818314824680298,0.0,0.0,0.0,0.0,0.0,0.0,1.0,0.0,0.0,0.0,0.0,0.0,0.0,1.0,0.0,0.0,0.0,0.0,1.0,0.0,1.0,0.0,0.0,0.0,0.0,1.0,0.0,0.0,0.0,0.0,0.0,0.0,0.0,0.0,0.0,0.0,0.0,0.0,0.0,0.0,0.0,0.0,0.0,0.0,0.0,0.0,0.0,0.0,0.0,0.0,0.0,0.0,1.0,0.0,0.0,0.0,0.0,0.0,0.0,0.0,0.0,0.0,0.0,0.0,0.0,0.0,0.0,0.0,0.0,0.0,0.0,0.0,0.0,0.0,0.0,0.0,0.0,0.0,0.0,0.0,0.0,0.0,0.0,0.0,0.0,0.0,0.0,0.0,0.0,0.0,0.0,0.0,0.0,0.0,0.0,0.0,0.0,0.0,0.0,0.0,0.0,0.0,0.0,0.0,0.0,0.0,0.0,0.0,1.0,0.0,1.0,0.0,0.0,0.0,0.0,0.0,0.0,1.0,0.0,0.0
103562,1,0.0,0.0,0.0,1.0,1.0,130500.0,729792.0,37390.5,630000.0,0.01885,39.27671232876713,-1367.0,-1363.0,-3975.0,,3.0,2.0,2.0,17.0,0.3780382881163683,0.0139862039220807,0.4740512892789932,,,,,,,,,,,,,,,,,,,,,,,,,,,,,,,,,,,,,,,,,,,,,0.0,0.0,0.0,0.0,-546.0,0.0,0.0,0.0,0.0,0.0,4.0,1.0,1.0,0.0,1.0,0.0,0.0,0.0,0.0,0.0,0.0,1.0,1.0,0.0,1.0,0.0,0.0,0.0,0.0,0.0,0.0,0.0,0.0,0.0,0.0,0.0,0.0,0.0,0.0,0.0,0.0,0.0,0.0,6.0,5508.0,0.0,113413.5,31304.25,0.0,0.0,0.0,0.0,-562.5,30866.0,-77.0,-714.0,119.0,-15.0,4.0,13860.225,38227.5,40245.75,0.0,173227.5,3.0,-329.5,182479.0,-376.5,182439.0,182439.0,182442.5,10.0,0.0,0.0,0.0,8.0,6.0,2.5,-14.5,0.0,0.0,22.0,13613.7375,13613.7375,-190.0,-183.5,6.0,0.0,9.0,253766.52,270000.0,6300.0,6300.0,0.0,0.0,13559.265,13950.0,77.22,249938.1,253287.18,253287.18,1.0,1.0,0.0,0.0,3.0,-5.0,0.0,0.0,8349943716.0,184454776327.5,165634698564.0,51990551155.935,1863.0,1705.0,71125.0,70864.0,9140.0,506260.0,,,,,,,128471.0,663078.0,,,,13532441.068492748,-602191865.0,-922244265.0,-296624852.0,-1535706247.0416667,44029.0,30712.0,,,,,,,67496.0178515915,158098.35684966377,126154.3430147346,,,,,,,3715575.0,,,,,,,,,,,,,,,,436611.0,431405.0,,6427.388143002898,632193.0,625744.0,,,,,,,,,19.0,57185336.56499999,22353760.215,5917015183.004997,1953908026.7850008,66968826.20999997,709995.5099999999,108.0,12189.0,-19136296.5,8748017.0,-9898454.0,-10749415.0,-9.0,0.0,0.0,211500.0,0.0,0.0,0.0,0.0,0.0,-1080.0,-714.0,-714.0,-714.0,209544232.81499952,2981880266.265003,3357141006.375001,48147441.38999996,2981880266.265003,215649.0,-14753911.5,3427217722.5,151973791.0,771786893.5,336714895.5,806004263.5,215374.0,3346.0,601.8693257358706,4998790.0,1755010.0,1080650.5,-3537241.5,1238411.0,100153.0,2347363015.56014,2373120953.4600787,-143201574.5,-142029190.5,2560797.5,116514.0,2215991540.9249887,6017314500.0,189384568.56,290326227.02999943,10265426.1,90399478.45499995,126707462.4599996,319520399.08499813,294756180.25500107,2126712325.5899987,2207451301.9649854,2207538603.8999853,9696.0,24202.0,145.0,14361.0,737486.0,-1313446.0,576342.0,1269.0,1468022.0,14803486.0,3233966.0,8558415.0,11612004.0,1416349.0,1059566552.3745012,801779241.1724951,72138074257.30461,21688919794.08012,582873478.1144989,5792665.7475,689.5,94245.0,-277031178.5,22012667.5,-123832304.5,-218786361.0,-2020607.5,5924537329.319962,18728968500.0,198833007.825,448094372.3549976,1948107.735,256856242.2975008,309201085.10249865,636719892.0299982,459281577.8249993,5709634120.642532,5887810745.617499,5888053928.3625,13389.5,80881.0,44.0,70386.5,971782.5,-1699197.5,177364.0,6755.0,4274659.0,2480218.5,-9007156.0,921269.0,37582.5,3735212398.469961,3659924578.184961,-260730062.0,-257417487.5,2527491.0,269306.5,3927782341.034957,33266085713.07841,36695543856.615135,1730186634.6675494,48103320314.81321,3989598.0,-247678967.5,103127118409.0,1054982456.5,17279804200.0,3505094690.0,18893278001.0,3673500.0,71953.0,20878.953428282995,89814562.5,-34.80433872767857,5.592275862068965,3.490191358767601,137.08324197066392,19.518112889637734,766.6073051667032,43500.0,1.0,0.0,0.0,0.0,0.0,0.0,0.0,0.0,1.0,0.0,0.0,0.0,0.0,0.0,0.0,1.0,0.0,0.0,0.0,0.0,1.0,0.0,1.0,0.0,0.0,0.0,0.0,1.0,0.0,0.0,0.0,0.0,0.0,0.0,0.0,0.0,0.0,0.0,0.0,0.0,1.0,0.0,0.0,0.0,0.0,0.0,0.0,0.0,0.0,0.0,0.0,0.0,0.0,0.0,0.0,0.0,0.0,0.0,0.0,0.0,0.0,0.0,0.0,0.0,0.0,0.0,0.0,0.0,0.0,0.0,1.0,0.0,0.0,0.0,0.0,0.0,0.0,0.0,0.0,0.0,0.0,0.0,0.0,0.0,0.0,0.0,0.0,0.0,0.0,0.0,0.0,0.0,0.0,0.0,0.0,0.0,0.0,0.0,0.0,0.0,0.0,0.0,0.0,0.0,0.0,0.0,0.0,0.0,0.0,0.0,0.0,0.0,0.0,0.0,0.0,0.0,0.0,0.0,0.0,0.0,0.0,0.0
103570,1,0.0,1.0,1.0,1.0,0.0,270000.0,135000.0,14539.5,135000.0,0.006852,35.58356164383561,-823.0,-4453.0,-2616.0,21.0,1.0,3.0,3.0,8.0,0.1745995242616236,0.014580640576335,,,,,,,,,,,,,,,,,,,,,,,,,,,,,,,,,,,,,,,,,,,,,,0.0,0.0,0.0,0.0,-238.0,,,,,,,1.0,1.0,0.0,1.0,0.0,0.0,0.0,0.0,0.0,0.0,1.0,1.0,0.0,1.0,0.0,0.0,0.0,0.0,0.0,0.0,0.0,0.0,0.0,0.0,0.0,0.0,0.0,0.0,0.0,0.0,0.0,0.0,0.0,,,,,,,,,,,,,0.0,,3.0,14133.78,45000.0,45000.0,13945.5,92227.5,3.0,-413.0,182415.5,-373.5,-313.5,182505.0,182491.0,7.0,0.5,0.0986638425886554,700.0,6.0,6.0,3.5,-11.5,0.0,0.0,21.0,962.28,962.28,-291.0,-291.0,6.0,0.0,13.0,0.0,0.0,0.0,0.0,0.0,0.0,0.0,962.28,962.28,0.0,0.0,0.0,0.0,0.0,0.0,0.0,1.0,-8.0,0.0,0.0,8349958255.5,184454911327.5,165634833564.0,51990821155.935,,,,,,,,,,,,,128471.0,663079.0,,,,13532476.652054392,-602192688.0,-922246881.0,-296625090.0,-1535710700.0416667,44029.0,30712.0,,,,,,,67496.19245111577,158098.37143030437,,,,,,,,3715583.0,,,,,,,,,,,,,,,,436611.0,431405.0,1263647.0,6427.394995002898,632196.0,625747.0,,,,,,,,,,,,,,,,,,,,,,,,,,,,,,,,,,,210017260.34999952,2987540856.765003,3363172563.375001,48231231.38999996,2987563356.765003,216107.0,-14782537.0,3433425384.0,151958987.0,774151338.0,338168228.5,808551593.5,215980.0,3352.0,602.6663340702621,5010179.0,1757033.0,1081849.5,-3541224.5,1238411.0,100153.0,2350583516.700138,2376330302.6100783,-143331526.0,-142157140.0,2563030.0,116671.0,2221617747.239988,6032862000.0,189569968.56,291008575.79999954,10265426.1,90896427.22499992,126966302.36999962,320051597.93999803,295147301.76000094,2132214569.2799983,2213072720.0999846,2213160022.0349846,9705.0,24309.0,145.0,14459.0,737710.0,-1313759.0,576342.0,1269.0,1468022.0,14803486.0,3233979.0,8558421.0,11612025.0,1416352.0,,,,,,,,,,,,,,5924537329.319962,18728968500.0,198833007.825,448094372.3549976,1948107.735,256856242.2975008,309201085.10249865,636720854.309998,459282540.1049993,5709634120.642532,5887810745.617499,5888053928.3625,13389.5,80881.0,44.0,70386.5,971783.5,-1699205.5,177364.0,6755.0,4274665.0,2480222.0,-9007167.5,921269.0,37582.5,3735213360.749962,3659925540.4649615,-260730353.0,-257417778.5,2527497.0,269306.5,3927796474.814956,33266130713.07841,36695588856.615135,1730200580.1675494,48103412542.31321,3989601.0,-247679380.5,103127300824.5,1054982083.0,17279803886.5,3505277195.0,18893460492.0,3673507.0,71953.5,20879.052092125585,89815262.5,-23.128657222051125,0.5,18.570102135561743,660.7903740730849,9.285051067780872,330.39518703654244,270000.0,0.6234898018587336,0.7818314824680298,0.0,0.0,0.0,0.0,0.0,0.0,1.0,0.0,0.0,0.0,0.0,0.0,0.0,1.0,0.0,0.0,0.0,0.0,1.0,0.0,0.0,1.0,0.0,0.0,0.0,1.0,0.0,0.0,0.0,0.0,0.0,0.0,0.0,0.0,0.0,0.0,0.0,0.0,1.0,0.0,0.0,0.0,0.0,0.0,0.0,0.0,0.0,0.0,0.0,0.0,0.0,0.0,0.0,1.0,0.0,0.0,0.0,0.0,0.0,0.0,0.0,0.0,0.0,0.0,0.0,0.0,0.0,0.0,0.0,0.0,0.0,0.0,0.0,0.0,0.0,0.0,0.0,0.0,0.0,0.0,0.0,0.0,0.0,0.0,0.0,0.0,0.0,0.0,0.0,0.0,0.0,0.0,0.0,0.0,0.0,0.0,0.0,0.0,0.0,0.0,0.0,0.0,0.0,0.0,0.0,0.0,0.0,0.0,0.0,0.0,0.0,0.0,0.0,0.0,0.0,0.0,0.0,0.0,0.0,0.0
103572,0,0.0,1.0,0.0,1.0,0.0,112500.0,360000.0,23134.5,360000.0,0.019101,43.136986301369866,-335.0,-6814.0,-3378.0,,2.0,2.0,2.0,10.0,,0.5297285570340203,,,,,,,,,,,,,,,,,,,,,,,,,,,,,,,,,,,,,,,,,,,,,,8.0,0.0,8.0,0.0,0.0,0.0,0.0,0.0,0.0,0.0,0.0,1.0,1.0,1.0,1.0,1.0,0.0,0.0,0.0,0.0,0.0,0.0,0.0,0.0,1.0,0.0,0.0,0.0,0.0,0.0,0.0,0.0,0.0,0.0,0.0,0.0,0.0,0.0,0.0,0.0,0.0,0.0,0.0,2.0,,,44918.46,0.0,,0.0,0.0,0.0,-1996.5,-1722.5,-893.0,-1751.0,132.0,-32.5,5.0,6043.185,29655.0,67500.0,2700.0,46784.25,10.0,-1516.0,365243.0,-1222.0,-997.0,-802.0,-844.5,9.0,0.0,0.0965791524467256,30.0,45.0,10.0,3.0,-45.0,0.0,0.0,33.0,8869.86,8869.86,-1369.0,-1365.0,6.0,1.0,30.0,0.0,67500.0,,0.0,,,0.0,,0.0,0.0,0.0,0.0,,0.0,,,0.0,-18.5,0.0,0.0,8349981390.0,184455271327.5,165635193564.0,51990933655.935,1863.0,1705.0,71125.0,70864.0,9140.0,506260.0,,,,,,,128471.0,663081.0,,,,13532519.789040696,-602193023.0,-922250259.0,-296625090.0,-1535717514.0416667,44029.0,30712.0,,,,,,,,158098.90115886138,,,,,,,,3715593.0,,,,,,,,,,,,,,,,436619.0,431413.0,,6427.414096002898,632198.0,625749.0,,,,,,,,,66.0,,,5933129565.644997,1955978362.0350008,,709995.5099999999,108.0,12189.0,-19161239.0,8783844.5,-9909798.0,-10761267.0,-32.5,,,21805.56,0.0,,0.0,0.0,0.0,-2766.0,-2553.0,-912.0,-2582.0,210075839.4599995,2988233118.765003,3363964302.375001,48258231.38999996,2988247946.265003,216157.0,-14790526.0,3435068771.5,152135368.5,774328649.5,338528733.5,808911979.0,216033.0,3352.0,603.1278517632405,5011367.0,1757605.0,1082198.0,-3543373.0,1238447.0,100189.0,2351444682.960144,2377109116.485082,-143376410.0,-142201792.0,2563305.0,116705.0,2221670733.344988,6033953250.0,,291061079.54999954,,,126966302.36999962,,295152113.1600008,2132267073.0299983,2213125260.7049847,2213212562.6399846,,24320.0,,,737715.0,-1314048.0,576342.0,1269.0,1468024.0,14803618.0,3234009.0,8558466.0,11612058.0,1416357.0,,,72138119175.76462,21688919794.08012,,5792665.7475,689.5,94245.0,-277033175.0,22010945.0,-123833197.5,-218788112.0,-2020640.0,5924537329.319962,18729036000.0,,448094372.3549976,,,309201085.10249865,,459282540.1049993,5709634120.642532,5887810745.617499,5888053928.3625,,80881.0,,,971783.5,-1699224.0,177364.0,6755.0,4274675.0,2480225.0,-9007212.5,921269.0,37582.5,3735222230.6099615,3659934410.3249617,-260731722.0,-257419143.5,2527503.0,269307.5,3927802517.999956,33266160368.07841,36695656356.615135,1730203280.1675494,48103459326.56321,3989611.0,-247680896.5,103127666067.5,1054980861.0,17279802889.5,3505276393.0,18893459647.5,3673516.0,71953.5,20879.14867127803,89815292.5,-7.765957446808509,3.2,4.862867146469559,209.7694334826389,15.561174868702588,671.2621871444445,56250.0,1.0,0.0,0.0,0.0,0.0,0.0,0.0,0.0,1.0,0.0,0.0,0.0,0.0,0.0,0.0,1.0,0.0,0.0,0.0,0.0,1.0,1.0,0.0,0.0,0.0,0.0,0.0,1.0,0.0,0.0,0.0,0.0,0.0,0.0,0.0,0.0,0.0,0.0,0.0,0.0,1.0,0.0,0.0,0.0,0.0,0.0,0.0,0.0,0.0,0.0,0.0,0.0,0.0,0.0,0.0,1.0,0.0,0.0,0.0,0.0,0.0,0.0,0.0,0.0,0.0,0.0,0.0,0.0,0.0,0.0,0.0,0.0,0.0,0.0,0.0,0.0,0.0,0.0,0.0,0.0,0.0,0.0,0.0,0.0,0.0,0.0,0.0,0.0,0.0,0.0,0.0,0.0,0.0,0.0,0.0,0.0,0.0,0.0,0.0,0.0,0.0,0.0,0.0,0.0,0.0,0.0,0.0,0.0,0.0,0.0,0.0,0.0,0.0,0.0,0.0,0.0,0.0,0.0,0.0,0.0,0.0,0.0
103574,0,0.0,0.0,0.0,1.0,0.0,270000.0,270000.0,15498.0,270000.0,0.0145199999999999,45.93150684931507,-3562.0,-4327.0,-292.0,,2.0,2.0,2.0,11.0,,0.6507449198651057,0.7238369900414456,,,0.9901,,,,0.1379,0.3333,,,,0.1455,,,,,0.9901,,,,0.1379,0.3333,,,,0.1516,,,,,0.9901,,,,0.1379,0.3333,,,,0.1481,,,0.1459,1.0,3.0,1.0,3.0,1.0,-636.0,0.0,0.0,0.0,0.0,0.0,0.0,1.0,1.0,0.0,1.0,0.0,0.0,0.0,0.0,0.0,0.0,0.0,0.0,0.0,1.0,0.0,0.0,0.0,0.0,0.0,0.0,0.0,0.0,0.0,0.0,0.0,0.0,0.0,0.0,0.0,0.0,0.0,0.0,4.0,0.0,0.0,126877.5,0.0,0.0,0.0,0.0,0.0,-1365.0,-1152.0,-1150.5,-1570.0,201.0,-25.0,1.0,24727.95,478575.0,478575.0,0.0,478575.0,24.0,-636.0,365243.0,-604.0,365243.0,86.0,365243.0,21.0,0.0,0.0,200.0,21.0,24.0,14.0,-11.0,0.0,0.0,23.0,24727.95,24727.95,-280.0,-274.0,12.0,1.0,0.0,,,,,,,,,,,,,,,,,,,,,8349996888.0,184455541327.5,165635463564.0,51991203655.935,1863.0,1705.0,71125.0,70864.0,9140.0,506260.0,,,,,,,128471.0,663083.0,,,,13532565.720547546,-602196585.0,-922250551.0,-296625726.0,-1535721841.0416667,44030.0,30713.0,,,,22896.34960000972,22818.253600009684,22203.587300008247,,158099.55190378125,126155.06685172464,35015.45190002795,34955.700200028376,34401.1343000288,,,,3715604.0,,,,,,,16474.00049999975,16659.406299999693,16256.134999999702,,,,,,,436622.0,431416.0,,6427.428616002898,632200.0,625751.0,,16338.593799999802,154239.68869999066,154242.43529999026,154134.1684999872,,,,45.5,57240509.53499999,22353760.215,5935559261.984998,1957002364.0350008,66968826.20999997,709995.5099999999,108.0,12189.0,-19169186.0,8781810.0,-9914126.0,-10766435.0,-22.25,0.0,0.0,135000.0,0.0,0.0,0.0,0.0,0.0,-1754.0,-1570.0,-1570.0,-1570.0,210130728.47999948,2989112508.765003,3364811472.375001,48295581.38999996,2989112508.765003,216217.0,-14795132.0,3436347122.0,152315238.0,774874816.0,338710013.0,809458394.0,216090.0,3352.0,603.3333400065962,5011765.0,1758187.0,1082553.0,-3544672.0,1239784.0,100189.0,2352220421.040142,2377847285.91008,-143410174.0,-142235737.0,2563554.0,116743.0,,,,,,,,,,,,,,,,,,,,,1468028.0,14803819.0,3234009.0,8558487.0,11612081.0,1416358.0,1059566552.3745012,801779241.1724951,72138246053.26462,21688919794.08012,582873478.1144989,5792665.7475,689.5,94245.0,-277034540.0,22009793.0,-123834348.0,-218789682.0,-2020665.0,,,,,,,,,,,,,,,,,,,,,4274699.0,2480239.0,-9007223.5,921269.0,37582.5,3735246958.559961,3659959138.274962,-260732002.0,-257419417.5,2527515.0,269308.5,3927827245.949957,33266638943.07841,36696134931.615135,1730203280.1675494,48103937901.56321,3989635.0,-247681532.5,103128031310.5,1054980257.0,17280168132.5,3505276479.0,18893824890.5,3673537.0,71953.5,20879.14867127803,89815492.5,-77.55025350432449,1.0,17.421602787456447,800.2004677581023,17.421602787456447,800.2004677581023,135000.0,-0.2225209339563143,0.9749279121818236,0.0,0.0,0.0,0.0,0.0,0.0,1.0,0.0,0.0,0.0,0.0,0.0,0.0,1.0,0.0,1.0,0.0,0.0,0.0,0.0,1.0,0.0,0.0,0.0,0.0,1.0,0.0,0.0,0.0,0.0,0.0,0.0,0.0,0.0,0.0,0.0,0.0,0.0,1.0,0.0,0.0,0.0,0.0,0.0,0.0,0.0,0.0,0.0,0.0,0.0,0.0,0.0,0.0,0.0,0.0,0.0,0.0,0.0,0.0,0.0,0.0,0.0,0.0,0.0,0.0,0.0,0.0,0.0,0.0,0.0,0.0,0.0,0.0,0.0,0.0,0.0,0.0,0.0,0.0,0.0,0.0,0.0,0.0,0.0,0.0,0.0,0.0,0.0,0.0,0.0,0.0,0.0,0.0,0.0,0.0,0.0,0.0,0.0,0.0,0.0,0.0,0.0,0.0,1.0,0.0,0.0,0.0,0.0,0.0,0.0,0.0,0.0,0.0,0.0,0.0,0.0,0.0,0.0,0.0,0.0
103575,0,0.0,0.0,1.0,0.0,4.0,112500.0,573408.0,29407.5,495000.0,0.025164,43.701369863013696,-3146.0,-9676.0,-4222.0,10.0,6.0,2.0,2.0,8.0,,0.6064454844534138,0.5513812618027899,,,,,,,,,,,,,,,,,,,,,,,,,,,,,,,,,,,,,,,,,,,,,0.0,0.0,0.0,0.0,-217.0,0.0,0.0,0.0,0.0,0.0,3.0,1.0,1.0,0.0,1.0,0.0,0.0,0.0,0.0,0.0,0.0,1.0,1.0,0.0,1.0,0.0,0.0,0.0,0.0,0.0,0.0,0.0,0.0,0.0,0.0,0.0,0.0,0.0,0.0,0.0,0.0,0.0,0.0,8.0,0.0,0.0,129791.25,0.0,0.0,0.0,0.0,0.0,-2038.0,-627.0,-915.0,-1204.0,480.0,-35.0,8.0,9668.25,118230.75,115395.75,0.0,118230.75,6.0,-896.0,365243.0,-865.0,-550.0,-535.0,-545.5,11.5,0.0,0.0,36.0,87.0,18.0,6.0,-47.0,0.0,0.0,96.0,9211.5,9211.5,-1570.5,-1558.0,6.0,1.0,8.0,0.0,202500.0,0.0,0.0,0.0,0.0,0.0,0.0,0.0,0.0,0.0,0.0,0.0,0.0,0.0,0.0,1.5,-5.5,0.0,0.0,8350026295.5,184456114735.5,165635958564.0,51991316155.935,1863.0,1705.0,71125.0,70864.0,9140.0,506263.0,,,,,,,128475.0,663089.0,,,,13532609.421917409,-602199731.0,-922254773.0,-296625943.0,-1535731517.0416667,44030.0,30713.0,,,,,,,,158100.1583492657,126155.61823298644,,,,,,,3715612.0,,,,,,,,,,,,,,,,436622.0,431416.0,1263657.0,6427.453780002898,632202.0,625753.0,,,,,,,,,67.5,57240509.53499999,22353760.215,5936959121.984998,1957046320.0350008,66968826.20999997,709995.5099999999,108.0,12189.0,-19183537.0,8808547.5,-9921785.5,-10774097.5,-33.25,0.0,0.0,225000.0,0.0,0.0,0.0,0.0,0.0,-2644.0,-1218.0,-1195.0,-1195.0,210207561.70499948,2990264301.765003,3365964295.875001,48295581.38999996,2990264301.765003,216261.0,-14798444.0,3437625256.5,152312139.0,775236633.0,339071878.0,809820244.0,216143.0,3352.0,603.3333400065962,5011966.5,1759349.0,1083178.0,-3547031.0,1239786.0,100191.0,2354028713.0101438,2379583556.032581,-143487284.0,-142312372.0,2564130.0,116800.5,2221670733.344988,6035843250.0,189574468.56,291061079.54999954,10265426.1,90944430.97499992,126979472.5649996,320056890.4799979,295374902.4450008,2132267073.0299983,2213125260.7049847,2213212562.6399846,9706.0,24320.0,145.0,14469.0,737723.0,-1314383.5,576342.0,1269.0,1468036.0,14804299.0,3234017.0,8558574.0,11612177.0,1416366.0,1059566552.3745012,801779241.1724951,72138375844.51462,21688919794.08012,582873478.1144989,5792665.7475,689.5,94245.0,-277036578.0,22009166.0,-123835263.0,-218790886.0,-2020700.0,5924537329.319962,18729238500.0,198833007.825,448094372.3549976,1948107.735,256856242.2975008,309201085.10249865,636720854.309998,459282540.1049993,5709634120.642532,5887810745.617499,5888053928.3625,13389.5,80881.0,44.0,70386.5,971785.0,-1699229.5,177364.0,6755.0,4274717.0,2480245.0,-9007270.5,921269.0,37582.5,3735256170.059961,3659968349.774962,-260733572.5,-257420975.5,2527521.0,269309.5,3927836914.199957,33266757173.82841,36696250327.365135,1730203280.1675494,48104056132.31321,3989641.0,-247682428.5,103128396553.5,1054979392.0,17280167582.5,3505275944.0,18893824345.0,3673548.5,71953.5,20879.14867127803,89815528.5,-71.98859005704972,5.09696,3.825554705432288,167.1819811132888,19.498699311400152,852.1198704551886,18750.0,-0.2225209339563143,0.9749279121818236,0.0,0.0,0.0,0.0,0.0,0.0,1.0,0.0,0.0,0.0,0.0,0.0,0.0,1.0,0.0,0.0,0.0,0.0,1.0,0.0,1.0,0.0,0.0,0.0,0.0,1.0,0.0,0.0,0.0,0.0,0.0,0.0,0.0,0.0,0.0,0.0,0.0,0.0,1.0,0.0,0.0,0.0,0.0,0.0,0.0,0.0,0.0,0.0,0.0,0.0,0.0,0.0,0.0,0.0,0.0,0.0,0.0,0.0,0.0,0.0,0.0,0.0,0.0,0.0,0.0,0.0,0.0,0.0,1.0,0.0,0.0,0.0,0.0,0.0,0.0,0.0,0.0,0.0,0.0,0.0,0.0,0.0,0.0,0.0,0.0,0.0,0.0,0.0,0.0,0.0,0.0,0.0,0.0,0.0,0.0,0.0,0.0,0.0,0.0,0.0,0.0,0.0,0.0,0.0,0.0,0.0,0.0,0.0,0.0,0.0,0.0,0.0,0.0,0.0,0.0,0.0,0.0,0.0,0.0,0.0
103591,0,0.0,0.0,0.0,1.0,0.0,157500.0,266652.0,17172.0,202500.0,0.014464,47.613698630136994,-561.0,-2811.0,-936.0,,2.0,2.0,2.0,7.0,0.8559550149441796,0.4373057444694115,0.2498850627504553,,,,,,,,,,,,,,,,,,,,,,,,,,,,,,,,,,,,,,,,,,,,,0.0,0.0,0.0,0.0,-1215.0,0.0,0.0,0.0,0.0,0.0,3.0,1.0,1.0,0.0,1.0,0.0,1.0,0.0,0.0,0.0,0.0,0.0,0.0,0.0,1.0,0.0,0.0,0.0,0.0,0.0,0.0,0.0,0.0,0.0,0.0,0.0,0.0,0.0,0.0,0.0,0.0,0.0,0.0,12.0,0.0,,237172.5,0.0,0.0,0.0,0.0,0.0,-1379.5,-320.0,-505.0,-941.0,587.0,-25.0,6.0,27384.57,147597.75,163318.5,0.0,472500.0,30.0,-664.5,365243.0,-830.0,-695.0,220.0,-690.5,9.0,1.0,0.0,-1.0,28.0,24.0,18.5,-27.5,0.0,0.0,27.0,18306.45,18306.45,-812.0,-809.0,4.0,1.0,0.0,,,,,,,,,,,,,,,,,,,,,8350043467.5,184456381387.5,165636161064.0,51991473655.935,1863.0,1705.0,71125.0,70864.0,9140.0,506266.0,,,,,,,128475.0,663091.0,,,,13532657.035616037,-602200292.0,-922255709.0,-296627158.0,-1535734328.0416667,44030.0,30713.0,,,,,,,67497.04840613072,158100.59565501017,126155.86811804918,,,,,,,3715619.0,,,,,,,,,,,,,,,,436622.0,431416.0,,6427.468244002896,632204.0,625755.0,,,,,,,,,46.0,57849020.54999999,,5960629471.454998,1964488060.0350008,66968826.20999997,709995.5099999999,108.0,12189.0,-19263059.5,8847932.0,-9966026.0,-10820616.0,-22.5,0.0,,202500.0,0.0,0.0,0.0,0.0,0.0,-2008.0,-649.0,-1376.0,-1406.0,211069786.0724995,2999332829.160003,3376625644.0350013,48461936.62499996,2999332829.160003,217085.0,-14867829.5,3456982006.5,153355014.5,779947110.5,340503495.0,814530983.5,217112.0,3374.5,605.4877861732775,5021308.5,1768166.0,1088305.0,-3564638.0,1239861.0,100210.0,2365678211.715147,2390682247.830087,-144050279.0,-142870141.0,2570962.0,117404.0,,,,,,,,,,,,,,,,,,,,,1468048.0,14804886.0,3234017.0,8558602.0,11612204.0,1416372.0,1059566552.3745012,,72138613017.01462,21688919794.08012,582873478.1144989,5792665.7475,689.5,94245.0,-277037957.5,22008846.0,-123835768.0,-218791827.0,-2020725.0,,,,,,,,,,,,,,,,,,,,,4274741.0,2480263.5,-9007298.0,921269.0,37582.5,3735274476.509961,3659986656.224961,-260734384.5,-257421784.5,2527525.0,269310.5,3927864298.769956,33266904771.57841,36696413645.865135,1730203280.1675494,48104528632.31321,3989671.0,-247683093.0,103128761796.5,1054978562.0,17280166887.5,3505276164.0,18893823654.5,3673557.5,71954.5,20879.14867127803,89815527.5,-11.782323493871912,1.693028571428571,9.171907756813416,436.7084517963297,15.528301886792455,739.3598862755234,78750.0,1.0,0.0,0.0,0.0,0.0,0.0,0.0,0.0,0.0,0.0,0.0,0.0,0.0,0.0,0.0,1.0,0.0,0.0,0.0,0.0,1.0,0.0,1.0,0.0,0.0,0.0,0.0,1.0,0.0,0.0,0.0,0.0,0.0,0.0,0.0,0.0,0.0,0.0,0.0,0.0,0.0,0.0,0.0,0.0,0.0,0.0,1.0,0.0,0.0,0.0,0.0,0.0,0.0,0.0,0.0,0.0,0.0,0.0,0.0,0.0,0.0,0.0,0.0,0.0,0.0,0.0,0.0,0.0,0.0,0.0,0.0,0.0,0.0,0.0,0.0,0.0,0.0,0.0,0.0,0.0,0.0,0.0,0.0,0.0,0.0,0.0,0.0,0.0,0.0,0.0,0.0,0.0,1.0,0.0,0.0,0.0,0.0,0.0,0.0,0.0,0.0,0.0,0.0,0.0,0.0,0.0,0.0,0.0,0.0,0.0,0.0,0.0,0.0,0.0,0.0,0.0,0.0,0.0,0.0,0.0,0.0,0.0
103594,0,0.0,0.0,1.0,0.0,0.0,99000.0,260640.0,18270.0,225000.0,0.020713,60.07945205479452,,-5293.0,-4846.0,30.0,2.0,3.0,3.0,11.0,,0.5883130118952762,,,,,,,,,,,,,,,,,,,,,,,,,,,,,,,,,,,,,,,,,,,,,,2.0,1.0,2.0,1.0,-2172.0,0.0,0.0,0.0,0.0,1.0,4.0,1.0,0.0,0.0,1.0,0.0,0.0,0.0,0.0,0.0,0.0,0.0,0.0,0.0,1.0,0.0,0.0,0.0,0.0,0.0,0.0,0.0,0.0,0.0,0.0,0.0,0.0,0.0,0.0,0.0,0.0,0.0,0.0,1.0,4329.0,,24232.5,0.0,,0.0,0.0,0.0,-2526.0,-2343.0,-2339.0,-2341.0,84.0,-41.5,6.0,13500.0,156915.0,149791.5,17766.0,225000.0,6.0,-563.0,365243.0,-533.0,-293.0,-293.0,-287.5,8.0,0.0,0.2095181224583816,-1.0,26.0,6.0,4.0,-17.5,0.0,0.0,24.0,17317.665,17317.665,-480.5,-458.0,4.5,1.0,22.0,0.0,270000.0,,0.0,,,0.0,,0.0,0.0,0.0,0.0,,0.0,,,0.0,-12.5,0.0,0.0,8350061737.5,184456642027.5,165636386064.0,51991572655.935,1863.0,1705.0,71125.0,70865.0,9140.0,506270.0,,,,,,,128475.0,663093.0,,,,13532717.115068091,,-922260555.0,-296629330.0,-1535739621.0416667,44031.0,30714.0,,,,,,,,158101.18396802206,,,,,,,,3715630.0,,,,,,,,,,,,,,,,436624.0,431418.0,1263687.0,6427.488957002896,632207.0,625758.0,,,,,,,,,84.0,58111843.04999999,,5968639261.98,1969701859.6200008,,709995.5099999999,108.0,12189.0,-19279401.0,8846565.0,-9976200.0,-10829623.0,-41.5,4329.0,,24232.5,0.0,,0.0,0.0,0.0,-2526.0,-2343.0,-2339.0,-2341.0,211341738.28499943,3002407774.5600038,3379894089.4350014,48510649.12499996,3002363359.5600038,217364.0,-14910528.0,3460269193.5,153710448.0,780670698.0,340863233.0,815254607.0,217409.5,3378.0,606.4603831246503,5022928.5,1769612.0,1089334.0,-3566827.0,1239863.0,100212.0,2368911357.6751394,2393989444.3050804,-144115276.0,-142934349.5,2571467.5,117493.5,2230591364.8199887,6063012000.0,,293577240.9599996,,,127512625.0499996,,297550257.97500074,2141022612.1049984,2222026676.5049853,2222113978.4399853,,24451.0,,,738036.0,-1315091.0,576342.0,1269.0,1468049.0,14804970.0,3234039.0,8558628.0,11612228.0,1416378.0,1059570881.3745012,,72138637249.51462,21688919794.08012,,5792665.7475,689.5,94245.0,-277040483.5,22006503.0,-123838107.0,-218794168.0,-2020766.5,5924537329.319962,18729508500.0,,448094372.3549976,,,309201085.10249865,,459282540.1049993,5709634120.642532,5887810745.617499,5888053928.3625,,80881.0,,,971785.0,-1699242.0,177364.0,6755.0,4274747.0,2480267.5,-9007315.5,921269.0,37582.5,3735291794.174961,3660003973.889961,-260734865.0,-257422242.5,2527529.5,269311.5,3927877798.769956,33267061686.57841,36696563437.365135,1730221046.1675494,48104753632.31321,3989677.0,-247683656.0,103129127039.5,1054978029.0,17280166594.5,3505275871.0,18893823367.0,3673565.5,71954.5,20879.35818940049,89815526.5,,2.632727272727273,5.41871921182266,325.5536810850935,14.266009852216747,857.0940549294826,49500.0,-0.9009688679024191,0.4338837391175582,0.0,1.0,0.0,0.0,0.0,0.0,0.0,0.0,0.0,1.0,0.0,0.0,0.0,0.0,0.0,0.0,0.0,0.0,1.0,0.0,1.0,0.0,0.0,0.0,0.0,1.0,0.0,0.0,0.0,0.0,0.0,0.0,0.0,0.0,0.0,0.0,0.0,0.0,0.0,0.0,0.0,0.0,0.0,0.0,0.0,0.0,0.0,0.0,0.0,0.0,0.0,0.0,0.0,0.0,0.0,0.0,0.0,0.0,0.0,0.0,0.0,0.0,0.0,0.0,0.0,0.0,0.0,0.0,0.0,0.0,0.0,0.0,0.0,0.0,0.0,0.0,0.0,0.0,0.0,0.0,0.0,0.0,0.0,0.0,0.0,0.0,0.0,0.0,0.0,0.0,0.0,0.0,0.0,0.0,0.0,0.0,0.0,0.0,0.0,0.0,0.0,0.0,0.0,0.0,0.0,1.0,0.0,0.0,0.0,0.0,0.0,0.0,0.0,0.0,0.0,0.0,0.0,0.0,0.0,0.0
103609,0,0.0,1.0,1.0,0.0,0.0,270000.0,1107900.0,35739.0,900000.0,0.010556,51.93424657534246,,-2001.0,-2171.0,9.0,2.0,3.0,3.0,11.0,0.3108543485926813,0.5167188819343359,0.6817058776720116,0.0619,0.0548,0.9821,,,0.0,0.1379,0.1667,,0.0397,,0.0508,,0.0032,0.063,0.0569,0.9821,,,0.0,0.1379,0.1667,,0.0406,,0.0529,,0.0034,0.0625,0.0548,0.9821,,,0.0,0.1379,0.1667,,0.0404,,0.0517,,0.0033,0.0406,1.0,0.0,0.0,0.0,0.0,-942.0,0.0,0.0,0.0,0.0,0.0,0.0,1.0,0.0,0.0,1.0,1.0,0.0,0.0,0.0,0.0,0.0,0.0,0.0,0.0,0.0,0.0,0.0,0.0,0.0,1.0,0.0,0.0,0.0,0.0,0.0,0.0,0.0,0.0,0.0,0.0,0.0,0.0,0.0,2.0,20700.0,0.0,123824.88,0.0,207383.805,0.0,0.0,0.0,-1080.5,-13.5,-252.0,-834.0,72.0,-17.5,5.0,27000.2475,450000.0,533160.0,0.0,450000.0,48.0,-795.0,365243.0,-884.5,-269.5,525.5,-262.0,14.0,1.0,0.0,-1.0,62.0,48.0,35.5,-21.0,0.0,0.0,60.0,26217.54,26217.54,-695.5,-614.5,8.0,1.0,0.0,,,,,,,,,,,,,,,,,,,,,8350097476.5,184457749927.5,165637286064.0,51991842655.935,1863.0,1705.0,71125.0,70865.0,9140.0,506270.0,17815.144600002288,17877.43069999911,17328.757099998027,11299.762700000092,11237.579800000096,11184.968200000056,128475.0,663095.0,,,,13532769.049314668,,-922262726.0,-296630272.0,-1535741622.0416667,44031.0,30714.0,11354.061599999188,11230.07999999898,10714.287899997287,22896.48750000972,22818.39150000969,22203.725200008248,67497.35926047932,158101.700686904,126156.54982392683,35015.61860002795,34955.866900028384,34401.3010000288,,,,3715641.0,8298.690700000163,8403.267100000074,8126.795700000231,,,,16474.05129999975,16659.457999999693,16256.187899999702,,,,3915.381100000125,3898.595600000164,3731.22240000016,436624.0,431418.0,1263696.0,6427.4995130028965,632210.0,625761.0,,16338.634399999804,154240.67079999065,154243.41739999026,154135.15059998722,,,,36.0,58171638.64499999,22699070.28,5993639168.715001,1972347812.2800007,67356009.13499999,709995.5099999999,108.0,12189.0,-19359715.5,8909180.5,-10012885.5,-10872359.0,-17.5,20700.0,0.0,40649.76,0.0,207383.805,0.0,0.0,0.0,-1142.0,-808.0,-489.0,-834.0,211883451.54749948,3011116865.3100038,3389245080.4350014,48646920.37499996,3011341865.3100038,218204.0,-14952333.0,3471226038.5,154045435.5,783206027.0,341211480.5,817790322.5,218128.0,3389.5,607.9359920375414,5031381.0,1776748.0,1093745.5,-3578929.0,1240622.0,100336.0,2375239013.5276427,2399935101.907581,-144621188.5,-143435800.5,2582032.0,117897.5,,,,,,,,,,,,,,,,,,,,,1468051.0,14805042.0,3234039.0,8558690.0,11612288.0,1416383.0,1059591581.3745012,801779241.1724951,72138761074.39462,21688919794.08012,583080861.9194987,5792665.7475,689.5,94245.0,-277041564.0,22006489.5,-123838359.0,-218795002.0,-2020784.0,,,,,,,,,,,,,,,,,,,,,4274795.0,2480303.0,-9007336.5,921269.0,37582.5,3735318011.714961,3660030191.4299607,-260735560.5,-257422857.0,2527537.5,269312.5,3927904799.017456,33267511686.57841,36697096597.365135,1730221046.1675494,48105203632.31321,3989725.0,-247684451.0,103129492282.5,1054977144.5,17280166325.0,3505276396.5,18893823105.0,3673579.5,71955.5,20879.35818940049,89815525.5,,4.1033333333333335,7.554772097708386,392.3513969429046,30.99974817426341,1609.9485654557184,135000.0,0.6234898018587336,0.7818314824680298,0.0,0.0,0.0,0.0,0.0,0.0,1.0,0.0,0.0,1.0,0.0,0.0,0.0,0.0,0.0,0.0,0.0,0.0,1.0,0.0,1.0,0.0,0.0,0.0,0.0,1.0,0.0,0.0,0.0,0.0,0.0,0.0,0.0,0.0,0.0,0.0,0.0,0.0,0.0,0.0,0.0,0.0,0.0,0.0,0.0,0.0,0.0,0.0,0.0,0.0,0.0,0.0,0.0,0.0,0.0,0.0,0.0,0.0,0.0,0.0,0.0,0.0,0.0,0.0,0.0,0.0,0.0,0.0,0.0,0.0,0.0,0.0,0.0,0.0,0.0,0.0,0.0,0.0,0.0,0.0,0.0,0.0,0.0,0.0,0.0,0.0,0.0,0.0,0.0,0.0,0.0,0.0,0.0,0.0,0.0,0.0,0.0,0.0,0.0,0.0,0.0,0.0,0.0,0.0,0.0,1.0,0.0,0.0,0.0,0.0,1.0,0.0,0.0,0.0,0.0,0.0,0.0,1.0,0.0,0.0
103613,0,0.0,0.0,1.0,1.0,0.0,270000.0,535306.5,29038.5,400500.0,0.035792,57.30958904109588,,-6992.0,-3097.0,7.0,2.0,2.0,2.0,11.0,0.7295104803603593,0.71922482146448,0.2498850627504553,,,,,,,,,,,,,,,,,,,,,,,,,,,,,,,,,,,,,,,,,,,,,1.0,1.0,1.0,1.0,-583.0,0.0,0.0,0.0,0.0,1.0,2.0,1.0,0.0,0.0,1.0,0.0,0.0,0.0,0.0,0.0,0.0,0.0,0.0,0.0,1.0,0.0,0.0,0.0,0.0,0.0,0.0,0.0,0.0,0.0,0.0,0.0,0.0,0.0,0.0,0.0,0.0,0.0,0.0,5.0,9171.0,,337468.5,179599.5,0.0,0.0,0.0,0.0,-767.0,-2.0,-10.0,-731.0,116.0,-13.0,5.0,25996.365,337500.0,384277.5,,337500.0,36.0,-477.0,365243.0,-553.0,365243.0,497.0,365243.0,13.0,1.0,,69.0,19.0,36.0,27.0,-10.0,0.0,0.0,22.0,25996.365,25996.365,-301.5,-298.0,9.5,1.0,0.0,,,,,,,,,,,,,,,,,,,,,8350126515.0,184458285234.0,165637686564.0,51992112655.935,1863.0,1705.0,71125.0,70866.0,9140.0,506272.0,,,,,,,128475.0,663097.0,,,,13532826.358903708,,-922265823.0,-296630855.0,-1535748614.0416667,44032.0,30715.0,,,,,,,67498.08877095967,158102.41991172545,126156.7997089896,,,,,,,3715652.0,,,,,,,,,,,,,,,,436625.0,431419.0,1263703.0,6427.535305002897,632212.0,625763.0,,,,,,,,,26.0,58187456.14499999,,5997984300.8550005,1973733627.7800007,67569497.00999999,709995.5099999999,108.0,12189.0,-19371873.0,8910175.0,-10017533.0,-10878368.0,-12.5,9171.0,,1575000.0,179599.5,0.0,0.0,0.0,0.0,-911.0,-731.0,-10.0,-731.0,212077310.30999956,3015042417.8100038,3393618666.4350014,,3015042417.8100038,218460.0,-14961516.0,3474330604.0,155135324.0,784663931.0,341940555.0,819248240.0,218347.0,3393.0,,5033638.0,1779113.0,1095413.0,-3581028.0,1240622.0,100336.0,2377246259.7676373,2402143210.1475763,-144684357.5,-143496630.5,2582723.5,118026.5,,,,,,,,,,,,,,,,,,,,,1468056.0,14805158.0,3234039.0,8558709.0,11612310.0,1416388.0,1059600752.3745012,,72139098542.89462,21689099393.58012,583080861.9194987,5792665.7475,689.5,94245.0,-277042331.0,22006487.5,-123838369.0,-218795733.0,-2020797.0,,,,,,,,,,,,,,,,,,,,,4274831.0,2480330.0,-9007346.5,921269.0,37582.5,3735344008.079961,3660056187.794961,-260735862.0,-257423155.0,2527547.0,269313.5,3927930795.382455,33267849186.57841,36697480874.865135,,48105541132.31321,3989761.0,-247684928.0,103129857525.5,1054976591.5,17280531568.0,3505276893.5,18894188348.0,3673592.5,71956.5,,89815594.5,,1.9826166666666667,9.298000929800091,532.8646121905708,18.434371610103828,1056.4662612058958,135000.0,-0.9009688679024191,-0.433883739117558,0.0,1.0,0.0,0.0,0.0,0.0,0.0,0.0,0.0,1.0,0.0,0.0,0.0,0.0,0.0,0.0,0.0,0.0,1.0,0.0,1.0,0.0,0.0,0.0,0.0,1.0,0.0,0.0,0.0,0.0,0.0,0.0,0.0,0.0,0.0,0.0,0.0,0.0,0.0,0.0,0.0,0.0,0.0,0.0,0.0,0.0,0.0,0.0,0.0,0.0,0.0,0.0,0.0,0.0,0.0,0.0,0.0,0.0,0.0,0.0,0.0,0.0,0.0,0.0,0.0,0.0,0.0,0.0,0.0,0.0,0.0,0.0,0.0,0.0,0.0,0.0,0.0,0.0,0.0,0.0,0.0,0.0,0.0,0.0,0.0,0.0,0.0,0.0,0.0,0.0,0.0,0.0,0.0,0.0,0.0,0.0,0.0,0.0,0.0,0.0,0.0,0.0,0.0,0.0,0.0,1.0,0.0,0.0,0.0,0.0,0.0,0.0,0.0,0.0,0.0,0.0,0.0,0.0,0.0,0.0
103614,0,0.0,0.0,0.0,0.0,0.0,135000.0,100737.0,6291.0,76500.0,0.0228,65.67123287671232,,-9861.0,-5570.0,,2.0,2.0,2.0,11.0,0.8349550495659243,0.1634380291304081,0.6296742509538716,0.0041,,0.9712,,,,,0.0,,,,0.0028,,,0.0042,,0.9712,,,,,0.0,,,,0.003,,,0.0042,,0.9712,,,,,0.0,,,,0.0029,,,0.0022,1.0,0.0,0.0,0.0,0.0,0.0,0.0,0.0,0.0,0.0,0.0,4.0,1.0,0.0,0.0,1.0,0.0,0.0,0.0,0.0,0.0,0.0,0.0,0.0,0.0,0.0,0.0,0.0,1.0,0.0,0.0,0.0,0.0,0.0,0.0,0.0,0.0,0.0,0.0,0.0,0.0,0.0,0.0,0.0,10.0,0.0,0.0,74511.945,0.0,0.0,0.0,0.0,0.0,-1601.5,-1503.0,-174.0,-1489.5,522.0,-27.0,11.0,9349.515,135000.0,152820.0,2247.75,169393.5,24.0,-1526.0,365243.0,-1775.0,-1505.0,-1085.0,-1498.0,14.0,0.0,0.0506947518551159,-1.0,149.0,24.0,15.0,-37.0,0.0,0.0,148.0,12880.485,12880.485,-1059.5,-1046.0,10.0,1.0,0.0,,,,,,,,,,,,,,,,,,,,,8350132806.0,184458385971.0,165637763064.0,51992247655.935,1863.0,1705.0,71125.0,70866.0,9140.0,506276.0,17815.148700002286,17877.43489999911,17328.761299998027,,,,128475.0,663099.0,,,,13532892.030136583,,-922271393.0,-296630855.0,-1535758475.0416667,44032.0,30715.0,,,,,,,67498.92372600923,158102.58334975454,126157.42938324055,35015.61860002795,34955.866900028384,34401.3010000288,,,,3715663.0,,,,,,,16474.05409999975,16659.460899999696,16256.190899999703,,,,,,,436625.0,431419.0,,6427.558105002897,632214.0,625765.0,,16338.636599999803,154241.64199999065,154244.38859999026,154136.12179998722,,,,53.0,58322766.64499999,22699070.28,6000893779.905003,1976433364.5300007,67569497.00999999,709995.5099999999,108.0,12189.0,-19384056.5,8901952.0,-10019564.0,-10886343.0,-26.0,0.0,0.0,73003.5,0.0,0.0,0.0,0.0,0.0,-1808.0,-1503.0,-25.0,-1503.0,212187573.80999947,3017205239.3100038,3396009070.9350014,48685415.62499996,3017160311.3100038,218688.0,-14972384.0,3475791576.0,155128809.0,785025355.0,341937880.0,819609680.0,218448.0,3394.0,608.5037711119647,5035521.0,1782226.0,1097124.0,-3583863.0,1240623.0,100337.0,2378889597.802624,2403688900.8825645,-144772932.0,-143584715.0,2584064.0,118113.5,,,,,,,,,,,,,,,,,,,,,1468066.0,14805680.0,3234039.0,8558858.0,11612458.0,1416399.0,1059600752.3745012,801779241.1724951,72139173054.83963,21689099393.58012,583080861.9194987,5792665.7475,689.5,94245.0,-277043932.5,22004984.5,-123838543.0,-218797222.5,-2020824.0,,,,,,,,,,,,,,,,,,,,,4274855.0,2480345.0,-9007383.5,921269.0,37582.5,3735356888.564961,3660069068.279961,-260736921.5,-257424201.0,2527557.0,269314.5,3927940144.897455,33267984186.57841,36697633694.865135,1730223293.9175494,48105710525.81321,3989785.0,-247686454.0,103130222768.5,1054974816.5,17280530063.0,3505275808.5,18894186850.0,3673606.5,71956.5,20879.408884152344,89815593.5,,0.7462,21.45922746781116,1409.2539243929682,16.012875536480685,1051.5852783820328,67500.0,1.0,0.0,0.0,0.0,0.0,0.0,0.0,0.0,0.0,0.0,0.0,1.0,0.0,0.0,0.0,0.0,0.0,0.0,0.0,0.0,1.0,0.0,1.0,0.0,0.0,0.0,0.0,0.0,1.0,0.0,0.0,0.0,0.0,0.0,0.0,0.0,0.0,0.0,0.0,0.0,0.0,0.0,0.0,0.0,0.0,0.0,0.0,0.0,0.0,0.0,0.0,0.0,0.0,0.0,0.0,0.0,0.0,0.0,0.0,0.0,0.0,0.0,0.0,0.0,0.0,0.0,0.0,0.0,0.0,0.0,0.0,0.0,0.0,0.0,0.0,0.0,0.0,0.0,0.0,0.0,0.0,0.0,0.0,0.0,0.0,0.0,0.0,0.0,0.0,0.0,0.0,0.0,0.0,0.0,0.0,0.0,0.0,0.0,0.0,0.0,0.0,0.0,0.0,0.0,0.0,0.0,0.0,1.0,0.0,0.0,0.0,0.0,1.0,0.0,0.0,0.0,0.0,0.0,0.0,0.0,0.0,1.0
103615,0,0.0,0.0,0.0,0.0,0.0,202500.0,291915.0,18783.0,252000.0,0.007305,67.78630136986301,,-10038.0,-4165.0,,1.0,3.0,3.0,13.0,0.7316696444077636,0.6116522789494792,0.2707073872651806,0.4082,0.2637,0.9861,0.8096,0.168,0.44,0.3793,0.3333,0.375,0.3668,0.3312,0.4592,0.0077,0.0093,0.416,0.2736,0.9861,0.8171,0.1695,0.4431,0.3793,0.3333,0.375,0.3752,0.3618,0.4784,0.0078,0.0098,0.4122,0.2637,0.9861,0.8121,0.1691,0.44,0.3793,0.3333,0.375,0.3732,0.3369,0.4675,0.0078,0.0095,0.455,1.0,9.0,0.0,9.0,0.0,-2079.0,0.0,0.0,0.0,0.0,0.0,2.0,1.0,0.0,0.0,1.0,0.0,0.0,0.0,0.0,0.0,0.0,0.0,0.0,0.0,1.0,0.0,0.0,0.0,0.0,0.0,0.0,0.0,0.0,0.0,0.0,0.0,0.0,0.0,0.0,0.0,0.0,0.0,0.0,12.0,5406.705,0.0,41878.71,0.0,0.0,0.0,0.0,0.0,-2143.5,-1950.0,-38.5,-1950.0,732.0,-34.5,24.0,7315.695,45000.0,47841.75,0.0,69747.75,12.0,-729.0,365243.0,-953.0,-640.0,-640.0,-635.5,7.5,1.0,0.0,-1.0,117.0,12.0,9.0,-26.0,0.0,0.0,124.0,7189.74,5848.92,-763.0,-765.0,6.0,1.0,0.0,,,,,,,,,,,,,,,,,,,,,8350151589.0,184458677886.0,165638015064.0,51992450155.935,1863.0,1705.0,71125.0,70866.0,9140.0,506278.0,17815.556900002288,17877.847099999108,17329.177299998028,11300.026400000092,11237.843500000095,11185.241800000056,128475.0,663100.0,4140.190600000116,4137.876100000016,3948.448400000093,13532959.816437954,,-922275558.0,-296632934.0,-1535768513.0416667,44032.0,30715.0,11354.501599999188,11230.51999999898,10714.73099999729,22896.86680000972,22818.770800009686,22204.10450000825,67499.65539565364,158103.19500203352,126157.7000906278,35015.95190002795,34956.200200028376,34401.6343000288,22963.859799995906,22936.983799995483,22583.74789999572,3715676.0,8299.057500000163,8403.640300000074,8127.170900000231,9821.560500000716,9936.620000002162,10296.543299999645,16474.51329999975,16659.928399999695,16256.669299999705,828.8688000001764,814.0431000000459,759.9657000000133,3915.390400000125,3898.605100000165,3731.23220000016,436634.0,431428.0,,6427.565410002897,632217.0,625768.0,,16339.091599999803,154242.62809999063,154245.3746999903,154137.1078999872,77643.66199999629,77981.60310000657,78383.13580000655,71.0,58356217.95749998,22723648.47,6001766713.237502,1976853267.5175009,67570889.57999998,709995.5099999999,108.0,12189.0,-19402329.5,8887741.0,-10024183.5,-10901788.0,-35.0,4500.0,0.0,38754.0,0.0,0.0,0.0,0.0,0.0,-2257.0,-2279.0,-23.0,-2305.0,212296028.53499952,3018416481.8100038,3397371058.9350014,48697239.37499996,3018416481.8100038,218930.0,-14990430.0,3478896141.5,155116531.0,785748473.5,341930087.0,820332837.0,218616.5,3400.0,608.7601885831681,5036195.5,1785708.0,1099354.0,-3588797.0,1240629.0,100339.0,2380417491.780116,2405121950.0700607,-144914695.0,-143725548.0,2585508.0,118251.5,,,,,,,,,,,,,,,,,,,,,1468078.0,14806412.0,3234039.0,8558975.0,11612582.0,1416423.0,1059606159.0795012,801779241.1724951,72139214933.54964,21689099393.58012,583080861.9194987,5792665.7475,689.5,94245.0,-277046076.0,22003034.5,-123838581.5,-218799172.5,-2020858.5,,,,,,,,,,,,,,,,,,,,,4274867.0,2480354.0,-9007409.5,921269.0,37582.5,3735364078.3049607,3660074917.1999607,-260737684.5,-257424966.0,2527563.0,269315.5,3927947460.592456,33268029186.57841,36697681536.615135,1730223293.9175494,48105780273.56321,3989797.0,-247687183.0,103130588011.5,1054973863.5,17280529423.0,3505275168.5,18894186214.5,3673614.0,71957.5,20879.408884152344,89815592.5,,1.4415555555555557,10.781025395304262,730.8058365222412,15.541447053186392,1053.497213671062,202500.0,0.6234898018587336,0.7818314824680298,0.0,0.0,0.0,0.0,0.0,0.0,1.0,0.0,0.0,1.0,0.0,0.0,0.0,0.0,0.0,1.0,0.0,0.0,0.0,0.0,0.0,0.0,0.0,1.0,0.0,0.0,1.0,0.0,0.0,0.0,0.0,0.0,0.0,0.0,0.0,0.0,0.0,0.0,0.0,0.0,0.0,0.0,0.0,0.0,0.0,0.0,0.0,0.0,0.0,0.0,0.0,0.0,0.0,0.0,0.0,0.0,0.0,0.0,0.0,0.0,0.0,0.0,0.0,0.0,0.0,0.0,0.0,0.0,0.0,0.0,0.0,0.0,0.0,0.0,0.0,0.0,0.0,0.0,0.0,0.0,0.0,0.0,0.0,0.0,0.0,0.0,0.0,0.0,0.0,0.0,0.0,0.0,0.0,0.0,0.0,0.0,0.0,0.0,0.0,0.0,0.0,0.0,0.0,0.0,0.0,1.0,0.0,0.0,0.0,1.0,1.0,0.0,0.0,0.0,0.0,0.0,0.0,1.0,0.0,0.0
103624,0,0.0,0.0,0.0,0.0,1.0,148500.0,742500.0,26797.5,742500.0,0.028663,28.263013698630136,-3161.0,-6470.0,-2788.0,,3.0,2.0,2.0,9.0,,0.7121636967734293,0.4276573700350293,0.0165,0.0,0.9732,0.6328,0.0014,0.0,0.069,0.0417,0.0417,0.0525,0.0134,0.0127,0.0,0.0039,0.0168,0.0,0.9732,0.6472,0.0014,0.0,0.069,0.0417,0.0417,0.0537,0.0147,0.0132,0.0,0.0041,0.0167,0.0,0.9732,0.6377,0.0014,0.0,0.069,0.0417,0.0417,0.0534,0.0137,0.0129,0.0,0.004,0.0107,2.0,6.0,1.0,6.0,0.0,-1210.0,0.0,0.0,0.0,0.0,1.0,5.0,1.0,1.0,0.0,1.0,0.0,1.0,0.0,0.0,0.0,0.0,0.0,0.0,0.0,1.0,0.0,0.0,0.0,0.0,0.0,0.0,0.0,0.0,0.0,0.0,0.0,0.0,0.0,0.0,0.0,0.0,0.0,0.0,2.0,16317.0,,127949.085,66260.25,0.0,0.0,0.0,0.0,-538.0,9.5,-244.0,-455.0,37.0,-14.0,9.0,9552.2625,78660.0,88897.5,7866.0,89887.5,12.0,-1396.0,365243.0,-1522.5,-1162.5,-1100.0,-1158.5,13.0,0.0,0.1001232736466016,30.0,84.0,12.0,7.5,-50.5,0.0,0.0,146.0,8294.13,8294.13,-849.0,-841.5,10.0,1.0,27.0,350144.73,765000.0,2700.0,34997.49,0.0,23074.605,12047.13,23002.9425,3259.845,346700.925,350144.73,350144.73,1.0,8.0,0.0,7.0,9.0,-14.0,0.0,0.0,8350178386.5,184459420386.0,165638757564.0,51992598655.935,1863.0,1705.0,71125.0,70867.0,9140.0,506283.0,17815.57340000229,17877.863799999108,17329.194099998032,11300.026400000092,11237.843500000095,11185.241800000056,128476.0,663103.0,4140.192000000116,4137.877500000016,3948.4498000000935,13532988.079451654,-602203453.0,-922278346.0,-296634144.0,-1535774983.0416667,44033.0,30715.0,11354.501599999188,11230.51999999898,10714.73099999729,22896.93580000972,22818.83980000969,22204.173500008248,,158103.90716573028,126158.12774799785,35015.99360002795,34956.241900028384,34401.6760000288,22963.901499995907,22937.025499995485,22583.78959999572,3715685.0,8299.110000000162,8403.693700000074,8127.22460000023,9821.573900000716,9936.63370000216,10296.557999999644,16474.52599999975,16659.941299999697,16256.682499999702,828.8688000001764,814.0431000000459,759.9657000000133,3915.394300000125,3898.609100000164,3731.23630000016,436640.0,431434.0,,6427.594073002897,632219.0,625770.0,,16339.102299999804,154243.6012999907,154246.34789999024,154138.0810999872,77644.29479999629,77982.24080000658,78383.78300000656,18.5,58612844.42999998,,6018314158.440002,1982946804.8400009,68282726.98499998,709995.5099999999,109.0,12189.0,-19460000.5,9006683.0,-10043754.5,-10924658.0,-8.75,16317.0,,102115.17,0.0,0.0,0.0,0.0,0.0,-975.0,-245.0,-447.0,-455.0,213244128.1799996,3033605716.110003,3414762289.9350014,48839697.67499996,3033605716.110003,219976.0,-15050892.0,3493139309.5,155069443.0,787898156.5,342635819.5,822482715.5,219442.0,3419.5,611.0658696617396,5065367.0,1793568.0,1105119.0,-3604275.5,1241318.0,100872.0,2394435766.927617,2419544711.587561,-145320885.5,-144127801.5,2589858.0,118646.0,2236797527.759988,6086592000.0,190756930.23,294785604.0899996,10265426.1,93486326.98499994,127824870.9599996,324051663.7124996,298418694.705001,2147080128.3899984,2228215651.289984,2228302953.224984,9760.0,24627.0,145.0,14722.0,739897.0,-1320635.0,576343.0,1270.0,1468080.0,14806449.0,3234066.0,8559059.0,11612728.0,1416432.0,1059622476.0795012,,72139342882.63464,21689165653.83012,583080861.9194987,5792665.7475,689.5,94245.0,-277046614.0,22003044.0,-123838825.5,-218799627.5,-2020872.5,5924887474.049961,18730273500.0,198835707.825,448129369.8449976,1948107.735,256879316.90250075,309213132.23249865,636743857.252498,459285799.9499993,5709980821.567534,5888160890.347499,5888404073.0925,13390.5,80889.0,44.0,70393.5,971794.0,-1699256.0,177364.0,6755.0,4274879.0,2480361.5,-9007460.0,921269.0,37582.5,3735372372.434961,3660083211.329961,-260738533.5,-257425807.5,2527573.0,269316.5,3927957012.8549542,33268107846.57841,36697770434.115135,1730231159.9175494,48105870161.06321,3989809.0,-247688579.0,103130953254.5,1054972341.0,17280528260.5,3505274068.5,18894185056.0,3673627.0,71957.5,20879.50900742599,89815622.5,-111.84228383094224,5.0,5.541561712846347,156.6212346019806,27.707808564231733,783.1061730099028,49500.0,-0.9009688679024191,0.4338837391175582,0.0,0.0,0.0,0.0,0.0,0.0,1.0,0.0,0.0,0.0,0.0,0.0,0.0,1.0,0.0,0.0,0.0,0.0,1.0,0.0,1.0,0.0,0.0,0.0,0.0,0.0,0.0,0.0,0.0,1.0,0.0,0.0,0.0,0.0,0.0,0.0,0.0,0.0,0.0,0.0,0.0,0.0,0.0,0.0,1.0,0.0,0.0,0.0,0.0,0.0,0.0,0.0,0.0,0.0,0.0,0.0,0.0,0.0,0.0,0.0,0.0,0.0,0.0,0.0,0.0,0.0,0.0,0.0,0.0,0.0,0.0,0.0,0.0,0.0,0.0,0.0,0.0,0.0,0.0,0.0,0.0,0.0,0.0,0.0,0.0,0.0,0.0,0.0,0.0,0.0,0.0,0.0,0.0,0.0,0.0,0.0,0.0,0.0,0.0,1.0,0.0,0.0,0.0,0.0,0.0,0.0,0.0,0.0,1.0,0.0,1.0,0.0,0.0,1.0,0.0,0.0,0.0,0.0,0.0,0.0
103625,0,0.0,1.0,1.0,1.0,2.0,135000.0,526500.0,27013.5,526500.0,0.018209,40.4986301369863,-270.0,-683.0,-4306.0,16.0,4.0,3.0,3.0,12.0,0.3099234474753123,0.0829609112741257,0.520897599048938,,,,,,,,,,,,,,,,,,,,,,,,,,,,,,,,,,,,,,,,,,,,,1.0,0.0,1.0,0.0,-275.0,0.0,0.0,0.0,0.0,1.0,0.0,1.0,1.0,0.0,1.0,0.0,1.0,0.0,0.0,0.0,0.0,1.0,1.0,0.0,1.0,0.0,0.0,0.0,0.0,0.0,0.0,0.0,0.0,0.0,0.0,0.0,0.0,0.0,0.0,0.0,0.0,0.0,0.0,15.0,504.0,0.0,126000.0,0.0,0.0,0.0,0.0,0.0,-1360.0,-705.0,-816.0,-1545.5,704.0,-24.0,1.0,5106.96,46845.0,52411.5,0.0,46845.0,12.0,-275.0,365243.0,-245.0,365243.0,85.0,365243.0,10.0,1.0,0.0,100.0,9.0,12.0,8.0,-5.0,0.0,0.0,9.0,5106.96,5106.96,-134.0,-125.0,5.0,1.0,0.0,,,,,,,,,,,,,,,,,,,,,8350205400.0,184459946886.0,165639284064.0,51992733655.935,1863.0,1705.0,71125.0,70868.0,9140.0,506283.0,,,,,,,128478.0,663107.0,,,,13533028.57808179,-602203723.0,-922282652.0,-296634419.0,-1535775666.0416667,44033.0,30715.0,,,,,,,67499.96531910112,158103.99012664155,126158.6486455969,,,,,,,3715697.0,,,,,,,,,,,,,,,,436641.0,431435.0,1263719.0,6427.612282002897,632222.0,625773.0,,,,,,,,,45.0,58647489.92999998,22733665.335,6022106817.93,1984319320.5900009,68282726.98499998,709995.5099999999,109.0,12189.0,-19471969.0,9007744.5,-10052993.0,-10935034.5,-22.0,0.0,0.0,149850.0,0.0,0.0,0.0,0.0,0.0,-1885.0,-1520.0,-1723.0,-1743.0,213290059.72499955,3034050838.110003,3415274461.9350014,48857013.67499996,3034050838.110003,220054.0,-15056057.0,3494782903.0,155064178.0,788262214.0,342635424.0,822846784.0,219504.0,3422.0,611.2746517181113,5066514.0,1794338.0,1105630.0,-3606139.0,1241318.0,100872.0,2395411075.89012,2420520020.550064,-145406340.0,-144212490.0,2590701.0,118709.0,,,,,,,,,,,,,,,,,,,,,1468095.0,14807153.0,3234066.0,8559068.0,11612737.0,1416433.0,1059622980.0795012,801779241.1724951,72139468882.63464,21689165653.83012,583080861.9194987,5792665.7475,689.5,94245.0,-277047974.0,22002339.0,-123839641.5,-218801173.0,-2020896.5,,,,,,,,,,,,,,,,,,,,,4274891.0,2480369.5,-9007465.0,921269.0,37582.5,3735377479.394961,3660088318.289961,-260738667.5,-257425932.5,2527578.0,269317.5,3927962119.8149543,33268154691.57841,36697822845.615135,1730231159.9175494,48105917006.06321,3989821.0,-247688854.0,103131318497.5,1054972096.0,17280893503.5,3505274153.5,18894550299.0,3673637.0,71958.5,20879.50900742599,89815722.5,-6.666892166148018,3.9,4.997501249375312,202.3919547075777,19.49025487256372,789.328623359553,33750.0,-0.9009688679024191,-0.433883739117558,0.0,0.0,0.0,0.0,0.0,0.0,1.0,0.0,0.0,0.0,0.0,0.0,0.0,1.0,0.0,0.0,0.0,0.0,1.0,0.0,1.0,0.0,0.0,0.0,0.0,1.0,0.0,0.0,0.0,0.0,0.0,0.0,0.0,0.0,0.0,0.0,0.0,0.0,1.0,0.0,0.0,0.0,0.0,0.0,0.0,0.0,0.0,0.0,0.0,0.0,0.0,0.0,0.0,1.0,0.0,0.0,0.0,0.0,0.0,0.0,0.0,0.0,0.0,0.0,0.0,0.0,0.0,0.0,0.0,0.0,0.0,0.0,0.0,0.0,0.0,0.0,0.0,0.0,0.0,0.0,0.0,0.0,0.0,0.0,0.0,0.0,0.0,0.0,0.0,0.0,0.0,0.0,0.0,0.0,0.0,0.0,0.0,0.0,0.0,0.0,0.0,0.0,0.0,0.0,0.0,0.0,0.0,0.0,0.0,0.0,0.0,0.0,0.0,0.0,0.0,0.0,0.0,0.0,0.0,0.0
103628,1,0.0,0.0,0.0,0.0,1.0,117000.0,601470.0,30708.0,450000.0,0.00823,28.736986301369864,-3689.0,-10469.0,-2368.0,,3.0,2.0,2.0,14.0,0.2027229991181536,0.3292486053089939,0.3123653692278984,,,,,,,,,,,,,,,,,,,,,,,,,,,,,,,,,,,,,,,,,,,,,0.0,0.0,0.0,0.0,0.0,0.0,0.0,0.0,0.0,0.0,0.0,1.0,1.0,0.0,1.0,0.0,1.0,0.0,0.0,0.0,0.0,1.0,1.0,0.0,1.0,0.0,0.0,0.0,0.0,0.0,0.0,0.0,0.0,0.0,0.0,0.0,0.0,0.0,0.0,0.0,0.0,0.0,0.0,1.0,,,26213.85,0.0,,0.0,0.0,0.0,-365.0,-30.0,-57.0,-59.0,12.0,-6.5,3.0,5790.96,62041.5,62041.5,0.0,62041.5,12.0,-583.0,365243.0,-552.0,-252.0,-222.0,-250.0,11.0,0.0,0.0,2300.0,21.0,12.0,6.0,-16.0,0.0,0.0,20.0,5790.96,5790.96,-456.5,-447.0,4.0,1.0,0.0,,,,,,,,,,,,,,,,,,,,,8350236108.0,184460548356.0,165639734064.0,51992850655.935,1863.0,1705.0,71125.0,70868.0,9140.0,506283.0,,,,,,,128479.0,663110.0,,,,13533057.315068092,-602207412.0,-922285020.0,-296634419.0,-1535786135.0416667,44033.0,30715.0,,,,,,,67500.16804210024,158104.31937524685,126158.96101096612,,,,,,,3715711.0,,,,,,,,,,,,,,,,436641.0,431435.0,,6427.620512002897,632224.0,625775.0,,,,,,,,,12.0,,,6024815621.280003,1984673479.5900009,,709995.5099999999,109.0,12189.0,-19491515.0,8995395.0,-10065667.0,-10947377.0,-6.5,,,26213.85,0.0,,0.0,0.0,0.0,-365.0,-30.0,-57.0,-59.0,213387608.6099996,3034933135.110003,3416219218.9350014,48858764.17499996,3034933135.110003,220156.0,-15062865.0,3497704847.0,155058003.0,788988942.0,342632069.0,823573559.0,219612.0,3425.0,611.3607782405013,5073362.0,1795666.0,1106374.0,-3608284.0,1241331.0,100885.0,2396449804.950119,2421558749.610063,-145463859.0,-144268008.0,2591323.5,118798.5,,,,,,,,,,,,,,,,,,,,,1468096.0,14807165.0,3234066.0,8559089.0,11612757.0,1416436.0,,,72139495096.48465,21689165653.83012,,5792665.7475,689.5,94245.0,-277048339.0,22002309.0,-123839698.5,-218801232.0,-2020903.0,,,,,,,,,,,,,,,,,,,,,4274903.0,2480375.5,-9007481.0,921269.0,37582.5,3735383270.354961,3660094109.249962,-260739124.0,-257426379.5,2527582.0,269318.5,3927967910.774955,33268216733.07841,36697884887.115135,1730231159.9175494,48105979047.56321,3989833.0,-247689437.0,103131683740.5,1054971544.0,17280893251.5,3505273931.5,18894550049.0,3673648.0,71958.5,20879.50900742599,89818022.5,-128.37115072933548,5.140769230769231,3.810082063305978,109.49027606031896,19.58675263774912,562.8642422393166,39000.0,-0.9009688679024191,-0.433883739117558,0.0,0.0,0.0,0.0,0.0,0.0,1.0,0.0,0.0,0.0,0.0,0.0,0.0,1.0,0.0,0.0,0.0,0.0,1.0,0.0,1.0,0.0,0.0,0.0,0.0,0.0,0.0,0.0,1.0,0.0,0.0,0.0,0.0,0.0,0.0,0.0,0.0,0.0,0.0,0.0,0.0,1.0,0.0,0.0,0.0,0.0,0.0,0.0,0.0,0.0,0.0,0.0,0.0,0.0,0.0,0.0,0.0,0.0,0.0,0.0,0.0,0.0,0.0,0.0,0.0,0.0,0.0,0.0,0.0,0.0,0.0,0.0,0.0,0.0,0.0,0.0,0.0,0.0,1.0,0.0,0.0,0.0,0.0,0.0,0.0,0.0,0.0,0.0,0.0,0.0,0.0,0.0,0.0,0.0,0.0,0.0,0.0,0.0,0.0,0.0,0.0,0.0,0.0,0.0,0.0,0.0,0.0,0.0,0.0,0.0,0.0,0.0,0.0,0.0,0.0,0.0,0.0,0.0,0.0,0.0
103629,0,0.0,0.0,0.0,1.0,0.0,157500.0,166810.5,17514.0,144000.0,0.016612,39.56986301369864,-1974.0,-13111.0,-694.0,,1.0,2.0,2.0,11.0,0.3878613616872365,0.6448828149023087,0.7713615919194317,0.0928,0.0902,0.9771,0.6872,0.0421,0.0,0.2069,0.1667,0.2083,0.076,0.0756,0.0782,0.0,0.0,0.0945,0.0936,0.9772,0.6994,0.0425,0.0,0.2069,0.1667,0.2083,0.0778,0.0826,0.0815,0.0,0.0,0.0937,0.0902,0.9771,0.6914,0.0423,0.0,0.2069,0.1667,0.2083,0.0774,0.077,0.0796,0.0,0.0,0.0845,1.0,0.0,0.0,0.0,0.0,-943.0,0.0,0.0,0.0,0.0,1.0,1.0,1.0,1.0,0.0,1.0,0.0,1.0,0.0,0.0,0.0,0.0,0.0,0.0,0.0,1.0,0.0,0.0,0.0,0.0,0.0,0.0,0.0,0.0,0.0,0.0,0.0,0.0,0.0,0.0,0.0,0.0,0.0,0.0,3.0,0.0,0.0,42345.99,0.0,0.0,0.0,0.0,0.0,-1251.0,-1159.0,-963.0,-1154.0,123.0,-20.0,4.0,13777.8525,60313.5,123822.0,4032.0,80626.5,8.0,-712.0,365243.0,-458.0,-218.0,-218.0,-215.0,12.5,0.5,0.0504667694738029,499.5,29.0,10.0,5.0,-19.0,0.0,0.0,34.0,18168.57,8568.45,-515.5,-502.0,5.5,1.0,21.0,0.0,720000.0,,0.0,,,0.0,,0.0,0.0,0.0,0.0,,0.0,,,0.0,-13.0,0.0,0.0,8350253622.0,184460715166.5,165639878064.0,51993008155.935,1863.0,1705.0,71125.0,70869.0,9140.0,506284.0,17815.666200002288,17877.95749999911,17329.288599998028,11300.116600000092,11237.933700000096,11185.335400000056,128479.0,663111.0,4140.234100000116,4137.919800000016,3948.4923000000936,13533096.884931104,-602209386.0,-922285714.0,-296635362.0,-1535799246.0416667,44033.0,30715.0,11354.501599999188,11230.51999999898,10714.73099999729,22897.14270000972,22819.046700009687,22204.380400008253,67500.55590346192,158104.96425806175,126159.73237255804,35016.16030002795,34956.408600028386,34401.8427000288,22964.109799995906,22937.233799995483,22583.99789999572,3715722.0,8299.186000000162,8403.771100000075,8127.30240000023,9821.649500000716,9936.71070000216,10296.640599999644,16474.60419999975,16660.020899999698,16256.763999999705,828.8688000001764,814.0431000000459,759.9657000000133,3915.394300000125,3898.609100000164,3731.23630000016,436641.0,431435.0,,6427.6371240028975,632226.0,625777.0,,16339.186799999805,154244.57839999066,154247.32499999026,154139.0582999872,77644.9819999963,77982.93220000657,78384.48240000656,42.0,58686687.94499998,22733665.335,6024943466.280003,1984673479.5900009,68282726.98499998,709995.5099999999,109.0,12189.0,-19493926.0,8993737.0,-10067125.0,-10949029.0,-20.5,0.0,0.0,42345.99,0.0,0.0,0.0,0.0,0.0,-1251.0,-1159.0,-963.0,-1154.0,213440956.5599996,3035051262.360003,3417058327.1850014,48868628.17499996,3035071262.610003,220175.0,-15066238.0,3498983197.5,155420218.0,789351832.0,342995019.0,823936472.0,219660.5,3425.5,611.5579212237149,5074884.0,1795870.0,1106480.0,-3608958.0,1241331.0,100885.0,2396680160.580118,2421794784.082562,-145484127.5,-144287998.0,2591434.0,118841.5,2240827079.399987,6104457000.0,,295259479.60499966,,,128014463.6099996,,298545920.86500096,2151027277.4249983,2232229056.9299827,2232316358.8649826,,24767.0,,,740011.0,-1320962.0,576343.0,1270.0,1468099.0,14807288.0,3234087.0,8559118.0,11612791.0,1416440.0,1059622980.0795012,801779241.1724951,72139537442.47466,21689165653.83012,583080861.9194987,5792665.7475,689.5,94245.0,-277049590.0,22001150.0,-123840661.5,-218802386.0,-2020923.0,5924887474.049961,18730993500.0,,448129369.8449976,,,309213132.23249865,,459285799.9499993,5709980821.567534,5888160890.347499,5888404073.0925,,80889.0,,,971794.0,-1699269.0,177364.0,6755.0,4274913.0,2480380.5,-9007500.0,921269.0,37582.5,3735401438.924961,3660102677.6999607,-260739639.5,-257426881.5,2527587.5,269319.5,3927981688.627455,33268277046.57841,36698008709.115135,1730235191.9175494,48106059674.06321,3989841.0,-247690149.0,103132048983.5,1054971086.0,17280893033.5,3505273713.5,18894549834.0,3673660.5,71959.0,20879.559474195463,89818522.0,-49.88645018347989,1.0591142857142857,8.992805755395683,355.8440918498078,9.524409044193217,376.8795611651578,157500.0,-0.9009688679024191,-0.433883739117558,0.0,0.0,0.0,0.0,0.0,0.0,1.0,0.0,0.0,0.0,0.0,0.0,0.0,1.0,0.0,1.0,0.0,0.0,0.0,0.0,0.0,0.0,1.0,0.0,0.0,1.0,0.0,0.0,0.0,0.0,0.0,0.0,0.0,1.0,0.0,0.0,0.0,0.0,0.0,0.0,0.0,0.0,0.0,0.0,0.0,0.0,0.0,0.0,0.0,0.0,0.0,0.0,0.0,0.0,0.0,0.0,0.0,0.0,0.0,0.0,0.0,0.0,0.0,0.0,0.0,0.0,0.0,0.0,0.0,0.0,0.0,0.0,0.0,0.0,0.0,0.0,1.0,0.0,0.0,0.0,0.0,0.0,0.0,0.0,0.0,0.0,0.0,0.0,0.0,0.0,0.0,0.0,0.0,0.0,0.0,0.0,0.0,0.0,0.0,0.0,0.0,0.0,0.0,0.0,0.0,0.0,0.0,0.0,1.0,0.0,1.0,0.0,0.0,0.0,0.0,0.0,0.0,1.0,0.0,0.0
103647,0,0.0,1.0,1.0,0.0,0.0,180000.0,272520.0,16672.5,225000.0,0.02461,53.37808219178083,-3448.0,-4997.0,-3038.0,6.0,2.0,2.0,2.0,20.0,0.4537763637047774,0.4687338216836205,0.4223696523543468,0.1093,0.155,0.993,,,0.04,0.2414,0.1667,,0.0535,,0.1769,,0.0058,0.1113,0.1608,0.993,,,0.0403,0.2414,0.1667,,0.0547,,0.1843,,0.0061,0.1103,0.155,0.993,,,0.04,0.2414,0.1667,,0.0544,,0.1801,,0.0059,0.1558,1.0,0.0,0.0,0.0,0.0,-2182.0,0.0,0.0,0.0,0.0,0.0,3.0,1.0,1.0,1.0,1.0,1.0,0.0,0.0,0.0,0.0,0.0,1.0,1.0,0.0,1.0,0.0,0.0,0.0,0.0,0.0,0.0,0.0,0.0,0.0,0.0,0.0,0.0,0.0,0.0,0.0,0.0,0.0,0.0,7.0,0.0,,200628.0,62835.75,0.0,0.0,0.0,0.0,-689.0,19.0,-168.0,-304.0,168.0,-13.0,8.0,18212.7825,450000.0,488245.5,6300.0,450000.0,48.0,-644.5,365243.0,-1700.0,-1370.0,-1370.0,-1355.0,10.0,0.0,0.1000739874460011,-1.0,39.0,12.0,6.0,-51.0,0.0,0.0,43.0,6879.96,6559.92,-1553.0,-1550.0,7.0,1.0,0.0,,,,,,,,,,,,,,,,,,,,,8350270294.5,184460987686.5,165640103064.0,51993188155.935,1863.0,1705.0,71125.0,70869.0,9140.0,506287.0,17815.775500002288,17878.06779999911,17329.399899998032,11300.271600000093,11238.088700000097,11185.496200000056,128479.0,663113.0,,,,13533150.263013298,-602212834.0,-922288752.0,-296637544.0,-1535804243.0416667,44033.0,30715.0,11354.541599999187,11230.55999999898,10714.77129999729,22897.38410000972,22819.28810000969,22204.621800008248,67501.00967982563,158105.43299188346,126160.1547422104,35016.32700002795,34956.57530002839,34402.0094000288,,,,3715742.0,8299.239500000162,8403.825500000074,8127.35710000023,,,,16474.781099999753,16660.2009999997,16256.948299999704,,,,3915.400100000125,3898.615000000165,3731.24240000016,436641.0,431435.0,1263725.0,6427.661734002898,632228.0,625779.0,,16339.342599999803,154245.57139999064,154248.31799999022,154140.05129998722,,,,23.0,58929970.09499998,,6053706576.585003,1991812995.4950008,68294529.80999997,710189.0099999999,110.0,12249.0,-19612821.0,9061396.0,-10123900.0,-11011353.0,-11.0,0.0,,229050.0,0.0,0.0,0.0,0.0,0.0,-814.0,19.0,-168.0,-304.0,214473718.57499963,3051305837.145004,3434671066.1850014,49078477.70999996,3051305837.145004,221458.0,-15152126.0,3517062142.0,155727407.0,793328491.0,344055968.0,828278630.0,220820.0,3441.0,614.8914831278154,5104610.0,1808834.0,1114292.0,-3628879.0,1241404.0,100912.0,2410427099.3401136,2435083183.5750604,-146091451.0,-144887716.0,2597960.0,119591.0,,,,,,,,,,,,,,,,,,,,,1468106.0,14807456.0,3234087.0,8559157.0,11612834.0,1416448.0,1059622980.0795012,,72139738070.47466,21689228489.58012,583080861.9194987,5792665.7475,689.5,94245.0,-277050279.0,22001169.0,-123840829.5,-218802690.0,-2020936.0,,,,,,,,,,,,,,,,,,,,,4274925.0,2480386.5,-9007551.0,921269.0,37582.5,3735408318.884961,3660109237.619961,-260741192.5,-257428431.5,2527594.5,269320.5,3927999901.4099545,33268727046.57841,36698496954.615135,1730241491.9175494,48106509674.06321,3989889.0,-247690793.5,103132414226.5,1054969386.0,17280891663.5,3505272343.5,18894548479.0,3673670.5,71959.0,20879.65954818291,89818521.0,-64.59580146794643,1.514,10.796221322537113,576.2815891150426,16.345479082321187,872.4903259201744,90000.0,-0.2225209339563143,0.9749279121818236,0.0,0.0,0.0,0.0,0.0,0.0,1.0,0.0,0.0,0.0,0.0,0.0,0.0,1.0,0.0,1.0,0.0,0.0,0.0,0.0,1.0,0.0,0.0,0.0,0.0,1.0,0.0,0.0,0.0,0.0,0.0,0.0,0.0,0.0,0.0,0.0,0.0,0.0,0.0,0.0,0.0,0.0,0.0,0.0,0.0,0.0,0.0,0.0,0.0,0.0,0.0,0.0,0.0,0.0,0.0,0.0,0.0,0.0,0.0,1.0,0.0,0.0,0.0,0.0,0.0,0.0,0.0,0.0,0.0,0.0,0.0,0.0,0.0,0.0,0.0,0.0,0.0,0.0,0.0,0.0,0.0,0.0,0.0,0.0,0.0,0.0,0.0,0.0,0.0,0.0,0.0,0.0,0.0,0.0,0.0,0.0,0.0,0.0,0.0,0.0,0.0,0.0,0.0,0.0,0.0,0.0,0.0,0.0,0.0,0.0,1.0,0.0,0.0,0.0,0.0,0.0,0.0,0.0,1.0,0.0
103648,0,0.0,1.0,1.0,1.0,0.0,270000.0,1779030.0,55350.0,1485000.0,0.020246,53.64657534246575,-5274.0,-11386.0,-3136.0,5.0,2.0,3.0,3.0,8.0,0.5348666289720602,0.325574384491384,,0.0928,0.0876,0.9776,0.6940000000000001,0.0118,0.0,0.2069,0.1667,0.2083,0.0929,0.0748,0.0866,0.0039,0.0034,0.0945,0.0909,0.9777,0.706,0.0119,0.0,0.2069,0.1667,0.2083,0.095,0.0817,0.0902,0.0039,0.0036,0.0937,0.0876,0.9776,0.6981,0.0119,0.0,0.2069,0.1667,0.2083,0.0945,0.0761,0.0881,0.0039,0.0035,0.0753,1.0,0.0,0.0,0.0,0.0,-1380.0,0.0,0.0,0.0,0.0,1.0,2.0,1.0,1.0,0.0,1.0,0.0,1.0,0.0,0.0,0.0,0.0,0.0,0.0,0.0,1.0,0.0,0.0,0.0,0.0,0.0,0.0,0.0,0.0,0.0,0.0,0.0,0.0,0.0,0.0,0.0,0.0,0.0,0.0,5.0,0.0,,360000.0,1345.275,1809.45,0.0,0.0,0.0,-840.0,477.0,-321.0,-364.0,165.0,-17.0,7.0,45000.0,0.0,0.0,0.0,900000.0,12.0,-430.0,365243.0,-400.0,-310.0,650.0,-305.0,8.0,0.0,0.0,-1.0,19.0,12.0,7.0,-37.0,0.0,0.0,41.0,18747.675,18747.675,-310.0,-310.0,8.0,0.0,19.0,243765.18,900000.0,0.0,0.0,0.0,0.0,12149.865,22500.0,22500.0,234361.71,241290.09,241290.09,0.0,0.0,0.0,0.0,2.0,-11.0,0.0,0.0,8350325644.5,184462766716.5,165641588064.0,51993458155.935,1863.0,1705.0,71125.0,70870.0,9140.0,506289.0,17815.868300002287,17878.16149999911,17329.494399998028,11300.359200000095,11238.176300000096,11185.587100000055,128479.0,663115.0,4140.245900000116,4137.931700000017,3948.5042000000935,13533203.90958864,-602218108.0,-922291888.0,-296638924.0,-1535815629.0416667,44033.0,30715.0,11354.541599999187,11230.55999999898,10714.77129999729,22897.59100000972,22819.495000009687,22204.828700008253,67501.5445464546,158105.7585662679,,35016.493700027946,34956.74200002839,34402.176100028795,22964.318099995904,22937.44209999548,22584.20619999572,3715750.0,8299.332400000161,8403.920000000075,8127.4521000002305,9821.724300000717,9936.78680000216,10296.722299999645,16474.867699999748,16660.2890999997,16257.038499999704,828.8727000001766,814.047000000046,759.9696000000133,3915.403500000125,3898.618500000164,3731.24600000016,436641.0,431435.0,1263730.0,6427.681980002898,632231.0,625782.0,,16339.417899999808,154246.54899999066,154249.29559999026,154141.02899998715,77645.6759999963,77983.63030000657,78385.18840000656,28.0,58982800.09499998,,6056593704.585003,1993571727.7950008,68296339.25999998,710189.0099999999,110.0,12249.0,-19619309.0,9062336.0,-10125284.0,-11012519.0,-13.5,0.0,,4500.0,2690.55,1809.45,0.0,0.0,0.0,-1155.0,477.0,-321.0,-364.0,214614249.83999965,3053455622.145004,3437060437.9350014,49084777.70999996,3054355622.145004,221608.0,-15158022.0,3517792628.0,155724493.0,793690584.0,344419021.0,828640739.0,220895.0,3442.0,614.9915571152612,5104658.0,1809270.0,1114568.0,-3630297.0,1241404.0,100912.0,2412489010.9501147,2437431837.480061,-146135846.0,-144931754.0,2598299.0,119623.0,2247586187.5349874,6131610000.0,191524630.23,296439296.0399997,10265426.1,94372318.93499991,128312426.87999956,324916357.5899996,298999582.74000096,2157588178.4249988,2238939816.164984,2239027118.099984,9790.0,25132.0,145.0,15197.0,740154.0,-1325968.0,576343.0,1270.0,1468111.0,14807621.0,3234106.0,8559176.0,11612875.0,1416455.0,1059622980.0795012,,72140098070.47466,21689229834.85512,583082671.3694987,5792665.7475,689.5,94245.0,-277051119.0,22001646.0,-123841150.5,-218803054.0,-2020953.0,5925131239.229961,18731893500.0,198835707.825,448129369.8449976,1948107.735,256879316.90250075,309225282.09749866,636766357.252498,459308299.9499993,5710215183.277535,5888402180.437499,5888645363.1825,13390.5,80889.0,44.0,70393.5,971796.0,-1699280.0,177364.0,6755.0,4274937.0,2480393.5,-9007588.0,921269.0,37582.5,3735427066.559961,3660127985.294962,-260741502.5,-257428741.5,2527602.5,269320.5,3928044901.4099545,33268727046.57841,36698496954.615135,1730241491.9175494,48107409674.06321,3989901.0,-247691223.5,103132779469.5,1054968986.0,17280891353.5,3505272993.5,18894548174.0,3673678.5,71959.0,20879.65954818291,89818520.0,-98.3100965221388,6.589,4.878048780487805,261.6906114266622,32.141463414634146,1724.2794386902772,135000.0,-0.9009688679024191,0.4338837391175582,0.0,0.0,0.0,0.0,0.0,0.0,1.0,0.0,0.0,0.0,0.0,0.0,0.0,1.0,0.0,0.0,0.0,0.0,1.0,0.0,1.0,0.0,0.0,0.0,0.0,1.0,0.0,0.0,0.0,0.0,0.0,0.0,0.0,0.0,1.0,0.0,0.0,0.0,0.0,0.0,0.0,0.0,0.0,0.0,0.0,0.0,0.0,0.0,0.0,0.0,0.0,0.0,0.0,0.0,0.0,0.0,0.0,0.0,0.0,0.0,0.0,0.0,0.0,0.0,0.0,0.0,0.0,0.0,0.0,0.0,0.0,0.0,0.0,0.0,0.0,0.0,0.0,0.0,0.0,0.0,0.0,0.0,0.0,0.0,0.0,0.0,0.0,0.0,0.0,0.0,1.0,0.0,0.0,0.0,0.0,0.0,0.0,0.0,0.0,0.0,0.0,0.0,0.0,0.0,0.0,0.0,0.0,0.0,0.0,1.0,1.0,0.0,0.0,0.0,0.0,0.0,0.0,1.0,0.0,0.0
103651,0,0.0,0.0,0.0,0.0,0.0,103500.0,332946.0,16146.0,238500.0,0.022625,46.18904109589041,-4126.0,-721.0,-397.0,,2.0,2.0,2.0,16.0,0.8989961150358821,0.2420687458963897,0.6279908192952864,0.0825,,0.9767,,,0.0,0.1379,0.1667,,,,0.0684,,0.004,0.084,,0.9767,,,0.0,0.1379,0.1667,,,,0.0712,,0.0043,0.0833,,0.9767,,,0.0,0.1379,0.1667,,,,0.0696,,0.0041,0.0546,1.0,2.0,1.0,2.0,1.0,-121.0,0.0,0.0,0.0,0.0,0.0,0.0,1.0,1.0,0.0,1.0,0.0,1.0,0.0,0.0,0.0,0.0,0.0,0.0,0.0,1.0,0.0,0.0,0.0,0.0,0.0,0.0,0.0,0.0,0.0,0.0,0.0,0.0,0.0,0.0,0.0,0.0,0.0,0.0,4.0,17786.25,,270000.0,0.0,0.0,0.0,0.0,0.0,-1430.0,-626.5,-655.5,-1007.0,206.0,-25.0,3.0,20741.49,157446.0,151051.5,8271.0,157446.0,10.0,-2227.0,365243.0,-1242.0,181500.0,-1032.0,181503.5,14.0,0.0,0.1028092885908673,34.0,30.0,20.0,7.5,-81.5,0.0,0.0,33.0,10894.095,10894.095,-2499.0,-2499.0,7.0,1.0,0.0,,,,,,,,,,,,,,,,,,,,,8350341790.5,184463099662.5,165641826564.0,51993561655.935,1863.0,1705.0,71125.0,70870.0,9140.0,506289.0,17815.950800002287,17878.24479999911,17329.578399998027,,,,128479.0,663117.0,,,,13533250.098629735,-602222234.0,-922292285.0,-296639045.0,-1535816350.0416667,44034.0,30716.0,11354.541599999187,11230.55999999898,10714.77129999729,22897.728900009726,22819.63290000969,22204.96660000825,67502.44354256964,158106.0006350138,126160.7827330297,35016.660400027955,34956.90870002839,34402.342800028804,,,,3715766.0,,,,,,,16474.936099999748,16660.3586999997,16257.109699999704,,,,3915.407500000125,3898.622600000164,3731.25030000016,436643.0,431437.0,,6427.704605002898,632233.0,625784.0,,16339.472499999803,154247.52569999066,154250.27229999026,154142.00569998714,,,,47.5,59041223.59499998,,6063762423.960003,1995806976.7950008,68296339.25999998,710189.0099999999,110.0,12249.0,-19633032.0,9064472.0,-10132197.5,-11020843.0,-23.25,0.0,,202500.0,0.0,0.0,0.0,0.0,0.0,-1832.0,-736.0,-743.0,-1007.0,214773852.64499968,3057367503.645004,3440672898.4350014,49130277.20999996,3057367503.645004,221830.0,-15178733.0,3521992518.5,156076907.5,795142230.5,344776549.5,830092416.0,221132.0,3445.0,616.1081122574989,5106996.0,1810787.0,1115405.0,-3635353.5,1241404.0,100912.0,2414205555.4801173,2439576593.820064,-146291319.0,-145085744.0,2599128.0,119733.0,,,,,,,,,,,,,,,,,,,,,1468115.0,14807827.0,3234106.0,8559206.0,11612908.0,1416458.0,1059640766.3295012,,72140368070.47466,21689229834.85512,583082671.3694987,5792665.7475,689.5,94245.0,-277052549.0,22001019.5,-123841806.0,-218804061.0,-2020978.0,,,,,,,,,,,,,,,,,,,,,4274957.0,2480401.0,-9007669.5,921269.0,37582.5,3735437960.654961,3660138879.389961,-260744001.5,-257431240.5,2527609.5,269321.5,3928065642.899955,33268884492.57841,36698648006.115135,1730249762.9175494,48107567120.06321,3989911.0,-247693450.5,103133144712.5,1054967744.0,17281072853.5,3505271961.5,18894729677.5,3673692.5,71959.0,20879.7623574715,89818554.0,-89.32854854973604,3.216869565217391,6.410256410256411,296.0835967685283,20.62095875139353,952.4623112047768,51750.0,-0.2225209339563143,0.9749279121818236,0.0,0.0,0.0,0.0,0.0,0.0,1.0,0.0,1.0,0.0,0.0,0.0,0.0,0.0,0.0,0.0,0.0,0.0,1.0,0.0,1.0,0.0,0.0,0.0,0.0,1.0,0.0,0.0,0.0,0.0,0.0,0.0,0.0,0.0,0.0,0.0,0.0,0.0,0.0,0.0,0.0,1.0,0.0,0.0,0.0,0.0,0.0,0.0,0.0,0.0,0.0,0.0,0.0,0.0,0.0,0.0,0.0,0.0,0.0,0.0,0.0,0.0,0.0,0.0,0.0,0.0,0.0,0.0,0.0,0.0,0.0,0.0,0.0,0.0,0.0,0.0,0.0,0.0,1.0,0.0,0.0,0.0,0.0,0.0,0.0,0.0,0.0,0.0,0.0,0.0,0.0,0.0,0.0,0.0,0.0,0.0,0.0,0.0,0.0,0.0,0.0,0.0,0.0,0.0,0.0,0.0,0.0,0.0,0.0,0.0,1.0,0.0,0.0,0.0,0.0,0.0,0.0,0.0,0.0,0.0
103658,0,0.0,0.0,0.0,1.0,0.0,135000.0,247500.0,17599.5,247500.0,0.006207,62.95890410958904,-7596.0,-11525.0,-4200.0,,2.0,2.0,2.0,9.0,0.8342558764319994,0.3701963140925916,0.5495965024956946,0.1113,0.018,0.9841,0.7824,0.001,0.12,0.1034,0.3333,0.375,0.0709,0.0899,0.0735,0.0039,0.0026,0.1134,0.0187,0.9841,0.7909,0.001,0.1208,0.1034,0.3333,0.375,0.0726,0.0983,0.0766,0.0039,0.0027,0.1124,0.018,0.9841,0.7853,0.001,0.12,0.1034,0.3333,0.375,0.0722,0.0915,0.0749,0.0039,0.0026,0.0883,1.0,0.0,0.0,0.0,0.0,-2163.0,0.0,0.0,0.0,0.0,0.0,1.0,1.0,1.0,1.0,1.0,1.0,0.0,0.0,0.0,0.0,0.0,0.0,0.0,0.0,1.0,0.0,0.0,0.0,0.0,0.0,0.0,0.0,0.0,0.0,0.0,0.0,0.0,0.0,0.0,0.0,0.0,0.0,0.0,3.0,13099.5,,180000.0,0.0,0.0,0.0,0.0,0.0,-373.0,175.0,-10.0,-1080.0,111.0,-36.0,3.0,11209.5,100791.0,112432.5,2250.0,100791.0,14.0,-1992.0,365243.0,-2046.5,-1686.5,-1686.5,-1671.0,14.0,0.0,0.0566939567460129,50.0,29.0,14.0,6.0,-61.0,0.0,0.0,29.0,11185.245,4773.33,-1985.0,-1841.0,8.0,1.0,0.0,,,,,,,,,,,,,,,,,,,,,8350359390.0,184463347162.5,165642074064.0,51993696655.935,1863.0,1705.0,71125.0,70870.0,9140.0,506290.0,17816.062100002287,17878.357199999107,17329.691799998025,11300.377200000095,11238.194300000096,11185.605800000056,128479.0,663119.0,4140.246900000117,4137.932700000017,3948.505200000093,13533313.057533847,-602229830.0,-922296485.0,-296641208.0,-1535827875.0416667,44034.0,30716.0,11354.661599999186,11230.679999998982,10714.89209999729,22897.83230000973,22819.73630000969,22205.07000000825,67503.27779844607,158106.3708313279,126161.3323295322,35016.993700027946,34957.24200002839,34402.676100028795,22964.693099995904,22937.81709999548,22584.58119999572,3715775.0,8299.403300000162,8403.992200000075,8127.524700000232,9821.814200000716,9936.87830000216,10296.820599999644,16475.00959999975,16660.4335999997,16257.186299999705,828.8766000001765,814.0509000000459,759.9735000000132,3915.410100000125,3898.625200000164,3731.25300000016,436643.0,431437.0,,6427.710812002898,632235.0,625786.0,,16339.560799999805,154248.50979999066,154251.25639999026,154142.98979998718,77646.45839999629,77984.41560000657,78385.97930000657,13.0,59253568.15499998,,6077538095.175003,1999838973.9600005,68329342.84499997,710189.0099999999,111.0,12249.0,-19666366.0,9100001.0,-10144190.0,-11035164.5,-6.0,0.0,,62262.0,0.0,0.0,0.0,0.0,0.0,-2796.0,-1971.0,-8.0,-1971.0,215117926.6049997,3061252200.645004,3445789938.4350014,49199446.70999996,3061252200.645004,222116.0,-15201189.0,3527103701.5,156791321.5,795860626.5,345865032.5,831176781.0,221445.0,3448.0,617.1057194653038,5121753.0,1812782.0,1116805.0,-3639984.0,1241404.0,100912.0,2420383856.445112,2445545311.33506,-146503730.0,-145296621.0,2603502.0,119853.0,,,,,,,,,,,,,,,,,,,,,1468118.0,14807938.0,3234106.0,8559235.0,11612937.0,1416461.0,1059653865.8295012,,72140548070.47466,21689229834.85512,583082671.3694987,5792665.7475,689.5,94245.0,-277052922.0,22001194.5,-123841816.0,-218805141.0,-2021014.0,,,,,,,,,,,,,,,,,,,,,4274971.0,2480407.0,-9007730.5,921269.0,37582.5,3735449145.899961,3660143652.719961,-260745986.5,-257433081.5,2527617.5,269322.5,3928076852.399955,33268985283.57841,36698760438.615135,1730252012.9175494,48107667911.06321,3989925.0,-247695442.5,103133509955.5,1054965697.5,17281071167.0,3505270275.0,18894728006.5,3673706.5,71959.0,20879.819051428247,89818604.0,-120.65013054830288,1.8333333333333333,7.670672462285861,482.9371320091207,14.062899514190743,885.3847420167215,67500.0,-0.9009688679024191,-0.433883739117558,0.0,0.0,0.0,0.0,0.0,0.0,1.0,0.0,0.0,0.0,0.0,0.0,0.0,1.0,0.0,1.0,0.0,0.0,0.0,0.0,1.0,0.0,0.0,0.0,0.0,1.0,0.0,0.0,0.0,0.0,0.0,0.0,0.0,1.0,0.0,0.0,0.0,0.0,0.0,0.0,0.0,0.0,0.0,0.0,0.0,0.0,0.0,0.0,0.0,0.0,0.0,0.0,0.0,0.0,0.0,0.0,0.0,0.0,0.0,0.0,0.0,0.0,0.0,0.0,0.0,0.0,0.0,0.0,0.0,0.0,0.0,0.0,0.0,0.0,0.0,0.0,0.0,0.0,1.0,0.0,0.0,0.0,0.0,0.0,0.0,0.0,0.0,0.0,0.0,0.0,0.0,0.0,0.0,0.0,0.0,0.0,0.0,0.0,0.0,0.0,0.0,0.0,0.0,0.0,0.0,0.0,0.0,0.0,1.0,0.0,1.0,0.0,0.0,0.0,0.0,0.0,0.0,1.0,0.0,0.0
103668,0,0.0,0.0,1.0,1.0,0.0,225000.0,450000.0,32877.0,450000.0,0.0145199999999999,36.895890410958906,-1563.0,-681.0,-665.0,3.0,2.0,2.0,2.0,10.0,0.5067734709752272,0.6338207709387748,0.3996756156233169,0.2268,,0.9901,,,0.16,0.1379,0.4583,,,,0.1292,,0.3565,0.2311,,0.9901,,,0.1611,0.1379,0.4583,,,,0.1346,,0.3774,0.229,,0.9901,,,0.16,0.1379,0.4583,,,,0.1315,,0.364,0.1791,1.0,1.0,0.0,1.0,0.0,-2537.0,0.0,0.0,0.0,0.0,1.0,7.0,1.0,1.0,0.0,1.0,0.0,0.0,0.0,0.0,0.0,0.0,0.0,0.0,0.0,1.0,0.0,0.0,0.0,0.0,0.0,0.0,0.0,0.0,0.0,0.0,0.0,0.0,0.0,0.0,0.0,0.0,0.0,0.0,14.0,15027.75,0.0,339750.0,0.0,0.0,0.0,0.0,0.0,-653.5,106.0,-332.5,-476.0,304.0,-11.0,21.0,18088.29,0.0,0.0,2250.0,452250.0,36.0,-381.0,365243.0,-1051.0,-916.0,-1.0,-910.5,12.0,0.5,0.087308875187663,-1.0,34.0,6.0,4.0,-46.0,0.0,0.0,51.0,4847.625,4847.625,-625.0,-625.0,5.0,1.0,20.0,0.0,0.0,0.0,0.0,0.0,0.0,0.0,46.53,46.53,0.0,0.0,0.0,0.0,0.0,0.0,0.0,1.0,-11.5,0.0,0.0,8350392267.0,184463797162.5,165642524064.0,51993921655.935,1863.0,1705.0,71125.0,70871.0,9140.0,506297.0,17816.288900002288,17878.58619999911,17329.922899998026,,,,128479.0,663121.0,,,,13533349.953424258,-602231393.0,-922297150.0,-296643745.0,-1535828556.0416667,44034.0,30716.0,11354.821599999186,11230.839999998982,10715.05319999729,22897.970200009728,22819.874200009694,22205.20790000825,67503.78457191704,158107.00465209884,126161.73200514785,35017.45200002795,34957.70030002839,34403.1344000288,,,,3715785.0,,,,,,,16475.138799999746,16660.565099999698,16257.320899999704,,,,3915.766600000125,3898.989200000164,3731.63040000016,436644.0,431438.0,1263733.0,6427.725332002898,632237.0,625788.0,,16339.739899999804,154249.49989999065,154252.24649999026,154143.97989998714,,,,22.0,59386043.65499998,23024620.395,6097749014.565003,2007276692.1750004,68927968.03499997,710189.0099999999,111.0,12249.0,-19704622.0,9119918.0,-10163184.5,-11054141.0,-10.5,12730.5,0.0,173250.0,0.0,0.0,0.0,0.0,0.0,-807.0,-418.0,-473.0,-688.0,215597193.7949997,3071820950.145004,3457330354.9350014,49272954.20999996,3070155950.145004,222728.0,-15243612.0,3534587347.0,157125927.5,797665688.5,347128027.5,833165551.5,221985.0,3461.0,618.7644252123115,5127963.0,1819172.0,1120231.0,-3653580.0,1363748.0,100917.0,2429584274.970097,2455496342.3700514,-146929408.0,-145717602.0,2611782.0,120137.0,2286408041.8649893,6185565000.0,193942480.23,299617277.30999976,10265426.1,95131776.1499999,130306647.59999956,329190407.5949995,303114319.96500075,2195108487.045001,2277769520.5199857,2277856822.4549856,9953.0,25404.0,145.0,15306.0,745655.5,-1332600.5,576377.0,1275.0,1468132.0,14808242.0,3234126.0,8559269.0,11612988.0,1416482.0,1059668893.5795012,801779241.1724951,72140887820.47466,21689229834.85512,583082671.3694987,5792665.7475,689.5,94245.0,-277053575.5,22001300.5,-123842148.5,-218805617.0,-2021025.0,5925131239.229961,18731893500.0,198835707.825,448129369.8449976,1948107.735,256879316.90250075,309225282.09749866,636766403.782498,459308346.4799993,5710215183.277535,5888402180.437499,5888645363.1825,13390.5,80889.0,44.0,70393.5,971797.0,-1699291.5,177364.0,6755.0,4274977.0,2480411.0,-9007776.5,921269.0,37582.5,3735453993.524961,3660148500.344961,-260746611.5,-257433706.5,2527622.5,269323.5,3928094940.6899543,33268985283.57841,36698760438.615135,1730254262.9175494,48108120161.06321,3989961.0,-247695823.5,103133875198.5,1054964646.5,17281070251.0,3505270274.0,18894727096.0,3673718.5,71959.5,20879.906360303437,89818603.0,-42.362441523724655,2.0,6.84369011771147,252.5040405896449,13.68738023542294,505.0080811792897,112500.0,-0.9009688679024191,0.4338837391175582,0.0,0.0,0.0,0.0,0.0,0.0,1.0,0.0,0.0,0.0,0.0,0.0,0.0,1.0,0.0,0.0,0.0,0.0,1.0,0.0,1.0,0.0,0.0,0.0,0.0,1.0,0.0,0.0,0.0,0.0,0.0,0.0,0.0,0.0,0.0,0.0,0.0,0.0,1.0,0.0,0.0,0.0,0.0,0.0,0.0,0.0,0.0,0.0,0.0,0.0,0.0,0.0,0.0,0.0,0.0,0.0,0.0,0.0,0.0,0.0,0.0,0.0,0.0,0.0,0.0,0.0,0.0,0.0,0.0,0.0,0.0,0.0,0.0,0.0,0.0,0.0,0.0,0.0,0.0,0.0,0.0,0.0,0.0,0.0,0.0,0.0,0.0,0.0,0.0,0.0,1.0,0.0,0.0,0.0,0.0,0.0,0.0,0.0,0.0,0.0,0.0,0.0,0.0,0.0,0.0,0.0,0.0,0.0,0.0,0.0,0.0,0.0,0.0,0.0,0.0,0.0,0.0,1.0,0.0,0.0
103669,0,0.0,0.0,0.0,0.0,0.0,135000.0,499500.0,36346.5,499500.0,0.010276,27.383561643835613,-1560.0,-2698.0,-1266.0,,2.0,2.0,2.0,16.0,0.6226090210144132,0.6386741767078266,0.5709165417729987,0.0993,0.0539,0.9896,0.8572,0.0327,0.1064,0.0803,0.3471,0.3888,0.0555,0.081,0.1083,0.0,0.0,0.021,0.0559,0.9871,0.8301,0.033,0.0403,0.0345,0.3333,0.375,0.0135,0.0184,0.0285,0.0,0.0,0.0833,0.0539,0.9906,0.8725,0.0329,0.08,0.0345,0.3333,0.375,0.0356,0.0684,0.0873,0.0,0.0,0.1666,1.0,3.0,0.0,3.0,0.0,-1225.0,0.0,0.0,0.0,0.0,0.0,4.0,1.0,1.0,0.0,1.0,1.0,0.0,0.0,0.0,0.0,0.0,0.0,0.0,0.0,1.0,0.0,0.0,0.0,0.0,0.0,0.0,0.0,0.0,0.0,0.0,0.0,0.0,0.0,0.0,0.0,0.0,0.0,0.0,4.0,42286.5,0.0,354487.5,451795.5,0.0,0.0,0.0,0.0,-1264.0,-29.5,-253.0,-734.0,160.0,-19.5,11.0,11250.0,122517.0,122517.0,0.0,225000.0,0.0,-482.0,365243.0,-621.0,182301.5,-111.0,182315.5,16.0,0.0,0.0,-1.0,36.0,18.0,12.5,-21.5,0.0,0.0,58.0,9166.725,9166.725,-265.0,-256.0,8.0,1.0,11.0,157816.485,207000.0,4500.0,13058.64,0.0,0.0,8306.46,13571.505,4657.86,154343.07,156245.985,156245.985,1.0,2.0,0.0,0.0,4.0,-6.0,0.0,0.0,8350428613.5,184464296662.5,165643023564.0,51994056655.935,1863.0,1705.0,71125.0,70871.0,9140.0,506301.0,17816.38820000229,17878.66949999911,17329.943899998027,11300.431100000094,11238.248200000096,11185.661700000055,128479.0,663123.0,4140.279600000116,4137.965600000017,3948.538200000093,13533377.336985905,-602232953.0,-922298416.0,-296644970.0,-1535831254.0416667,44034.0,30716.0,11354.927999999189,11230.91999999898,10715.09349999729,22898.050500009733,22819.90870000969,22205.242400008254,67504.40718093804,158107.64332627557,126162.3029216896,35017.79910002795,34958.033600028386,34403.4677000288,22965.081899995905,22938.19209999548,22584.95619999572,3715801.0,8299.458800000162,8404.027800000074,8127.538200000232,9821.895200000718,9936.94670000216,10296.838999999643,16475.247099999746,16660.652399999693,16257.349399999704,828.8766000001765,814.0509000000459,759.9735000000132,3915.766600000125,3898.989200000164,3731.63040000016,436647.0,431441.0,,6427.735608002898,632239.0,625790.0,,16339.906499999805,154250.48949999065,154253.23709999025,154144.96699998714,77647.31559999629,77985.28810000657,78386.80940000658,42.0,59476723.15499998,23024620.395,6102998841.195004,2007827021.9250004,68927968.03499997,710189.0099999999,111.0,12249.0,-19711650.5,9120918.0,-10166010.5,-11057612.0,-20.5,42286.5,0.0,258975.0,451795.5,0.0,0.0,0.0,0.0,-1264.0,114.0,-33.0,-992.0,215777552.3549997,3073122467.145004,3458669865.4350014,49272954.20999996,3073350158.145004,222884.0,-15250904.0,3535865054.5,157122195.0,798028799.0,347674994.0,833710737.5,222170.0,3462.0,618.7644252123115,5130123.0,1819942.0,1120873.0,-3654642.0,1363748.0,100917.0,2430663022.5076,2456665199.9325533,-146952533.5,-145740421.0,2612372.5,120159.5,2287739146.0499897,6189138000.0,194219230.23,300471758.4149997,10265426.1,95709507.25499988,130347393.74999955,330087923.5949993,303967898.86500055,2196421148.115001,2279093180.174986,2279180482.109986,9963.0,25456.0,145.0,15348.0,745686.0,-1332772.0,576377.0,1275.0,1468136.0,14808402.0,3234137.0,8559305.0,11613046.0,1416493.0,1059711180.0795012,801779241.1724951,72141242307.97466,21689681630.35512,583082671.3694987,5792665.7475,689.5,94245.0,-277054839.5,22001271.0,-123842401.5,-218806351.0,-2021044.5,5925289055.714961,18732100500.0,198840207.825,448142428.4849976,1948107.735,256879316.90250075,309233588.55749863,636779975.287498,459313004.3399993,5710369526.347533,5888558426.4225,5888801609.1675,13391.5,80891.0,44.0,70393.5,971801.0,-1699297.5,177364.0,6755.0,4274995.0,2480423.5,-9007798.0,921269.0,37582.5,3735463160.249961,3660157667.069961,-260746876.5,-257433962.5,2527630.5,269324.5,3928106190.6899543,33269107800.57841,36698882955.615135,1730254262.9175494,48108345161.06321,3989961.0,-247696305.5,103134240441.5,1054964025.5,17281252552.5,3505270163.0,18894909411.5,3673734.5,71959.5,20879.906360303437,89818602.0,-56.968484242121065,3.7,3.714250340472948,101.7094031589784,13.742726259749908,376.32479168822016,67500.0,1.0,0.0,0.0,0.0,0.0,0.0,0.0,0.0,1.0,0.0,0.0,0.0,0.0,0.0,0.0,1.0,0.0,0.0,0.0,0.0,1.0,0.0,1.0,0.0,0.0,0.0,0.0,0.0,1.0,0.0,0.0,0.0,0.0,0.0,0.0,0.0,0.0,0.0,0.0,0.0,1.0,0.0,0.0,0.0,0.0,0.0,0.0,0.0,0.0,0.0,0.0,0.0,0.0,0.0,0.0,0.0,0.0,0.0,0.0,0.0,0.0,0.0,0.0,0.0,1.0,0.0,0.0,0.0,0.0,0.0,0.0,0.0,0.0,0.0,0.0,0.0,0.0,0.0,0.0,0.0,0.0,0.0,0.0,0.0,0.0,0.0,0.0,0.0,0.0,0.0,0.0,0.0,0.0,0.0,0.0,0.0,0.0,0.0,0.0,0.0,0.0,0.0,0.0,0.0,0.0,0.0,0.0,0.0,0.0,0.0,1.0,0.0,1.0,0.0,0.0,0.0,0.0,0.0,0.0,1.0,0.0,0.0
103676,0,0.0,0.0,0.0,1.0,0.0,103500.0,112500.0,6412.5,112500.0,0.0228,58.13698630136986,-2927.0,-47.0,-3385.0,,1.0,2.0,2.0,9.0,,0.5258154561575856,0.4686596550493113,0.1402,0.0611,0.993,0.9048,0.0211,0.0,0.3448,0.1667,0.2083,0.1381,0.1126,0.1223,0.0077,0.0135,0.1429,0.0634,0.993,0.9085,0.0213,0.0,0.3448,0.1667,0.2083,0.1412,0.123,0.1274,0.0078,0.0143,0.1416,0.0611,0.993,0.9061,0.0212,0.0,0.3448,0.1667,0.2083,0.1405,0.1146,0.1245,0.0078,0.0138,0.1086,1.0,1.0,0.0,1.0,0.0,-859.0,0.0,0.0,0.0,0.0,1.0,1.0,1.0,1.0,0.0,1.0,0.0,0.0,0.0,0.0,0.0,0.0,0.0,0.0,0.0,1.0,0.0,0.0,0.0,0.0,0.0,0.0,0.0,0.0,0.0,0.0,0.0,0.0,0.0,0.0,0.0,0.0,0.0,0.0,11.0,4414.5,0.0,117000.0,79965.0,0.0,0.0,0.0,0.0,-1091.0,4.0,-135.0,-1101.0,299.0,-16.0,2.0,4496.67,41717.25,41717.25,0.0,41717.25,3.0,-368.0,182439.0,-332.5,-257.0,182527.5,-191.0,10.0,0.0,0.0,144.0,6.0,6.0,3.0,-9.5,0.0,0.0,16.0,1709.9775,1709.9775,-307.0,-301.0,4.5,0.0,11.0,0.0,0.0,0.0,0.0,0.0,0.0,0.0,0.0,0.0,0.0,0.0,0.0,0.0,0.0,0.0,0.0,2.0,-7.0,0.0,0.0,8350435026.0,184464409162.5,165643136064.0,51994160155.935,1863.0,1705.0,71125.0,70872.0,9140.0,506302.0,17816.52840000229,17878.811099999108,17330.086799998026,11300.492200000095,11238.309300000095,11185.725100000054,128479.0,663124.0,4140.300700000116,4137.986800000017,3948.5595000000935,13533435.473972203,-602235880.0,-922301801.0,-296645829.0,-1535831301.0416667,44034.0,30716.0,11354.927999999189,11230.91999999898,10715.09349999729,22898.395300009728,22820.25350000969,22205.587200008253,,158108.1691417317,126162.77158134464,35017.96580002795,34958.20030002839,34403.6344000288,22965.290199995903,22938.400399995484,22585.16449999572,3715810.0,8299.596900000162,8404.168300000074,8127.679400000232,9822.007800000718,9937.061300002162,10296.961999999645,16475.369399999745,16660.7768999997,16257.476799999704,828.8843000001765,814.058700000046,759.9813000000132,3915.780100000125,3899.003000000164,3731.64470000016,436648.0,431442.0,,6427.758408002896,632241.0,625792.0,,16340.015099999804,154251.48249999064,154254.2300999902,154145.95999998716,77648.2203999963,77986.19420000656,78387.71790000657,36.0,59492250.40499998,23052677.895,6105393972.900003,2008537484.1750004,68927968.03499997,710189.0099999999,111.0,12249.0,-19734924.0,9120993.0,-10180978.0,-11069182.0,-17.5,4414.5,0.0,117000.0,79965.0,0.0,0.0,0.0,0.0,-1091.0,4.0,-778.0,-1101.0,215988979.00499973,3075970175.145004,3461533449.4350014,49376679.20999996,3075970175.145004,223054.0,-15269123.0,3541160895.5,157109475.5,799845511.0,347849785.5,835527597.5,222478.0,3463.0,619.6246977260787,5138024.0,1822128.0,1122124.0,-3658381.5,1363748.0,100917.0,2432802189.420105,2458763098.5150585,-147066538.0,-145853069.0,2613434.5,120327.0,2288455377.8849897,6190317000.0,194327230.23,300722563.4399997,10265426.1,95852312.2799999,130377706.51499955,330195280.36499923,304040696.1750005,2197123518.690001,2279802550.409985,2279889852.344985,9968.0,25477.0,145.0,15364.0,745719.0,-1332845.0,576377.0,1275.0,1468147.0,14808701.0,3234148.0,8559311.0,11613062.0,1416495.0,1059715594.5795012,801779241.1724951,72141359307.97466,21689761595.35512,583082671.3694987,5792665.7475,689.5,94245.0,-277055930.5,22001275.0,-123842536.5,-218807452.0,-2021060.5,5925289055.714961,18732100500.0,198840207.825,448142428.4849976,1948107.735,256879316.90250075,309233588.55749863,636779975.287498,459313004.3399993,5710369526.347533,5888558426.4225,5888801609.1675,13391.5,80891.0,44.0,70393.5,971803.0,-1699304.5,177364.0,6755.0,4275001.0,2480426.5,-9007807.5,921269.0,37582.5,3735464870.227461,3660159377.047461,-260747183.5,-257434263.5,2527635.0,269324.5,3928110687.359955,33269149517.82841,36698924672.865135,1730254262.9175494,48108386878.31321,3989964.0,-247696673.5,103134422880.5,1054963693.0,17281252295.5,3505452690.5,18894909220.5,3673744.5,71959.5,20879.906360303437,89818746.0,-50.34660697455232,1.0869565217391304,16.140350877192983,938.3513578466716,17.543859649122812,1019.9471280942082,103500.0,-0.2225209339563143,0.9749279121818236,0.0,0.0,0.0,0.0,0.0,0.0,1.0,0.0,0.0,0.0,0.0,0.0,0.0,1.0,0.0,0.0,0.0,0.0,1.0,0.0,0.0,0.0,0.0,1.0,0.0,1.0,0.0,0.0,0.0,0.0,0.0,0.0,0.0,0.0,0.0,0.0,0.0,0.0,0.0,0.0,0.0,0.0,0.0,0.0,1.0,0.0,0.0,0.0,0.0,0.0,0.0,0.0,0.0,0.0,0.0,0.0,0.0,0.0,0.0,0.0,0.0,0.0,0.0,0.0,0.0,0.0,0.0,0.0,0.0,0.0,0.0,0.0,0.0,0.0,0.0,0.0,0.0,0.0,0.0,0.0,0.0,0.0,0.0,0.0,0.0,0.0,0.0,0.0,0.0,0.0,1.0,0.0,0.0,0.0,0.0,0.0,0.0,0.0,0.0,0.0,0.0,0.0,0.0,0.0,0.0,0.0,0.0,0.0,1.0,0.0,1.0,0.0,0.0,0.0,0.0,0.0,0.0,0.0,1.0,0.0
103682,0,0.0,0.0,0.0,1.0,0.0,247500.0,439740.0,22581.0,315000.0,0.025164,47.47397260273973,-2524.0,-7427.0,-875.0,,2.0,2.0,2.0,13.0,,0.6180940120107127,0.2910973802776635,,,,,,,,,,,,,,,,,,,,,,,,,,,,,,,,,,,,,,,,,,,,,0.0,0.0,0.0,0.0,-1748.0,0.0,0.0,0.0,0.0,0.0,5.0,1.0,1.0,0.0,1.0,0.0,0.0,0.0,0.0,0.0,0.0,1.0,1.0,0.0,1.0,0.0,0.0,0.0,0.0,0.0,0.0,0.0,0.0,0.0,0.0,0.0,0.0,0.0,0.0,0.0,0.0,0.0,0.0,9.0,0.0,0.0,180000.0,0.0,0.0,0.0,0.0,0.0,-1034.0,-575.0,-444.0,-695.5,336.0,-20.5,9.0,8575.7625,33066.0,26793.0,7850.25,45135.0,6.0,-221.0,365243.0,-1057.0,-907.0,-907.0,-898.0,12.0,0.0,0.1050600753669938,41.0,44.0,6.0,3.0,-32.5,0.0,0.0,35.0,9518.22,9518.22,-743.0,-722.0,3.0,1.0,0.0,,,,,,,,,,,,,,,,,,,,,8350457607.0,184464848902.5,165643451064.0,51994407655.935,1863.0,1705.0,71125.0,70872.0,9140.0,506307.0,,,,,,,128479.0,663126.0,,,,13533482.947944809,-602238404.0,-922302676.0,-296647577.0,-1535838728.0416667,44034.0,30716.0,,,,,,,,158108.78723574374,126163.06267872492,,,,,,,3715823.0,,,,,,,,,,,,,,,,436648.0,431442.0,,6427.783572002897,632243.0,625794.0,,,,,,,,,35.0,59560710.52499998,23070215.744999997,6111494730.225004,2009965455.5400004,69290218.03499997,710189.0099999999,111.0,12249.0,-19798428.0,9115809.0,-10218603.0,-11109541.5,-17.0,0.0,0.0,129600.0,0.0,0.0,0.0,0.0,0.0,-1792.0,-720.0,-720.0,-720.0,216160178.5799997,3077685404.145004,3463317451.9350014,49464420.20999996,3077630729.145004,223222.0,-15280401.0,3546091493.5,157099109.5,800750752.0,348026839.5,836432962.5,222696.0,3465.5,621.2340674112747,5144591.0,1824166.0,1123285.0,-3661617.5,1363752.0,100918.0,2435127020.190097,2460790642.005057,-147163097.0,-145947620.0,2614593.0,120473.0,,,,,,,,,,,,,,,,,,,,,1468156.0,14809037.0,3234148.0,8559355.0,11613097.0,1416504.0,1059715594.5795012,801779241.1724951,72141539307.97466,21689761595.35512,583082671.3694987,5792665.7475,689.5,94245.0,-277056964.5,22000700.0,-123842980.5,-218808147.5,-2021081.0,,,,,,,,,,,,,,,,,,,,,4275007.0,2480429.5,-9007840.0,921269.0,37582.5,3735474388.447461,3660168895.267461,-260747926.5,-257434985.5,2527638.0,269325.5,3928119263.122455,33269182583.82841,36698951465.865135,1730262113.1675494,48108432013.31321,3989970.0,-247696894.5,103134788123.5,1054962636.0,17281251388.5,3505451783.5,18894908322.5,3673756.5,71959.5,20880.0114203788,89818787.0,-53.16597414589104,1.7767272727272727,10.96054204862495,520.3404729275976,19.473893981666,924.50310935427,123750.0,0.6234898018587336,0.7818314824680298,0.0,0.0,0.0,0.0,0.0,0.0,1.0,0.0,0.0,0.0,1.0,0.0,0.0,0.0,0.0,1.0,0.0,0.0,0.0,0.0,1.0,0.0,0.0,0.0,0.0,1.0,0.0,0.0,0.0,0.0,0.0,0.0,0.0,1.0,0.0,0.0,0.0,0.0,0.0,0.0,0.0,0.0,0.0,0.0,0.0,0.0,0.0,0.0,0.0,0.0,0.0,0.0,0.0,0.0,0.0,0.0,0.0,0.0,0.0,0.0,0.0,0.0,0.0,0.0,0.0,0.0,0.0,0.0,0.0,0.0,0.0,0.0,0.0,0.0,0.0,0.0,0.0,0.0,0.0,0.0,0.0,0.0,0.0,0.0,0.0,0.0,0.0,1.0,0.0,0.0,0.0,0.0,0.0,0.0,0.0,0.0,0.0,0.0,0.0,0.0,0.0,0.0,0.0,0.0,0.0,0.0,0.0,0.0,0.0,0.0,0.0,0.0,0.0,0.0,0.0,0.0,0.0,0.0,0.0,0.0
103683,0,0.0,0.0,0.0,0.0,0.0,45000.0,49752.0,5224.5,45000.0,0.01885,63.13972602739726,,-1086.0,-757.0,,1.0,2.0,2.0,9.0,,0.5842713420092128,0.4974688893052743,0.1557,0.0811,0.9752,0.66,0.0157,0.0,0.3103,0.1667,0.2083,0.0796,0.121,0.1226,0.027,0.1479,0.1586,0.0841,0.9752,0.6733,0.0159,0.0,0.3103,0.1667,0.2083,0.0814,0.1322,0.1277,0.0272,0.1566,0.1572,0.0811,0.9752,0.6645,0.0158,0.0,0.3103,0.1667,0.2083,0.081,0.1231,0.1248,0.0272,0.151,0.1372,1.0,2.0,1.0,1.0,1.0,-430.0,0.0,0.0,0.0,0.0,1.0,0.0,1.0,0.0,0.0,1.0,0.0,0.0,0.0,0.0,0.0,0.0,0.0,0.0,0.0,0.0,0.0,0.0,1.0,0.0,0.0,0.0,0.0,0.0,0.0,0.0,0.0,0.0,0.0,0.0,0.0,0.0,0.0,0.0,3.0,3213.0,,13500.0,0.0,,0.0,0.0,0.0,-154.0,-100.0,-100.0,-131.0,13.0,-2.0,1.0,3100.68,13635.0,14445.0,0.0,13635.0,6.0,-430.0,365243.0,-400.0,-280.0,-250.0,-278.0,11.0,1.0,0.0,160.0,6.0,6.0,3.5,-11.5,0.0,0.0,5.0,3100.68,3100.68,-372.0,-340.0,3.0,1.0,0.0,,,,,,,,,,,,,,,,,,,,,8350462831.5,184464898654.5,165643496064.0,51994452655.935,1863.0,1705.0,71125.0,70873.0,9140.0,506307.0,17816.68410000229,17878.96829999911,17330.245399998024,11300.573300000096,11238.390400000097,11185.809200000054,128479.0,663127.0,4140.316400000116,4138.002600000017,3948.575400000093,13533546.087670837,,-922303433.0,-296648007.0,-1535839814.0416667,44035.0,30717.0,11354.927999999189,11230.91999999898,10715.09349999729,22898.705600009733,22820.56380000969,22205.897500008254,,158109.3715070857,126163.56014761422,35018.132500027954,34958.36700002839,34403.801100028795,22965.498499995894,22938.60869999548,22585.372799995712,3715832.0,8299.676500000161,8404.249300000074,8127.760800000232,9822.128800000715,9937.184400002165,10297.094199999645,16475.491999999744,16660.9016999997,16257.604499999705,828.9113000001765,814.085900000046,760.0085000000133,3915.928000000125,3899.154000000164,3731.8013000001592,436650.0,431443.0,,6427.8024220028965,632245.0,625796.0,,16340.152299999803,154252.45769999066,154255.2052999902,154146.93519998714,77648.8803999963,77986.85870000656,78388.39120000658,6.0,59603073.52499998,,6113272230.225004,2010687255.5400004,,710189.0099999999,111.0,12249.0,-19801409.0,9116067.0,-10219977.0,-11111165.0,-2.5,3213.0,,13500.0,0.0,,0.0,0.0,0.0,-154.0,-100.0,-100.0,-131.0,216186175.34999976,3077780511.645004,3463408419.4350014,49478037.20999996,3077780511.645004,223244.0,-15285338.0,3547369844.0,157094381.0,800930190.0,348022666.0,836612418.0,222755.0,3468.0,621.4923476091242,5145132.0,1824339.0,1123391.5,-3662683.5,1363752.0,100918.0,2435303320.0650964,2460959315.370056,-147186990.0,-145971408.0,2614661.0,120494.0,,,,,,,,,,,,,,,,,,,,,1468159.0,14809050.0,3234148.0,8559361.0,11613102.0,1416505.0,1059718807.5795012,,72141552807.97466,21689761595.35512,,5792665.7475,689.5,94245.0,-277057118.5,22000600.0,-123843080.5,-218808278.5,-2021083.0,,,,,,,,,,,,,,,,,,,,,4275013.0,2480433.0,-9007851.5,921269.0,37582.5,3735477489.127461,3660171995.947461,-260748298.5,-257435325.5,2527641.0,269326.5,3928122363.8024554,33269196218.82841,36698965910.865135,1730262113.1675494,48108445648.31321,3989976.0,-247697324.5,103135153366.5,1054962236.0,17281251108.5,3505451533.5,18894908044.5,3673767.5,71960.5,20880.0114203788,89818947.0,,1.1056,8.613264427217915,543.839156136066,9.522825150732128,601.2685710240346,45000.0,-0.2225209339563143,0.9749279121818236,0.0,0.0,0.0,0.0,0.0,0.0,1.0,0.0,0.0,1.0,0.0,0.0,0.0,0.0,0.0,1.0,0.0,0.0,0.0,0.0,0.0,1.0,0.0,0.0,0.0,1.0,0.0,0.0,0.0,0.0,0.0,0.0,0.0,0.0,0.0,0.0,0.0,0.0,0.0,0.0,0.0,0.0,0.0,0.0,0.0,0.0,0.0,0.0,0.0,0.0,0.0,0.0,0.0,0.0,0.0,0.0,0.0,0.0,0.0,0.0,0.0,0.0,0.0,0.0,0.0,0.0,0.0,0.0,0.0,0.0,0.0,0.0,0.0,0.0,0.0,0.0,0.0,0.0,0.0,0.0,0.0,0.0,0.0,0.0,0.0,0.0,0.0,0.0,0.0,0.0,0.0,0.0,0.0,0.0,0.0,0.0,0.0,0.0,0.0,0.0,0.0,0.0,0.0,0.0,0.0,1.0,0.0,0.0,1.0,0.0,1.0,0.0,0.0,0.0,0.0,0.0,0.0,0.0,1.0,0.0
103689,0,0.0,1.0,1.0,0.0,1.0,360000.0,157500.0,16537.5,157500.0,0.032561,46.27945205479452,-1249.0,-4262.0,-420.0,2.0,3.0,1.0,1.0,11.0,,0.695515600866679,0.6195277080511546,0.3732,0.2339,0.9816,,,0.38,0.3276,0.3333,,,,0.3644,,0.0159,0.3099,0.1982,0.9816,,,0.3222,0.2759,0.3333,,,,0.3089,,0.0115,0.3768,0.2339,0.9816,,,0.38,0.3276,0.3333,,,,0.371,,0.0163,0.2355,1.0,2.0,0.0,2.0,0.0,-3613.0,0.0,0.0,0.0,0.0,0.0,0.0,1.0,1.0,1.0,1.0,0.0,0.0,0.0,0.0,0.0,0.0,0.0,0.0,0.0,1.0,0.0,0.0,0.0,0.0,0.0,0.0,0.0,0.0,0.0,0.0,0.0,0.0,0.0,0.0,0.0,0.0,0.0,0.0,0.0,,,,,,,,,,,,,0.0,,5.0,15119.19,103500.0,125163.0,,135000.0,12.0,-616.0,365243.0,-889.5,-559.5,-559.5,-552.0,10.0,1.0,,-1.0,26.0,12.0,6.0,-25.0,0.0,0.0,25.0,13610.565,13610.565,-872.0,-863.0,7.0,1.0,0.0,,,,,,,,,,,,,,,,,,,,,8350479369.0,184465056154.5,165643653564.0,51994812655.935,1863.0,1705.0,71125.0,70873.0,9140.0,506307.0,17817.057300002292,17879.345099999107,17330.555299998025,11300.807200000096,11238.624300000096,11186.007400000057,128480.0,663130.0,,,,13533592.36712289,-602239653.0,-922303853.0,-296651620.0,-1535844076.0416667,44035.0,30717.0,11355.307999999188,11231.29999999898,10715.415699997293,22899.033200009733,22820.89140000969,22206.17340000825,,158110.0670226866,126164.17967532226,35018.46580002795,34958.70030002839,34404.1344000288,,,,3715843.0,,,,,,,16475.856399999742,16661.2726999997,16257.913399999705,,,,3915.943900000125,3899.170300000165,3731.8128000001593,436652.0,431445.0,1263735.0,6427.8349830028965,632246.0,625797.0,,16340.387799999804,154253.43929999066,154256.1868999902,154147.91679998714,,,,,,,,,,,,,,,,,,,,,,,,,,,,,,216595880.59499976,3081998974.995003,3468031102.9350014,,3081998974.995003,223609.0,-15311530.0,3554857325.5,157072087.0,802008012.0,348008727.0,837690424.0,223152.0,3479.5,,5151327.0,1826878.0,1124979.0,-3669464.5,1363842.0,101008.0,2439610865.190094,2464901805.0150537,-147403653.0,-146186755.0,2615891.0,120716.0,,,,,,,,,,,,,,,,,,,,,1468159.0,14809050.0,3234148.0,8559387.0,11613127.0,1416510.0,,,,,,,,,,,,,,,,,,,,,,,,,,,,,,,,,,4275025.0,2480439.0,-9007876.5,921269.0,37582.5,3735491099.692461,3660185606.5124607,-260749170.5,-257436188.5,2527648.0,269327.5,3928137482.992455,33269299718.82841,36699091073.865135,,48108580648.31321,3989988.0,-247697940.5,103135518609.5,1054961346.5,17281250549.0,3505450974.0,18894907492.5,3673777.5,71961.5,,89818946.0,-26.98821927539664,0.4375,21.7687074829932,1007.4438542540304,9.523809523809524,440.7566862361383,120000.0,1.0,0.0,0.0,0.0,0.0,0.0,0.0,0.0,1.0,0.0,0.0,0.0,0.0,0.0,0.0,1.0,0.0,1.0,0.0,0.0,0.0,0.0,1.0,0.0,0.0,0.0,0.0,1.0,0.0,0.0,0.0,0.0,0.0,0.0,0.0,0.0,0.0,0.0,0.0,0.0,0.0,0.0,0.0,0.0,0.0,0.0,0.0,0.0,0.0,0.0,0.0,0.0,0.0,0.0,0.0,1.0,0.0,0.0,0.0,0.0,0.0,0.0,0.0,0.0,0.0,0.0,0.0,0.0,0.0,0.0,0.0,0.0,0.0,0.0,0.0,0.0,0.0,0.0,0.0,0.0,0.0,0.0,0.0,0.0,0.0,0.0,0.0,0.0,0.0,0.0,0.0,0.0,0.0,0.0,0.0,0.0,0.0,0.0,0.0,0.0,0.0,0.0,0.0,0.0,0.0,0.0,0.0,0.0,0.0,0.0,0.0,0.0,1.0,0.0,0.0,0.0,0.0,0.0,0.0,1.0,0.0,0.0
103725,0,0.0,0.0,1.0,1.0,1.0,292500.0,746280.0,54436.5,675000.0,0.00963,28.441095890410963,-3152.0,-167.0,-2617.0,13.0,3.0,2.0,2.0,12.0,0.4492646550319409,0.3800117631010925,0.4794489811780563,0.2044,0.0,0.998,0.9728,,0.15,0.1552,0.375,,0.0088,0.186,0.2669,0.0025,0.0166,0.1334,0.0,0.998,0.9739,,0.1208,0.1034,0.375,,0.0,0.1139,0.1591,0.0039,0.0,0.1322,0.0,0.998,0.9732,,0.12,0.1034,0.375,,0.0089,0.1086,0.1571,0.0039,0.0065,0.1584,1.0,1.0,0.0,1.0,0.0,-283.0,0.0,0.0,0.0,0.0,1.0,0.0,1.0,1.0,0.0,1.0,1.0,1.0,0.0,0.0,0.0,0.0,0.0,0.0,0.0,1.0,0.0,0.0,0.0,0.0,0.0,0.0,0.0,0.0,0.0,0.0,0.0,0.0,0.0,0.0,0.0,0.0,0.0,0.0,8.0,12714.75,68517.0,508500.0,31401.0,0.0,0.0,0.0,0.0,-1352.0,84.0,-103.0,-542.0,288.0,-21.5,2.0,4492.26,84831.75,98268.75,0.0,84831.75,12.0,-283.0,365243.0,182495.0,365243.0,182840.0,182558.0,19.0,0.5,0.0,1880.0,20.0,10.0,9.5,-82.5,0.0,0.0,9.0,8984.52,8984.52,-140.0,-133.0,5.0,1.0,9.0,0.0,0.0,,0.0,,,0.0,,0.0,0.0,0.0,0.0,,0.0,,,0.0,-5.0,0.0,0.0,8350533805.5,184465802434.5,165644328564.0,51995105155.935,1863.0,1705.0,71125.0,70874.0,9140.0,506307.0,17817.26170000229,17879.477299999107,17330.688699998023,11300.807200000096,11238.624300000096,11186.007400000057,128481.0,663133.0,,,,13533620.80821878,-602242805.0,-922306470.0,-296651903.0,-1535844243.0416667,44035.0,30717.0,11355.457999999187,11231.41999999898,10715.536499997292,22899.18840000973,22820.99480000969,22206.27680000825,67504.85644559309,158110.4470344497,126164.65912430346,35018.84080002795,34959.07530002839,34404.5094000288,,,,3715855.0,8299.685300000161,8404.258200000075,8127.760800000232,9822.314800000717,9937.293000002162,10297.208099999643,16476.12329999974,16661.4297999997,16258.072499999704,828.9138000001767,814.0898000000459,760.0124000000133,3915.960500000124,3899.176800000163,3731.8128000001593,436653.0,431446.0,1263748.0,6427.844613002897,632248.0,625799.0,,16340.546199999804,154254.43729999062,154257.18489999018,154148.9147999871,77649.8531999963,77987.83190000655,78389.36510000657,45.0,60347500.73999997,23583064.41,6184427082.885005,2028738804.12,69998600.56499997,710243.0099999999,112.0,13952.0,-19996744.5,9194436.0,-10313325.0,-11221198.0,-22.0,0.0,68517.0,315000.0,62802.0,0.0,0.0,0.0,0.0,-1551.0,-147.0,-287.0,-542.0,218782252.845,3114666607.590003,3505435238.880001,49804125.20999996,3114666607.590003,225649.0,-15458047.5,3589913355.5,158971633.5,814529842.5,353609647.5,850030899.5,225313.5,3522.0,627.6111162293292,5169293.0,1845368.0,1137046.5,-3703815.5,1364015.0,101146.0,2468468831.535109,2493255972.960068,-148889861.0,-147659654.0,2646200.0,121939.0,2333563678.619991,6272779500.0,,305961660.4499997,,,132646761.22499956,,308630384.19000053,2240456793.389997,2324668600.7549863,2324755902.6899858,,26179.0,,,752859.0,-1343387.0,576408.0,1276.0,1468167.0,14809338.0,3234157.0,8559407.0,11613136.0,1416512.0,1059731522.3295012,801847758.1724951,72142061307.97466,21689792996.35512,583082671.3694987,5792665.7475,689.5,94245.0,-277058470.5,22000684.0,-123843183.5,-218808820.5,-2021104.5,5925289055.714961,18732100500.0,,448142428.4849976,,,309233588.55749863,,459313004.3399993,5710369526.347533,5888558426.4225,5888801609.1675,,80891.0,,,971803.0,-1699309.5,177364.0,6755.0,4275035.0,2480448.5,-9007959.0,921269.0,37582.5,3735500084.212461,3660194591.032461,-260749310.5,-257436321.5,2527653.0,269328.5,3928141975.252455,33269384550.57841,36699189342.615135,1730262113.1675494,48108665480.06321,3990000.0,-247698223.5,103135883852.5,1055143841.5,17281615792.0,3505633814.0,18895090050.5,3673796.5,71962.0,20880.0114203788,89820826.0,-110.82554667180425,2.551384615384616,5.373233032983384,152.82063593260415,13.709184095230222,389.9042194317397,97500.0,0.6234898018587336,0.7818314824680298,0.0,0.0,0.0,0.0,0.0,0.0,1.0,0.0,1.0,0.0,0.0,0.0,0.0,0.0,0.0,1.0,0.0,0.0,0.0,0.0,1.0,0.0,0.0,0.0,0.0,1.0,0.0,0.0,0.0,0.0,0.0,0.0,0.0,1.0,0.0,0.0,0.0,0.0,0.0,0.0,0.0,0.0,0.0,0.0,0.0,0.0,0.0,0.0,0.0,0.0,0.0,0.0,0.0,0.0,0.0,0.0,0.0,0.0,0.0,0.0,0.0,0.0,0.0,0.0,0.0,0.0,0.0,0.0,0.0,0.0,0.0,0.0,0.0,0.0,0.0,0.0,0.0,0.0,0.0,0.0,0.0,0.0,0.0,0.0,0.0,0.0,0.0,0.0,0.0,0.0,0.0,0.0,0.0,0.0,0.0,0.0,0.0,0.0,0.0,0.0,0.0,1.0,0.0,0.0,0.0,0.0,0.0,0.0,1.0,0.0,1.0,0.0,0.0,0.0,0.0,0.0,0.0,1.0,0.0,0.0
103733,0,0.0,1.0,1.0,0.0,1.0,270000.0,1639057.5,67639.5,1530000.0,0.072508,31.50958904109589,-467.0,-4468.0,-3985.0,13.0,3.0,1.0,1.0,15.0,0.6384267148737641,0.5590787066797407,0.0005272652387098,0.1074,0.0974,0.9762,0.6736,0.0,0.016,0.1586,0.225,0.2667,0.0,0.0876,0.0666,0.0,0.0432,0.084,0.0398,0.9747,0.6668,0.0,0.0,0.1379,0.1667,0.2083,0.0,0.0735,0.0489,0.0,0.0273,0.0833,0.0819999999999999,0.9762,0.6779999999999999,0.0,0.0,0.1379,0.1667,0.2083,0.0,0.0684,0.0484,0.0,0.027,0.0549,1.0,0.0,0.0,0.0,0.0,-435.0,0.0,0.0,0.0,0.0,0.0,2.0,1.0,1.0,0.0,1.0,1.0,0.0,0.0,0.0,0.0,0.0,0.0,0.0,0.0,1.0,0.0,0.0,0.0,0.0,0.0,0.0,0.0,0.0,0.0,0.0,0.0,0.0,0.0,0.0,0.0,0.0,0.0,0.0,3.0,18279.495,13492.71,1350000.0,532802.4075,0.0,0.0,0.0,0.0,-695.0,111.0,-151.0,,125.0,-31.0,4.0,13930.335,71797.5,64617.75,14359.5,206797.5,5.0,-435.0,182405.0,-534.5,182418.5,182418.5,182420.0,18.0,0.0,0.1089090909090909,-1.0,11.0,10.0,5.0,-18.0,0.0,0.0,43.0,13346.235,12908.745,-241.0,-241.0,12.0,0.0,14.0,254952.855,270000.0,0.0,29543.6475,0.0,29543.6475,11599.56,31514.4,31514.4,246731.4675,254282.355,254282.355,0.0,10.0,0.0,10.0,6.5,-7.5,0.0,0.0,8350601445.0,184467441492.0,165645858564.0,51995375155.935,1863.0,1705.0,71125.0,70874.0,9140.0,506309.0,17817.36910000229,17879.560599999106,17330.772699998022,11300.904600000094,11238.706300000094,11186.047200000055,128482.0,663136.0,4140.316400000116,4138.002600000017,3948.575400000093,13533652.317807823,-602243272.0,-922310455.0,-296652338.0,-1535848711.0416667,44035.0,30717.0,11355.473999999189,11231.41999999898,10715.536499997292,22899.347000009733,22821.132700009694,22206.414700008256,67505.49487230796,158111.0061131564,126164.65965156868,35019.06580002795,34959.24200002839,34404.676100028795,22965.765199995894,22938.81699999548,22585.581099995707,3715870.0,8299.685300000161,8404.258200000075,8127.760800000232,9822.402400000718,9937.361400002164,10297.281599999646,16476.189899999743,16661.4781999997,16258.121399999703,828.9138000001767,814.0898000000459,760.0124000000133,3916.003700000125,3899.203800000165,3731.84010000016,436653.0,431446.0,1263761.0,6427.917121002897,632249.0,625800.0,,16340.601099999803,154255.41349999062,154258.1610999902,154149.88949998713,77650.5267999963,77988.50990000655,78390.03190000658,23.0,60524422.96499997,23615994.869999997,6200982537.885005,2032367914.4175005,70019573.17499997,710243.0099999999,114.0,13952.0,-20013595.0,9225319.0,-10318468.0,,-11.0,18279.495,13492.71,3633975.0,1065604.815,0.0,0.0,0.0,0.0,-2850.0,-1004.0,-1602.0,,219131031.6449999,3118864826.790004,3510163569.3300014,49895628.20999996,3119071624.290004,225942.0,-15476119.0,3595573878.5,159507609.5,816714718.5,354701281.5,851667908.5,225712.0,3527.0,628.7742811801282,5174439.0,1850000.0,1139881.0,-3709265.0,1364041.0,101172.0,2472593005.350118,2497173987.645074,-149015416.0,-147783306.0,2649171.0,122131.0,2336813046.337491,6279250500.0,198055480.23,307046866.6124997,10376351.1,98323940.4524999,132826444.67249957,336287296.39499843,309671774.95500046,2243539966.522498,2327879036.9924865,2327966338.9274864,10138.0,26305.5,147.0,16020.5,753043.5,-1343653.5,576408.0,1276.0,1468170.0,14809463.0,3234171.0,8559418.0,11613179.0,1416516.0,1059749801.8245012,801861250.8824952,72143411307.97466,21690325798.76262,583082671.3694987,5792665.7475,689.5,94245.0,-277059165.5,22000795.0,-123843334.5,,-2021135.5,5925544008.569961,18732370500.0,198840207.825,448171972.1324976,1948107.735,256908860.5500008,309245188.11749864,636811489.6874981,459344518.7399993,5710616257.815033,5888812708.777497,5889055891.522499,13391.5,80901.0,44.0,70403.5,971809.5,-1699317.0,177364.0,6755.0,4275045.0,2480453.5,-9007977.0,921269.0,37582.5,3735513430.447461,3660207499.777461,-260749551.5,-257436562.5,2527665.0,269328.5,3928155905.587455,33269456348.07841,36699253960.365135,1730276472.6675494,48108872277.56321,3990005.0,-247698658.5,103136066257.5,1055143307.0,17281798210.5,3505816232.5,18895272470.5,3673814.5,71962.0,20880.120329469708,89820825.0,-14.820885140422574,6.0705833333333326,3.9917503825427447,125.7784141085592,24.232253343090942,763.5483443805177,90000.0,-0.2225209339563143,0.9749279121818236,0.0,0.0,0.0,0.0,0.0,0.0,1.0,0.0,0.0,0.0,0.0,0.0,0.0,1.0,0.0,0.0,1.0,0.0,0.0,0.0,1.0,0.0,0.0,0.0,0.0,0.0,0.0,0.0,0.0,1.0,0.0,0.0,0.0,0.0,0.0,0.0,1.0,0.0,0.0,0.0,0.0,0.0,0.0,0.0,0.0,0.0,0.0,0.0,0.0,0.0,0.0,0.0,0.0,1.0,0.0,0.0,0.0,0.0,0.0,0.0,0.0,0.0,0.0,0.0,0.0,0.0,0.0,0.0,0.0,0.0,0.0,0.0,0.0,0.0,0.0,0.0,0.0,0.0,0.0,0.0,0.0,0.0,0.0,0.0,0.0,0.0,0.0,0.0,0.0,0.0,0.0,0.0,0.0,0.0,0.0,0.0,0.0,0.0,0.0,0.0,0.0,0.0,0.0,0.0,0.0,0.0,0.0,0.0,1.0,0.0,1.0,0.0,0.0,0.0,0.0,0.0,0.0,1.0,0.0,0.0
103744,0,0.0,0.0,1.0,1.0,0.0,135000.0,1993702.5,62014.5,1782000.0,0.02461,46.80273972602741,-2875.0,-5015.0,-625.0,3.0,2.0,2.0,2.0,17.0,0.7504472350503544,0.4874470627456376,0.7958031328748403,0.1237,0.1149,0.9806,,,0.0,0.2759,0.1667,,0.1094,,0.1129,,0.0468,0.1261,0.1192,0.9806,,,0.0,0.2759,0.1667,,0.1119,,0.1176,,0.0495,0.1249,0.1149,0.9806,,,0.0,0.2759,0.1667,,0.1113,,0.1149,,0.0477,0.108,1.0,1.0,1.0,1.0,1.0,-1248.0,0.0,0.0,0.0,0.0,0.0,1.0,1.0,1.0,0.0,1.0,0.0,0.0,0.0,0.0,0.0,0.0,0.0,0.0,0.0,1.0,0.0,0.0,0.0,0.0,0.0,0.0,0.0,0.0,0.0,0.0,0.0,0.0,0.0,0.0,0.0,0.0,0.0,0.0,0.0,,,,,,,,,,,,,0.0,,5.0,15204.555,34335.0,36675.0,1716.75,73233.0,6.0,-153.0,365243.0,-123.0,-80.0,27.0,-52.0,14.0,0.0,0.0466159746233795,10.0,10.0,6.0,4.0,-21.0,0.0,0.0,15.0,15074.055,15074.055,-120.0,-111.0,3.0,1.0,5.0,0.0,157500.0,0.0,42532.11,0.0,42532.11,0.0,39312.1125,234.225,0.0,0.0,0.0,0.0,20.0,0.0,20.0,2.0,-3.0,0.0,0.0,8350663459.5,184469435194.5,165647640564.0,51995510155.935,1863.0,1705.0,71125.0,70874.0,9140.0,506310.0,17817.492800002292,17879.685499999105,17330.898799998024,11301.019500000097,11238.821200000097,11186.166400000056,128482.0,663138.0,,,,13533699.120547548,-602246147.0,-922311080.0,-296653586.0,-1535853726.0416667,44036.0,30718.0,11355.473999999189,11231.41999999898,10715.536499997292,22899.62290000973,22821.40860000969,22206.690600008256,67506.24531954301,158111.49356021913,126165.45545470154,35019.23250002795,34959.40870002839,34404.842800028804,,,,3715887.0,8299.79470000016,8404.369500000075,8127.872700000232,,,,16476.302799999743,16661.5930999997,16258.238999999705,,,,3916.050500000125,3899.251500000164,3731.88960000016,436654.0,431447.0,1263764.0,6427.9417310028975,632251.0,625802.0,,16340.709099999804,154256.39409999063,154259.1416999902,154150.87009998714,,,,,,,,,,,,,,,,,,,,,,,,,,,,,,219737436.75,3124471951.9350038,3518056068.300001,49954353.88499996,3124471951.9350038,226496.0,-15533221.0,3607257503.0,159462114.0,818321954.0,356680254.0,853642961.0,226398.0,3542.0,629.9557597831068,5190352.0,1854566.0,1142620.0,-3723349.5,1364042.0,101173.0,2480021315.2801204,2504824120.755077,-149592461.0,-148356708.0,2657374.0,122516.0,2348176331.24999,6302583000.0,198667480.23,309281679.5399998,10376351.1,99945953.99999988,133444057.90499954,338756406.34499985,311918319.58500046,2254560787.844997,2339216455.679985,2339303757.614985,10160.0,26757.0,147.0,16450.0,754401.0,-1347752.0,576408.0,1276.0,1468170.0,14809463.0,3234176.0,8559428.0,11613194.0,1416521.0,,,,,,,,,,,,,,5925544008.569961,18732528000.0,198840207.825,448214504.2424976,1948107.735,256951392.6600008,309245188.11749864,636850801.7999978,459344752.9649993,5710616257.815033,5888812708.777497,5889055891.522499,13391.5,80921.0,44.0,70423.5,971811.5,-1699320.0,177364.0,6755.0,4275051.0,2480457.5,-9007998.0,921269.0,37582.5,3735528504.502461,3660222573.832461,-260749671.5,-257436673.5,2527668.0,269329.5,3928171110.142455,33269490683.07841,36699290635.365135,1730278189.4175494,48108945510.56321,3990011.0,-247698811.5,103136431500.5,1055143184.0,17281798130.5,3505816259.5,18895272418.5,3673828.5,71962.0,20880.166945444333,89820835.0,-61.42802786395832,14.768166666666668,2.1769102387344894,101.88536331041448,32.14897322400407,1504.660026262086,67500.0,-0.9009688679024191,-0.433883739117558,0.0,0.0,0.0,0.0,0.0,1.0,0.0,0.0,1.0,0.0,0.0,0.0,0.0,0.0,0.0,1.0,0.0,0.0,0.0,0.0,1.0,0.0,0.0,0.0,0.0,1.0,0.0,0.0,0.0,0.0,0.0,0.0,0.0,0.0,0.0,0.0,0.0,0.0,0.0,0.0,1.0,0.0,0.0,0.0,0.0,0.0,0.0,0.0,0.0,0.0,0.0,0.0,0.0,0.0,0.0,0.0,0.0,0.0,0.0,0.0,0.0,0.0,0.0,0.0,0.0,0.0,0.0,0.0,0.0,0.0,0.0,0.0,0.0,0.0,0.0,0.0,0.0,0.0,0.0,0.0,0.0,0.0,0.0,0.0,0.0,0.0,0.0,0.0,0.0,0.0,1.0,0.0,0.0,0.0,0.0,0.0,0.0,0.0,0.0,0.0,0.0,0.0,0.0,0.0,0.0,0.0,0.0,0.0,0.0,0.0,1.0,0.0,0.0,0.0,0.0,0.0,0.0,1.0,0.0,0.0
103762,0,0.0,0.0,0.0,1.0,3.0,202500.0,360000.0,26194.5,360000.0,0.026392,37.52054794520548,-1490.0,-2747.0,-4912.0,,5.0,2.0,2.0,12.0,0.4689168242823527,0.5929446341132277,,,,,,,,,,,,,,,,,,,,,,,,,,,,,,,,,,,,,,,,,,,,,,0.0,0.0,0.0,0.0,-1120.0,0.0,0.0,0.0,0.0,0.0,0.0,1.0,1.0,1.0,1.0,1.0,1.0,0.0,0.0,0.0,0.0,0.0,0.0,0.0,1.0,0.0,0.0,0.0,0.0,0.0,0.0,0.0,0.0,0.0,0.0,0.0,0.0,0.0,0.0,0.0,0.0,0.0,0.0,3.0,0.0,,45000.0,,,0.0,0.0,0.0,-201.0,-156.0,-192.0,-264.0,23.0,-3.0,3.0,16583.535,225000.0,254700.0,1.8,225000.0,24.0,-276.0,365243.0,-664.5,-559.5,-214.5,-545.0,12.0,0.5,4.879767498223039e-05,2.0,12.0,8.0,3.5,-30.5,0.0,0.0,13.0,6672.465,6612.255,-1010.0,-933.0,5.0,1.0,0.0,,,,,,,,,,,,,,,,,,,,,8350689654.0,184469795194.5,165648000564.0,51995712655.935,1863.0,1705.0,71125.0,70874.0,9140.0,506310.0,,,,,,,128485.0,663143.0,,,,13533736.641095491,-602247637.0,-922315992.0,-296654706.0,-1535856473.0416667,44036.0,30718.0,,,,,,,67506.71423636729,158112.08650485324,,,,,,,,3715899.0,,,,,,,,,,,,,,,,436654.0,431447.0,,6427.968123002896,632253.0,625804.0,,,,,,,,,7.0,61045632.76499997,,6242906694.960007,,,710243.0099999999,118.0,13952.0,-20212622.0,9288136.0,-10432091.0,-11352101.0,-3.0,0.0,,45000.0,,,0.0,0.0,0.0,-201.0,-156.0,-192.0,-264.0,220685930.4149999,3137158643.535003,3532569996.600001,50208981.43499996,3137158643.535003,227412.0,-15608381.0,3623875735.5,160498933.5,820830128.5,357737175.5,856151999.5,227171.0,3560.0,632.8591593186817,5201359.0,1861984.0,1147412.5,-3742938.5,1367781.0,101189.0,2490774825.060105,2516693283.4950595,-150100506.0,-148860472.0,2660051.0,123004.0,,,,,,,,,,,,,,,,,,,,,1468173.0,14809486.0,3234176.0,8559440.0,11613207.0,1416524.0,1059749801.8245012,,72143456307.97466,,,5792665.7475,689.5,94245.0,-277059366.5,22000639.0,-123843526.5,-218809084.5,-2021138.5,,,,,,,,,,,,,,,,,,,,,4275059.0,2480461.0,-9008028.5,921269.0,37582.5,3735535176.967461,3660229186.087461,-260750681.5,-257437606.5,2527673.0,269330.5,3928187693.6774554,33269715683.07841,36699545335.365135,1730278191.217549,48109170510.56321,3990035.0,-247699087.5,103136796743.5,1055142519.5,17281797571.0,3505816045.0,18895271873.5,3673840.5,71962.5,20880.16699424201,89820837.0,-39.711573566995256,1.7777777777777777,7.730630475863252,290.05749141629383,13.74334306820134,515.6577625178559,40500.0,-0.2225209339563146,-0.9749279121818236,0.0,0.0,0.0,0.0,0.0,0.0,1.0,0.0,0.0,0.0,0.0,0.0,0.0,1.0,0.0,0.0,0.0,0.0,1.0,0.0,1.0,0.0,0.0,0.0,0.0,0.0,0.0,0.0,0.0,1.0,0.0,0.0,0.0,0.0,0.0,0.0,0.0,0.0,1.0,0.0,0.0,0.0,0.0,0.0,0.0,0.0,0.0,0.0,0.0,0.0,0.0,0.0,0.0,1.0,0.0,0.0,0.0,0.0,0.0,0.0,0.0,0.0,0.0,0.0,0.0,0.0,0.0,0.0,0.0,0.0,0.0,0.0,0.0,0.0,0.0,0.0,0.0,0.0,0.0,0.0,0.0,0.0,0.0,0.0,0.0,0.0,0.0,0.0,0.0,0.0,0.0,0.0,0.0,0.0,0.0,0.0,0.0,0.0,0.0,0.0,0.0,0.0,0.0,0.0,0.0,0.0,0.0,0.0,0.0,0.0,0.0,0.0,0.0,0.0,0.0,0.0,0.0,0.0,0.0,0.0
103771,1,0.0,1.0,0.0,1.0,0.0,135000.0,266652.0,21195.0,202500.0,0.006852,61.60821917808219,,-5060.0,-5696.0,,2.0,3.0,3.0,6.0,,0.0092074146682007,,,,,,,,,,,,,,,,,,,,,,,,,,,,,,,,,,,,,,,,,,,,,,4.0,0.0,4.0,0.0,0.0,,,,,,,1.0,0.0,0.0,1.0,0.0,0.0,0.0,0.0,0.0,0.0,0.0,0.0,0.0,0.0,0.0,0.0,1.0,0.0,0.0,0.0,0.0,0.0,0.0,0.0,0.0,0.0,0.0,0.0,0.0,0.0,0.0,0.0,0.0,,,,,,,,,,,,,0.0,,9.0,18413.775,0.0,0.0,0.0,256500.0,36.0,-261.0,365243.0,-242.5,182580.5,447.5,182581.5,7.0,0.5,0.0,-1.0,16.0,12.0,7.5,-6.5,0.0,0.0,15.0,12737.7,12737.7,-224.0,-202.0,5.0,1.0,0.0,,,,,,,,,,,,,,,,,,,,,8350710849.0,184470061846.5,165648203064.0,51995847655.935,,,,,,,,,,,,,128485.0,663145.0,,,,13533798.249314671,,-922321688.0,-296654706.0,-1535861533.0416667,44036.0,30718.0,,,,,,,,158112.09571226788,,,,,,,,3715905.0,,,,,,,,,,,,,,,,436658.0,431451.0,,6427.974975002898,632256.0,625807.0,,,,,,,,,,,,,,,,,,,,,,,,,,,,,,,,,,,221558471.59499985,3151720398.285003,3548613612.600001,50394419.68499996,3151720398.285003,228134.0,-15638316.0,3634101364.5,161206496.5,822822176.5,358459119.5,858510555.5,227752.0,3565.5,634.5239939821462,5232463.0,1866143.0,1150165.5,-3749925.5,1368487.0,101203.0,2500534240.7850943,2528251687.530044,-150528087.0,-149284195.0,2673562.0,123445.0,,,,,,,,,,,,,,,,,,,,,1468173.0,14809486.0,3234176.0,8559456.0,11613222.0,1416533.0,,,,,,,,,,,,,,,,,,,,,,,,,,,,,,,,,,4275071.0,2480468.5,-9008035.0,921269.0,37582.5,3735547914.667461,3660241923.78746,-260750905.5,-257437808.5,2527678.0,269331.5,3928206107.452455,33269715683.07841,36699545335.365135,1730278191.217549,48109427010.56321,3990071.0,-247699348.5,103137161986.5,1055142277.0,17281980151.5,3505816492.5,18895454455.0,3673847.5,71963.0,20880.16699424201,89820836.0,,1.9752,6.369426751592357,392.409039350842,12.580891719745225,775.0863345257831,67500.0,-0.2225209339563143,0.9749279121818236,0.0,0.0,0.0,0.0,0.0,1.0,0.0,0.0,0.0,1.0,0.0,0.0,0.0,0.0,0.0,0.0,0.0,0.0,1.0,1.0,0.0,0.0,0.0,0.0,0.0,1.0,0.0,0.0,0.0,0.0,0.0,0.0,0.0,0.0,0.0,0.0,0.0,0.0,0.0,0.0,0.0,0.0,0.0,0.0,0.0,0.0,0.0,0.0,0.0,0.0,0.0,0.0,0.0,0.0,0.0,0.0,0.0,0.0,0.0,0.0,0.0,0.0,0.0,0.0,0.0,0.0,0.0,0.0,0.0,0.0,0.0,0.0,0.0,0.0,0.0,0.0,0.0,0.0,0.0,0.0,0.0,0.0,0.0,0.0,0.0,0.0,0.0,0.0,0.0,0.0,0.0,0.0,0.0,0.0,0.0,0.0,0.0,0.0,0.0,0.0,0.0,0.0,0.0,0.0,0.0,1.0,0.0,0.0,0.0,0.0,0.0,0.0,0.0,0.0,0.0,0.0,0.0,0.0,0.0,0.0
103773,0,0.0,0.0,1.0,0.0,0.0,225000.0,315000.0,31153.5,315000.0,0.031329,45.01643835616439,-4267.0,-10530.0,-4872.0,7.0,1.0,2.0,2.0,12.0,0.8309666305882577,0.7814326483320481,0.5673792367572691,0.0165,0.0,0.9727,0.626,0.0017,0.0,0.069,0.0417,0.0833,0.0251,0.0134,0.0125,0.0,,0.0168,0.0,0.9727,0.6406,0.0017,0.0,0.069,0.0417,0.0833,0.0256,0.0147,0.0131,0.0,,0.0167,0.0,0.9727,0.631,0.0017,0.0,0.069,0.0417,0.0833,0.0255,0.0137,0.0128,0.0,,0.0099,1.0,0.0,0.0,0.0,0.0,-1757.0,1.0,0.0,0.0,0.0,1.0,2.0,1.0,1.0,1.0,1.0,1.0,0.0,0.0,0.0,0.0,0.0,0.0,0.0,0.0,1.0,0.0,0.0,0.0,0.0,0.0,0.0,0.0,0.0,0.0,0.0,0.0,0.0,0.0,0.0,0.0,0.0,0.0,0.0,9.0,0.0,,123264.09,0.0,0.0,0.0,0.0,0.0,-718.0,-414.0,-434.0,-459.0,275.0,-18.0,5.0,12511.665,90000.0,109480.5,0.0,90000.0,12.0,-1757.0,365243.0,-1727.0,-1397.0,-1397.0,-1391.0,12.0,1.0,0.0,-1.0,48.0,12.0,5.0,-56.5,0.0,0.0,46.0,12511.665,12467.43,-1852.0,-1849.0,5.0,1.0,0.0,,,,,,,,,,,,,,,,,,,,,8350742002.5,184470376846.5,165648518064.0,51996072655.935,1863.0,1706.0,71125.0,70875.0,9140.0,506312.0,17817.509300002293,17879.702199999105,17330.915599998025,11301.019500000097,11238.821200000097,11186.166400000056,128485.0,663146.0,4140.318100000116,4138.004300000017,3948.5771000000927,13533843.265753029,-602251904.0,-922326560.0,-296656463.0,-1535872063.0416667,44036.0,30718.0,11355.473999999189,11231.41999999898,10715.536499997292,22899.691900009733,22821.477600009694,22206.759600008256,67507.54520299788,158112.87714491625,126166.02283393832,35019.274200027954,34959.450400028385,34404.884500028806,22965.8484999959,22938.90029999548,22585.66439999571,3715917.0,8299.819800000161,8404.395000000075,8127.898300000232,9822.415800000716,9937.375100002162,10297.296299999643,16476.31529999974,16661.6058999997,16258.252099999703,828.9138000001767,814.0898000000459,760.0124000000133,,,,436658.0,431451.0,1263771.0,6428.006304002898,632258.0,625809.0,,16340.718999999805,154257.36679999065,154260.11439999018,154151.84279998715,77651.1527999963,77989.14090000655,78390.67250000658,24.0,61111822.63499997,,6269792333.310004,2048967924.435,71270741.60999995,710243.0099999999,118.0,13952.0,-20312783.0,9250346.0,-10488845.0,-11413060.0,-11.5,0.0,,225000.0,0.0,0.0,0.0,0.0,0.0,-1973.0,-745.0,-622.0,-879.0,221654676.59999985,3153193392.285003,3550223658.600001,50447542.18499996,3153193392.285003,228248.0,-15648526.0,3635744958.0,161200682.0,823000400.0,358455330.0,858688803.0,227878.0,3568.0,635.1844523156686,5236275.0,1867145.0,1150708.0,-3751759.5,1368487.0,101203.0,2502020335.0725965,2529521231.8275447,-150583597.0,-149339206.0,2674116.0,123506.5,,,,,,,,,,,,,,,,,,,,,1468182.0,14809761.0,3234176.0,8559504.0,11613268.0,1416538.0,1059749801.8245012,,72143579572.06465,21690325798.76262,583082671.3694987,5792665.7475,689.5,94245.0,-277060084.5,22000225.0,-123843960.5,-218809543.5,-2021156.5,,,,,,,,,,,,,,,,,,,,,4275083.0,2480473.5,-9008091.5,921269.0,37582.5,3735560426.332461,3660254391.21746,-260752757.5,-257439657.5,2527683.0,269332.5,3928218619.117455,33269805683.07841,36699654815.865135,1730278191.217549,48109517010.56321,3990083.0,-247701105.5,103137527229.5,1055140550.0,17281978754.5,3505815095.5,18895453064.0,3673859.5,71964.0,20880.16699424201,89820835.0,-94.78759661615238,1.4,7.222302470027444,325.12233393156424,10.111223458038422,455.1712675041899,225000.0,-0.9009688679024191,-0.433883739117558,0.0,0.0,0.0,0.0,0.0,0.0,1.0,0.0,0.0,0.0,0.0,0.0,0.0,1.0,0.0,1.0,0.0,0.0,0.0,0.0,0.0,0.0,1.0,0.0,0.0,1.0,0.0,0.0,0.0,0.0,0.0,0.0,0.0,1.0,0.0,0.0,0.0,0.0,0.0,0.0,0.0,0.0,0.0,0.0,0.0,0.0,0.0,0.0,0.0,0.0,0.0,0.0,0.0,0.0,0.0,0.0,0.0,0.0,0.0,0.0,0.0,0.0,0.0,0.0,0.0,0.0,0.0,0.0,0.0,0.0,0.0,0.0,0.0,0.0,0.0,0.0,0.0,0.0,1.0,0.0,0.0,0.0,0.0,0.0,0.0,0.0,0.0,0.0,0.0,0.0,0.0,0.0,0.0,0.0,0.0,0.0,0.0,0.0,0.0,0.0,0.0,0.0,0.0,0.0,0.0,0.0,0.0,0.0,1.0,0.0,1.0,0.0,0.0,0.0,0.0,0.0,1.0,0.0,0.0,0.0
103783,0,0.0,1.0,0.0,1.0,2.0,90000.0,332946.0,17127.0,238500.0,0.010643,36.92602739726028,-869.0,-7541.0,-4620.0,,4.0,2.0,2.0,15.0,0.5748654551641783,0.5914448246174405,0.5064842396679806,0.232,0.0,0.9886,,,0.24,0.2069,0.3333,,0.1815,,0.2389,,0.0097,0.2363,0.0,0.9886,,,0.2417,0.2069,0.3333,,0.1857,,0.249,,0.0103,0.2342,0.0,0.9886,,,0.24,0.2069,0.3333,,0.1847,,0.2432,,0.0099,0.1901,1.0,0.0,0.0,0.0,0.0,-664.0,0.0,0.0,0.0,0.0,0.0,2.0,1.0,1.0,0.0,1.0,0.0,0.0,0.0,0.0,0.0,0.0,0.0,0.0,0.0,1.0,0.0,0.0,0.0,0.0,0.0,0.0,0.0,0.0,0.0,0.0,0.0,0.0,0.0,0.0,0.0,0.0,0.0,0.0,2.0,,0.0,158801.805,72571.5,0.0,0.0,0.0,0.0,-593.0,133.0,-160.5,-233.0,40.0,-9.5,3.0,7938.6975,104863.5,127012.5,0.0,153681.75,12.0,-432.0,365243.0,-633.0,365243.0,57.0,365243.0,9.0,0.0,0.0,-1.0,22.0,24.0,13.5,-11.5,0.0,0.0,22.0,5752.395,5752.395,-327.5,-318.0,11.5,1.0,0.0,,,,,,,,,,,,,,,,,,,,,8350759129.5,184470709792.5,165648756564.0,51996162655.935,1863.0,1706.0,71125.0,70875.0,9140.0,506314.0,17817.741300002293,17879.936399999104,17331.151899998025,11301.019500000097,11238.821200000097,11186.166400000056,128487.0,663150.0,,,,13533880.191780426,-602252773.0,-922331180.0,-296657127.0,-1535879604.0416667,44036.0,30718.0,11355.713999999189,11231.65999999898,10715.778199997292,22899.89880000973,22821.68450000969,22206.966500008257,67508.12006845303,158113.46858974086,126166.529318178,35019.60750002795,34959.78370002839,34405.217800028804,,,,3715932.0,8300.001300000162,8404.579700000075,8128.084000000232,,,,16476.55419999974,16661.8490999997,16258.501099999705,,,,3916.060200000125,3899.261400000164,3731.89990000016,436658.0,431451.0,,6428.016947002898,632260.0,625811.0,,16340.909099999802,154258.35539999066,154261.10299999022,154152.83139998716,,,,20.0,,23736653.50499999,6278836965.075005,2051836387.56,71305780.27499995,710243.0099999999,118.0,13952.0,-20346180.0,9276042.5,-10504050.5,-11430332.0,-9.5,,0.0,158801.805,72571.5,0.0,0.0,0.0,0.0,-593.0,133.0,-160.5,-233.0,222362359.98749983,3161731696.785003,3559584293.100001,50552536.18499996,3161784128.535003,228948.0,-15715150.0,3647067491.0,161531676.0,825896210.0,358799044.0,861584751.0,228568.0,3584.0,636.9728355282244,5247082.0,1872121.0,1153816.0,-3763499.0,1368538.0,101224.0,2510458490.54261,2538774345.622557,-151073209.0,-149824484.5,2680305.0,123965.5,,,,,,,,,,,,,,,,,,,,,1468184.0,14809801.0,3234176.0,8559526.0,11613290.0,1416541.0,,801861250.8824952,72143738373.86964,21690398370.26262,583082671.3694987,5792665.7475,689.5,94245.0,-277060677.5,22000358.0,-123844121.0,-218809776.5,-2021166.0,,,,,,,,,,,,,,,,,,,,,4275107.0,2480487.0,-9008103.0,921269.0,37582.5,3735566178.727461,3660260143.61246,-260753085.0,-257439975.5,2527694.5,269333.5,3928226557.8149543,33269910546.57841,36699781828.365135,1730278191.217549,48109670692.31321,3990095.0,-247701537.5,103137892472.5,1055139917.0,17282343997.5,3505815152.5,18895818307.0,3673868.5,71964.0,20880.16699424201,89820834.0,-23.53353613295741,3.6994,5.254860746190227,194.04113188260783,19.439831844456123,717.8357632865195,22500.0,-0.2225209339563143,0.9749279121818236,0.0,0.0,0.0,0.0,0.0,0.0,1.0,0.0,0.0,0.0,0.0,0.0,0.0,1.0,0.0,0.0,0.0,0.0,1.0,0.0,1.0,0.0,0.0,0.0,0.0,0.0,0.0,0.0,0.0,1.0,0.0,0.0,0.0,0.0,0.0,0.0,0.0,0.0,1.0,0.0,0.0,0.0,0.0,0.0,0.0,0.0,0.0,0.0,0.0,0.0,0.0,0.0,0.0,1.0,0.0,0.0,0.0,0.0,0.0,0.0,0.0,0.0,0.0,0.0,0.0,0.0,0.0,0.0,0.0,0.0,0.0,0.0,0.0,0.0,0.0,0.0,0.0,0.0,0.0,0.0,0.0,0.0,0.0,0.0,0.0,0.0,0.0,0.0,0.0,0.0,0.0,0.0,0.0,0.0,0.0,0.0,0.0,0.0,0.0,0.0,0.0,0.0,0.0,0.0,0.0,0.0,0.0,0.0,0.0,0.0,1.0,0.0,0.0,0.0,0.0,0.0,0.0,1.0,0.0,0.0
103784,0,0.0,1.0,0.0,0.0,0.0,306000.0,179865.0,11133.0,148500.0,0.035792,59.49589041095891,-5218.0,-11615.0,-5224.0,,2.0,2.0,2.0,12.0,,0.6624396384958746,0.3910549766342248,0.0619,0.0143,0.9742,0.6464,,0.0,0.1034,0.1667,,0.0833,0.0504,0.0316,,0.0113,0.063,0.0148,0.9742,0.6602,,0.0,0.1034,0.1667,,0.0852,0.0551,0.033,,0.012,0.0625,0.0143,0.9742,0.6511,,0.0,0.1034,0.1667,,0.0847,0.0513,0.0322,,0.0115,0.0369,1.0,0.0,0.0,0.0,0.0,0.0,0.0,0.0,0.0,0.0,0.0,4.0,1.0,1.0,0.0,1.0,0.0,0.0,0.0,0.0,0.0,0.0,0.0,0.0,0.0,1.0,0.0,0.0,0.0,0.0,0.0,0.0,0.0,0.0,0.0,0.0,0.0,0.0,0.0,0.0,0.0,0.0,0.0,0.0,5.0,4500.0,23978.25,427500.0,87834.7125,0.0,0.0,0.0,0.0,-1396.0,809.0,-38.0,-1105.5,178.0,-23.0,5.0,14924.5875,157500.0,178290.0,11250.0,247500.0,14.5,-696.0,365243.0,-1410.0,181874.5,-540.0,181876.5,16.0,0.5,0.2288006111535524,-1.0,52.0,24.0,17.0,-51.5,0.0,0.0,80.0,12988.125,12988.125,-412.0,-407.5,12.5,1.0,15.0,261251.01,337500.0,0.0,0.0,0.0,0.0,12344.175,22500.0,22500.0,250240.185,258203.655,258203.655,0.0,0.0,0.0,0.0,6.0,-8.0,0.0,0.0,8350770262.5,184470889657.5,165648905064.0,51996468655.935,1863.0,1706.0,71125.0,70875.0,9140.0,506318.0,17817.803200002294,17879.998899999104,17331.214899998024,11301.033800000096,11238.835500000096,11186.181200000055,128487.0,663152.0,,,,13533939.687670834,-602257991.0,-922336404.0,-296657127.0,-1535891219.0416667,44036.0,30718.0,11355.713999999189,11231.65999999898,10715.778199997292,22900.00220000973,22821.78790000969,22207.069900008257,,158114.13102937935,126166.9203731546,35019.774200027954,34959.950400028385,34405.384500028806,,,,3715944.0,8300.084600000162,8404.664400000074,8128.169200000232,9822.466200000716,9937.42640000216,10297.351399999645,16476.585799999742,16661.881299999706,16258.534099999702,,,,3916.071500000125,3899.272900000164,3731.91190000016,436658.0,431451.0,,6428.0527390028965,632262.0,625813.0,,16340.945999999802,154259.32959999063,154262.07719999022,154153.80559998716,77651.7991999963,77989.79200000655,78391.33270000658,46.0,61170322.63499997,23760631.75499999,6280683266.880005,2052035267.31,71305780.27499995,710243.0099999999,118.0,13952.0,-20351284.0,9275866.0,-10504739.0,-11432375.5,-22.5,0.0,47956.5,427500.0,0.0,0.0,0.0,0.0,0.0,-1404.0,57.0,-220.0,-1876.0,222395876.39249983,3162385110.285003,3560258145.600001,50575036.18499996,3162306360.285003,228977.0,-15721262.0,3647615140.5,161527437.0,826258030.0,359160369.0,861946575.0,228628.0,3584.5,637.4304367505315,5248359.0,1872892.5,1154194.0,-3765343.0,1368573.0,101224.0,2511150867.562612,2539460123.055058,-151111219.5,-149862241.0,2680922.5,123990.5,2362837445.729989,6366010500.0,200366005.23,311492263.1399998,10376351.1,100458012.59999986,134364141.5849995,341792381.0250001,314842564.395,2268597550.859997,2353869027.449985,2353956329.3849845,10275.0,26893.0,147.0,16471.0,763040.0,-1359060.0,576410.0,1278.0,1468189.0,14809979.0,3234191.0,8559578.0,11613370.0,1416546.0,1059754301.8245012,801885229.1324952,72144165873.86964,21690486204.97512,583082671.3694987,5792665.7475,689.5,94245.0,-277062073.5,22001167.0,-123844159.0,-218810882.0,-2021189.0,5925805259.579961,18732865500.0,198840207.825,448214504.2424976,1948107.735,256951392.6600008,309257532.29249865,636873301.7999978,459367252.9649993,5710866498.000032,5889070912.432498,5889314095.177499,13391.5,80921.0,44.0,70423.5,971817.5,-1699328.0,177364.0,6755.0,4275131.0,2480504.0,-9008154.5,921269.0,37582.5,3735579166.852461,3660273131.73746,-260753497.0,-257440383.0,2527707.0,269334.5,3928241482.402455,33270068046.57841,36699960118.365135,1730289441.217549,48109918192.31321,3990109.5,-247702233.5,103138257715.5,1055138507.0,17282525872.0,3505814612.5,18896000183.5,3673884.5,71964.5,20880.39579485316,89820833.0,-87.70353656290294,0.5877941176470588,27.485852869846408,1635.295290196122,16.156022635408245,961.2169521932204,153000.0,0.6234898018587334,-0.7818314824680299,0.0,0.0,0.0,0.0,0.0,0.0,1.0,0.0,1.0,0.0,0.0,0.0,0.0,0.0,0.0,0.0,0.0,0.0,1.0,0.0,1.0,0.0,0.0,0.0,0.0,1.0,0.0,0.0,0.0,0.0,0.0,0.0,0.0,0.0,0.0,0.0,0.0,0.0,1.0,0.0,0.0,0.0,0.0,0.0,0.0,0.0,0.0,0.0,0.0,0.0,0.0,0.0,0.0,0.0,0.0,0.0,0.0,0.0,0.0,0.0,0.0,0.0,0.0,0.0,0.0,0.0,0.0,0.0,1.0,0.0,0.0,0.0,0.0,0.0,0.0,0.0,0.0,0.0,0.0,0.0,0.0,0.0,0.0,0.0,0.0,0.0,0.0,0.0,0.0,0.0,0.0,0.0,0.0,0.0,0.0,0.0,0.0,0.0,0.0,0.0,0.0,0.0,0.0,0.0,0.0,0.0,0.0,0.0,0.0,0.0,1.0,0.0,0.0,1.0,0.0,0.0,0.0,0.0,0.0,0.0
103808,0,0.0,0.0,0.0,1.0,0.0,144000.0,182448.0,18823.5,157500.0,0.01885,63.54794520547945,,-10973.0,-5060.0,,1.0,2.0,2.0,11.0,,0.6824195988644517,0.6577838002083306,0.034,0.0,0.9771,0.6872,0.0018,0.0,0.1034,0.0833,0.125,0.0222,0.0252,0.0143,0.0116,0.0044,0.0347,0.0,0.9772,0.6994,0.0018,0.0,0.1034,0.0833,0.125,0.0227,0.0275,0.0149,0.0117,0.0047,0.0344,0.0,0.9771,0.6914,0.0018,0.0,0.1034,0.0833,0.125,0.0226,0.0257,0.0146,0.0116,0.0045,0.0163,1.0,0.0,0.0,0.0,0.0,-1927.0,0.0,0.0,0.0,0.0,0.0,2.0,1.0,0.0,0.0,1.0,0.0,0.0,0.0,0.0,0.0,0.0,0.0,0.0,0.0,0.0,0.0,0.0,1.0,0.0,0.0,0.0,0.0,0.0,0.0,0.0,0.0,0.0,0.0,0.0,0.0,0.0,0.0,0.0,15.0,0.0,10.17,13500.0,0.0,0.0,0.0,0.0,0.0,-321.0,-218.0,-117.0,-298.0,378.0,-21.0,6.0,10761.165,94108.5,96583.5,9000.0,102717.0,12.0,-557.0,365243.0,-907.5,-592.5,-577.5,-586.5,11.5,0.5,0.0870402324947779,4.5,46.0,12.0,6.5,-32.5,0.0,0.0,45.0,10761.165,10552.5,-1132.0,-1018.0,6.0,1.0,0.0,,,,,,,,,,,,,,,,,,,,,8350789086.0,184471072105.5,165649062564.0,51996612655.935,1863.0,1706.0,71125.0,70875.0,9140.0,506320.0,17817.837200002294,17880.033299999104,17331.249599998024,11301.033800000096,11238.835500000096,11186.181200000055,128487.0,663153.0,4140.319900000116,4138.006100000017,3948.5789000000927,13534003.23561604,,-922341464.0,-296659054.0,-1535902192.0416667,44036.0,30718.0,11355.713999999189,11231.65999999898,10715.778199997292,22900.10560000973,22821.89130000969,22207.173300008257,,158114.8134489782,126167.57815695484,35019.85750002795,34960.03370002839,34405.467800028804,22965.9734999959,22939.02529999548,22585.78939999571,3715955.0,8300.106800000161,8404.687000000074,8128.1919000002335,9822.491400000716,9937.45210000216,10297.378899999643,16476.600099999738,16661.8958999997,16258.548999999704,828.9254000001768,814.1014000000459,760.0241000000133,3916.075900000125,3899.277400000164,3731.91660000016,436658.0,431451.0,,6428.071589002898,632264.0,625815.0,,16340.9622999998,154260.30669999064,154263.05429999018,154154.78279998715,77652.4863999963,77990.48340000655,78392.03210000657,11.0,61474396.63499997,23804060.17499999,6310286099.2800045,2058684407.4600005,72561181.72499995,710243.0099999999,118.0,13952.0,-20464008.0,9395489.5,-10564979.0,-11493884.0,-5.0,0.0,20.34,159165.0,0.0,0.0,0.0,0.0,0.0,-2342.0,-2016.0,-461.0,-554.0,224100059.625,3187371969.945003,3589885403.100001,50915710.84499995,3187486719.945003,230675.0,-15835388.5,3674633340.5,162163474.0,832763784.5,362029528.5,869187971.5,230024.5,3615.0,641.1388996348543,5305108.5,1887338.0,1163387.0,-3796052.0,1371027.0,101229.0,2534399855.95514,2561989724.820089,-152474054.0,-151224378.0,2704370.0,125079.0,,,,,,,,,,,,,,,,,,,,,1468204.0,14810357.0,3234191.0,8559624.0,11613415.0,1416552.0,1059754301.8245012,801885239.3024951,72144179373.86964,21690486204.97512,583082671.3694987,5792665.7475,689.5,94245.0,-277062394.5,22000949.0,-123844276.0,-218811180.0,-2021210.0,,,,,,,,,,,,,,,,,,,,,4275143.0,2480510.5,-9008187.0,921269.0,37582.5,3735589928.01746,3660283684.23746,-260754629.0,-257441401.0,2527713.0,269335.5,3928252243.567455,33270162155.07841,36700056701.865135,1730298441.217549,48110020909.31321,3990121.5,-247702790.5,103138622958.5,1055137599.5,17282525279.5,3505814035.0,18895999597.0,3673896.0,71965.0,20880.48283508565,89820837.5,,1.267,7.650011953143678,486.1425404196372,9.692565144633036,615.9425987116803,144000.0,0.6234898018587336,0.7818314824680298,0.0,0.0,0.0,0.0,0.0,0.0,1.0,0.0,0.0,1.0,0.0,0.0,0.0,0.0,0.0,0.0,0.0,1.0,0.0,0.0,0.0,0.0,1.0,0.0,0.0,1.0,0.0,0.0,0.0,0.0,0.0,0.0,0.0,0.0,0.0,0.0,0.0,0.0,0.0,0.0,0.0,0.0,0.0,0.0,0.0,0.0,0.0,0.0,0.0,0.0,0.0,0.0,0.0,0.0,0.0,0.0,0.0,0.0,0.0,0.0,0.0,0.0,0.0,0.0,0.0,0.0,0.0,0.0,0.0,0.0,0.0,0.0,0.0,0.0,0.0,0.0,0.0,0.0,0.0,0.0,0.0,0.0,0.0,0.0,0.0,0.0,0.0,0.0,0.0,0.0,0.0,0.0,0.0,0.0,0.0,0.0,0.0,0.0,0.0,0.0,0.0,0.0,0.0,0.0,0.0,1.0,0.0,0.0,0.0,1.0,1.0,0.0,0.0,0.0,0.0,0.0,0.0,0.0,1.0,0.0
103812,0,0.0,0.0,0.0,1.0,0.0,94500.0,296280.0,18256.5,225000.0,0.020713,66.97534246575343,,-2746.0,-4570.0,,1.0,3.0,1.0,7.0,,0.3365913282616973,,0.0814,0.0806,0.9771,,,0.0,0.1379,0.1667,,0.0364,,0.0694,,0.0022,0.083,0.0837,0.9772,,,0.0,0.1379,0.1667,,0.0372,,0.0723,,0.0023,0.0822,0.0806,0.9771,,,0.0,0.1379,0.1667,,0.037,,0.0706,,0.0023,0.0551,1.0,1.0,1.0,1.0,1.0,-936.0,,,,,,,1.0,0.0,0.0,1.0,0.0,0.0,0.0,0.0,0.0,0.0,0.0,0.0,0.0,0.0,0.0,0.0,1.0,0.0,0.0,0.0,0.0,0.0,0.0,0.0,0.0,0.0,0.0,0.0,0.0,0.0,0.0,0.0,0.0,,,,,,,,,,,,,0.0,,6.0,15637.68,58831.335,56590.335,0.0,111213.0,8.0,-557.5,365243.0,-646.5,-466.5,-436.5,-459.0,7.5,0.0,0.0,35.5,41.0,10.0,6.5,-15.0,0.0,0.0,36.0,16293.15,16293.15,-441.5,-415.0,5.0,1.0,0.0,,,,,,,,,,,,,,,,,,,,,8350807342.5,184471368385.5,165649287564.0,51996707155.935,,,,,,,17817.918600002293,17880.115499999105,17331.332599998022,11301.114400000097,11238.916100000097,11186.264900000057,128487.0,663154.0,,,,13534070.210958503,,-922346034.0,-296659990.0,-1535904938.0416667,44037.0,30719.0,11355.713999999189,11231.65999999898,10715.778199997292,22900.243500009725,22822.029200009696,22207.311200008266,,158115.15004030647,,35020.024200027954,34960.200400028385,34405.634500028806,,,,3715962.0,8300.143200000162,8404.724000000075,8128.229100000231,,,,16476.669499999738,16661.9664999997,16258.621299999702,,,,3916.078100000124,3899.279700000164,3731.91890000016,436659.0,431452.0,,6428.092302002898,632267.0,625816.0,,16341.0173999998,154261.28379999063,154264.0313999902,154155.75999998717,,,,,,,,,,,,,,,,,,,,,,,,,,,,,,224399123.4824999,3189803460.615003,3592613475.270001,50948875.84499995,3189984468.615003,230824.0,-15846979.5,3678650548.5,162155178.0,833852747.0,362389819.5,870276990.0,230238.5,3619.0,641.4221878367614,5305524.5,1888515.0,1164034.5,-3798516.0,1371027.0,101229.0,2536460507.1601377,2564041836.6450863,-152550214.0,-151298942.5,2705353.5,125180.5,,,,,,,,,,,,,,,,,,,,,1468204.0,14810357.0,3234191.0,8559665.0,11613451.0,1416558.0,,,,,,,,,,,,,,,,,,,,,,,,,,,,,,,,,,4275153.0,2480517.0,-9008202.0,921269.0,37582.5,3735606221.167461,3660299977.38746,-260755070.5,-257441816.0,2527718.0,269336.5,3928267881.247455,33270220986.41341,36700113292.20013,1730298441.217549,48110132122.31321,3990129.5,-247703348.0,103138988201.5,1055136953.0,17282524813.0,3505813598.5,18895999138.0,3673903.5,71965.0,20880.48283508565,89820873.0,,3.1352380952380954,5.176238599950702,346.68035291615035,16.228740448607347,1086.925449333302,94500.0,-0.9009688679024191,0.4338837391175582,0.0,0.0,0.0,0.0,0.0,0.0,1.0,0.0,0.0,1.0,0.0,0.0,0.0,0.0,0.0,0.0,0.0,0.0,1.0,0.0,0.0,1.0,0.0,0.0,0.0,1.0,0.0,0.0,0.0,0.0,0.0,0.0,0.0,0.0,0.0,0.0,0.0,0.0,0.0,0.0,0.0,0.0,0.0,0.0,0.0,0.0,0.0,0.0,0.0,0.0,0.0,0.0,0.0,0.0,0.0,0.0,0.0,0.0,0.0,0.0,0.0,0.0,0.0,0.0,0.0,0.0,0.0,0.0,0.0,0.0,0.0,0.0,0.0,0.0,0.0,0.0,0.0,0.0,0.0,0.0,0.0,0.0,0.0,0.0,0.0,0.0,0.0,0.0,0.0,0.0,0.0,0.0,0.0,0.0,0.0,0.0,0.0,0.0,0.0,0.0,0.0,0.0,0.0,0.0,0.0,1.0,0.0,0.0,0.0,0.0,1.0,0.0,0.0,0.0,0.0,0.0,0.0,1.0,0.0,0.0
103813,0,0.0,0.0,0.0,1.0,0.0,211500.0,550980.0,30897.0,450000.0,0.00496,37.48219178082192,-868.0,-350.0,-256.0,,2.0,2.0,2.0,9.0,0.4649146778500423,0.3363911554713775,,0.0724,,0.9831,,,,0.069,0.1667,,,,,,,0.063,,0.9821,,,,0.069,0.1667,,,,,,,0.0656,,0.9831,,,,0.069,0.1667,,,,,,,0.0277,1.0,0.0,0.0,0.0,0.0,-817.0,0.0,0.0,0.0,0.0,0.0,0.0,1.0,1.0,0.0,1.0,0.0,0.0,0.0,0.0,0.0,1.0,1.0,1.0,0.0,1.0,0.0,0.0,0.0,0.0,0.0,0.0,0.0,0.0,0.0,0.0,0.0,0.0,0.0,0.0,0.0,0.0,0.0,0.0,3.0,40275.0,0.0,1323000.0,926989.47,0.0,0.0,0.0,0.0,-424.0,1407.0,-22.0,-80.0,42.0,-6.5,2.0,28489.905,85837.5,475701.75,0.0,171675.0,6.0,-928.0,365243.0,-1045.0,-715.0,-715.0,-709.0,12.5,0.0,0.0,15.5,13.0,12.0,6.0,-29.0,0.0,0.0,12.0,18729.81,18729.81,-888.0,-880.0,6.5,1.0,0.0,,,,,,,,,,,,,,,,,,,,,8350838239.5,184471919365.5,165649737564.0,51996918655.935,1863.0,1706.0,71125.0,70875.0,9140.0,506320.0,17817.991000002294,17880.18109999911,17331.395599998017,,,,128487.0,663156.0,,,,13534107.693150286,-602258859.0,-922346290.0,-296660807.0,-1535905288.0416667,44037.0,30719.0,,,,22900.31250000973,22822.098200009696,22207.380200008258,67508.58498313089,158115.48643146193,,35020.19090002796,34960.3671000284,34405.801200028814,,,,3715971.0,,,,,,,,,,,,,,,,436659.0,431452.0,,6428.097262002898,632269.0,625818.0,,16341.0450999998,154262.26689999065,154265.01449999018,154156.74209998714,,,,14.0,61603669.61999997,23804070.34499999,6317157450.7800045,2061751451.9400003,72561181.72499995,710382.5099999999,118.0,14057.0,-20479003.0,9395649.0,-10571330.0,-11501482.0,-6.5,31144.5,0.0,1323000.0,926989.47,0.0,0.0,0.0,0.0,-424.0,1407.0,-22.0,-80.0,224474701.0049999,3190224224.115003,3593822848.020001,50957416.84499995,3190310061.615003,230839.0,-15850288.0,3679563656.0,162152857.0,833851643.0,362388147.0,870275894.0,230279.5,3619.0,641.526155976056,5305770.0,1888830.0,1164225.0,-3799141.0,1371027.0,101229.0,2536948849.1401386,2564530178.6250877,-152565382.5,-151313757.5,2705511.5,125206.5,,,,,,,,,,,,,,,,,,,,,1468207.0,14810399.0,3234191.0,8559678.0,11613463.0,1416560.0,1059794576.8245012,801885239.3024951,72145502373.86964,21691413194.44512,583082671.3694987,5792665.7475,689.5,94245.0,-277062818.5,22002356.0,-123844298.0,-218811260.0,-2021216.5,,,,,,,,,,,,,,,,,,,,,4275165.0,2480523.0,-9008231.0,921269.0,37582.5,3735624950.977461,3660318707.19746,-260755958.5,-257442696.0,2527724.5,269337.5,3928296371.152455,33270306823.91341,36700588993.95013,1730298441.217549,48110303797.31321,3990135.5,-247704276.0,103139353444.5,1055135908.0,17282524098.0,3505812883.5,18895998429.0,3673916.0,71965.0,20880.48283508565,89820888.5,-23.157663913456613,2.6051063829787235,6.845324788814447,256.5777765363575,17.832799300903,668.4124033853534,105750.0,0.6234898018587336,0.7818314824680298,0.0,0.0,0.0,0.0,0.0,0.0,1.0,0.0,0.0,0.0,1.0,0.0,0.0,0.0,0.0,0.0,1.0,0.0,0.0,0.0,1.0,0.0,0.0,0.0,0.0,1.0,0.0,0.0,0.0,0.0,0.0,0.0,0.0,1.0,0.0,0.0,0.0,0.0,0.0,0.0,0.0,0.0,0.0,0.0,0.0,0.0,0.0,0.0,0.0,0.0,0.0,0.0,0.0,0.0,0.0,0.0,0.0,0.0,0.0,0.0,0.0,0.0,0.0,0.0,0.0,0.0,0.0,0.0,0.0,0.0,0.0,0.0,0.0,0.0,0.0,0.0,1.0,0.0,0.0,0.0,0.0,0.0,0.0,0.0,0.0,0.0,0.0,0.0,0.0,0.0,0.0,0.0,0.0,0.0,0.0,0.0,0.0,0.0,0.0,0.0,0.0,0.0,0.0,0.0,0.0,0.0,0.0,0.0,0.0,0.0,0.0,1.0,0.0,0.0,0.0,0.0,0.0,0.0,1.0,0.0
103814,0,0.0,1.0,1.0,0.0,0.0,135000.0,1022022.0,43429.5,913500.0,0.035792,33.68767123287671,,-2504.0,-4356.0,7.0,1.0,2.0,2.0,18.0,0.2137862379051885,0.5954703083896647,,,,,,,,,,,,,,,,,,,,,,,,,,,,,,,,,,,,,,,,,,,,,,2.0,0.0,2.0,0.0,-484.0,,,,,,,1.0,0.0,0.0,1.0,0.0,0.0,0.0,0.0,0.0,0.0,0.0,0.0,0.0,1.0,0.0,0.0,0.0,0.0,0.0,0.0,0.0,0.0,0.0,0.0,0.0,0.0,0.0,0.0,0.0,0.0,0.0,0.0,0.0,,,,,,,,,,,,,0.0,,2.0,17334.0,76455.0,73730.25,15291.0,152910.0,10.0,-295.0,365243.0,-454.0,-184.0,-184.0,-176.0,13.0,1.0,0.1023234138604503,83.5,11.0,10.0,5.0,-11.0,0.0,0.0,10.0,17334.0,17334.0,-327.5,-319.0,5.5,1.0,0.0,,,,,,,,,,,,,,,,,,,,,8350881669.0,184472941387.5,165650651064.0,51997053655.935,,,,,,,,,,,,,128487.0,663157.0,,,,13534141.38082152,,-922350646.0,-296661291.0,-1535907792.0416667,44037.0,30719.0,,,,,,,67508.79876936879,158116.08190177032,,,,,,,,3715989.0,,,,,,,,,,,,,,,,436661.0,431454.0,1263778.0,6428.133054002898,632271.0,625820.0,,,,,,,,,,,,,,,,,,,,,,,,,,,,,,,,,,,224501399.9099999,3190462971.615003,3594063510.270001,50972707.84499995,3190462971.615003,230855.0,-15851363.0,3679928899.0,162152403.0,833851459.0,362387963.0,870275718.0,230306.0,3620.0,641.6284793899164,5305953.5,1888962.0,1164285.0,-3799375.0,1371027.0,101229.0,2537147200.095138,2564728529.580087,-152572595.5,-151320862.0,2705560.5,125217.5,,,,,,,,,,,,,,,,,,,,,1468207.0,14810399.0,3234191.0,8559689.0,11613473.0,1416562.0,,,,,,,,,,,,,,,,,,,,,,,,,,,,,,,,,,4275175.0,2480528.0,-9008242.0,921269.0,37582.5,3735642284.977461,3660336041.19746,-260756286.0,-257443015.0,2527730.0,269338.5,3928313705.152455,33270383278.91341,36700662724.20013,1730313732.217549,48110456707.31321,3990145.5,-247704571.0,103139718687.5,1055135454.0,17282523914.0,3505812699.5,18895998253.0,3673929.0,71966.0,20880.58515849952,89820972.0,,7.570533333333334,3.108486167236556,104.7176600338101,23.53289814526992,792.7685358746272,135000.0,1.0,0.0,0.0,1.0,0.0,0.0,0.0,0.0,0.0,0.0,0.0,1.0,0.0,0.0,0.0,0.0,0.0,1.0,0.0,0.0,0.0,0.0,0.0,0.0,1.0,0.0,0.0,1.0,0.0,0.0,0.0,0.0,0.0,0.0,0.0,0.0,0.0,0.0,0.0,0.0,0.0,0.0,0.0,0.0,0.0,0.0,0.0,0.0,0.0,0.0,0.0,0.0,0.0,0.0,0.0,0.0,0.0,0.0,0.0,0.0,0.0,0.0,0.0,0.0,0.0,0.0,0.0,0.0,0.0,0.0,0.0,0.0,0.0,0.0,0.0,0.0,0.0,0.0,0.0,0.0,0.0,0.0,0.0,0.0,0.0,0.0,0.0,0.0,0.0,0.0,0.0,0.0,0.0,0.0,0.0,0.0,0.0,0.0,0.0,0.0,0.0,0.0,0.0,0.0,0.0,0.0,0.0,1.0,0.0,0.0,0.0,0.0,0.0,0.0,0.0,0.0,0.0,0.0,0.0,0.0,0.0,0.0
103818,0,0.0,0.0,0.0,0.0,2.0,139500.0,208512.0,21892.5,180000.0,0.026392,35.01917808219178,-393.0,-1875.0,-2711.0,,3.0,2.0,2.0,12.0,0.3186460295296844,0.5769872541949774,0.1500851762342935,,,,,,,,,,,,,,,,,,,,,,,,,,,,,,,,,,,,,,,,,,,,,2.0,1.0,2.0,1.0,-1473.0,0.0,0.0,0.0,0.0,0.0,5.0,1.0,1.0,1.0,1.0,0.0,0.0,0.0,0.0,0.0,1.0,1.0,0.0,0.0,1.0,0.0,0.0,0.0,0.0,0.0,0.0,0.0,0.0,0.0,0.0,0.0,0.0,0.0,0.0,0.0,0.0,0.0,0.0,4.0,16875.0,0.0,35374.5,9157.5,0.0,0.0,0.0,0.0,-716.5,-509.0,-268.0,-578.5,100.0,-14.0,8.0,26762.805,106686.0,139455.0,0.0,135000.0,9.0,-728.5,365243.0,-716.5,-371.5,-296.5,-365.0,14.0,0.5,0.0,2.0,40.0,12.0,8.0,-24.5,0.0,0.0,39.0,21421.755,21421.755,-529.0,-490.0,7.0,2.0,27.0,0.0,450000.0,,0.0,,,0.0,,0.0,0.0,0.0,0.0,,0.0,,,0.0,-14.0,0.0,0.0,8350903561.5,184473149899.5,165650831064.0,51997193155.935,1863.0,1706.0,71125.0,70875.0,9140.0,506325.0,,,,,,,128489.0,663160.0,,,,13534176.3999996,-602259252.0,-922353357.0,-296662764.0,-1535909667.0416667,44038.0,30720.0,,,,,,,67509.11741539832,158116.65888902452,126167.72824213108,,,,,,,3716001.0,,,,,,,,,,,,,,,,436663.0,431456.0,,6428.159446002896,632273.0,625822.0,,,,,,,,,24.0,61663116.86999997,23804070.34499999,6321273234.840005,2063366990.9100003,72561181.72499995,710382.5099999999,118.0,14057.0,-20499511.0,9389350.0,-10583300.5,-11514547.0,-11.5,33750.0,0.0,37089.0,18315.0,0.0,0.0,0.0,0.0,-740.0,-509.0,-29.0,-648.0,224812739.385,3194104812.615003,3598505419.770001,50992057.84499995,3194121642.615003,231089.0,-15867792.5,3684127861.5,162507087.5,834211082.5,363115134.5,870635416.5,230586.5,3626.5,641.7381587872907,5314829.5,1891893.0,1166252.0,-3802137.5,1371027.0,101229.0,2541945427.8751373,2569635270.315085,-152697202.0,-151443650.0,2709508.0,125437.0,2396414576.699987,6466135500.0,,315649681.3349996,,,136226947.49999964,,318054048.9299997,2301009985.439996,2387288016.4499817,2387375318.3849816,,27332.0,,,771810.0,-1373379.0,576411.0,1278.0,1468211.0,14810499.0,3234218.0,8559729.0,11613512.0,1416570.0,1059811451.8245012,801885239.3024951,72145537748.36964,21691422351.94512,583082671.3694987,5792665.7475,689.5,94245.0,-277063535.0,22001847.0,-123844566.0,-218811838.5,-2021230.5,5925805259.579961,18733315500.0,,448214504.2424976,,,309257532.29249865,,459367252.9649993,5710866498.000032,5889070912.432498,5889314095.177499,,80921.0,,,971817.5,-1699342.0,177364.0,6755.0,4275187.0,2480536.0,-9008266.5,921269.0,37582.5,3735663706.732461,3660357462.95246,-260756815.0,-257443505.0,2527737.0,269340.5,3928340467.957455,33270489964.91341,36700802179.20013,1730313732.217549,48110591707.31321,3990154.5,-247705299.5,103140083930.5,1055134737.5,17282523542.5,3505812403.0,18895997888.0,3673943.0,71966.5,20880.58515849952,89820974.0,-11.222422156157096,1.494709677419355,6.3720452209660845,223.1437863407904,9.524357656731755,333.5351768995762,46500.0,1.0,0.0,0.0,0.0,0.0,0.0,0.0,0.0,1.0,0.0,0.0,0.0,0.0,0.0,0.0,1.0,0.0,0.0,0.0,0.0,1.0,0.0,0.0,1.0,0.0,0.0,0.0,1.0,0.0,0.0,0.0,0.0,0.0,0.0,0.0,0.0,0.0,0.0,0.0,0.0,1.0,0.0,0.0,0.0,0.0,0.0,0.0,0.0,0.0,0.0,0.0,0.0,0.0,0.0,0.0,0.0,0.0,0.0,0.0,0.0,0.0,0.0,0.0,0.0,0.0,0.0,0.0,0.0,0.0,0.0,0.0,0.0,1.0,0.0,0.0,0.0,0.0,0.0,0.0,0.0,0.0,0.0,0.0,0.0,0.0,0.0,0.0,0.0,0.0,0.0,0.0,0.0,0.0,0.0,0.0,0.0,0.0,0.0,0.0,0.0,0.0,0.0,0.0,0.0,0.0,0.0,0.0,0.0,0.0,0.0,0.0,0.0,0.0,0.0,0.0,0.0,0.0,0.0,0.0,0.0,0.0,0.0
103824,0,0.0,0.0,1.0,1.0,1.0,112500.0,427500.0,27450.0,427500.0,0.028663,26.405479452054795,-483.0,-3760.0,-2081.0,4.0,3.0,2.0,2.0,11.0,0.8594172388769279,0.6152095365675769,0.5673792367572691,,0.0824,0.9786,,,,0.1379,0.1667,,,,0.0642,,,,0.0855,0.9786,,,,0.1379,0.1667,,,,0.0669,,,,0.0824,0.9786,,,,0.1379,0.1667,,,,0.0654,,,0.0719,1.0,6.0,0.0,6.0,0.0,0.0,0.0,0.0,0.0,0.0,0.0,0.0,1.0,1.0,0.0,1.0,0.0,0.0,0.0,0.0,0.0,0.0,0.0,0.0,0.0,1.0,0.0,0.0,0.0,0.0,0.0,0.0,0.0,0.0,0.0,0.0,0.0,0.0,0.0,0.0,0.0,0.0,0.0,0.0,1.0,3150.0,0.0,31500.0,8932.5,22564.395,0.0,0.0,0.0,-814.0,,-24.0,,27.0,-13.0,8.0,5751.1575,46773.0,47695.5,2025.0,46773.0,11.0,-743.5,365243.0,-712.5,-389.5,-325.5,-384.0,11.0,0.0,0.0526274421614375,71.0,81.0,12.0,6.0,-20.0,0.0,0.0,71.0,6190.38,6190.38,-619.0,-610.0,5.0,1.0,0.0,,,,,,,,,,,,,,,,,,,,,8350931011.5,184473577399.5,165651258564.0,51997305655.935,1863.0,1706.0,71125.0,70875.0,9140.0,506325.0,,,,11301.196800000096,11238.998500000096,11186.350400000054,128490.0,663163.0,,,,13534202.805479052,-602259735.0,-922355438.0,-296662764.0,-1535913427.0416667,44038.0,30720.0,,,,22900.450400009733,22822.236100009697,22207.518100008263,67509.9768326372,158117.2740985611,126168.29562136786,35020.357600027965,34960.533800028395,34405.967900028816,,,,3716012.0,,,,,,,16476.733699999742,16662.0318999997,16258.688199999702,,,,,,,436669.0,431462.0,1263782.0,6428.188109002896,632275.0,625824.0,,16341.116999999802,154263.24549999065,154265.99309999018,154157.72069998714,,,,27.0,61949955.82499996,23831522.369999982,6337983843.540005,2075416784.9100003,72672462.94499995,710382.5099999999,118.0,14057.0,-20519559.0,,-10593689.0,,-13.0,3150.0,0.0,31500.0,8932.5,22564.395,0.0,0.0,0.0,-814.0,,-24.0,,225263490.05249995,3200257112.602504,3605103326.272501,51085429.82999995,3200257112.602504,231610.0,-15891158.5,3692893693.5,163220937.5,836389410.0,363839817.0,872448511.0,231032.5,3635.0,642.9304312327115,5317576.5,1896107.0,1169269.0,-3807910.0,1371027.0,101229.0,2547656075.6551437,2575466104.455092,-152857428.0,-151599870.0,2710739.0,125683.0,,,,,,,,,,,,,,,,,,,,,1468212.0,14810526.0,3234218.0,8559810.0,11613583.0,1416578.0,1059814601.8245012,801885239.3024951,72145569248.36964,21691431284.44512,583105235.7644987,5792665.7475,689.5,94245.0,-277064349.0,,-123844590.0,,-2021243.5,,,,,,,,,,,,,,,,,,,,,4275199.0,2480542.0,-9008286.5,921269.0,37582.5,3735669897.112461,3660363653.332461,-260757434.0,-257444115.0,2527742.0,269341.5,3928346219.1149545,33270536737.91341,36700849874.70013,1730315757.217549,48110638480.31321,3990165.5,-247706043.0,103140449173.5,1055134025.0,17282523153.0,3505812077.5,18895997504.0,3673954.0,71966.5,20880.637785941675,89821045.0,-18.29165802033617,3.8,4.0983606557377055,108.21917808219176,15.57377049180328,411.2328767123288,37500.0,-0.2225209339563146,-0.9749279121818236,0.0,0.0,0.0,0.0,0.0,0.0,1.0,0.0,0.0,0.0,0.0,0.0,0.0,1.0,0.0,0.0,0.0,0.0,1.0,0.0,1.0,0.0,0.0,0.0,0.0,0.0,0.0,0.0,0.0,1.0,0.0,0.0,0.0,0.0,0.0,0.0,0.0,0.0,0.0,0.0,0.0,0.0,0.0,0.0,1.0,0.0,0.0,0.0,0.0,0.0,0.0,0.0,0.0,0.0,0.0,0.0,0.0,0.0,0.0,0.0,0.0,0.0,0.0,0.0,0.0,0.0,0.0,0.0,0.0,0.0,0.0,0.0,0.0,0.0,0.0,0.0,0.0,0.0,0.0,0.0,0.0,0.0,0.0,0.0,0.0,0.0,0.0,0.0,0.0,0.0,1.0,0.0,0.0,0.0,0.0,0.0,0.0,0.0,0.0,0.0,0.0,0.0,0.0,0.0,0.0,0.0,0.0,0.0,0.0,0.0,0.0,0.0,0.0,0.0,0.0,0.0,0.0,0.0,1.0,0.0
103828,0,0.0,0.0,0.0,0.0,0.0,135000.0,260640.0,26838.0,225000.0,0.019101,67.10958904109589,,-9212.0,-4568.0,,2.0,2.0,2.0,9.0,,0.6295114415591485,0.646329897706246,0.0567,0.0582,0.9881,0.8368,0.0202,0.0,0.1034,0.1667,0.2083,0.0105,0.0462,0.0601,0.0,0.0,0.0578,0.0604,0.9881,0.8432,0.0204,0.0,0.1034,0.1667,0.2083,0.0107,0.0505,0.0626,0.0,0.0,0.0573,0.0582,0.9881,0.8390000000000001,0.0203,0.0,0.1034,0.1667,0.2083,0.0106,0.047,0.0612,0.0,0.0,0.0583,1.0,0.0,0.0,0.0,0.0,-1335.0,0.0,0.0,0.0,0.0,0.0,3.0,1.0,0.0,0.0,1.0,1.0,0.0,0.0,0.0,0.0,0.0,0.0,0.0,0.0,1.0,0.0,0.0,0.0,0.0,0.0,0.0,0.0,0.0,0.0,0.0,0.0,0.0,0.0,0.0,0.0,0.0,0.0,0.0,10.0,0.0,0.0,111649.5,0.0,0.0,0.0,0.0,0.0,-1725.0,-1000.0,-976.5,-1000.0,533.0,-28.0,8.0,14542.8525,225000.0,254520.0,0.0,225000.0,24.0,-884.0,365243.0,-994.0,-615.0,-304.0,-598.0,10.0,1.0,0.0,-1.0,130.0,24.0,12.0,-27.0,0.0,0.0,129.0,16293.15,16293.15,-764.0,-765.0,9.0,1.0,0.0,,,,,,,,,,,,,,,,,,,,,8350957849.5,184473838039.5,165651483564.0,51997440655.935,1863.0,1706.0,71125.0,70875.0,9140.0,506328.0,17818.047700002295,17880.23839999911,17331.453399998016,11301.255000000096,11239.056700000096,11186.410800000054,128490.0,663165.0,4140.340100000116,4138.026400000017,3948.5993000000926,13534269.915068092,,-922360006.0,-296664099.0,-1535922639.0416667,44038.0,30720.0,11355.713999999189,11231.65999999898,10715.778199997292,22900.553800009733,22822.339500009697,22207.621500008263,,158117.90361000266,126168.94195126551,35020.524300027966,34960.7005000284,34406.13460002881,22966.1817999959,22939.233599995478,22585.997699995707,3716021.0,8300.153700000164,8404.734600000074,8128.239800000232,9822.537600000718,9937.499100002162,10297.429399999644,16476.793799999738,16662.0930999997,16258.7507999997,828.9254000001768,814.1014000000459,760.0241000000133,3916.078100000124,3899.279700000164,3731.91890000016,436669.0,431462.0,,6428.207210002896,632277.0,625826.0,,16341.175299999804,154264.23359999064,154266.9811999902,154158.70879998713,77653.3231999963,77991.32240000655,78392.87530000658,57.0,62043569.32499996,23831522.369999982,6342819045.390004,2076126326.01,72672462.94499995,710382.5099999999,118.0,14057.0,-20563030.5,9462843.0,-10613457.5,-11548332.0,-28.0,0.0,0.0,122400.0,0.0,0.0,0.0,0.0,0.0,-1902.0,-1136.0,-997.0,-1000.0,225451087.83,3203331308.145004,3608376021.315001,51134151.32999995,3203331308.145004,231859.0,-15908241.0,3697456678.0,163204871.0,838204703.0,364197964.0,874263859.0,231207.5,3641.0,643.7873484460694,5321051.5,1900413.0,1171840.0,-3812779.0,1371027.0,101229.0,2551578907.680155,2579381032.2301025,-153195321.0,-151935159.0,2722099.0,125926.0,,,,,,,,,,,,,,,,,,,,,1468222.0,14811059.0,3234218.0,8559940.0,11613712.0,1416586.0,1059814601.8245012,801885239.3024951,72145680897.86964,21691431284.44512,583105235.7644987,5792665.7475,689.5,94245.0,-277066074.0,22000847.0,-123845566.5,-218812838.5,-2021271.5,,,,,,,,,,,,,,,,,,,,,4275223.0,2480554.0,-9008313.5,921269.0,37582.5,3735686190.2624607,3660379946.482461,-260758198.0,-257444880.0,2527751.0,269342.5,3928360761.967455,33270761737.91341,36701104394.70013,1730315757.217549,48110863480.31321,3990189.5,-247706927.0,103140814416.5,1055133031.0,17282522538.0,3505811773.5,18895996906.0,3673964.0,71967.5,20880.637785941675,89821044.0,,1.9306666666666668,5.030181086519113,337.5733855185909,9.711602951039572,651.7416829745598,67500.0,-0.2225209339563143,0.9749279121818236,0.0,0.0,0.0,0.0,0.0,0.0,1.0,0.0,0.0,1.0,0.0,0.0,0.0,0.0,0.0,0.0,0.0,0.0,1.0,0.0,1.0,0.0,0.0,0.0,0.0,1.0,0.0,0.0,0.0,0.0,0.0,0.0,0.0,0.0,0.0,0.0,0.0,0.0,0.0,0.0,0.0,0.0,0.0,0.0,0.0,0.0,0.0,0.0,0.0,0.0,0.0,0.0,0.0,0.0,0.0,0.0,0.0,0.0,0.0,0.0,0.0,0.0,0.0,0.0,0.0,0.0,0.0,0.0,0.0,0.0,0.0,0.0,0.0,0.0,0.0,0.0,0.0,0.0,0.0,0.0,0.0,0.0,0.0,0.0,0.0,0.0,0.0,0.0,0.0,0.0,0.0,0.0,0.0,0.0,0.0,0.0,0.0,0.0,0.0,0.0,0.0,0.0,0.0,0.0,0.0,1.0,0.0,0.0,1.0,0.0,1.0,0.0,0.0,0.0,0.0,0.0,0.0,1.0,0.0,0.0
103830,0,0.0,0.0,0.0,1.0,0.0,135000.0,187659.0,17338.5,162000.0,0.0096569999999999,58.89315068493151,,-1240.0,-3964.0,,1.0,2.0,2.0,10.0,,0.0471979143214871,0.1237353221130787,0.1485,0.1125,0.9806,0.7348,0.0358,0.16,0.1379,0.3333,0.375,0.0818,0.121,0.1584,0.0,0.0,0.1513,0.1168,0.9806,0.7452,0.0361,0.1611,0.1379,0.3333,0.375,0.0836,0.1322,0.1651,0.0,0.0,0.1499,0.1125,0.9806,0.7383,0.036,0.16,0.1379,0.3333,0.375,0.0832,0.1231,0.1613,0.0,0.0,0.1616,1.0,1.0,1.0,1.0,1.0,-1741.0,0.0,0.0,0.0,0.0,1.0,2.0,1.0,0.0,0.0,1.0,0.0,0.0,0.0,0.0,0.0,0.0,0.0,0.0,0.0,1.0,0.0,0.0,0.0,0.0,0.0,0.0,0.0,0.0,0.0,0.0,0.0,0.0,0.0,0.0,0.0,0.0,0.0,0.0,11.0,0.0,0.0,64282.5,0.0,0.0,0.0,0.0,0.0,-304.0,-215.5,-121.0,-280.0,166.0,-9.0,12.0,6918.615,40605.75,44599.5,4.185,86779.95749999999,12.0,-539.5,365243.0,-849.0,-549.0,-519.0,-543.0,13.0,0.0,4.297414203591532e-05,53.0,62.0,12.0,6.0,-31.5,0.0,0.0,92.0,6918.389999999999,4786.29,-716.0,-733.5,7.0,1.0,14.0,72552.4875,270000.0,0.0,0.0,0.0,0.0,1125.0,12016.935,6009.3,67500.0,67840.9875,67840.9875,0.0,0.0,0.0,0.0,5.5,-7.5,0.0,0.0,8350975188.0,184474025698.5,165651645564.0,51997575655.935,1863.0,1706.0,71125.0,70876.0,9140.0,506330.0,17818.196200002294,17880.388299999107,17331.604699998017,11301.367500000091,11239.169200000097,11186.527600000054,128490.0,663166.0,4140.375900000116,4138.062400000017,3948.635400000093,13534328.808218775,,-922363970.0,-296665840.0,-1535923879.0416667,44039.0,30721.0,11355.873999999189,11231.81999999898,10715.939299997292,22900.69170000973,22822.477400009702,22207.75940000826,,158117.950807917,126169.06568658764,35020.857600027965,34961.033800028395,34406.467900028816,22966.5567999959,22939.608599995478,22586.372699995707,3716031.0,8300.235500000164,8404.817800000073,8128.323400000232,9822.658600000716,9937.622200002164,10297.561599999644,16476.952199999738,16662.2543999997,16258.915899999702,828.9254000001768,814.1014000000459,760.0241000000133,3916.078100000124,3899.279700000164,3731.91890000016,436670.0,431463.0,,6428.216867002897,632279.0,625828.0,,16341.336899999802,154265.21419999065,154267.96179999018,154159.68939998714,77654.05799999631,77992.06070000655,78393.62050000657,11.0,62043569.32499996,23831522.369999982,6344623175.490005,2076318552.51,72672462.94499995,710382.5099999999,118.0,14057.0,-20586838.0,9447344.5,-10628560.0,-11562994.5,-5.0,0.0,0.0,64282.5,0.0,0.0,0.0,0.0,0.0,-628.0,-532.0,-351.0,-612.0,225605455.38,3205579984.830004,3610820299.815001,51156385.51499996,3205592899.830004,232129.0,-15931724.0,3702569653.0,163549625.0,838925885.0,364914959.0,874985082.0,231514.5,3647.0,644.4563813355211,5322181.5,1902848.0,1173385.5,-3820618.5,1371027.0,101229.0,2553952350.3301487,2581719161.557598,-153415467.0,-152153568.5,2723220.0,126074.5,2402321096.699989,6480346500.0,203310355.23,315878281.3349996,10556279.1,101719752.79499993,136537947.13499963,346030065.58500034,318770014.45499974,2306595184.6049967,2393187152.3999834,2393274454.334984,10417.0,27368.0,149.0,16802.0,775282.5,-1377406.5,576413.0,1278.0,1468233.0,14811225.0,3234232.0,8560002.0,11613804.0,1416598.0,1059814601.8245012,801885239.3024951,72145745180.36964,21691431284.44512,583105235.7644987,5792665.7475,689.5,94245.0,-277066378.0,22000631.5,-123845687.5,-218813118.5,-2021280.5,5925877812.067461,18733585500.0,198840207.825,448214504.2424976,1948107.735,256951392.6600008,309258657.29249865,636885318.7349979,459373262.2649993,5710933998.000032,5889138753.419997,5889381936.164999,13391.5,80921.0,44.0,70423.5,971823.0,-1699349.5,177364.0,6755.0,4275235.0,2480560.0,-9008345.0,921269.0,37582.5,3735693108.652461,3660384732.772461,-260758914.0,-257445613.5,2527758.0,269343.5,3928367680.5824537,33270802343.66341,36701148994.20013,1730315761.4025495,48110950260.27071,3990201.5,-247707466.5,103141179659.5,1055132182.0,17282521989.0,3505811254.5,18895996363.0,3673977.0,71967.5,20880.637828915816,89821097.0,,1.3900666666666666,7.7861406696080975,458.5503557093032,10.823254606799896,637.4155644596452,135000.0,-0.9009688679024191,0.4338837391175582,0.0,1.0,0.0,0.0,0.0,0.0,0.0,0.0,0.0,1.0,0.0,0.0,0.0,0.0,0.0,0.0,0.0,0.0,1.0,0.0,0.0,0.0,0.0,1.0,0.0,1.0,0.0,0.0,0.0,0.0,0.0,0.0,0.0,0.0,0.0,0.0,0.0,0.0,0.0,0.0,0.0,0.0,0.0,0.0,0.0,0.0,0.0,0.0,0.0,0.0,0.0,0.0,0.0,0.0,0.0,0.0,0.0,0.0,0.0,0.0,0.0,0.0,0.0,0.0,0.0,0.0,0.0,0.0,0.0,0.0,0.0,0.0,0.0,0.0,0.0,0.0,0.0,0.0,0.0,0.0,0.0,0.0,0.0,0.0,0.0,0.0,0.0,0.0,0.0,0.0,0.0,0.0,0.0,0.0,0.0,0.0,0.0,0.0,0.0,0.0,0.0,0.0,0.0,0.0,0.0,1.0,0.0,0.0,1.0,0.0,1.0,0.0,0.0,0.0,0.0,0.0,0.0,1.0,0.0,0.0
103840,0,0.0,0.0,0.0,1.0,0.0,157500.0,799299.0,33993.0,702000.0,0.006233,46.15616438356165,-3471.0,-12053.0,-377.0,,1.0,2.0,2.0,14.0,0.6267890689979498,0.6126750604043834,0.7435593141311444,0.1526,0.0907,0.9831,0.7688,0.0344,0.16,0.1379,0.3333,0.375,0.0833,0.1244,0.1505,0.0,0.0,0.1555,0.0942,0.9831,0.7779,0.0347,0.1611,0.1379,0.3333,0.375,0.0852,0.1359,0.1569,0.0,0.0,0.1541,0.0907,0.9831,0.7719,0.0346,0.16,0.1379,0.3333,0.375,0.0848,0.1266,0.1532,0.0,0.0,0.1372,1.0,2.0,0.0,2.0,0.0,-1621.0,0.0,0.0,0.0,0.0,0.0,0.0,1.0,1.0,0.0,1.0,0.0,1.0,0.0,0.0,0.0,0.0,0.0,0.0,0.0,1.0,0.0,0.0,0.0,0.0,0.0,0.0,0.0,0.0,0.0,0.0,0.0,0.0,0.0,0.0,0.0,0.0,0.0,0.0,0.0,,,,,,,,,,,,,0.0,,2.0,28651.8375,262284.75,285250.5,0.0,262284.75,12.0,-1229.0,365243.0,-1196.5,-896.5,-866.5,-893.5,13.5,0.5,0.0,710.5,24.0,12.0,6.5,-42.5,0.0,0.0,22.0,27984.015,27984.015,-1283.5,-1271.0,6.0,1.0,0.0,,,,,,,,,,,,,,,,,,,,,8351009181.0,184474824997.5,165652347564.0,51997733155.935,1863.0,1706.0,71125.0,70876.0,9140.0,506330.0,17818.348800002295,17880.542399999107,17331.760199998018,11301.458200000096,11239.259900000096,11186.621800000054,128490.0,663167.0,4140.410300000115,4138.097000000017,3948.6701000000926,13534374.96438316,-602263206.0,-922364347.0,-296667461.0,-1535935932.0416667,44039.0,30721.0,11356.033999999188,11231.97999999898,10716.10039999729,22900.829600009736,22822.615300009704,22207.897300008262,67510.60362170619,158118.5634829774,126169.80924590176,35021.19090002796,34961.3671000284,34406.801200028814,22966.9317999959,22939.983599995478,22586.747699995707,3716045.0,8300.318800000163,8404.902600000074,8128.4086000002335,9822.783000000718,9937.748800002162,10297.697499999644,16477.102699999738,16662.4075999997,16259.072799999702,828.9254000001768,814.1014000000459,760.0241000000133,3916.078100000124,3899.279700000164,3731.91890000016,436672.0,431465.0,,6428.223100002897,632281.0,625830.0,,16341.4740999998,154266.19729999066,154268.94489999022,154160.67249998715,77654.82679999631,77992.83260000656,78394.39840000657,,,,,,,,,,,,,,,,,,,,,,,,,,,226102801.1625,3211331580.8100038,3618409804.065001,51279649.24499995,3211331580.8100038,232605.0,-15960115.5,3710419645.5,163527258.0,840367494.0,366000916.0,876428059.0,231912.0,3657.0,645.5077604779748,5336472.0,1906599.0,1175764.0,-3826453.0,1371130.0,101325.0,2560765594.522649,2589511236.907596,-153729376.5,-152464928.0,2727656.0,126423.5,,,,,,,,,,,,,,,,,,,,,1468233.0,14811225.0,3234232.0,8560026.0,11613826.0,1416600.0,,,,,,,,,,,,,,,,,,,,,,,,,,,,,,,,,,4275247.0,2480566.5,-9008387.5,921269.0,37582.5,3735721092.667461,3660412716.78746,-260760197.5,-257446884.5,2527764.0,269344.5,3928396332.419953,33271064628.41341,36701434244.70013,1730315761.4025495,48111212545.02071,3990213.5,-247708695.5,103141544902.5,1055130985.5,17282521092.5,3505810388.0,18895995469.5,3673990.5,71968.0,20880.637828915816,89821807.5,-75.20122276963258,5.074914285714286,4.633306857294148,213.8556729447521,23.51363516018004,1085.2992097083647,157500.0,1.0,0.0,0.0,0.0,0.0,0.0,0.0,0.0,1.0,0.0,1.0,0.0,0.0,0.0,0.0,0.0,0.0,0.0,0.0,0.0,1.0,0.0,0.0,0.0,1.0,0.0,0.0,1.0,0.0,0.0,0.0,0.0,0.0,0.0,0.0,1.0,0.0,0.0,0.0,0.0,0.0,0.0,0.0,0.0,0.0,0.0,0.0,0.0,0.0,0.0,0.0,0.0,0.0,0.0,0.0,0.0,0.0,0.0,0.0,0.0,0.0,0.0,0.0,0.0,0.0,0.0,0.0,0.0,0.0,0.0,0.0,0.0,0.0,0.0,0.0,0.0,1.0,0.0,0.0,0.0,0.0,0.0,0.0,0.0,0.0,0.0,0.0,0.0,0.0,0.0,0.0,0.0,0.0,0.0,0.0,0.0,0.0,0.0,0.0,0.0,0.0,0.0,0.0,0.0,0.0,0.0,0.0,0.0,0.0,0.0,0.0,1.0,1.0,0.0,0.0,0.0,0.0,0.0,0.0,1.0,0.0,0.0
103842,0,0.0,1.0,0.0,1.0,0.0,225000.0,450000.0,35554.5,450000.0,0.032561,26.641095890410963,-1046.0,-8058.0,-2327.0,,2.0,1.0,1.0,15.0,0.1754495689859576,0.5029539727860056,0.6246146584503397,0.0536,0.0892,0.9498,0.3132,0.0281,0.08,0.1379,0.25,0.2917,,0.0378,0.0866,0.027,0.0996,0.0546,0.0925,0.9499,0.3401,0.0283,0.0806,0.1379,0.25,0.2917,,0.0413,0.0902,0.0272,0.1054,0.0541,0.0892,0.9498,0.3224,0.0282,0.08,0.1379,0.25,0.2917,,0.0385,0.0881,0.0272,0.1017,0.0897,1.0,0.0,0.0,0.0,0.0,-76.0,0.0,0.0,0.0,0.0,0.0,2.0,1.0,1.0,1.0,1.0,1.0,0.0,0.0,0.0,0.0,0.0,0.0,0.0,0.0,1.0,0.0,0.0,0.0,0.0,0.0,0.0,0.0,0.0,0.0,0.0,0.0,0.0,0.0,0.0,0.0,0.0,0.0,0.0,2.0,0.0,11.07,78268.5,0.0,0.0,0.0,0.0,0.0,-1192.5,-929.0,-860.0,-867.0,79.0,-19.0,3.0,19199.43,243000.0,243000.0,6639.75,243000.0,24.0,-740.0,365243.0,-710.0,-530.0,-20.0,-524.0,17.0,0.0,0.0462179998378911,1215.0,36.0,24.0,12.5,-43.5,0.0,0.0,34.0,9406.98,9406.98,-1312.0,-1315.0,8.5,1.0,0.0,,,,,,,,,,,,,,,,,,,,,8351044735.5,184475274997.5,165652797564.0,51997958155.935,1863.0,1706.0,71125.0,70876.0,9140.0,506332.0,17818.402400002295,17880.59649999911,17331.814799998017,11301.547400000096,11239.349100000096,11186.714300000054,128490.0,663169.0,4140.438400000116,4138.125200000017,3948.698400000093,13534401.60547905,-602264252.0,-922366674.0,-296667537.0,-1535943990.0416667,44039.0,30721.0,11356.113999999186,11232.05999999898,10716.18099999729,22900.967500009738,22822.7532000097,22208.03520000826,67510.77907127517,158119.06643695018,126170.4338605602,35021.44090002796,34961.6171000284,34407.051200028814,22967.2234999959,22940.27529999548,22587.03939999571,3716060.0,,,,9822.820800000718,9937.787300002165,10297.738799999644,16477.189299999736,16662.4956999997,16259.162999999702,828.9524000001767,814.1286000000459,760.0513000000133,3916.177700000124,3899.381400000165,3732.02430000016,436672.0,431465.0,,6428.255661002897,632282.0,625831.0,,16341.563799999802,154267.14709999063,154269.89469999023,154161.62239998716,77655.13999999633,77993.15500000656,78394.73850000657,39.5,62332939.52999996,23881633.10999999,6367352561.415007,2085931298.9700005,72863632.48499994,710382.5099999999,118.0,14057.0,-20627268.5,9459881.0,-10648555.0,-11582186.0,-19.25,0.0,11.07,77787.0,0.0,0.0,0.0,0.0,0.0,-1234.0,-929.0,-916.0,-928.0,226300848.75,3214170588.0600038,3621461706.315001,51300574.24499995,3214170588.0600038,232841.0,-15976153.0,3713889454.0,163511515.0,840721433.0,365991988.0,876782079.0,232028.0,3659.0,645.7030002697803,5342276.0,1910667.0,1178274.5,-3832755.0,1371156.0,101340.0,2564675662.5901585,2593101198.285105,-153933741.5,-152661942.0,2729291.5,126575.5,,,,,,,,,,,,,,,,,,,,,1468235.0,14811304.0,3234232.0,8560062.0,11613860.0,1416603.0,1059814601.8245012,801885250.3724952,72145823448.86964,21691431284.44512,583105235.7644987,5792665.7475,689.5,94245.0,-277067570.5,21999702.5,-123846547.5,-218813985.5,-2021299.5,,,,,,,,,,,,,,,,,,,,,4275271.0,2480579.0,-9008431.0,921269.0,37582.5,3735730499.647461,3660422123.76746,-260761509.5,-257448199.5,2527772.5,269345.5,3928415531.849954,33271307628.41341,36701677244.70013,1730322401.1525495,48111455545.02071,3990237.5,-247709435.5,103141910145.5,1055130275.5,17282520562.5,3505810368.0,18895994945.5,3674007.5,71968.0,20880.684046915656,89823022.5,-39.26264911559029,2.0,6.328312871788381,168.59319004183624,12.656625743576765,337.1863800836725,112500.0,-0.2225209339563146,-0.9749279121818236,0.0,1.0,0.0,0.0,0.0,0.0,0.0,0.0,0.0,0.0,0.0,0.0,0.0,1.0,0.0,0.0,0.0,0.0,1.0,0.0,1.0,0.0,0.0,0.0,0.0,1.0,0.0,0.0,0.0,0.0,0.0,0.0,0.0,0.0,0.0,0.0,0.0,0.0,1.0,0.0,0.0,0.0,0.0,0.0,0.0,0.0,0.0,0.0,0.0,0.0,0.0,0.0,0.0,1.0,0.0,0.0,0.0,0.0,0.0,0.0,0.0,0.0,0.0,0.0,0.0,0.0,0.0,0.0,0.0,0.0,0.0,0.0,0.0,0.0,0.0,0.0,0.0,0.0,0.0,0.0,0.0,0.0,0.0,0.0,0.0,0.0,0.0,0.0,0.0,0.0,0.0,0.0,0.0,0.0,0.0,0.0,0.0,0.0,0.0,0.0,0.0,0.0,0.0,0.0,0.0,0.0,0.0,0.0,1.0,0.0,1.0,0.0,0.0,0.0,0.0,0.0,0.0,0.0,1.0,0.0
103847,0,0.0,0.0,0.0,1.0,1.0,261000.0,792162.0,40576.5,630000.0,0.018634,48.50684931506849,-2437.0,-8553.0,-363.0,,3.0,2.0,2.0,9.0,0.4987387720039155,0.5907207139267104,0.1714683668967994,,,,,,,,,,,,,,,,,,,,,,,,,,,,,,,,,,,,,,,,,,,,,0.0,0.0,0.0,0.0,0.0,0.0,0.0,0.0,0.0,1.0,4.0,1.0,1.0,0.0,1.0,0.0,0.0,1.0,1.0,0.0,0.0,0.0,0.0,0.0,1.0,0.0,0.0,0.0,0.0,0.0,0.0,0.0,0.0,0.0,0.0,0.0,0.0,0.0,0.0,0.0,0.0,0.0,0.0,4.0,10611.495,7321.4775,104235.75,0.0,0.0,0.0,0.0,0.0,-280.0,85.0,-181.0,-295.0,48.0,-5.5,15.0,9224.145,45000.0,46485.0,0.0,85932.0,11.0,-273.0,365243.0,-243.0,-167.0,164.0,-163.0,14.0,0.0,0.0,-1.0,36.0,10.0,6.5,-13.5,0.0,0.0,53.0,5192.1,5192.1,-263.0,-244.0,5.0,1.0,9.0,28245.555,67500.0,0.0,0.0,0.0,0.0,2250.0,4548.78,4548.78,27213.345,28245.555,28245.555,0.0,0.0,0.0,0.0,1.0,-5.0,0.0,0.0,8351085312.0,184476067159.5,165653427564.0,51998219155.935,1863.0,1706.0,71125.0,70877.0,9140.0,506336.0,,,,,,,128491.0,663172.0,,,,13534450.112328364,-602266689.0,-922367037.0,-296667537.0,-1535952543.0416667,44039.0,30721.0,,,,,,,67511.27781004718,158119.6571576641,126170.60532892712,,,,,,,3716069.0,,,,,,,,,,,,,,,,436672.0,431465.0,,6428.274295002897,632284.0,625833.0,,,,,,,,,9.5,62364881.02499996,23900606.95499999,6377202008.775004,2090425158.9450004,72875663.23499994,710450.0099999999,118.0,14076.0,-20659616.5,9513324.0,-10665883.5,-11601028.0,-4.25,0.0,0.0,119146.5,0.0,0.0,0.0,0.0,0.0,-357.0,8.0,-284.0,-428.0,226640933.91,3221951940.3600035,3630586128.6150007,51310213.24499995,3221537940.3600035,233375.0,-15988486.0,3718272370.0,164233102.0,842905474.0,366718644.0,878966193.0,232422.0,3665.0,646.0140258621399,5348929.0,1912459.0,1179415.0,-3836724.0,1371156.0,101340.0,2566482101.640154,2594948137.3351,-154033335.0,-152760470.0,2730102.0,126680.0,2406662702.504988,6499741500.0,204037105.23,317494779.8399996,11286179.1,101879259.34499992,136726727.30999964,347397614.91000026,320111016.74999964,2310700668.614998,2397452972.219984,2397540274.1549835,10461.0,27438.0,151.0,16826.0,776639.0,-1380727.0,576414.0,1279.0,1468239.0,14811352.0,3234241.0,8560098.0,11613913.0,1416618.0,1059825213.3195012,801892571.8499951,72145927684.61964,21691431284.44512,583105235.7644987,5792665.7475,689.5,94245.0,-277067850.5,21999787.5,-123846728.5,-218814280.5,-2021305.0,5925906057.622461,18733653000.0,198840207.825,448214504.2424976,1948107.735,256951392.6600008,309260907.29249865,636889867.5149977,459377811.0449993,5710961211.345035,5889166998.9749975,5889410181.719999,13391.5,80921.0,44.0,70423.5,971824.0,-1699354.5,177364.0,6755.0,4275281.0,2480585.5,-9008444.5,921269.0,37582.5,3735735691.747461,3660427315.86746,-260761772.5,-257448443.5,2527777.5,269346.5,3928424755.994954,33271352628.41341,36701723729.70013,1730322401.1525495,48111541477.02071,3990248.5,-247709708.5,103142275388.5,1055130032.5,17282520395.5,3505810532.0,18895994782.5,3674021.5,71968.0,20880.684046915656,89823021.5,-50.240327591075975,3.0351034482758616,6.432294554729954,312.0103427164214,19.522679383386933,946.9836670763444,87000.0,0.6234898018587336,0.7818314824680298,0.0,1.0,0.0,0.0,0.0,0.0,0.0,0.0,0.0,0.0,0.0,0.0,0.0,1.0,0.0,0.0,0.0,0.0,1.0,1.0,0.0,0.0,0.0,0.0,0.0,1.0,0.0,0.0,0.0,0.0,0.0,0.0,0.0,0.0,0.0,0.0,0.0,0.0,0.0,0.0,0.0,0.0,0.0,0.0,0.0,0.0,0.0,0.0,0.0,0.0,0.0,0.0,0.0,1.0,0.0,0.0,0.0,0.0,0.0,0.0,0.0,0.0,0.0,0.0,0.0,0.0,0.0,0.0,0.0,0.0,0.0,0.0,0.0,0.0,0.0,0.0,0.0,0.0,0.0,0.0,0.0,0.0,0.0,0.0,0.0,0.0,0.0,0.0,0.0,0.0,0.0,0.0,0.0,0.0,0.0,0.0,0.0,0.0,0.0,0.0,0.0,0.0,0.0,0.0,0.0,0.0,0.0,0.0,0.0,0.0,0.0,0.0,0.0,0.0,0.0,0.0,0.0,0.0,0.0,0.0
103848,0,0.0,1.0,0.0,1.0,0.0,225000.0,876078.0,53725.5,765000.0,0.020246,46.20821917808219,-157.0,-9282.0,-421.0,,2.0,3.0,3.0,7.0,0.2676203730013308,0.7341964524826804,0.5226973172821112,,,0.9742,,,,0.2069,0.1667,,,,,,,,,0.9742,,,,0.2069,0.1667,,,,,,,,,0.9742,,,,0.2069,0.1667,,,,,,,0.075,1.0,0.0,0.0,0.0,0.0,-2365.0,0.0,0.0,0.0,0.0,1.0,0.0,1.0,1.0,0.0,1.0,0.0,1.0,0.0,0.0,0.0,0.0,0.0,0.0,0.0,1.0,0.0,0.0,0.0,0.0,0.0,0.0,0.0,0.0,0.0,0.0,0.0,0.0,0.0,0.0,0.0,0.0,0.0,0.0,9.0,17376.75,0.0,180000.0,0.0,0.0,0.0,0.0,0.0,-1244.0,-351.5,-340.0,-890.5,326.0,-19.0,1.0,15564.465,186269.4,219217.5,0.9,186269.4,24.0,-2365.0,365243.0,-2334.0,-1644.0,-1644.0,-1635.0,9.0,0.0,4.471257057718776e-06,501.0,25.0,24.0,12.0,-66.0,0.0,0.0,37.0,15564.465,15557.985,-1933.0,-1914.0,15.0,1.0,0.0,,,,,,,,,,,,,,,,,,,,,8351139037.5,184476943237.5,165654192564.0,51998444155.935,1863.0,1706.0,71125.0,70878.0,9140.0,506336.0,,,,,,,128491.0,663174.0,,,,13534496.320547543,-602266846.0,-922367458.0,-296669902.0,-1535961825.0416667,44039.0,30721.0,,,,22901.174400009742,22822.960100009703,22208.24210000826,67511.54543042017,158120.39135411658,126171.1280262444,35021.607600027965,34961.783800028395,34407.217900028816,,,,3716076.0,,,,,,,,,,,,,,,,436672.0,431465.0,,6428.294541002897,632287.0,625836.0,,16341.638799999802,154268.12129999066,154270.86889999022,154162.59659998716,,,,41.0,62570734.01999996,23900606.95499999,6379878397.275004,2092078924.6950004,72875663.23499994,710450.0099999999,118.0,14076.0,-20666126.0,9512898.5,-10668496.0,-11604093.5,-20.0,17397.0,0.0,180000.0,0.0,0.0,0.0,0.0,0.0,-1343.5,-913.0,-750.0,-1246.0,226709619.66,3222471623.760004,3631150874.1150007,51310214.14499995,3222471623.760004,233475.0,-15993693.0,3720098321.0,164230275.0,843269073.0,366717278.0,879329801.0,232529.0,3666.0,646.0140303333969,5351682.0,1912963.0,1179772.0,-3838001.0,1371156.0,101340.0,2567175049.485157,2595552923.3851013,-154088073.0,-152814863.0,2730470.0,126723.0,,,,,,,,,,,,,,,,,,,,,1468248.0,14811678.0,3234241.0,8560123.0,11613950.0,1416619.0,1059842590.0695012,801892571.8499951,72146107684.61964,21691431284.44512,583105235.7644987,5792665.7475,689.5,94245.0,-277069094.5,21999436.0,-123847068.5,-218815171.0,-2021324.0,,,,,,,,,,,,,,,,,,,,,4275305.0,2480597.5,-9008510.5,921269.0,37582.5,3735751256.212461,3660442873.852461,-260763705.5,-257450357.5,2527792.5,269347.5,3928440320.459953,33271538897.81342,36701942947.20013,1730322402.0525494,48111727746.42072,3990272.5,-247712073.5,103142640631.5,1055127698.5,17282518751.5,3505808888.0,18895993147.5,3674030.5,71968.0,20880.68405138692,89823522.5,-3.3976639392861383,3.89368,4.187955440154116,193.51796288668308,16.306558338219286,753.4970217326203,112500.0,-0.9009688679024191,0.4338837391175582,0.0,0.0,0.0,0.0,0.0,0.0,1.0,0.0,0.0,0.0,0.0,0.0,0.0,1.0,0.0,0.0,0.0,0.0,1.0,0.0,1.0,0.0,0.0,0.0,0.0,1.0,0.0,0.0,0.0,0.0,0.0,0.0,0.0,1.0,0.0,0.0,0.0,0.0,0.0,0.0,0.0,0.0,0.0,0.0,0.0,0.0,0.0,0.0,0.0,0.0,0.0,0.0,0.0,0.0,0.0,0.0,0.0,0.0,0.0,0.0,0.0,0.0,0.0,0.0,0.0,0.0,0.0,0.0,0.0,0.0,0.0,0.0,0.0,0.0,0.0,0.0,0.0,0.0,0.0,0.0,0.0,0.0,0.0,0.0,0.0,0.0,0.0,0.0,0.0,0.0,1.0,0.0,0.0,0.0,0.0,0.0,0.0,0.0,0.0,0.0,0.0,0.0,0.0,0.0,0.0,0.0,0.0,0.0,0.0,0.0,1.0,0.0,0.0,0.0,0.0,0.0,0.0,0.0,0.0,0.0
103851,0,0.0,1.0,1.0,1.0,1.0,405000.0,1800000.0,55872.0,1800000.0,0.04622,50.53972602739726,-897.0,-10949.0,-2001.0,12.0,3.0,1.0,1.0,18.0,0.6357084633309213,0.6592146127676519,0.6496203111237195,,0.0559,0.9806,,,,,,,,,0.0996,,,,0.058,0.9806,,,,,,,,,0.1038,,,,0.0559,0.9806,,,,,,,,,0.1014,,,0.0783,1.0,0.0,0.0,0.0,0.0,-2807.0,0.0,0.0,0.0,0.0,0.0,0.0,1.0,1.0,0.0,1.0,1.0,0.0,0.0,1.0,1.0,0.0,0.0,0.0,0.0,0.0,0.0,0.0,0.0,0.0,1.0,0.0,0.0,0.0,0.0,0.0,0.0,0.0,0.0,0.0,0.0,0.0,0.0,0.0,3.0,59472.0,0.0,74902.5,0.0,,0.0,0.0,0.0,-1193.0,-1009.0,-579.0,-1312.5,108.0,-21.0,6.0,42775.065,69120.0,63947.25,5172.75,569227.5,36.0,-732.0,365243.0,-1881.5,-1416.5,-1221.5,-1410.0,12.5,0.5,0.0544545454545454,-1.0,35.0,36.0,19.0,-28.0,0.0,0.0,34.0,48829.095,48829.095,-834.5,-827.0,8.5,1.0,0.0,,,,,,,,,,,,,,,,,,,,,8351194909.5,184478743237.5,165655992564.0,51998849155.935,1863.0,1706.0,71125.0,70878.0,9140.0,506336.0,,,,11301.603300000092,11239.405000000095,11186.772300000055,128492.0,663177.0,,,,13534546.860273572,-602267743.0,-922369459.0,-296672709.0,-1535972774.0416667,44039.0,30721.0,,,,,,,67512.18113888352,158121.05056872935,126171.7776465555,,,,,,,3716094.0,,,,,,,16477.288899999738,16662.5970999997,16259.266799999705,,,,,,,436672.0,431465.0,1263794.0,6428.340761002897,632288.0,625837.0,,16341.717099999802,154269.1018999907,154271.84949999026,154163.57719998714,,,,39.0,62656261.01999996,23953450.45499999,6387550032.150004,2092305418.6950004,,710450.0099999999,118.0,14076.0,-20683329.0,9521481.0,-10675148.0,-11615639.5,-20.0,59472.0,0.0,33718.5,0.0,,0.0,0.0,0.0,-1724.0,-1556.0,-610.0,-1616.0,226912594.815,3224650082.760004,3633308972.8650007,51411081.64499995,3224650082.760004,233629.0,-16010046.0,3723933372.5,164218118.0,843259226.0,366708886.0,879320023.5,232764.0,3668.5,646.9443814643852,5352345.5,1914464.0,1180625.0,-3842268.0,1371196.0,101340.0,2569607822.767657,2597820236.257599,-154226534.5,-152952075.0,2731288.5,126835.5,,,,,,,,,,,,,,,,,,,,,1468251.0,14811786.0,3234241.0,8560158.0,11613984.0,1416625.0,1059902062.0695012,801892571.8499951,72146182587.11964,21691431284.44512,,5792665.7475,689.5,94245.0,-277070287.5,21998427.0,-123847647.5,-218816483.5,-2021345.0,,,,,,,,,,,,,,,,,,,,,4275341.0,2480616.5,-9008538.5,921269.0,37582.5,3735800085.30746,3660491702.94746,-260764540.0,-257451184.5,2527801.0,269348.5,3928483095.524953,33271608017.81342,36702006894.45013,1730327574.8025494,48112296973.92072,3990308.5,-247712805.5,103143005874.5,1055125817.0,17282517335.0,3505807666.5,18895991737.5,3674043.0,71968.5,20880.738505932368,89823521.5,-17.748414376321353,4.4444444444444455,7.248711340206184,366.34788518570815,32.21649484536083,1628.212823047592,135000.0,-0.2225209339563143,0.9749279121818236,0.0,0.0,0.0,0.0,0.0,0.0,1.0,0.0,1.0,0.0,0.0,0.0,0.0,0.0,0.0,0.0,0.0,0.0,1.0,0.0,1.0,0.0,0.0,0.0,0.0,1.0,0.0,0.0,0.0,0.0,0.0,0.0,0.0,0.0,0.0,0.0,0.0,0.0,0.0,0.0,0.0,0.0,0.0,0.0,0.0,0.0,1.0,0.0,0.0,0.0,0.0,0.0,0.0,0.0,0.0,0.0,0.0,0.0,0.0,0.0,0.0,0.0,0.0,0.0,0.0,0.0,0.0,0.0,0.0,0.0,0.0,0.0,0.0,0.0,0.0,0.0,0.0,0.0,0.0,0.0,0.0,0.0,0.0,0.0,0.0,0.0,0.0,0.0,1.0,0.0,0.0,0.0,0.0,0.0,0.0,0.0,0.0,0.0,0.0,0.0,0.0,0.0,0.0,0.0,0.0,0.0,0.0,0.0,0.0,0.0,1.0,0.0,0.0,0.0,0.0,0.0,0.0,1.0,0.0,0.0
103854,0,0.0,1.0,1.0,1.0,1.0,112500.0,218016.0,14062.5,180000.0,0.028663,24.78904109589041,-252.0,-674.0,-1716.0,10.0,3.0,2.0,2.0,11.0,0.1821948005341345,0.5219373766241254,0.2940831009471255,,,,,,,,,,,,,,,,,,,,,,,,,,,,,,,,,,,,,,,,,,,,,0.0,0.0,0.0,0.0,0.0,0.0,0.0,0.0,0.0,2.0,2.0,1.0,1.0,1.0,1.0,1.0,0.0,0.0,1.0,1.0,0.0,1.0,1.0,0.0,1.0,0.0,0.0,0.0,0.0,0.0,0.0,0.0,0.0,0.0,0.0,0.0,0.0,0.0,0.0,0.0,0.0,0.0,0.0,5.0,0.0,,52650.0,27063.0,0.0,0.0,0.0,0.0,-800.0,-70.0,-267.0,-559.0,100.0,-14.0,4.0,3478.8825,32463.0,33252.75,0.0,32463.0,9.0,-351.0,365243.0,-270.0,182492.5,-30.0,182494.0,13.0,0.5,0.0,30.0,23.0,12.0,7.0,-10.0,0.0,0.0,23.0,5966.82,4421.97,-289.0,-291.0,4.0,1.0,12.0,0.0,45000.0,,0.0,,,0.0,,0.0,0.0,0.0,0.0,,0.0,,,0.0,-6.5,0.0,0.0,8351208972.0,184478961253.5,165656172564.0,51998961655.935,1863.0,1706.0,71125.0,70880.0,9140.0,506338.0,,,,,,,128493.0,663180.0,,,,13534571.649314668,-602267995.0,-922371175.0,-296672709.0,-1535973448.0416667,44039.0,30721.0,,,,,,,67512.36333368406,158121.57250610596,126172.07172965644,,,,,,,3716105.0,,,,,,,,,,,,,,,,436672.0,431465.0,1263804.0,6428.369424002897,632290.0,625839.0,,,,,,,,,27.0,62683454.51999996,,6390739767.150004,2093038747.6950004,72875663.23499994,710450.0099999999,118.0,14076.0,-20692114.0,9531750.0,-10678829.0,-11619211.0,-13.0,0.0,,67266.0,0.0,0.0,0.0,0.0,0.0,-943.0,-576.0,-728.0,-838.0,227066005.665,3227418028.260004,3636661108.3650007,51426818.14499995,3227418028.260004,233800.0,-16027224.5,3727584602.5,164567989.5,843612751.0,367428830.0,880039735.5,232936.5,3670.5,647.2597655004962,5355035.0,1916730.0,1181936.0,-3848680.0,1371200.0,101344.0,2572651167.165152,2600770715.955093,-154449746.0,-153174075.0,2733600.0,126974.0,2408286983.8499885,6507706500.0,,317788129.30499953,,,136819223.77499962,,320358701.6099993,2312271243.719998,2399072221.844984,2399159523.779984,,27450.0,,,776982.0,-1381741.0,576414.0,1279.0,1468256.0,14811886.0,3234253.0,8560181.0,11614007.0,1416629.0,1059902062.0695012,,72146235237.11964,21691458347.44512,583105235.7644987,5792665.7475,689.5,94245.0,-277071087.5,21998357.0,-123847914.5,-218817042.5,-2021359.0,5925906057.622461,18733698000.0,,448214504.2424976,,,309260907.29249865,,459377811.0449993,5710961211.345035,5889166998.9749975,5889410181.719999,,80921.0,,,971824.0,-1699361.0,177364.0,6755.0,4275353.0,2480623.5,-9008548.5,921269.0,37582.5,3735806052.127461,3660496124.91746,-260764829.0,-257451475.5,2527805.0,269349.5,3928486574.407455,33271640480.81342,36702040147.20013,1730327574.8025494,48112329436.92072,3990317.5,-247713156.5,103143371117.5,1055125547.0,17282699827.5,3505807636.5,18896174231.5,3674056.0,71969.0,20880.738505932368,89823551.5,-10.1657824933687,1.93792,8.0,198.3123287671233,15.50336,384.3134281643836,37500.0,-0.2225209339563143,0.9749279121818236,0.0,0.0,0.0,0.0,0.0,0.0,1.0,0.0,0.0,0.0,0.0,0.0,0.0,1.0,0.0,0.0,0.0,0.0,1.0,0.0,1.0,0.0,0.0,0.0,0.0,1.0,0.0,0.0,0.0,0.0,0.0,0.0,0.0,0.0,0.0,0.0,0.0,0.0,0.0,0.0,0.0,0.0,0.0,0.0,0.0,0.0,1.0,0.0,0.0,0.0,0.0,0.0,0.0,0.0,0.0,0.0,0.0,0.0,0.0,0.0,0.0,0.0,0.0,0.0,0.0,0.0,0.0,0.0,0.0,0.0,0.0,0.0,0.0,0.0,0.0,0.0,0.0,0.0,0.0,0.0,0.0,0.0,0.0,0.0,0.0,0.0,0.0,0.0,1.0,0.0,0.0,0.0,0.0,0.0,0.0,0.0,0.0,0.0,0.0,0.0,0.0,0.0,0.0,0.0,0.0,0.0,0.0,0.0,0.0,0.0,0.0,0.0,0.0,0.0,0.0,0.0,0.0,0.0,0.0,0.0
103857,0,0.0,1.0,0.0,1.0,0.0,180000.0,420588.0,38704.5,360000.0,0.007114,25.504109589041096,-846.0,-9284.0,-1655.0,,1.0,2.0,2.0,18.0,0.2487219225310794,0.4046966274101788,0.4311917977993083,,,,,,,,,,,,,,,,,,,,,,,,,,,,,,,,,,,,,,,,,,,,,6.0,0.0,6.0,0.0,-887.0,0.0,0.0,0.0,0.0,0.0,1.0,1.0,1.0,0.0,1.0,0.0,1.0,0.0,0.0,0.0,0.0,1.0,1.0,0.0,1.0,0.0,0.0,0.0,0.0,0.0,0.0,0.0,0.0,0.0,0.0,0.0,0.0,0.0,0.0,0.0,0.0,0.0,0.0,5.0,0.0,0.0,82125.0,34155.0,0.0,0.0,0.0,0.0,-864.0,84.0,-329.0,-450.0,119.0,-12.0,2.0,7268.175,85428.0,88553.25,0.0,85428.0,3.0,-886.5,365243.0,-856.0,-736.0,-706.0,-732.0,17.5,0.0,0.0,352.0,6.0,6.0,3.5,-26.5,0.0,0.0,5.0,7786.35,7786.35,-803.0,-796.0,3.0,1.0,0.0,,,,,,,,,,,,,,,,,,,,,8351247676.5,184479381841.5,165656532564.0,51999141655.935,1863.0,1706.0,71125.0,70880.0,9140.0,506339.0,,,,,,,128493.0,663181.0,,,,13534597.153424256,-602268841.0,-922372830.0,-296673596.0,-1535982732.0416667,44039.0,30721.0,,,,,,,67512.61205560659,158121.97720273337,126172.50292145426,,,,,,,3716123.0,,,,,,,,,,,,,,,,436678.0,431471.0,,6428.376538002897,632292.0,625841.0,,,,,,,,,29.0,63292232.51999996,23964083.95499999,6399372872.745007,2096460156.1950004,72880163.23499994,710450.0099999999,118.0,14076.0,-20707407.0,9530705.0,-10685688.0,-11628070.5,-14.0,0.0,0.0,82125.0,34155.0,0.0,0.0,0.0,0.0,-864.0,84.0,-329.0,-547.0,227124924.52499992,3228177988.260004,3637418989.3650007,51440516.14499995,3228177988.260004,233892.0,-16032342.5,3729958682.0,164928764.0,844339388.0,367426972.0,880766402.0,233034.5,3672.0,647.5905198026467,5355638.0,1917202.5,1182262.0,-3849706.0,1371200.0,101344.0,2573293631.985152,2601408758.8050942,-154477288.0,-153201236.0,2733747.0,127010.0,,,,,,,,,,,,,,,,,,,,,1468261.0,14812005.0,3234253.0,8560187.0,11614012.0,1416631.0,1059902062.0695012,801892571.8499951,72146317362.11964,21691492502.44512,583105235.7644987,5792665.7475,689.5,94245.0,-277071951.5,21998441.0,-123848243.5,-218817492.5,-2021371.0,,,,,,,,,,,,,,,,,,,,,4275359.0,2480627.0,-9008575.0,921269.0,37582.5,3735813838.477461,3660503911.26746,-260765632.0,-257452271.5,2527808.0,269350.5,3928493842.582455,33271725908.81342,36702128700.45013,1730327574.8025494,48112414864.92072,3990320.5,-247714043.0,103143736360.5,1055124691.0,17282699091.5,3505806930.5,18896173499.5,3674073.5,71969.0,20880.738505932368,89823903.5,-33.17112471801482,2.3366,4.650622020695269,118.60997367301988,10.866643413556565,277.1440644843782,180000.0,-0.9009688679024191,0.4338837391175582,0.0,0.0,0.0,1.0,0.0,0.0,0.0,0.0,0.0,0.0,0.0,0.0,0.0,1.0,0.0,0.0,0.0,0.0,1.0,0.0,0.0,0.0,1.0,0.0,0.0,0.0,1.0,0.0,0.0,0.0,0.0,0.0,0.0,0.0,0.0,0.0,0.0,0.0,1.0,0.0,0.0,0.0,0.0,0.0,0.0,0.0,0.0,0.0,0.0,0.0,0.0,0.0,0.0,0.0,0.0,0.0,0.0,0.0,0.0,0.0,0.0,0.0,0.0,0.0,0.0,0.0,0.0,0.0,0.0,0.0,0.0,0.0,0.0,0.0,0.0,0.0,0.0,0.0,0.0,0.0,0.0,0.0,0.0,0.0,0.0,0.0,0.0,0.0,0.0,0.0,1.0,0.0,0.0,0.0,0.0,0.0,0.0,0.0,0.0,0.0,0.0,0.0,0.0,0.0,0.0,0.0,0.0,0.0,0.0,0.0,0.0,0.0,0.0,0.0,0.0,0.0,0.0,0.0,0.0,0.0
103861,0,0.0,1.0,1.0,0.0,0.0,225000.0,450000.0,25128.0,450000.0,0.04622,63.153424657534245,,-1268.0,-623.0,1.0,2.0,1.0,1.0,16.0,,0.7593834124628991,0.6674577419214722,,,,,,,,,,,,,,,,,,,,,,,,,,,,,,,,,,,,,,,,,,,,,0.0,0.0,0.0,0.0,-852.0,0.0,0.0,0.0,0.0,1.0,2.0,1.0,0.0,0.0,1.0,0.0,0.0,0.0,0.0,0.0,0.0,0.0,0.0,0.0,0.0,0.0,0.0,0.0,0.0,1.0,0.0,0.0,0.0,0.0,0.0,0.0,0.0,0.0,0.0,0.0,0.0,0.0,0.0,5.0,0.0,,900000.0,335344.5,0.0,0.0,0.0,0.0,-847.0,-222.0,-436.0,-839.0,148.0,-15.0,2.0,51410.61,699750.0,765351.0,,699750.0,27.0,-935.0,365243.0,-905.0,-680.0,-125.0,-671.5,11.5,0.5,,7.0,19.0,48.0,38.0,-24.0,0.0,0.0,22.0,53130.42,53130.42,-765.5,-755.0,4.5,1.0,0.0,,,,,,,,,,,,,,,,,,,,,8351272804.5,184479831841.5,165656982564.0,51999366655.935,1863.0,1706.0,71125.0,70881.0,9140.0,506341.0,,,,,,,128493.0,663183.0,,,,13534660.306848915,,-922373453.0,-296674448.0,-1535984000.0416667,44039.0,30721.0,,,,,,,,158122.73658614582,126173.17037919618,,,,,,,3716139.0,,,,,,,,,,,,,,,,436678.0,431471.0,1263805.0,6428.422758002896,632293.0,625842.0,,,,,,,,,28.0,63353563.01999996,,6405968561.625007,2099448422.5500004,72887270.30999994,710450.0099999999,118.0,14076.0,-20731528.0,9516884.0,-10702946.0,-11646706.5,-13.5,0.0,,900000.0,41179.5,0.0,0.0,0.0,0.0,-1323.0,-482.0,-742.0,-1147.0,227254743.225,3230212699.260004,3639616958.1150007,,3230212699.260004,234006.0,-16042094.0,3731967518.5,164921467.0,844333636.0,367422840.0,880760676.0,233152.0,3674.0,,5356276.5,1918637.0,1183147.0,-3852367.0,1371200.0,101344.0,2575932481.2151504,2604467778.0750923,-154537014.5,-153260671.0,2734255.0,127079.5,,,,,,,,,,,,,,,,,,,,,1468266.0,14812153.0,3234253.0,8560206.0,11614034.0,1416633.0,1059902062.0695012,,72147217362.11964,21691827846.94512,583105235.7644987,5792665.7475,689.5,94245.0,-277072798.5,21998219.0,-123848679.5,-218818331.5,-2021386.0,,,,,,,,,,,,,,,,,,,,,4275407.0,2480665.0,-9008599.0,921269.0,37582.5,3735866968.897461,3660557041.68746,-260766397.5,-257453026.5,2527812.5,269351.5,3928545253.192455,33272425658.81342,36702894051.45013,,48113114614.92072,3990347.5,-247714978.0,103144101603.5,1055123786.0,17282698411.5,3505806805.5,18896172828.0,3674085.0,71969.5,,89823910.5,,2.0,8.954154727793695,565.4855359736233,17.90830945558739,1130.9710719472466,112500.0,1.0,0.0,0.0,0.0,0.0,0.0,0.0,0.0,1.0,0.0,0.0,1.0,0.0,0.0,0.0,0.0,0.0,1.0,0.0,0.0,0.0,0.0,1.0,0.0,0.0,0.0,0.0,1.0,0.0,0.0,0.0,0.0,0.0,0.0,0.0,0.0,0.0,0.0,0.0,0.0,0.0,0.0,0.0,0.0,0.0,0.0,0.0,0.0,0.0,0.0,0.0,0.0,0.0,0.0,0.0,0.0,0.0,0.0,0.0,0.0,0.0,0.0,0.0,0.0,0.0,0.0,0.0,0.0,0.0,0.0,0.0,0.0,0.0,0.0,0.0,0.0,0.0,0.0,0.0,0.0,0.0,0.0,0.0,0.0,0.0,0.0,0.0,0.0,0.0,0.0,0.0,0.0,0.0,0.0,0.0,0.0,0.0,0.0,0.0,0.0,0.0,0.0,0.0,0.0,0.0,0.0,0.0,1.0,0.0,0.0,0.0,0.0,0.0,0.0,0.0,0.0,0.0,0.0,0.0,0.0,0.0,0.0
103862,0,0.0,0.0,0.0,1.0,0.0,121500.0,62554.5,6867.0,54000.0,0.01885,53.2931506849315,-8389.0,-1045.0,-2984.0,,1.0,2.0,2.0,12.0,,0.6185275196354857,0.1473459180275725,0.1237,0.0846,0.9846,0.7892,0.0455,0.0,0.069,0.1667,0.2083,0.1974,0.1009,0.061,0.0,0.0,0.1261,0.0878,0.9846,0.7975,0.0459,0.0,0.069,0.1667,0.2083,0.2019,0.1102,0.0635,0.0,0.0,0.1249,0.0846,0.9846,0.792,0.0458,0.0,0.069,0.1667,0.2083,0.2008,0.1026,0.0621,0.0,0.0,0.0583,1.0,2.0,0.0,2.0,0.0,-2061.0,0.0,0.0,1.0,0.0,1.0,4.0,1.0,1.0,0.0,1.0,1.0,0.0,0.0,0.0,0.0,0.0,0.0,0.0,0.0,1.0,0.0,0.0,0.0,0.0,0.0,0.0,0.0,0.0,0.0,0.0,0.0,0.0,0.0,0.0,0.0,0.0,0.0,0.0,11.0,0.0,0.0,139500.0,0.0,0.0,0.0,0.0,0.0,-1010.0,-367.0,-91.0,-550.0,322.0,-17.0,13.0,6176.655,54000.0,61128.0,1350.0,58500.0,12.0,-1422.0,365243.0,-1687.0,-1372.0,-1357.0,-1365.5,16.0,0.0,0.0498667998667998,34.0,94.0,12.0,5.0,-60.5,0.0,0.0,157.0,6299.37,4646.745,-1259.0,-1254.0,9.0,1.0,45.0,0.0,427500.0,0.0,0.0,0.0,0.0,0.0,132.795,132.795,0.0,0.0,0.0,0.0,0.0,0.0,0.0,14.0,-24.0,0.0,0.0,8351279671.5,184479894396.0,165657036564.0,51999488155.935,1863.0,1706.0,71125.0,70882.0,9141.0,506345.0,17818.526100002295,17880.721399999107,17331.940899998022,11301.687900000095,11239.489600000095,11186.860100000054,128493.0,663184.0,4140.483900000116,4138.171000000017,3948.7443000000926,13534713.5999996,-602277230.0,-922376437.0,-296676509.0,-1535985045.0416667,44039.0,30721.0,11356.113999999186,11232.05999999898,10716.18099999729,22901.243400009746,22823.029100009702,22208.31110000826,,158123.35511366546,126173.3177251142,35021.774300027966,34961.9505000284,34407.38460002881,22967.4317999959,22940.483599995478,22587.247699995707,3716151.0,8300.516200000162,8405.103400000075,8128.6105000002335,9822.921700000716,9937.889900002165,10297.848999999644,16477.349899999743,16662.6591999997,16259.330299999703,828.9524000001767,814.1286000000459,760.0513000000133,3916.177700000124,3899.381400000165,3732.02430000016,436680.0,431473.0,,6428.441608002898,632295.0,625844.0,,16341.775399999802,154270.08649999063,154272.83409999026,154164.56179998716,77655.92919999633,77993.94700000656,78395.53600000657,34.0,63361159.01999996,23964083.95499999,6408603289.125007,2099940875.5500004,72887270.30999994,710450.0099999999,118.0,14076.0,-20739481.0,9514346.0,-10705044.0,-11649798.0,-16.5,7596.0,0.0,133200.0,0.0,0.0,0.0,0.0,0.0,-1068.0,-733.0,-157.0,-895.0,227325912.66,3230786107.260004,3640237733.1150007,51453116.14499995,3230763607.260004,234111.0,-16053571.0,3733610471.5,164913095.0,844326828.0,367598882.0,880936458.5,233260.0,3676.0,648.0181430646877,5356982.0,1919445.0,1183648.0,-3855417.0,1371200.0,101344.0,2577106146.735152,2605423127.715091,-154683944.0,-153406866.0,2735156.0,127156.0,2408952527.774988,6513601500.0,204431305.23,317939144.80499953,11286179.1,101929424.30999991,136859057.6849996,348088721.37750006,320731637.5349994,2312907739.919998,2399733432.359984,2399820734.294984,10474.0,27455.0,151.0,16830.0,777179.5,-1382343.0,576414.0,1279.0,1468277.0,14812475.0,3234298.0,8560300.0,11614191.0,1416646.0,1059902062.0695012,801892571.8499951,72147356862.11964,21691827846.94512,583105235.7644987,5792665.7475,689.5,94245.0,-277073808.5,21997852.0,-123848770.5,-218818881.5,-2021403.0,5925906057.622461,18734125500.0,198840207.825,448214504.2424976,1948107.735,256951392.6600008,309260907.29249865,636890000.3099978,459377943.8399993,5710961211.345035,5889166998.9749975,5889410181.719999,13391.5,80921.0,44.0,70423.5,971838.0,-1699385.0,177364.0,6755.0,4275419.0,2480670.0,-9008659.5,921269.0,37582.5,3735873268.26746,3660561688.43246,-260767656.5,-257454280.5,2527821.5,269352.5,3928551429.847455,33272479658.81342,36702955179.45013,1730328924.8025494,48113173114.92072,3990359.5,-247716400.0,103144466846.5,1055122099.0,17282697039.5,3505805448.5,18896171462.5,3674101.0,71969.5,20880.78837273224,89823944.5,-157.41234834464322,0.5148518518518519,17.693315858453477,942.9325481606492,9.10943643512451,485.47056859189576,121500.0,-0.9009688679024191,0.4338837391175582,0.0,0.0,0.0,0.0,0.0,0.0,1.0,0.0,0.0,0.0,0.0,0.0,0.0,1.0,0.0,0.0,0.0,0.0,1.0,0.0,0.0,0.0,1.0,0.0,0.0,1.0,0.0,0.0,0.0,0.0,1.0,0.0,0.0,0.0,0.0,0.0,0.0,0.0,0.0,0.0,0.0,0.0,0.0,0.0,0.0,0.0,0.0,0.0,0.0,0.0,0.0,0.0,1.0,0.0,0.0,0.0,0.0,0.0,0.0,0.0,0.0,0.0,0.0,0.0,0.0,0.0,0.0,0.0,0.0,0.0,0.0,0.0,0.0,0.0,0.0,0.0,0.0,0.0,0.0,0.0,0.0,0.0,0.0,0.0,0.0,0.0,0.0,0.0,0.0,0.0,0.0,0.0,0.0,0.0,0.0,0.0,0.0,0.0,0.0,0.0,0.0,0.0,0.0,0.0,0.0,0.0,0.0,0.0,1.0,0.0,1.0,0.0,0.0,0.0,0.0,0.0,0.0,0.0,1.0,0.0
103865,0,0.0,0.0,0.0,1.0,0.0,157500.0,248760.0,25618.5,225000.0,0.016612,67.83835616438354,,-16825.0,-4790.0,,2.0,2.0,2.0,10.0,,0.3037980103530229,0.41534714488434,,,,,,,,,,,,,,,,,,,,,,,,,,,,,,,,,,,,,,,,,,,,,0.0,0.0,0.0,0.0,0.0,0.0,0.0,0.0,0.0,0.0,7.0,1.0,0.0,0.0,1.0,0.0,0.0,0.0,0.0,0.0,0.0,0.0,0.0,0.0,1.0,0.0,0.0,0.0,0.0,0.0,0.0,0.0,0.0,0.0,0.0,0.0,0.0,0.0,0.0,0.0,0.0,0.0,0.0,4.0,3496.5,0.0,146250.0,43907.8275,0.0,0.0,0.0,0.0,-586.5,-452.0,-163.5,-453.5,87.0,-11.0,13.0,13288.05,90000.0,92970.0,0.0,193500.0,18.0,-758.0,365243.0,-842.0,-752.0,-692.0,-745.0,11.0,1.0,0.0,0.0,98.0,18.0,9.0,-63.5,0.0,0.0,95.0,10492.02,10492.02,-1913.0,-1910.0,7.0,1.0,0.0,,,,,,,,,,,,,,,,,,,,,8351305290.0,184480143156.0,165657261564.0,51999645655.935,1863.0,1706.0,71125.0,70882.0,9141.0,506352.0,,,,,,,128493.0,663186.0,,,,13534781.438355764,,-922381227.0,-296676509.0,-1536001870.0416667,44039.0,30721.0,,,,,,,,158123.6589116758,126173.73307225909,,,,,,,3716161.0,,,,,,,,,,,,,,,,436680.0,431473.0,,6428.458220002898,632297.0,625846.0,,,,,,,,,20.0,64525164.29999996,23974771.45499999,6413853686.445004,2100957611.3775003,72922356.29249994,710450.0099999999,118.0,14076.0,-20759783.5,9538661.0,-10713826.0,-11659992.5,-9.5,0.0,0.0,135000.0,0.0,0.0,0.0,0.0,0.0,-702.0,-452.0,-306.0,-436.0,228021930.405,3243689884.260004,3656225049.6150007,51492720.64499995,3243644884.260004,234657.0,-16087549.0,3737627504.0,164894639.0,844679729.0,367768074.0,881472761.0,233628.0,3682.0,648.8413192503878,5360354.0,1921178.0,1184586.5,-3863380.5,1371208.0,101352.0,2580064221.0601463,2608227655.4700856,-154911665.0,-153632513.0,2737529.0,127278.0,,,,,,,,,,,,,,,,,,,,,1468281.0,14812562.0,3234298.0,8560398.0,11614286.0,1416659.0,1059905558.5695012,801892571.8499951,72147503112.11964,21691871754.772617,583105235.7644987,5792665.7475,689.5,94245.0,-277074395.0,21997400.0,-123848934.0,-218819335.0,-2021414.0,,,,,,,,,,,,,,,,,,,,,4275437.0,2480679.0,-9008723.0,921269.0,37582.5,3735883760.28746,3660572180.45246,-260769569.5,-257456190.5,2527828.5,269353.5,3928564717.897455,33272569658.81342,36703048149.45013,1730328924.8025494,48113366614.92072,3990377.5,-247717158.0,103144832089.5,1055121257.0,17282696287.5,3505804756.5,18896170717.5,3674112.0,71970.5,20880.78837273224,89823944.5,,1.5794285714285714,6.1479009309678565,417.06349301834257,9.710170384682945,658.7219969729707,78750.0,-0.2225209339563143,0.9749279121818236,0.0,1.0,0.0,0.0,0.0,0.0,0.0,0.0,0.0,1.0,0.0,0.0,0.0,0.0,0.0,0.0,0.0,0.0,1.0,1.0,0.0,0.0,0.0,0.0,0.0,1.0,0.0,0.0,0.0,0.0,0.0,0.0,0.0,0.0,0.0,0.0,0.0,0.0,0.0,0.0,0.0,0.0,0.0,0.0,0.0,0.0,0.0,0.0,0.0,0.0,0.0,0.0,0.0,0.0,0.0,0.0,0.0,0.0,0.0,0.0,0.0,0.0,0.0,0.0,0.0,0.0,0.0,0.0,0.0,0.0,0.0,0.0,0.0,0.0,0.0,0.0,0.0,0.0,0.0,0.0,0.0,0.0,0.0,0.0,0.0,0.0,0.0,0.0,0.0,0.0,0.0,0.0,0.0,0.0,0.0,0.0,0.0,0.0,0.0,0.0,0.0,0.0,0.0,0.0,0.0,1.0,0.0,0.0,0.0,0.0,0.0,0.0,0.0,0.0,0.0,0.0,0.0,0.0,0.0,0.0
103870,0,0.0,0.0,0.0,1.0,0.0,180000.0,547344.0,23319.0,472500.0,0.005084,45.19178082191781,-3492.0,-2287.0,-26.0,,2.0,2.0,2.0,17.0,0.8753915494475386,0.6573897028932859,0.6075573001388961,0.0876,0.0878,0.996,,,0.0,0.1724,0.2083,,0.0392,,0.0606,,0.0984,0.0893,0.0911,0.996,,,0.0,0.1724,0.2083,,0.04,,0.0632,,0.1042,0.0885,0.0878,0.996,,,0.0,0.1724,0.2083,,0.0398,,0.0617,,0.1005,0.0848,1.0,1.0,0.0,1.0,0.0,0.0,0.0,0.0,0.0,0.0,1.0,1.0,1.0,1.0,0.0,1.0,0.0,1.0,0.0,0.0,0.0,0.0,0.0,0.0,0.0,1.0,0.0,0.0,0.0,0.0,0.0,0.0,0.0,0.0,0.0,0.0,0.0,0.0,0.0,0.0,0.0,0.0,0.0,0.0,4.0,59946.75,,461250.0,411862.5,0.0,0.0,0.0,0.0,-958.0,690.0,-65.0,-521.0,138.0,-17.0,7.0,12838.5675,83205.0,90526.5,13565.25,202826.25,5.0,-336.0,365243.0,-484.5,-184.5,-184.5,-176.0,15.0,0.5,0.100424095970101,-1.0,24.0,12.0,5.5,-11.0,0.0,0.0,22.0,12176.415,12176.415,-337.0,-334.5,6.0,1.0,0.0,,,,,,,,,,,,,,,,,,,,,8351328609.0,184480690500.0,165657734064.0,51999825655.935,1863.0,1706.0,71125.0,70883.0,9141.0,506353.0,17818.613700002294,17880.80989999911,17332.030199998022,11301.775700000091,11239.577400000097,11186.951200000054,128493.0,663188.0,,,,13534826.630136589,-602280722.0,-922381253.0,-296676509.0,-1536004157.0416667,44039.0,30721.0,11356.113999999186,11232.05999999898,10716.18099999729,22901.415800009738,22823.2015000097,22208.48350000826,67513.48744715603,158124.31630137868,126174.34062955926,35021.982600027965,34962.158800028395,34407.592900028816,,,,3716178.0,8300.555400000161,8405.143200000075,8128.6505000002335,,,,16477.41049999974,16662.7208999997,16259.393499999704,,,,3916.276100000124,3899.481900000165,3732.12850000016,436681.0,431474.0,,6428.4633040028975,632299.0,625848.0,,16341.860199999805,154271.08249999068,154273.83009999024,154165.55779998715,,,,32.0,64693018.52999996,,6424424756.2800045,2106125391.1950004,73065932.18999995,710450.0099999999,118.0,14076.0,-20799835.5,9565136.5,-10732716.0,-11682672.0,-15.5,0.0,,450000.0,411862.5,0.0,0.0,0.0,0.0,-1249.0,429.0,-104.0,-521.0,228576090.375,3252335132.160004,3665844038.1150007,51634982.29499995,3252470132.160004,235132.0,-16119399.0,3745476564.5,165233628.5,846852152.5,368850442.5,883646413.5,233985.0,3694.0,650.7871704871033,5362846.0,1927656.0,1188273.5,-3873031.5,1371221.0,101365.0,2588070723.86263,2616335636.782569,-155363462.0,-154081111.5,2747052.0,127638.5,,,,,,,,,,,,,,,,,,,,,1468285.0,14812700.0,3234298.0,8560422.0,11614308.0,1416666.0,1059965505.3195012,,72147964362.11964,21692283617.272617,583105235.7644987,5792665.7475,689.5,94245.0,-277075353.0,21998090.0,-123848999.0,-218819856.0,-2021431.0,,,,,,,,,,,,,,,,,,,,,4275449.0,2480684.5,-9008734.0,921269.0,37582.5,3735895936.70246,3660584356.86746,-260769906.5,-257456525.0,2527834.5,269354.5,3928577556.464955,33272652863.81342,36703138675.95013,1730342490.0525494,48113569441.17072,3990382.5,-247717494.0,103145197332.5,1055120772.5,17282696103.0,3505804572.0,18896170541.5,3674127.0,71971.0,20880.888796828203,89823943.5,-77.27068808729919,3.0408,7.719027402547279,348.83659453429414,23.47201852566577,1060.7423166598817,90000.0,1.0,0.0,0.0,0.0,0.0,0.0,0.0,0.0,1.0,0.0,0.0,0.0,1.0,0.0,0.0,0.0,0.0,1.0,0.0,0.0,0.0,0.0,1.0,0.0,0.0,0.0,0.0,1.0,0.0,0.0,0.0,0.0,0.0,0.0,0.0,0.0,0.0,0.0,0.0,0.0,0.0,0.0,0.0,0.0,0.0,0.0,0.0,0.0,0.0,0.0,0.0,0.0,0.0,0.0,0.0,0.0,0.0,0.0,0.0,0.0,0.0,0.0,0.0,0.0,0.0,0.0,0.0,0.0,0.0,0.0,0.0,0.0,0.0,0.0,0.0,0.0,0.0,0.0,0.0,0.0,0.0,0.0,0.0,1.0,0.0,0.0,0.0,0.0,0.0,0.0,0.0,0.0,0.0,0.0,0.0,0.0,0.0,0.0,0.0,0.0,0.0,0.0,0.0,0.0,0.0,0.0,0.0,0.0,0.0,0.0,0.0,0.0,1.0,0.0,0.0,0.0,0.0,0.0,0.0,0.0,1.0,0.0
103876,0,0.0,0.0,0.0,0.0,1.0,225000.0,495000.0,31635.0,495000.0,0.00733,37.630136986301366,-5400.0,-7564.0,-5290.0,,3.0,2.0,2.0,12.0,,0.6289808744948581,0.5814837058057234,,,,,,,,,,,,,,,,,,,,,,,,,,,,,,,,,,,,,,,,,,,,,1.0,0.0,1.0,0.0,-722.0,0.0,0.0,0.0,0.0,0.0,2.0,1.0,1.0,1.0,1.0,1.0,0.0,0.0,0.0,0.0,0.0,0.0,0.0,0.0,1.0,0.0,0.0,0.0,0.0,0.0,0.0,0.0,0.0,0.0,0.0,0.0,0.0,0.0,0.0,0.0,0.0,0.0,0.0,17.0,0.0,0.0,70018.29,0.0,0.0,0.0,0.0,0.0,-1678.0,-1435.0,-931.0,-1425.0,819.0,-25.0,3.0,8891.235,94392.0,94392.0,0.0,94392.0,12.0,-624.0,365243.0,182276.0,182501.0,168.5,182502.0,17.0,0.0,0.0,380.0,18.0,24.0,15.5,-15.5,0.0,0.0,16.0,4405.5,4405.5,-588.0,-466.0,8.5,1.0,0.0,,,,,,,,,,,,,,,,,,,,,8351360244.0,184481185500.0,165658229064.0,52000050655.935,1863.0,1706.0,71125.0,70883.0,9141.0,506355.0,,,,,,,128494.0,663191.0,,,,13534864.260273576,-602286122.0,-922386543.0,-296677231.0,-1536011721.0416667,44039.0,30721.0,,,,,,,,158124.94528225315,126174.92211326506,,,,,,,3716190.0,,,,,,,,,,,,,,,,436682.0,431475.0,,6428.470634002899,632301.0,625850.0,,,,,,,,,55.0,64752965.27999996,23983028.95499999,6429203460.720005,2107943701.6950004,73065932.18999995,710450.0099999999,118.0,14076.0,-20836072.0,9543703.0,-10752177.0,-11705113.5,-28.0,0.0,0.0,56025.0,0.0,0.0,0.0,0.0,0.0,-1726.0,-1468.0,-1006.0,-1467.0,229330204.245,3262026552.210004,3675749933.1150007,52104235.09499995,3262026552.210004,235621.0,-16154989.0,3752416181.5,165575394.5,847930489.5,368834953.5,884724849.5,234482.0,3697.0,652.5561666268858,5369539.0,1932125.0,1190790.0,-3881672.0,1371228.0,101372.0,2593956346.3801355,2621801966.895075,-155628881.5,-154343443.5,2749306.0,127932.5,,,,,,,,,,,,,,,,,,,,,1468302.0,14813519.0,3234298.0,8560440.0,11614324.0,1416669.0,1059965505.3195012,801892571.8499951,72148034380.40964,21692283617.272617,583105235.7644987,5792665.7475,689.5,94245.0,-277077031.0,21996655.0,-123849930.0,-218821281.0,-2021456.0,,,,,,,,,,,,,,,,,,,,,4275473.0,2480700.0,-9008749.5,921269.0,37582.5,3735900342.20246,3660588762.36746,-260770494.5,-257456991.0,2527843.0,269355.5,3928586447.699957,33272747255.81342,36703233067.95013,1730342490.0525494,48113663833.17072,3990394.5,-247718118.0,103145562575.5,1055303048.5,17282878604.0,3505804740.5,18896353043.5,3674144.0,71971.0,20880.888796828203,89824323.5,-143.5020021842009,2.2,7.112375533428165,267.63966562092014,15.647226173541965,588.8072643660244,75000.0,1.0,0.0,0.0,0.0,0.0,0.0,0.0,0.0,0.0,0.0,0.0,0.0,0.0,0.0,0.0,1.0,0.0,0.0,0.0,0.0,1.0,0.0,1.0,0.0,0.0,0.0,0.0,1.0,0.0,0.0,0.0,0.0,0.0,0.0,0.0,0.0,0.0,0.0,0.0,0.0,0.0,0.0,0.0,0.0,1.0,0.0,0.0,0.0,0.0,0.0,0.0,0.0,0.0,0.0,0.0,0.0,0.0,0.0,0.0,0.0,0.0,0.0,0.0,0.0,0.0,0.0,0.0,0.0,0.0,0.0,0.0,0.0,0.0,0.0,0.0,0.0,0.0,0.0,0.0,0.0,0.0,0.0,0.0,0.0,0.0,0.0,0.0,0.0,0.0,0.0,0.0,0.0,0.0,1.0,0.0,0.0,0.0,0.0,0.0,0.0,0.0,0.0,0.0,0.0,0.0,0.0,0.0,0.0,0.0,0.0,0.0,0.0,0.0,0.0,0.0,0.0,0.0,0.0,0.0,0.0,0.0,0.0
103891,1,0.0,1.0,1.0,1.0,0.0,112500.0,537322.5,42583.5,486000.0,0.020713,30.51232876712329,-93.0,-5669.0,-3709.0,36.0,2.0,3.0,3.0,7.0,0.177804630722181,0.0328798032844083,,,,,,,,,,,,,,,,,,,,,,,,,,,,,,,,,,,,,,,,,,,,,,0.0,0.0,0.0,0.0,0.0,,,,,,,1.0,1.0,0.0,1.0,0.0,0.0,0.0,0.0,0.0,0.0,1.0,1.0,0.0,1.0,0.0,0.0,0.0,0.0,0.0,0.0,0.0,0.0,0.0,0.0,0.0,0.0,0.0,0.0,0.0,0.0,0.0,0.0,0.0,,,,,,,,,,,,,0.0,,1.0,16072.47,180000.0,151470.0,40500.0,180000.0,12.0,-392.0,365243.0,-360.0,-30.0,-30.0,-23.0,7.0,0.0,0.2297660145761411,84.0,12.0,12.0,6.5,-7.5,0.0,0.0,12.0,16072.47,16072.47,-210.0,-195.0,6.5,1.0,0.0,,,,,,,,,,,,,,,,,,,,,8351402827.5,184481722822.5,165658715064.0,52000163155.935,,,,,,,,,,,,,128494.0,663193.0,,,,13534894.772602342,-602286215.0,-922390252.0,-296677231.0,-1536017390.0416667,44039.0,30721.0,,,,,,,67513.66525178675,158124.97816205645,,,,,,,,3716197.0,,,,,,,,,,,,,,,,436682.0,431475.0,1263841.0,6428.4913470029,632304.0,625853.0,,,,,,,,,,,,,,,,,,,,,,,,,,,,,,,,,,,230351686.4700001,3277834478.100004,3693183207.6150007,52398716.98499995,3277834478.100004,236687.0,-16248081.0,3767933465.0,166247295.0,852635162.0,370265950.0,890162322.0,235352.0,3723.0,655.9708187046331,5383210.0,1941973.0,1197428.0,-3900811.5,1374738.0,101394.0,2607580332.5851307,2635291634.6250725,-156423341.5,-155133216.0,2761233.5,128548.5,,,,,,,,,,,,,,,,,,,,,1468302.0,14813519.0,3234298.0,8560452.0,11614336.0,1416670.0,,,,,,,,,,,,,,,,,,,,,,,,,,,,,,,,,,4275485.0,2480706.5,-9008757.0,921269.0,37582.5,3735916414.67246,3660604834.83746,-260770704.5,-257457186.0,2527849.5,269356.5,3928602520.169955,33272927255.81342,36703384537.95013,1730382990.0525494,48113843833.17072,3990406.5,-247718510.0,103145927818.5,1055302688.5,17282878574.0,3505804710.5,18896353020.5,3674151.0,71971.0,20881.11856284278,89824407.5,-3.04794828050642,4.7762,2.6418683292824685,80.6095550225174,12.618091514318929,385.0073566985476,56250.0,0.6234898018587336,0.7818314824680298,0.0,0.0,0.0,0.0,0.0,0.0,1.0,0.0,0.0,0.0,0.0,0.0,0.0,1.0,0.0,0.0,0.0,1.0,0.0,0.0,1.0,0.0,0.0,0.0,0.0,1.0,0.0,0.0,0.0,0.0,0.0,0.0,0.0,0.0,0.0,0.0,0.0,0.0,1.0,0.0,0.0,0.0,0.0,0.0,0.0,0.0,0.0,0.0,0.0,0.0,0.0,0.0,0.0,0.0,0.0,0.0,0.0,0.0,0.0,0.0,0.0,0.0,0.0,0.0,0.0,0.0,0.0,0.0,0.0,0.0,0.0,0.0,0.0,0.0,0.0,0.0,0.0,0.0,0.0,0.0,0.0,0.0,0.0,0.0,0.0,0.0,0.0,0.0,0.0,0.0,1.0,0.0,0.0,0.0,0.0,0.0,0.0,0.0,0.0,0.0,0.0,0.0,0.0,0.0,0.0,0.0,0.0,0.0,0.0,0.0,0.0,0.0,0.0,0.0,0.0,0.0,0.0,0.0,0.0,0.0
103908,0,0.0,0.0,1.0,1.0,0.0,112500.0,312840.0,24714.0,247500.0,0.019101,30.410958904109588,-1397.0,-664.0,-3050.0,8.0,2.0,2.0,2.0,15.0,,0.5794085113618647,,0.067,0.0785,0.9796,0.7212,0.0387,0.0,0.1379,0.1667,0.2083,0.0167,0.0546,0.0516,0.0,0.0,0.0683,0.0815,0.9796,0.7321,0.039,0.0,0.1379,0.1667,0.2083,0.0171,0.0597,0.0538,0.0,0.0,0.0677,0.0785,0.9796,0.7249,0.0389,0.0,0.1379,0.1667,0.2083,0.017,0.0556,0.0525,0.0,0.0,0.0617,1.0,2.0,0.0,2.0,0.0,-907.0,,,,,,,1.0,1.0,0.0,1.0,0.0,0.0,0.0,0.0,0.0,0.0,0.0,0.0,0.0,1.0,0.0,0.0,0.0,0.0,0.0,0.0,0.0,0.0,0.0,0.0,0.0,0.0,0.0,0.0,0.0,0.0,0.0,0.0,0.0,,,,,,,,,,,,,0.0,,3.0,9433.305,96700.5,96700.5,0.0,160850.25,24.0,-186.0,365243.0,-516.0,182513.5,174.0,182516.0,15.0,0.0,0.0,-1.0,29.0,24.0,16.0,-15.0,0.0,0.0,29.0,4356.36,4356.36,-466.0,-456.0,9.0,1.0,0.0,,,,,,,,,,,,,,,,,,,,,8351427541.5,184482035662.5,165658962564.0,52000275655.935,,,,,,,17818.680700002293,17880.87759999911,17332.098499998017,11301.854200000093,11239.655900000094,11187.032700000054,128494.0,663195.0,4140.522600000116,4138.209900000016,3948.783300000093,13534925.183561249,-602287612.0,-922393302.0,-296678138.0,-1536018054.0416667,44039.0,30721.0,11356.113999999186,11232.05999999898,10716.18099999729,22901.553700009743,22823.339400009703,22208.621400008265,,158125.55757056782,,35022.149300027966,34962.3255000284,34407.75960002881,22967.640099995897,22940.691899995472,22587.455999995705,3716212.0,8300.572100000161,8405.160200000075,8128.6676000002335,9822.976300000715,9937.945500002164,10297.908699999643,16477.462099999742,16662.7733999997,16259.447299999703,828.9524000001767,814.1286000000459,760.0513000000133,3916.276100000124,3899.481900000165,3732.12850000016,436684.0,431477.0,1263849.0,6428.5104480029,632306.0,625855.0,,16341.921899999805,154272.0620999907,154274.80969999026,154166.53739998714,77656.65039999633,77994.67190000656,78396.26810000658,,,,,,,,,,,,,,,,,,,,,,,,,,,231097849.0650001,3287883874.680004,3703942428.795001,52585544.38499994,3287996374.680004,237488.0,-16314723.0,3781629817.5,167297795.0,855337206.5,371328481.0,892864760.5,236214.0,3733.0,658.7088313443153,5397506.0,1946148.0,1199976.0,-3914300.0,1374937.0,101433.0,2612106022.9501467,2639880248.2200904,-157008387.0,-155715029.0,2770174.0,129199.0,,,,,,,,,,,,,,,,,,,,,1468302.0,14813519.0,3234298.0,8560481.0,11614365.0,1416673.0,,,,,,,,,,,,,,,,,,,,,,,,,,,,,,,,,,4275509.0,2480722.5,-9008772.0,921269.0,37582.5,3735920771.03246,3660609191.19746,-260771170.5,-257457642.0,2527858.5,269357.5,3928611953.4749546,33273023956.31342,36703481238.45013,1730382990.0525494,48114004683.42072,3990430.5,-247718696.0,103146293061.5,1055302172.5,17283061087.5,3505804884.5,18896535536.5,3674166.0,71971.0,20881.11856284278,89824406.5,-45.93738738738739,2.7808,4.552075746540423,138.43298845643477,12.658412235979604,384.9544542996538,56250.0,1.0,0.0,0.0,0.0,0.0,0.0,0.0,0.0,1.0,0.0,0.0,0.0,0.0,0.0,0.0,1.0,0.0,0.0,1.0,0.0,0.0,0.0,1.0,0.0,0.0,0.0,0.0,1.0,0.0,0.0,0.0,0.0,0.0,0.0,0.0,0.0,0.0,0.0,0.0,0.0,0.0,0.0,0.0,0.0,0.0,0.0,0.0,0.0,0.0,0.0,0.0,0.0,0.0,0.0,0.0,0.0,0.0,0.0,0.0,0.0,0.0,0.0,0.0,0.0,0.0,0.0,0.0,0.0,0.0,0.0,0.0,0.0,0.0,0.0,0.0,0.0,0.0,0.0,0.0,0.0,0.0,0.0,0.0,0.0,0.0,0.0,0.0,0.0,0.0,0.0,0.0,0.0,0.0,1.0,0.0,0.0,0.0,0.0,0.0,0.0,0.0,0.0,0.0,0.0,0.0,0.0,0.0,0.0,0.0,0.0,1.0,0.0,1.0,0.0,0.0,0.0,0.0,0.0,0.0,0.0,1.0,0.0
103914,0,0.0,1.0,1.0,1.0,0.0,90000.0,746703.0,28278.0,616500.0,0.019101,63.05205479452055,,-10598.0,-4012.0,19.0,2.0,2.0,2.0,10.0,,0.3022462213968179,0.5989262182569273,,,,,,,,,,,,,,,,,,,,,,,,,,,,,,,,,,,,,,,,,,,,,1.0,0.0,1.0,0.0,0.0,0.0,0.0,0.0,0.0,0.0,1.0,1.0,0.0,0.0,1.0,0.0,0.0,0.0,0.0,0.0,1.0,0.0,0.0,0.0,0.0,0.0,0.0,1.0,0.0,0.0,0.0,0.0,0.0,0.0,0.0,0.0,0.0,0.0,0.0,0.0,0.0,0.0,0.0,2.0,11583.0,,263250.0,171290.25,0.0,0.0,0.0,0.0,-724.5,601.0,-77.0,,48.0,-11.5,1.0,10453.905,276705.0,276705.0,0.0,276705.0,36.0,-613.0,365243.0,-577.0,365243.0,473.0,365243.0,11.0,0.0,0.0,57.0,20.0,36.0,26.5,-10.5,0.0,0.0,20.0,10453.905,10453.905,-302.0,-292.0,10.5,1.0,0.0,,,,,,,,,,,,,,,,,,,,,8351455819.5,184482782365.5,165659579064.0,52000365655.935,1863.0,1706.0,71125.0,70883.0,9141.0,506356.0,,,,,,,128494.0,663197.0,,,,13534988.23561604,,-922397314.0,-296678138.0,-1536028652.0416667,44039.0,30721.0,,,,,,,,158125.85981678922,126175.52103948328,,,,,,,3716222.0,,,,,,,,,,,,,,,,436685.0,431478.0,1263868.0,6428.5295490028975,632308.0,625857.0,,,,,,,,,24.0,65207743.91999997,,6472200985.065002,2123282323.2150009,75398350.09499995,710657.0999999999,118.0,14109.0,-21091860.0,9582711.0,-10897803.0,,-11.5,11583.0,,263250.0,171290.25,0.0,0.0,0.0,0.0,-724.5,601.0,-77.0,,231254748.58500013,3289977802.080004,3706227371.295001,52664349.28499994,3289977802.080004,237628.0,-16326033.0,3785464869.0,168385041.0,857339779.0,372054453.0,894867376.0,236405.0,3735.0,659.4652602918237,5403671.0,1947565.0,1200848.0,-3917087.0,1374952.0,101448.0,2613527473.927655,2641145455.9575963,-157096626.5,-155802128.5,2770807.0,129299.5,,,,,,,,,,,,,,,,,,,,,1468304.0,14813567.0,3234298.0,8560501.0,11614385.0,1416674.0,1059977088.3195012,,72148297630.40964,21692454907.522617,583105235.7644987,5792665.7475,689.5,94245.0,-277077755.5,21997256.0,-123850007.0,,-2021467.5,,,,,,,,,,,,,,,,,,,,,4275545.0,2480749.0,-9008782.5,921269.0,37582.5,3735931224.937461,3660619645.102461,-260771472.5,-257457934.0,2527869.0,269358.5,3928622407.379955,33273300661.31342,36703757943.45013,1730382990.0525494,48114281388.42072,3990466.5,-247719309.0,103146658304.5,1055301595.5,17283426330.5,3505805357.5,18896900779.5,3674177.0,71971.0,20881.11856284278,89824463.5,,8.2967,3.182686187141948,200.67490386543773,26.4057924888606,1664.9394749003775,45000.0,-0.2225209339563143,0.9749279121818236,0.0,0.0,0.0,0.0,0.0,0.0,1.0,0.0,0.0,1.0,0.0,0.0,0.0,0.0,0.0,0.0,0.0,0.0,1.0,0.0,1.0,0.0,0.0,0.0,0.0,1.0,0.0,0.0,0.0,0.0,0.0,0.0,0.0,0.0,0.0,0.0,0.0,0.0,0.0,0.0,0.0,0.0,0.0,0.0,0.0,0.0,0.0,0.0,0.0,0.0,0.0,0.0,0.0,0.0,0.0,0.0,0.0,0.0,0.0,0.0,0.0,0.0,0.0,0.0,0.0,0.0,0.0,0.0,0.0,0.0,0.0,0.0,0.0,0.0,0.0,0.0,0.0,0.0,0.0,0.0,0.0,0.0,0.0,0.0,0.0,0.0,0.0,0.0,0.0,0.0,0.0,0.0,0.0,0.0,0.0,0.0,0.0,0.0,0.0,0.0,0.0,0.0,0.0,0.0,0.0,1.0,0.0,0.0,0.0,0.0,0.0,0.0,0.0,0.0,0.0,0.0,0.0,0.0,0.0,0.0
103918,0,0.0,0.0,0.0,1.0,1.0,99000.0,677664.0,34731.0,585000.0,0.010966,48.602739726027394,-2466.0,-7078.0,-1281.0,,3.0,2.0,2.0,16.0,0.5121194155883381,0.4674053399680263,0.4400578303966329,,,,,,,,,,,,,,,,,,,,,,,,,,,,,,,,,,,,,,,,,,,,,0.0,0.0,0.0,0.0,-2102.0,0.0,0.0,0.0,0.0,0.0,0.0,1.0,1.0,0.0,1.0,0.0,0.0,0.0,0.0,0.0,0.0,0.0,0.0,0.0,1.0,0.0,0.0,0.0,0.0,0.0,0.0,0.0,0.0,0.0,0.0,0.0,0.0,0.0,0.0,0.0,0.0,0.0,0.0,10.0,0.0,0.0,76081.5,0.0,0.0,0.0,0.0,0.0,-1791.0,-548.0,-1048.0,-1251.5,568.0,-31.0,6.0,11205.675,16335.0,16146.0,3285.0,135000.0,12.0,-440.0,365243.0,-1240.5,181751.0,-820.5,181755.5,14.5,0.5,0.1005611388358669,-1.0,26.0,18.0,8.5,-14.5,0.0,0.0,33.0,4057.2,4057.2,-1745.0,-1741.0,8.0,1.0,0.0,,,,,,,,,,,,,,,,,,,,,8351490550.5,184483460029.5,165660164064.0,52000464655.935,1863.0,1706.0,71125.0,70883.0,9141.0,506356.0,,,,,,,128495.0,663200.0,,,,13535036.838355768,-602290078.0,-922398595.0,-296680240.0,-1536035730.0416667,44039.0,30721.0,,,,,,,67514.17737120233,158126.32722212918,126175.96109731367,,,,,,,3716238.0,,,,,,,,,,,,,,,,436685.0,431478.0,,6428.540515002898,632310.0,625859.0,,,,,,,,,59.0,65215834.91999997,24177443.849999987,6475121619.885001,2123755320.9600008,75580316.21249995,710657.0999999999,118.0,14109.0,-21107749.0,9651010.0,-10905715.0,-11863057.0,-29.0,0.0,0.0,71163.0,0.0,0.0,0.0,0.0,0.0,-2284.0,-1185.0,-1212.0,-1320.0,231365736.4050001,3292164487.080004,3708401150.295001,52734045.28499994,3292164487.080004,237808.0,-16333652.0,3788569434.5,168742918.5,858795450.5,372416245.5,896323080.0,236586.0,3736.0,660.3090981898588,5404555.5,1949196.0,1201936.0,-3919338.5,1374952.0,101448.0,2614366471.8601627,2641921937.0551004,-157175498.0,-155880067.0,2771485.0,129393.0,,,,,,,,,,,,,,,,,,,,,1468314.0,14814135.0,3234298.0,8560527.0,11614418.0,1416680.0,1059977088.3195012,801892571.8499951,72148373711.90964,21692454907.522617,583105235.7644987,5792665.7475,689.5,94245.0,-277079546.5,21996708.0,-123851055.0,-218822532.5,-2021498.5,,,,,,,,,,,,,,,,,,,,,4275563.0,2480757.5,-9008797.0,921269.0,37582.5,3735935282.13746,3660623702.30246,-260773217.5,-257459675.0,2527877.0,269359.5,3928633613.054957,33273316996.31342,36703774089.45013,1730386275.0525494,48114416388.42072,3990478.5,-247719749.0,103147023547.5,1055300355.0,17283608081.5,3505804537.0,18897082535.0,3674191.5,71971.5,20881.219123981617,89824462.5,-50.73788049605412,6.845090909090909,2.8504793988079813,138.54110831466735,19.511790619331435,948.3264810601084,33000.0,-0.2225209339563143,0.9749279121818236,0.0,0.0,0.0,0.0,0.0,0.0,1.0,0.0,0.0,0.0,0.0,0.0,0.0,1.0,0.0,0.0,0.0,0.0,1.0,0.0,1.0,0.0,0.0,0.0,0.0,1.0,0.0,0.0,0.0,0.0,0.0,0.0,0.0,0.0,0.0,0.0,0.0,0.0,0.0,0.0,0.0,0.0,0.0,0.0,0.0,0.0,1.0,0.0,0.0,0.0,0.0,0.0,1.0,0.0,0.0,0.0,0.0,0.0,0.0,0.0,0.0,0.0,0.0,0.0,0.0,0.0,0.0,0.0,0.0,0.0,0.0,0.0,0.0,0.0,0.0,0.0,0.0,0.0,0.0,0.0,0.0,0.0,0.0,0.0,0.0,0.0,0.0,0.0,0.0,0.0,0.0,0.0,0.0,0.0,0.0,0.0,0.0,0.0,0.0,0.0,0.0,0.0,0.0,0.0,0.0,0.0,0.0,0.0,0.0,0.0,0.0,0.0,0.0,0.0,0.0,0.0,0.0,0.0,0.0,0.0
103940,0,1.0,1.0,0.0,1.0,0.0,157500.0,135000.0,6750.0,135000.0,0.035792,22.92328767123288,-124.0,-3156.0,-1036.0,,2.0,2.0,2.0,13.0,0.3765741384877525,0.5239831365849477,0.6894791426446275,,,,,,,,,,,,,,,,,,,,,,,,,,,,,,,,,,,,,,,,,,,,,0.0,0.0,0.0,0.0,-74.0,0.0,0.0,0.0,0.0,1.0,3.0,1.0,1.0,0.0,1.0,0.0,1.0,0.0,0.0,0.0,0.0,0.0,0.0,0.0,0.0,0.0,0.0,0.0,0.0,0.0,0.0,0.0,0.0,0.0,0.0,0.0,0.0,0.0,0.0,0.0,0.0,0.0,0.0,2.0,0.0,,0.0,0.0,0.0,0.0,0.0,0.0,-1012.5,-282.0,-276.5,-428.0,67.0,-16.0,2.0,15183.18,115807.5,108969.75,11580.75,115807.5,8.0,-506.0,365243.0,-470.0,182359.5,-260.0,182361.5,17.0,0.5,0.1058559981430346,77.5,17.0,10.0,4.0,-10.0,0.0,0.0,15.0,18141.57,18141.57,-245.0,-236.0,4.0,1.0,0.0,,,,,,,,,,,,,,,,,,,,,8351497300.5,184483595029.5,165660299064.0,52000622155.935,1863.0,1706.0,71125.0,70884.0,9141.0,506359.0,,,,,,,128495.0,663202.0,,,,13535059.761643438,-602290202.0,-922399631.0,-296680314.0,-1536038886.0416667,44039.0,30721.0,,,,,,,67514.55394534083,158126.85120526573,126176.65057645632,,,,,,,3716251.0,,,,,,,,,,,,,,,,436685.0,431478.0,,6428.576307002898,632312.0,625861.0,,,,,,,,,33.5,65247712.91999997,,6541257070.080001,2153022538.5900006,76850745.25499995,710657.0999999999,118.0,14109.0,-21256211.5,9679730.0,-10990175.5,-11951270.0,-16.25,0.0,,0.0,0.0,0.0,0.0,0.0,0.0,-1305.0,-136.0,-129.0,-428.0,231922066.95,3299064842.835004,3715488004.545001,52988717.78999995,3299064842.835004,238377.0,-16393789.0,3802808926.5,169422688.0,861131263.5,373844471.0,899392288.5,237357.5,3744.5,663.1204776540151,5416386.0,1955182.0,1205277.0,-3936492.0,1374968.0,101452.0,2621595916.440157,2649011487.4350963,-157933613.0,-156632493.0,2785186.0,129833.0,,,,,,,,,,,,,,,,,,,,,1468316.0,14814202.0,3234298.0,8560544.0,11614433.0,1416682.0,1059977088.3195012,,72148373711.90964,21692454907.522617,583105235.7644987,5792665.7475,689.5,94245.0,-277080559.0,21996426.0,-123851331.5,-218822960.5,-2021514.5,,,,,,,,,,,,,,,,,,,,,4275573.0,2480761.5,-9008807.0,921269.0,37582.5,3735953423.707461,3660641843.872461,-260773462.5,-257459911.0,2527881.0,269360.5,3928648796.234955,33273432803.81342,36703883059.20013,1730397855.8025494,48114532195.92072,3990486.5,-247720255.0,103147388790.5,1055299885.0,17283790441.0,3505804277.0,18897264896.5,3674208.5,71972.0,20881.32497997976,89824540.0,-5.40934624118561,0.8571428571428571,23.33333333333333,534.8767123287671,20.0,458.4657534246576,78750.0,0.6234898018587336,0.7818314824680298,0.0,0.0,0.0,0.0,0.0,0.0,1.0,0.0,0.0,0.0,0.0,0.0,0.0,1.0,0.0,1.0,0.0,0.0,0.0,1.0,0.0,0.0,0.0,0.0,0.0,1.0,0.0,0.0,0.0,0.0,0.0,0.0,0.0,0.0,0.0,0.0,0.0,1.0,0.0,0.0,0.0,0.0,0.0,0.0,0.0,0.0,0.0,0.0,0.0,0.0,0.0,0.0,0.0,0.0,0.0,0.0,0.0,0.0,0.0,0.0,0.0,0.0,0.0,0.0,0.0,0.0,0.0,0.0,0.0,0.0,0.0,0.0,0.0,0.0,0.0,0.0,0.0,0.0,0.0,0.0,0.0,1.0,0.0,0.0,0.0,0.0,0.0,0.0,0.0,0.0,0.0,0.0,0.0,0.0,0.0,0.0,0.0,0.0,0.0,0.0,0.0,0.0,0.0,0.0,0.0,0.0,0.0,0.0,0.0,0.0,0.0,0.0,0.0,0.0,0.0,0.0,0.0,0.0,0.0,0.0
103963,0,0.0,0.0,1.0,0.0,0.0,103500.0,781920.0,42417.0,675000.0,0.018801,29.35068493150685,-2854.0,-4833.0,-3387.0,14.0,2.0,2.0,2.0,8.0,0.2416761114788368,0.1939004651815596,0.5797274227921155,,,,,,,,,,,,,,,,,,,,,,,,,,,,,,,,,,,,,,,,,,,,,0.0,0.0,0.0,0.0,-1886.0,0.0,0.0,0.0,0.0,1.0,5.0,1.0,1.0,0.0,1.0,0.0,0.0,0.0,0.0,0.0,0.0,1.0,1.0,0.0,1.0,0.0,0.0,0.0,0.0,0.0,0.0,0.0,0.0,0.0,0.0,0.0,0.0,0.0,0.0,0.0,0.0,0.0,0.0,10.0,0.0,0.0,40272.75,0.0,0.0,0.0,0.0,0.0,-2033.5,-1763.0,-1180.0,-1700.0,638.0,-33.5,20.0,11294.1,64516.5,67529.25,0.0,81900.0,12.0,-1105.5,365243.0,-1452.5,-1242.5,-1152.5,-1240.0,10.5,0.0,0.0,-1.0,112.0,36.0,10.0,-37.5,0.0,0.0,131.0,12730.5,12730.5,-899.0,-900.0,8.0,1.0,12.0,0.0,202500.0,0.0,0.0,0.0,0.0,0.0,568.395,568.395,0.0,0.0,0.0,0.0,0.0,0.0,0.0,5.0,-6.5,0.0,0.0,8351539717.5,184484376949.5,165660974064.0,52000725655.935,1863.0,1706.0,71125.0,70885.0,9141.0,506364.0,,,,,,,128495.0,663204.0,,,,13535089.11232837,-602293056.0,-922403018.0,-296682200.0,-1536043719.0416667,44039.0,30721.0,,,,,,,67514.7956214523,158127.04510573097,126177.23030387911,,,,,,,3716259.0,,,,,,,,,,,,,,,,436685.0,431478.0,1263882.0,6428.595108002898,632314.0,625863.0,,,,,,,,,67.0,65701070.41499997,24407925.434999984,6582010153.185,2163443434.110001,77135978.06999993,710657.0999999999,118.0,14109.0,-21422132.5,9710494.5,-11085679.0,-12050522.5,-33.0,0.0,0.0,37350.0,0.0,0.0,0.0,0.0,0.0,-2092.0,-1881.0,-1865.0,-1890.0,233089300.98,3316387510.350004,3734707666.7700014,53324449.82999994,3316424036.850004,239797.0,-16478828.5,3827276998.5,170081624.0,865642335.0,374897742.0,904269935.0,238612.5,3759.5,667.9678734805026,5443583.5,1965814.0,1211761.5,-3958746.0,1374988.0,101472.0,2634475216.770165,2663260921.935103,-158594078.0,-157282791.0,2794533.0,130647.0,2452466332.4399834,6609161250.0,206903906.685,323058988.9799996,11286179.1,104534501.53499988,139138178.7599995,353687225.58000034,325592258.01749927,2354767609.86,2443133737.304979,2443225449.239979,10640.0,27831.0,151.0,17040.0,795158.5,-1409917.0,590028.0,1301.0,1468326.0,14814840.0,3234310.0,8560656.0,11614564.0,1416702.0,1059977088.3195012,801892571.8499951,72148413984.65964,21692454907.522617,583105235.7644987,5792665.7475,689.5,94245.0,-277082592.5,21994663.0,-123852511.5,-218824660.5,-2021548.0,5925906057.622461,18734328000.0,198840207.825,448214504.2424976,1948107.735,256951392.6600008,309260907.29249865,636890568.7049978,459378512.2349993,5710961211.345035,5889166998.9749975,5889410181.719999,13391.5,80921.0,44.0,70423.5,971843.0,-1699391.5,177364.0,6755.0,4275609.0,2480771.5,-9008844.5,921269.0,37582.5,3735966154.207461,3660654574.372461,-260774361.5,-257460811.0,2527889.0,269361.5,3928660090.3349543,33273497320.31342,36703950588.45013,1730397855.8025494,48114614095.92072,3990498.5,-247721360.5,103147754033.5,1055298432.5,17283789198.5,3505803124.5,18897263656.5,3674219.0,71972.0,20881.32497997976,89824539.0,-97.23793521889294,7.554782608695652,2.44005941014216,71.61741496124098,18.434118395926163,541.0540010289234,51750.0,-0.2225209339563146,-0.9749279121818236,0.0,0.0,0.0,0.0,0.0,0.0,1.0,0.0,0.0,0.0,0.0,0.0,0.0,1.0,0.0,0.0,0.0,0.0,1.0,0.0,1.0,0.0,0.0,0.0,0.0,0.0,0.0,0.0,0.0,1.0,0.0,0.0,0.0,0.0,0.0,0.0,0.0,0.0,1.0,0.0,0.0,0.0,0.0,0.0,0.0,0.0,0.0,0.0,0.0,0.0,0.0,0.0,0.0,1.0,0.0,0.0,0.0,0.0,0.0,0.0,0.0,0.0,0.0,0.0,0.0,0.0,0.0,0.0,0.0,0.0,0.0,0.0,0.0,0.0,0.0,0.0,0.0,0.0,0.0,0.0,0.0,0.0,0.0,0.0,0.0,0.0,0.0,0.0,0.0,0.0,0.0,0.0,0.0,0.0,0.0,0.0,0.0,0.0,0.0,0.0,0.0,0.0,0.0,0.0,0.0,0.0,0.0,0.0,0.0,0.0,0.0,0.0,0.0,0.0,0.0,0.0,0.0,0.0,0.0,0.0
103966,0,0.0,0.0,0.0,1.0,0.0,40500.0,234000.0,9967.5,234000.0,0.01885,51.81917808219178,-4803.0,-6913.0,-2448.0,,2.0,2.0,2.0,17.0,0.5117196550233074,0.7639602225130396,0.1376544619182607,,,,,,,,,,,,,,,,,,,,,,,,,,,,,,,,,,,,,,,,,,,,,2.0,1.0,2.0,1.0,-1988.0,0.0,0.0,0.0,0.0,1.0,1.0,1.0,1.0,1.0,1.0,0.0,0.0,0.0,0.0,0.0,0.0,0.0,0.0,0.0,1.0,0.0,0.0,0.0,0.0,0.0,0.0,0.0,0.0,0.0,0.0,0.0,0.0,0.0,0.0,0.0,0.0,0.0,0.0,11.0,0.0,0.0,46548.0,0.0,0.0,0.0,0.0,0.0,-520.0,-264.0,-260.0,-308.0,278.0,-14.0,2.0,,45936.0,45936.0,0.0,45936.0,,-780.0,,,,,,11.5,,0.0,30.0,0.0,,,,,,98.0,450.0,450.0,-2177.5,-2175.0,79.5,0.0,93.0,0.0,67500.0,0.0,0.0,0.0,0.0,0.0,214.605,0.0,0.0,0.0,0.0,0.0,0.0,0.0,0.0,56.0,-50.0,0.0,0.0,8351549685.0,184484610949.5,165661208064.0,52000766155.935,1863.0,1706.0,71125.0,70886.0,9141.0,506365.0,,,,,,,128495.0,663206.0,,,,13535140.931506451,-602297859.0,-922405466.0,-296684188.0,-1536050632.0416667,44040.0,30722.0,,,,,,,67515.30734110733,158127.80906595345,126177.36795834106,,,,,,,3716276.0,,,,,,,,,,,,,,,,436687.0,431480.0,,6428.613958002898,632316.0,625865.0,,,,,,,,,18.0,65813003.41499997,24407925.434999984,6588250667.685,2166764677.110001,77135978.06999993,710657.0999999999,118.0,14109.0,-21437639.0,9710842.0,-11094321.0,-12060043.0,-8.5,0.0,0.0,35892.0,0.0,0.0,0.0,0.0,0.0,-1303.0,-1182.0,-963.0,-1182.0,,3318258623.850004,3736951499.5200014,53324449.82999994,3318258623.850004,,-16491648.0,,,,,,238732.0,,667.9678734805026,5448835.0,,,,,,2637422623.282668,2666932547.152606,-158803773.5,-157491634.5,2799212.5,130845.0,2455433816.579984,6617853000.0,207068156.685,323452949.2199996,11286179.1,104764211.7749999,139328202.59999952,354035615.44500065,325938432.2399993,2357623852.425001,2446127037.629979,2446236704.564979,10651.0,27878.0,151.0,17076.0,798334.0,-1416985.0,590028.0,1301.0,1468337.0,14815118.0,3234403.0,8560656.0,11614662.0,1416704.0,1059977088.3195012,801892571.8499951,72148460532.65964,21692454907.522617,583105235.7644987,5792665.7475,689.5,94245.0,-277083112.5,21994399.0,-123852771.5,-218824968.5,-2021562.0,5925906057.622461,18734395500.0,198840207.825,448214504.2424976,1948107.735,256951392.6600008,309260907.29249865,636890783.3099978,459378512.2349993,5710961211.345035,5889166998.9749975,5889410181.719999,13391.5,80921.0,44.0,70423.5,971899.0,-1699441.5,177364.0,6755.0,,,,,,3735966604.207461,3660655024.372461,-260776539.0,-257462986.0,2527968.5,269361.5,,33273543256.31342,36703996524.45013,1730397855.8025494,48114660031.92072,,-247722140.5,,,,,,3674230.5,,20881.32497997976,89824569.0,-92.68769165697368,5.777777777777778,4.063205417607223,210.5519651195152,23.476297968397287,1216.5224651349763,20250.0,0.6234898018587336,0.7818314824680298,0.0,0.0,0.0,0.0,0.0,0.0,1.0,0.0,0.0,0.0,0.0,0.0,0.0,1.0,0.0,0.0,0.0,0.0,1.0,0.0,1.0,0.0,0.0,0.0,0.0,1.0,0.0,0.0,0.0,0.0,0.0,0.0,0.0,0.0,0.0,0.0,0.0,0.0,1.0,0.0,0.0,0.0,0.0,0.0,0.0,0.0,0.0,0.0,0.0,0.0,0.0,0.0,0.0,0.0,0.0,0.0,0.0,0.0,0.0,0.0,0.0,0.0,0.0,0.0,0.0,0.0,0.0,0.0,0.0,0.0,0.0,0.0,0.0,0.0,0.0,0.0,1.0,0.0,0.0,0.0,0.0,0.0,0.0,0.0,0.0,0.0,0.0,0.0,0.0,0.0,0.0,0.0,0.0,0.0,0.0,0.0,0.0,0.0,0.0,0.0,0.0,0.0,0.0,0.0,0.0,0.0,0.0,0.0,0.0,0.0,0.0,0.0,0.0,0.0,0.0,0.0,0.0,0.0,0.0,0.0
103971,0,0.0,1.0,0.0,0.0,1.0,202500.0,450000.0,32746.5,450000.0,0.030755,38.08219178082192,-1734.0,-4451.0,-4443.0,,2.0,2.0,2.0,15.0,,0.5981013266687437,,,,,,,,,,,,,,,,,,,,,,,,,,,,,,,,,,,,,,,,,,,,,,0.0,0.0,0.0,0.0,-452.0,,,,,,,1.0,1.0,1.0,1.0,1.0,0.0,0.0,0.0,0.0,0.0,0.0,0.0,0.0,1.0,0.0,0.0,0.0,0.0,0.0,0.0,0.0,0.0,0.0,0.0,0.0,0.0,0.0,0.0,0.0,0.0,0.0,0.0,0.0,,,,,,,,,,,,,0.0,,4.0,9927.225,132747.75,136509.75,1732.5,132747.75,8.0,-452.0,365243.0,-397.5,-164.0,166.0,-158.5,12.5,0.0,0.0521322889469103,74.0,21.0,10.0,9.0,-12.0,0.0,0.0,55.0,7238.205,7115.535,-248.0,-250.0,10.0,0.0,14.0,125760.6675,270000.0,33750.0,34870.725,0.0,5816.25,7268.49,16969.3875,10397.565,118809.6525,123631.8075,123631.8075,1.0,3.0,0.0,3.0,5.5,-8.5,0.0,0.0,8351582431.5,184485060949.5,165661658064.0,52000968655.935,,,,,,,,,,,,,128496.0,663208.0,,,,13535179.013698231,-602299593.0,-922409909.0,-296684640.0,-1536055083.0416667,44040.0,30722.0,,,,,,,,158128.40716728012,,,,,,,,3716291.0,,,,,,,,,,,,,,,,436687.0,431480.0,,6428.644713002898,632318.0,625867.0,,,,,,,,,,,,,,,,,,,,,,,,,,,,,,,,,,,233296421.22,3319197566.850004,3737858551.0200014,53398519.82999994,3319197566.850004,240050.0,-16504695.0,3832389995.5,170064109.0,866359604.0,375250912.0,904987406.0,238929.0,3763.5,669.3357350965683,5457127.5,1968009.0,1213032.0,-3964045.0,1375000.0,101484.0,2638725015.96017,2668198458.690107,-158977013.0,-157663706.0,2803904.0,130913.0,2456941822.852483,6622803000.0,207524906.685,324046995.43499964,11286179.1,104879007.98999988,139463592.61499947,354707372.7000008,326655871.26749927,2359059947.5725,2447635795.4474783,2447761527.382478,10670.0,27937.5,151.0,17116.0,800630.5,-1419321.5,590028.0,1301.0,1468337.0,14815118.0,3234417.0,8560677.0,11614717.0,1416708.0,,,,,,,,,,,,,,5926031818.289961,18734665500.0,198873957.825,448249374.9674977,1948107.735,256957208.9100008,309268175.78249866,636907752.6974977,459388909.7999993,5711080020.997535,5889290630.782497,5889533813.527499,13392.5,80924.0,44.0,70426.5,971904.5,-1699450.0,177364.0,6755.0,4275619.0,2480780.5,-9008856.5,921269.0,37582.5,3735973842.41246,3660662139.90746,-260776787.0,-257463236.0,2527978.5,269361.5,3928670017.559954,33273676004.06342,36704133034.20013,1730399588.3025494,48114792779.67072,3990506.5,-247722592.5,103148119276.5,1055298035.0,17283789034.5,3505803290.5,18897263498.0,3674243.0,71972.0,20881.377112268707,89824643.0,-45.533093525179865,2.2222222222222223,6.183866978150338,235.4952082090128,13.741926618111858,523.3226849089174,101250.0,0.6234898018587334,-0.7818314824680299,0.0,0.0,0.0,0.0,0.0,0.0,1.0,0.0,1.0,0.0,0.0,0.0,0.0,0.0,0.0,0.0,0.0,0.0,1.0,0.0,0.0,0.0,1.0,0.0,0.0,1.0,0.0,0.0,0.0,0.0,0.0,0.0,0.0,0.0,1.0,0.0,0.0,0.0,0.0,0.0,0.0,0.0,0.0,0.0,0.0,0.0,0.0,0.0,0.0,0.0,0.0,0.0,0.0,0.0,0.0,0.0,0.0,0.0,0.0,0.0,0.0,0.0,0.0,0.0,0.0,0.0,0.0,0.0,0.0,0.0,0.0,0.0,0.0,0.0,0.0,0.0,0.0,0.0,0.0,0.0,0.0,0.0,0.0,0.0,0.0,0.0,0.0,0.0,0.0,0.0,1.0,0.0,0.0,0.0,0.0,0.0,0.0,0.0,0.0,0.0,0.0,0.0,0.0,0.0,0.0,0.0,0.0,0.0,0.0,0.0,0.0,0.0,0.0,0.0,0.0,0.0,0.0,0.0,0.0,0.0
103980,0,0.0,0.0,1.0,0.0,1.0,112500.0,450000.0,23107.5,450000.0,0.018634,24.92328767123288,-1204.0,-350.0,-1784.0,10.0,3.0,2.0,2.0,14.0,0.2231454324173988,0.5309921998186411,,,,,,,,,,,,,,,,,,,,,,,,,,,,,,,,,,,,,,,,,,,,,,1.0,1.0,1.0,1.0,-571.0,,,,,,,1.0,1.0,0.0,1.0,0.0,0.0,0.0,0.0,0.0,0.0,0.0,0.0,0.0,1.0,0.0,0.0,0.0,0.0,0.0,0.0,0.0,0.0,0.0,0.0,0.0,0.0,0.0,0.0,0.0,0.0,0.0,0.0,0.0,,,,,,,,,,,,,0.0,,1.0,9662.85,101137.5,91021.5,10116.0,101137.5,12.0,-571.0,365243.0,-534.0,-234.0,-204.0,-227.0,13.0,0.0,0.1089333198503387,10.0,13.0,11.0,6.0,-13.0,0.0,0.0,11.0,9662.85,9662.85,-398.0,-384.0,6.0,2.0,0.0,,,,,,,,,,,,,,,,,,,,,8351605539.0,184485510949.5,165662108064.0,52001081155.935,,,,,,,,,,,,,128497.0,663211.0,,,,13535203.936985902,-602300797.0,-922411693.0,-296685211.0,-1536055433.0416667,44041.0,30723.0,,,,,,,67515.53048653975,158128.93815947993,,,,,,,,3716305.0,,,,,,,,,,,,,,,,436688.0,431481.0,1263892.0,6428.663347002898,632320.0,625869.0,,,,,,,,,,,,,,,,,,,,,,,,,,,,,,,,,,,233912923.4699999,3331408604.850004,3751717858.0200014,53499468.32999994,3331408604.850004,240721.0,-16542689.0,3840970353.0,170031995.0,867796807.0,375963719.0,906790472.0,239336.0,3770.0,671.0729960125276,5461480.0,1973138.0,1216462.0,-3972411.0,1375072.0,101494.0,2647315307.745181,2678068350.720118,-159542942.0,-158227538.0,2820060.0,131206.0,,,,,,,,,,,,,,,,,,,,,1468337.0,14815118.0,3234417.0,8560690.0,11614728.0,1416709.0,,,,,,,,,,,,,,,,,,,,,,,,,,,,,,,,,,4275630.0,2480786.5,-9008869.5,921269.0,37582.5,3735983505.26246,3660671802.75746,-260777185.0,-257463620.0,2527984.5,269363.5,3928679680.4099545,33273777141.56342,36704224055.70013,1730409704.3025494,48114893917.17072,3990518.5,-247723163.5,103148484519.5,1055297501.0,17283788800.5,3505803086.5,18897263271.0,3674256.0,71972.0,20881.48604558856,89824653.0,-48.308233483566006,4.0,4.868549172346642,121.34025156393808,19.474196689386567,485.36100625575233,37500.0,-0.2225209339563143,0.9749279121818236,0.0,1.0,0.0,0.0,0.0,0.0,0.0,0.0,0.0,0.0,0.0,0.0,0.0,1.0,0.0,0.0,0.0,0.0,1.0,0.0,1.0,0.0,0.0,0.0,0.0,0.0,0.0,0.0,0.0,1.0,0.0,0.0,0.0,0.0,0.0,0.0,0.0,0.0,1.0,0.0,0.0,0.0,0.0,0.0,0.0,0.0,0.0,0.0,0.0,0.0,0.0,0.0,0.0,0.0,0.0,0.0,0.0,0.0,0.0,0.0,0.0,0.0,0.0,0.0,0.0,0.0,0.0,0.0,0.0,0.0,0.0,0.0,0.0,0.0,0.0,0.0,0.0,0.0,0.0,0.0,0.0,1.0,0.0,0.0,0.0,0.0,0.0,0.0,0.0,0.0,0.0,0.0,0.0,0.0,0.0,0.0,0.0,0.0,0.0,0.0,0.0,0.0,0.0,0.0,0.0,0.0,0.0,0.0,0.0,0.0,0.0,0.0,0.0,0.0,0.0,0.0,0.0,0.0,0.0,0.0
103984,0,0.0,1.0,0.0,1.0,0.0,74250.0,312840.0,18090.0,247500.0,0.072508,62.38356164383562,,-10111.0,-4327.0,,2.0,1.0,1.0,12.0,,0.4148986368283817,0.3927738606031339,0.1031,0.0617,0.9727,,,0.0,0.1724,0.1667,,0.1005,,0.0798,,0.0637,0.105,0.0641,0.9727,,,0.0,0.1724,0.1667,,0.1028,,0.0831,,0.0675,0.1041,0.0617,0.9727,,,0.0,0.1724,0.1667,,0.1023,,0.0812,,0.0651,0.0766,1.0,0.0,0.0,0.0,0.0,-130.0,0.0,0.0,0.0,0.0,0.0,0.0,1.0,0.0,0.0,1.0,0.0,0.0,0.0,0.0,0.0,0.0,0.0,0.0,0.0,0.0,0.0,0.0,1.0,0.0,0.0,0.0,0.0,0.0,0.0,0.0,0.0,0.0,0.0,0.0,0.0,0.0,0.0,0.0,3.0,,,60687.0,0.0,,0.0,0.0,0.0,-2711.0,-2442.0,-655.0,-2576.0,270.0,-44.5,7.0,23242.86,256500.0,310671.0,16191.0,355500.0,33.0,-345.0,365243.0,-714.0,-564.0,347.0,-558.0,15.0,1.0,0.2095256705651316,-1.0,33.0,18.0,16.0,-23.0,0.0,0.0,27.0,31633.2,31633.2,-728.0,-714.0,3.0,1.0,0.0,,,,,,,,,,,,,,,,,,,,,8351623629.0,184485823789.5,165662355564.0,52001155405.935,1863.0,1706.0,71125.0,70886.0,9141.0,506365.0,17818.783800002293,17880.98169999911,17332.203499998017,11301.915900000093,11239.717600000096,11187.096800000054,128497.0,663213.0,,,,13535266.320547547,,-922416020.0,-296685341.0,-1536065544.0416667,44041.0,30723.0,11356.113999999186,11232.05999999898,10716.18099999729,22901.726100009742,22823.511800009703,22208.79380000826,,158129.35305811674,126177.76073220164,35022.31600002796,34962.4922000284,34407.92630002881,,,,3716317.0,8300.672600000162,8405.262500000075,8128.770400000232,,,,16477.541899999742,16662.8545999997,16259.530399999703,,,,3916.339800000124,3899.547000000164,3732.19600000016,436688.0,431481.0,,6428.735855002898,632321.0,625870.0,,16341.998499999803,154273.03479999068,154275.78239999025,154167.51009998718,,,,90.0,,,6606415458.945001,2170687785.9750013,,711053.0999999999,118.0,14169.0,-21517386.0,9667704.0,-11140777.0,-12111546.5,-44.5,,,60687.0,0.0,,0.0,0.0,0.0,-2711.0,-2442.0,-655.0,-2681.0,234113645.3399999,3334693582.350004,3755786357.5200014,53515659.32999994,3334810582.350004,240925.0,-16551004.0,3843160579.0,170025148.0,868157644.0,376327486.0,907517245.0,239482.0,3774.0,671.2825216830927,5461748.0,1974711.0,1217506.0,-3974169.0,1375072.0,101494.0,2652422163.48018,2684067752.385117,-159641406.0,-158325226.0,2822604.0,131467.0,,,,,,,,,,,,,,,,,,,,,1468340.0,14815388.0,3234417.0,8560723.0,11614755.0,1416716.0,,,72148521219.65964,21692454907.522617,,5792665.7475,689.5,94245.0,-277085823.5,21991957.0,-123853426.5,-218827544.5,-2021606.5,,,,,,,,,,,,,,,,,,,,,4275648.0,2480802.5,-9008892.5,921269.0,37582.5,3736015138.46246,3660703435.957459,-260777913.0,-257464334.0,2527987.5,269364.5,3928702923.269954,33274033641.56342,36704534726.70013,1730425895.3025494,48115249417.17072,3990551.5,-247723508.5,103148849762.5,1055296787.0,17283788236.5,3505803433.5,18897262713.0,3674271.0,71973.0,20881.695571259123,89824652.0,,4.213333333333333,4.104477611940299,256.05193212022084,17.29353233830846,1078.8321406665302,37125.0,-0.9009688679024191,-0.433883739117558,0.0,0.0,0.0,0.0,0.0,0.0,1.0,0.0,0.0,1.0,0.0,0.0,0.0,0.0,0.0,0.0,1.0,0.0,0.0,0.0,1.0,0.0,0.0,0.0,0.0,1.0,0.0,0.0,0.0,0.0,0.0,0.0,0.0,0.0,0.0,0.0,0.0,0.0,0.0,0.0,0.0,0.0,0.0,0.0,0.0,0.0,0.0,0.0,0.0,0.0,0.0,0.0,0.0,0.0,0.0,0.0,0.0,0.0,0.0,0.0,0.0,0.0,0.0,0.0,0.0,0.0,0.0,0.0,0.0,0.0,0.0,0.0,0.0,0.0,0.0,0.0,0.0,0.0,0.0,0.0,0.0,0.0,0.0,0.0,0.0,0.0,0.0,0.0,0.0,0.0,0.0,0.0,0.0,0.0,0.0,0.0,0.0,0.0,0.0,0.0,0.0,0.0,0.0,0.0,0.0,1.0,0.0,0.0,0.0,0.0,0.0,0.0,1.0,0.0,0.0,0.0,0.0,0.0,1.0,0.0
103985,0,0.0,0.0,0.0,0.0,1.0,135000.0,238500.0,13819.5,238500.0,0.00712,31.528767123287672,-1971.0,-1984.0,-3398.0,,3.0,2.0,2.0,11.0,0.6683492041949831,0.5483417687328894,,0.0247,0.0,0.9757,0.6668,0.0014,0.0,0.1034,0.0417,0.0417,,0.0202,0.0194,0.0,0.0,0.0252,0.0,0.9757,0.6798,0.0014,0.0,0.1034,0.0417,0.0417,,0.022,0.0202,0.0,0.0,0.025,0.0,0.9757,0.6713,0.0014,0.0,0.1034,0.0417,0.0417,,0.0205,0.0198,0.0,0.0,0.0153,1.0,3.0,1.0,3.0,1.0,-972.0,0.0,0.0,0.0,0.0,0.0,5.0,1.0,1.0,0.0,1.0,0.0,0.0,0.0,0.0,0.0,0.0,0.0,0.0,0.0,1.0,0.0,0.0,0.0,0.0,0.0,0.0,0.0,0.0,0.0,0.0,0.0,0.0,0.0,0.0,0.0,0.0,0.0,0.0,1.0,,0.0,106803.0,,,0.0,0.0,0.0,-1187.0,-931.0,-926.0,-931.0,40.0,-19.5,3.0,4500.0,25155.0,90000.0,0.0,25155.0,12.0,-1596.0,365243.0,-1431.0,-831.0,-831.0,-824.0,12.0,0.5,0.0,-1.0,43.0,30.0,11.0,-24.0,0.0,0.0,43.0,26565.66,26565.66,-703.0,-702.0,11.0,1.0,0.0,,,,,,,,,,,,,,,,,,,,,8351637448.5,184486062289.5,165662594064.0,52001290405.935,1863.0,1706.0,71125.0,70886.0,9141.0,506370.0,17818.808500002295,17881.00669999911,17332.228699998017,11301.915900000093,11239.717600000096,11187.096800000054,128498.0,663216.0,4140.524000000116,4138.211300000016,3948.784700000093,13535297.849314673,-602302768.0,-922419418.0,-296686313.0,-1536067528.0416667,44042.0,30724.0,11356.113999999186,11232.05999999898,10716.18099999729,22901.829500009742,22823.615200009703,22208.89720000826,67516.19883574394,158129.9013998855,,35022.35770002796,34962.5339000284,34407.96800002881,22967.6817999959,22940.733599995478,22587.497699995707,3716328.0,,,,9822.996500000718,9937.966000002163,10297.930699999644,16477.561299999743,16662.8743999997,16259.550599999704,828.9524000001767,814.1286000000459,760.0513000000133,3916.339800000124,3899.547000000164,3732.19600000016,436691.0,431484.0,,6428.7429750029,632323.0,625872.0,,16342.013799999802,154274.0104999907,154276.75809999026,154168.48579998722,77657.31719999632,77995.34320000657,78396.94790000658,40.0,,24449612.849999987,6606569891.790001,,,711053.0999999999,118.0,14169.0,-21521138.0,9664331.0,-11142621.0,-12113713.0,-19.5,,0.0,106803.0,,,0.0,0.0,0.0,-1187.0,-931.0,-926.0,-931.0,234154587.195,3335290192.350004,3756545620.0200014,53515659.32999994,3335290192.350004,241003.0,-16557905.0,3844438929.5,170019705.0,868153146.0,376325064.0,907512768.5,239553.0,3776.5,671.2825216830927,5461876.0,1975519.0,1218060.0,-3975844.0,1375072.0,101494.0,2653387147.62018,2685028651.875118,-159689481.0,-158372952.0,2822864.0,131503.0,,,,,,,,,,,,,,,,,,,,,1468341.0,14815428.0,3234417.0,8560766.0,11614798.0,1416719.0,,801892571.8499951,72148628022.65964,,,5792665.7475,689.5,94245.0,-277087010.5,21991026.0,-123854352.5,-218828475.5,-2021626.0,,,,,,,,,,,,,,,,,,,,,4275678.0,2480813.5,-9008916.5,921269.0,37582.5,3736041704.122461,3660730001.6174593,-260778616.0,-257465036.0,2527998.5,269365.5,3928707423.269954,33274058796.56342,36704624726.70013,1730425895.3025494,48115274572.17072,3990563.5,-247725104.5,103149215005.5,1055295356.0,17283787405.5,3505802602.5,18897261889.0,3674283.0,71973.5,20881.695571259123,89824651.0,-62.51433785192909,1.7666666666666666,9.76880494952784,307.99837632648325,17.258222077499187,544.1304648434539,45000.0,-0.9009688679024191,-0.433883739117558,0.0,1.0,0.0,0.0,0.0,0.0,0.0,0.0,0.0,0.0,0.0,0.0,0.0,1.0,0.0,0.0,1.0,0.0,0.0,0.0,1.0,0.0,0.0,0.0,0.0,1.0,0.0,0.0,0.0,0.0,0.0,0.0,0.0,0.0,0.0,0.0,0.0,0.0,0.0,0.0,0.0,1.0,0.0,0.0,0.0,0.0,0.0,0.0,0.0,0.0,0.0,0.0,0.0,0.0,0.0,0.0,0.0,0.0,0.0,0.0,0.0,0.0,0.0,0.0,0.0,0.0,0.0,0.0,0.0,0.0,0.0,0.0,0.0,0.0,0.0,0.0,0.0,0.0,0.0,0.0,0.0,1.0,0.0,0.0,0.0,0.0,0.0,0.0,0.0,0.0,0.0,0.0,0.0,0.0,0.0,0.0,0.0,0.0,0.0,0.0,0.0,0.0,0.0,0.0,0.0,0.0,0.0,0.0,1.0,0.0,1.0,0.0,0.0,0.0,0.0,0.0,0.0,0.0,1.0,0.0
103998,1,0.0,1.0,0.0,1.0,0.0,157500.0,450000.0,19048.5,450000.0,0.018209,50.254794520547954,-3149.0,-8180.0,-1902.0,,1.0,3.0,3.0,7.0,,0.1171043506181062,0.3001077565791181,0.0619,0.0509,0.9762,0.6736,0.0221,0.0,0.1379,0.1667,0.0417,0.0599,0.0504,0.0543,0.0,0.0,0.063,0.0528,0.9762,0.6864,0.0223,0.0,0.1379,0.1667,0.0417,0.0613,0.0551,0.0566,0.0,0.0,0.0625,0.0509,0.9762,0.6779999999999999,0.0223,0.0,0.1379,0.1667,0.0417,0.0609,0.0513,0.0553,0.0,0.0,0.0427,1.0,0.0,0.0,0.0,0.0,-1226.0,0.0,0.0,0.0,0.0,0.0,2.0,1.0,1.0,0.0,1.0,0.0,0.0,0.0,0.0,0.0,0.0,0.0,0.0,0.0,1.0,0.0,0.0,0.0,0.0,0.0,0.0,0.0,0.0,0.0,0.0,0.0,0.0,0.0,0.0,0.0,0.0,0.0,0.0,9.0,0.0,0.0,117607.5,2227.5,0.0,0.0,0.0,0.0,-884.0,164.5,-771.0,-1004.0,279.0,-18.0,3.0,22500.0,540000.0,633739.5,,607500.0,48.0,-911.0,365243.0,-873.0,-532.0,848.0,-523.0,9.0,0.0,,-1.0,22.0,48.0,44.5,-29.5,0.0,0.0,77.0,9878.4,8128.035,-547.0,-542.0,19.0,0.0,30.0,196592.355,450000.0,0.0,4718.9025,0.0,0.0,9878.4,10350.0,10350.0,191054.25,195919.605,195919.605,0.0,1.0,0.0,0.0,14.0,-15.5,0.0,0.0,8351656497.0,184486512289.5,165663044064.0,52001447905.935,1863.0,1706.0,71125.0,70886.0,9141.0,506372.0,17818.870400002295,17881.06919999911,17332.29169999802,11301.966800000091,11239.768500000097,11187.149600000052,128498.0,663217.0,4140.546100000116,4138.233600000016,3948.8070000000935,13535348.104109192,-602305917.0,-922421320.0,-296687539.0,-1536075708.0416667,44042.0,30724.0,11356.113999999186,11232.05999999898,10716.18099999729,22901.96740000974,22823.7531000097,22209.035100008263,,158130.01850423613,126178.0608399582,35022.52440002796,34962.7006000284,34408.134700028815,22967.7234999959,22940.77529999548,22587.53939999571,3716335.0,8300.732500000162,8405.323400000076,8128.8317000002335,9823.046900000718,9938.017300002162,10297.985799999644,16477.615599999743,16662.9296999997,16259.607199999704,828.9524000001767,814.1286000000459,760.0513000000133,3916.339800000124,3899.547000000164,3732.19600000016,436691.0,431484.0,,6428.761184002898,632326.0,625875.0,,16342.056499999802,154274.9866999907,154277.73429999026,154169.4619999872,77657.99079999633,77996.02120000657,78397.63430000657,30.0,66208821.16499995,24483750.254999984,6619608675.630001,2175368162.400001,77509912.49999994,711053.0999999999,119.0,14169.0,-21583091.0,9686160.0,-11165887.0,-12147798.5,-14.5,0.0,0.0,112500.0,0.0,0.0,0.0,0.0,0.0,-1244.0,-771.0,-793.0,-1215.0,235183153.275,3348748013.220004,3772416035.5200014,,3349085513.220004,241675.0,-16606324.0,3855941308.0,170344394.0,870681918.0,377762934.0,910407353.0,240292.0,3792.0,,5535147.0,1983220.0,1222452.0,-3991883.0,1375201.0,101594.0,2664185072.130185,2695349460.0601263,-160252512.0,-158932246.0,2830863.0,131954.0,2484156260.812483,6681078000.0,210179681.685,327426765.56999964,11286179.1,105626351.7449999,140986259.9549995,358657829.280001,330442520.6249997,2384971365.9600034,2474775632.182479,2474902479.7574773,10821.0,28280.0,151.0,17308.0,809390.0,-1430538.0,590110.0,1350.0,1468350.0,14815707.0,3234447.0,8560788.0,11614875.0,1416722.0,1059977088.3195012,801892571.8499951,72148745630.15964,21692457135.022617,583105235.7644987,5792665.7475,689.5,94245.0,-277087894.5,21991190.5,-123855123.5,-218829479.5,-2021644.0,5926228410.64496,18735115500.0,198873957.825,448254093.8699976,1948107.735,256957208.9100008,309278054.18249863,636918102.6974977,459399259.7999993,5711271075.247535,5889486550.387498,5889729733.1325,13392.5,80925.0,44.0,70426.5,971918.5,-1699465.5,177364.0,6755.0,4275726.0,2480858.0,-9008946.0,921269.0,37582.5,3736051582.52246,3660738129.652459,-260779163.0,-257465578.0,2528017.5,269365.5,3928729923.269954,33274598796.56342,36705258466.20013,,48115882072.17072,3990611.5,-247726015.5,103149580248.5,1055294483.0,17283786873.5,3505803450.5,18897261366.0,3674292.0,71973.5,,89824650.0,-62.66068800087226,2.8571428571428568,8.268367587999053,415.5251141552512,23.62390739428301,1187.2146118721464,157500.0,-0.2225209339563146,-0.9749279121818236,0.0,0.0,0.0,0.0,0.0,0.0,1.0,0.0,0.0,0.0,0.0,0.0,0.0,1.0,0.0,0.0,0.0,0.0,1.0,0.0,0.0,0.0,0.0,1.0,0.0,1.0,0.0,0.0,0.0,0.0,0.0,0.0,0.0,0.0,0.0,0.0,0.0,0.0,0.0,0.0,0.0,0.0,0.0,0.0,0.0,0.0,1.0,0.0,0.0,0.0,0.0,0.0,0.0,0.0,0.0,0.0,0.0,0.0,0.0,0.0,0.0,0.0,0.0,0.0,0.0,0.0,0.0,0.0,0.0,0.0,0.0,0.0,0.0,0.0,0.0,0.0,0.0,0.0,0.0,0.0,0.0,0.0,0.0,0.0,0.0,0.0,0.0,1.0,0.0,0.0,0.0,0.0,0.0,0.0,0.0,0.0,0.0,0.0,0.0,0.0,0.0,0.0,0.0,0.0,0.0,0.0,0.0,0.0,1.0,0.0,1.0,0.0,0.0,0.0,0.0,0.0,0.0,1.0,0.0,0.0
104019,0,0.0,0.0,0.0,0.0,0.0,225000.0,360000.0,36886.5,360000.0,0.015221,50.2,-8210.0,-1345.0,-1862.0,,2.0,2.0,2.0,12.0,0.7026954341505388,0.6451231562109728,0.622922000268356,,,,,,,,,,,,,,,,,,,,,,,,,,,,,,,,,,,,,,,,,,,,1.0,0.0,0.0,0.0,0.0,-1640.0,0.0,0.0,0.0,0.0,0.0,1.0,1.0,1.0,1.0,1.0,0.0,0.0,0.0,0.0,0.0,0.0,0.0,0.0,0.0,1.0,0.0,0.0,0.0,0.0,0.0,0.0,0.0,0.0,0.0,0.0,0.0,0.0,0.0,0.0,0.0,0.0,0.0,0.0,7.0,3276.0,0.0,76950.0,0.0,0.0,0.0,0.0,0.0,-1391.0,-1025.0,-1083.0,-1107.0,343.0,-24.0,4.0,4611.375,27380.25,28095.75,0.0,27380.25,12.0,-1998.0,365243.0,-1967.0,-1711.5,-1711.5,-1705.0,9.0,0.0,0.0,31.0,54.0,12.0,6.0,-66.5,0.0,0.0,48.0,3092.31,3092.31,-2062.5,-2054.5,6.5,1.0,0.0,,,,,,,,,,,,,,,,,,,,,8351693383.5,184486872289.5,165663404064.0,52001672905.935,1863.0,1706.0,71125.0,70886.0,9141.0,506373.0,,,,,,,128498.0,663219.0,,,,13535398.304109192,-602314127.0,-922423182.0,-296689179.0,-1536077053.0416667,44042.0,30724.0,,,,,,,67516.9015311781,158130.66362739235,126178.68376195848,,,,,,,3716347.0,,,,,,,,,,,,,,,,436691.0,431484.0,,6428.776405002898,632328.0,625877.0,,,,,,,,,46.0,66504931.78499995,24641051.084999982,6662039183.7300005,2198520220.770001,77644912.49999994,711053.0999999999,119.0,14169.0,-21683287.0,9688335.0,-11216693.0,-12194576.0,-22.5,3276.0,0.0,75838.5,0.0,0.0,0.0,0.0,0.0,-1550.0,-1107.0,-1107.0,-1499.0,236811997.575,3372910711.830004,3798341300.2950015,54161627.53499995,3372910711.830004,243093.0,-16675621.0,3874020836.5,171030677.5,874299877.5,378107917.5,914025674.0,241446.5,3811.0,676.0806673110994,5555824.5,1990868.0,1227873.0,-4004003.5,1375247.0,101640.0,2679756552.4951963,2711562465.37514,-160596242.5,-159269470.5,2834056.0,132507.5,,,,,,,,,,,,,,,,,,,,,1468357.0,14816050.0,3234447.0,8560842.0,11614923.0,1416726.0,1059980364.3195012,801892571.8499951,72148822580.15964,21692457135.022617,583105235.7644987,5792665.7475,689.5,94245.0,-277089285.5,21990165.5,-123856206.5,-218830586.5,-2021668.0,,,,,,,,,,,,,,,,,,,,,4275738.0,2480864.0,-9009012.5,921269.0,37582.5,3736054674.83246,3660741221.96246,-260781225.5,-257467632.5,2528024.0,269366.5,3928734534.644954,33274626176.81342,36705286561.95013,1730425895.3025494,48115909452.42072,3990623.5,-247728013.5,103149945491.5,1055292516.0,17283785162.0,3505801739.0,18897259661.0,3674301.0,71973.5,20881.695571259123,89824681.0,-163.54581673306768,1.6,6.09979260705136,306.2095888739783,9.759668171282176,489.9353421983652,112500.0,-0.2225209339563143,0.9749279121818236,0.0,0.0,0.0,0.0,0.0,0.0,1.0,0.0,0.0,0.0,1.0,0.0,0.0,0.0,0.0,0.0,0.0,0.0,1.0,0.0,1.0,0.0,0.0,0.0,0.0,1.0,0.0,0.0,0.0,0.0,0.0,0.0,0.0,0.0,0.0,0.0,0.0,0.0,0.0,0.0,0.0,0.0,0.0,0.0,0.0,0.0,0.0,0.0,0.0,0.0,0.0,0.0,0.0,0.0,0.0,0.0,0.0,0.0,0.0,1.0,0.0,0.0,0.0,0.0,0.0,0.0,0.0,0.0,0.0,0.0,0.0,0.0,0.0,0.0,0.0,0.0,0.0,0.0,0.0,0.0,0.0,0.0,0.0,0.0,0.0,0.0,0.0,0.0,0.0,0.0,0.0,0.0,0.0,0.0,0.0,0.0,0.0,0.0,0.0,0.0,0.0,0.0,0.0,0.0,0.0,0.0,0.0,0.0,0.0,0.0,0.0,0.0,0.0,0.0,0.0,0.0,0.0,0.0,0.0,0.0
104026,0,0.0,0.0,1.0,1.0,1.0,135000.0,675000.0,25447.5,675000.0,0.0196889999999999,42.84931506849315,-8313.0,-5780.0,-5655.0,7.0,3.0,2.0,2.0,9.0,,0.5283827945944101,0.3689687382528466,,,,,,,,,,,,,,,,,,,,,,,,,,,,,,,,,,,,,,,,,,,,,3.0,0.0,3.0,0.0,-2863.0,0.0,0.0,0.0,0.0,1.0,0.0,1.0,1.0,0.0,1.0,0.0,0.0,0.0,0.0,0.0,0.0,0.0,0.0,0.0,1.0,0.0,0.0,0.0,0.0,0.0,0.0,0.0,0.0,0.0,0.0,0.0,0.0,0.0,0.0,0.0,0.0,0.0,0.0,9.0,0.0,,198000.0,0.0,0.0,0.0,0.0,0.0,-1275.0,-501.0,-192.0,-923.0,390.0,-25.0,4.0,5724.112499999998,60727.5,65337.75,11326.5,60727.5,10.0,-2214.0,365243.0,-2182.5,-1897.5,-1642.5,-1892.5,10.5,1.0,0.1818246759232104,99.0,46.0,12.0,5.5,-52.5,0.0,0.0,42.0,7597.485,7597.485,-1564.5,-1560.0,5.0,1.0,0.0,,,,,,,,,,,,,,,,,,,,,8351718831.0,184487547289.5,165664079064.0,52001807905.935,1863.0,1706.0,71125.0,70887.0,9141.0,506373.0,,,,,,,128499.0,663222.0,,,,13535441.15342426,-602322440.0,-922428837.0,-296692042.0,-1536082833.0416667,44042.0,30724.0,,,,,,,,158131.19201018693,126179.05273069676,,,,,,,3716356.0,,,,,,,,,,,,,,,,436694.0,431487.0,1263899.0,6428.796094002898,632330.0,625879.0,,,,,,,,,42.0,66765209.35499995,,6671583937.125,2199198429.270001,77652228.91499995,711102.5999999999,120.0,14199.0,-21740624.0,9684968.0,-11249358.0,-12228274.0,-20.5,0.0,,90000.0,0.0,0.0,0.0,0.0,0.0,-2044.0,-805.0,-192.0,-1022.0,237115700.775,3375521670.330004,3801674567.2950015,54304637.53499995,3375521670.330004,243441.0,-16719277.5,3883882397.5,171360277.0,875366632.0,378446217.0,915092567.0,241792.0,3817.5,678.3779758625336,5570856.0,1994740.0,1230191.0,-4015625.0,1375273.0,101666.0,2682269300.3851905,2714010973.4251337,-160935245.0,-159604304.0,2835671.5,132807.5,,,,,,,,,,,,,,,,,,,,,1468366.0,14816440.0,3234447.0,8560888.0,11614965.0,1416730.0,1059980364.3195012,,72149020580.15964,21692457135.022617,583105235.7644987,5792665.7475,689.5,94245.0,-277090560.5,21989664.5,-123856398.5,-218831509.5,-2021693.0,,,,,,,,,,,,,,,,,,,,,4275750.0,2480869.5,-9009065.0,921269.0,37582.5,3736062272.31746,3660748819.447459,-260782790.0,-257469192.5,2528029.0,269367.5,3928740258.757455,33274686904.31342,36705351899.70013,1730437221.8025494,48115970179.92072,3990633.5,-247730227.5,103150310734.5,1055290333.5,17283783264.5,3505800096.5,18897257768.5,3674311.5,71974.5,20881.877395935047,89824780.0,-194.00543478260872,5.0,5.3050397877984095,227.31732131826604,26.52519893899204,1136.58660659133,45000.0,-0.2225209339563143,0.9749279121818236,0.0,0.0,0.0,0.0,0.0,0.0,1.0,0.0,0.0,0.0,0.0,0.0,0.0,1.0,0.0,0.0,0.0,0.0,1.0,0.0,1.0,0.0,0.0,0.0,0.0,1.0,0.0,0.0,0.0,0.0,0.0,0.0,0.0,0.0,0.0,0.0,0.0,0.0,0.0,0.0,0.0,1.0,0.0,0.0,0.0,0.0,0.0,0.0,0.0,0.0,0.0,0.0,0.0,0.0,0.0,0.0,0.0,0.0,0.0,0.0,0.0,0.0,0.0,0.0,0.0,0.0,0.0,0.0,0.0,0.0,0.0,0.0,0.0,0.0,0.0,0.0,0.0,0.0,1.0,0.0,0.0,0.0,0.0,0.0,0.0,0.0,0.0,0.0,0.0,0.0,0.0,0.0,0.0,0.0,0.0,0.0,0.0,0.0,0.0,0.0,0.0,0.0,0.0,0.0,0.0,0.0,0.0,0.0,0.0,0.0,0.0,0.0,0.0,0.0,0.0,0.0,0.0,0.0,0.0,0.0
104035,0,0.0,0.0,0.0,0.0,0.0,90000.0,594121.5,30465.0,472500.0,0.0088659999999999,32.8027397260274,-1405.0,-5423.0,-4475.0,,2.0,2.0,2.0,10.0,,0.3746837979513292,0.5867400085415683,,,,,,,,,,,,,,,,,,,,,,,,,,,,,,,,,,,,,,,,,,,,,1.0,0.0,1.0,0.0,-265.0,0.0,0.0,0.0,0.0,1.0,3.0,1.0,1.0,0.0,1.0,0.0,0.0,0.0,0.0,0.0,1.0,1.0,0.0,0.0,1.0,0.0,0.0,0.0,0.0,0.0,0.0,0.0,0.0,0.0,0.0,0.0,0.0,0.0,0.0,0.0,0.0,0.0,0.0,7.0,0.0,0.0,102875.445,0.0,0.0,0.0,0.0,0.0,-932.0,-475.0,-320.0,-578.0,271.0,-20.0,4.0,3831.3,13702.5,35748.0,1370.25,88357.5,9.0,-724.0,365243.0,-693.0,-513.0,-3.0,-507.0,13.0,0.0,0.0510432787160507,1755.0,18.0,9.0,7.5,-85.5,0.0,0.0,16.0,3831.3,3831.3,-2603.5,-2599.0,4.5,1.0,21.0,0.0,45000.0,,0.0,,,0.0,,0.0,0.0,0.0,0.0,,0.0,,,0.0,-14.0,0.0,0.0,8351749296.0,184488141411.0,165664551564.0,52001897905.935,1863.0,1706.0,71125.0,70888.0,9141.0,506376.0,,,,,,,128499.0,663224.0,,,,13535473.956163986,-602323845.0,-922433312.0,-296692307.0,-1536088256.0416667,44042.0,30724.0,,,,,,,,158131.56669398487,126179.63947070528,,,,,,,3716366.0,,,,,,,,,,,,,,,,436695.0,431488.0,,6428.804960002898,632332.0,625881.0,,,,,,,,,31.0,66765209.35499995,24695253.13499999,6687637690.05,2208332533.770001,77652228.91499995,711102.5999999999,121.0,14199.0,-21787259.0,9663212.0,-11276503.0,-12260912.5,-15.0,0.0,0.0,26865.0,0.0,0.0,0.0,0.0,0.0,-1534.0,-1169.0,-927.0,-1169.0,237425649.97500005,3380376701.925004,3807245684.2950015,54396560.87999995,3380362999.425004,243739.0,-16744376.0,3889541361.0,171341975.0,876086557.0,378803637.0,916177995.0,242022.0,3824.0,679.2006792757094,5580951.5,1999850.5,1233307.5,-4023349.0,1375369.0,101670.0,2688359760.900184,2719880295.2101264,-161264932.5,-159931603.0,2840981.0,133055.5,2499385040.2799826,6712690500.0,,328038789.9599996,,,141868015.33499947,,331579112.7599997,2399524267.635004,2489999710.5899787,2490126558.164978,,28317.0,,,812299.0,-1434280.0,590118.0,1358.0,1468373.0,14816711.0,3234468.0,8560906.0,11614981.0,1416734.0,1059980364.3195012,801892571.8499951,72149123455.60464,21692457135.022617,583105235.7644987,5792665.7475,689.5,94245.0,-277091492.5,21989189.5,-123856718.5,-218832087.5,-2021713.0,5926228410.64496,18735160500.0,,448254093.8699976,,,309278054.18249863,,459399259.7999993,5711271075.247535,5889486550.387498,5889729733.1325,,80925.0,,,971918.5,-1699479.5,177364.0,6755.0,4275759.0,2480877.0,-9009150.5,921269.0,37582.5,3736066103.61746,3660752650.7474594,-260785393.5,-257471791.5,2528033.5,269368.5,3928744090.057456,33274700606.81342,36705387647.70013,1730438592.0525494,48116058537.42072,3990642.5,-247730951.5,103150675977.5,1055289640.5,17283782751.5,3505800093.5,18897257261.5,3674324.5,71974.5,20881.928439213763,89826535.0,-42.83178819009439,6.60135,2.9542097488921715,96.90617348900264,19.501772525849336,639.7115683616278,45000.0,-0.2225209339563143,0.9749279121818236,0.0,0.0,0.0,0.0,0.0,0.0,1.0,0.0,0.0,0.0,0.0,0.0,0.0,1.0,0.0,0.0,0.0,0.0,1.0,0.0,1.0,0.0,0.0,0.0,0.0,0.0,0.0,0.0,1.0,0.0,0.0,0.0,0.0,0.0,0.0,0.0,0.0,0.0,0.0,0.0,0.0,0.0,0.0,0.0,0.0,0.0,0.0,0.0,0.0,0.0,0.0,0.0,0.0,0.0,0.0,0.0,0.0,0.0,0.0,1.0,0.0,0.0,0.0,0.0,0.0,0.0,0.0,0.0,0.0,0.0,0.0,0.0,0.0,0.0,0.0,0.0,0.0,0.0,0.0,0.0,0.0,0.0,0.0,0.0,0.0,0.0,0.0,0.0,0.0,0.0,0.0,0.0,0.0,0.0,0.0,0.0,0.0,0.0,0.0,0.0,0.0,0.0,0.0,0.0,0.0,0.0,0.0,0.0,0.0,0.0,0.0,0.0,0.0,0.0,0.0,0.0,0.0,0.0,0.0,0.0
104044,0,0.0,0.0,0.0,0.0,0.0,180000.0,675000.0,21775.5,675000.0,0.0035409999999999,37.6958904109589,-1905.0,-4475.0,-2858.0,,2.0,1.0,1.0,14.0,0.5080107314770262,0.5356347267531477,0.2764406945454034,0.0954,0.1113,0.998,,,0.0,0.1552,0.1667,,0.0262,,0.1011,,0.0,0.0578,0.0606,0.997,,,0.0,0.1034,0.1667,,0.0158,,0.0623,,0.0,0.0963,0.1113,0.998,,,0.0,0.1552,0.1667,,0.0267,,0.103,,0.0,0.0558,1.0,4.0,0.0,4.0,0.0,-537.0,0.0,0.0,0.0,0.0,1.0,4.0,1.0,1.0,0.0,1.0,0.0,0.0,0.0,0.0,0.0,0.0,0.0,0.0,0.0,1.0,0.0,0.0,0.0,0.0,0.0,0.0,0.0,0.0,0.0,0.0,0.0,0.0,0.0,0.0,0.0,0.0,0.0,0.0,4.0,0.0,,460595.25,205654.5,0.0,0.0,0.0,0.0,-335.0,812.0,-134.0,-1015.0,127.0,-30.0,3.0,15090.39,99009.0,99009.0,0.0,256504.5,29.0,-291.0,365243.0,-496.0,-256.0,-226.0,-250.0,14.0,0.0,0.0,-1.0,11.0,10.0,5.5,-13.0,0.0,0.0,9.0,10880.1,10880.1,-388.0,-376.0,5.0,1.0,0.0,,,,,,,,,,,,,,,,,,,,,8351771071.5,184488816411.0,165665226564.0,52002077905.935,1863.0,1706.0,71125.0,70889.0,9141.0,506380.0,17818.965800002294,17881.165499999108,17332.349499998018,11302.078100000092,11239.879800000095,11187.210200000054,128499.0,663226.0,,,,13535511.652054396,-602325750.0,-922436170.0,-296692844.0,-1536092731.0416667,44042.0,30724.0,11356.113999999186,11232.05999999898,10716.18099999729,22902.12260000974,22823.9083000097,22209.138500008263,67517.40954190957,158132.10232871163,126179.91591139985,35022.691100027965,34962.8673000284,34408.30140002882,,,,3716380.0,8300.758700000162,8405.350100000076,8128.847500000234,,,,16477.716699999743,16663.032699999698,16259.669499999703,,,,3916.339800000124,3899.547000000164,3732.19600000016,436699.0,431492.0,,6428.808501002898,632333.0,625882.0,,16342.112299999802,154275.98469999072,154278.73229999025,154170.4589999872,,,,11.5,67370594.35499996,,6727337822.16,2213046428.4000006,77792745.41999994,711633.5999999999,121.0,14359.0,-21871687.0,9736234.0,-11318601.5,-12309593.0,-5.25,0.0,,900000.0,0.0,0.0,0.0,0.0,0.0,-2850.0,-1024.0,-196.0,-1015.0,238561586.50500005,3394531987.425004,3823494086.2950015,54471128.12999995,3394738987.425004,244233.0,-16779001.0,3896473273.0,171679046.0,877892567.0,380980123.0,918353135.0,242607.0,3831.0,680.3333052265199,5592239.0,2001917.0,1234510.0,-4029287.0,1375400.0,101701.0,2696472242.1452,2728634305.725137,-161740874.0,-160404898.0,2853335.0,133242.0,,,,,,,,,,,,,,,,,,,,,1468377.0,14816838.0,3234468.0,8560917.0,11614990.0,1416737.0,1059980364.3195012,,72149584050.85464,21692662789.522617,583105235.7644987,5792665.7475,689.5,94245.0,-277091827.5,21990001.5,-123856852.5,-218833102.5,-2021743.0,,,,,,,,,,,,,,,,,,,,,4275769.0,2480882.5,-9009163.5,921269.0,37582.5,3736076983.71746,3660763530.8474593,-260785781.5,-257472167.5,2528038.5,269369.5,3928759180.447456,33274799615.81342,36705486656.70013,1730438592.0525494,48116315041.92072,3990671.5,-247731242.5,103151041220.5,1055289144.5,17283782495.5,3505799867.5,18897257011.5,3674338.5,71974.5,20881.928439213763,89826534.0,-50.53601279162729,3.75,8.266170696424881,311.6006646907122,30.998140111593305,1168.5024925901705,90000.0,-0.9009688679024191,-0.433883739117558,0.0,0.0,0.0,0.0,0.0,0.0,1.0,0.0,0.0,0.0,0.0,0.0,0.0,1.0,0.0,1.0,0.0,0.0,0.0,0.0,1.0,0.0,0.0,0.0,0.0,1.0,0.0,0.0,0.0,0.0,0.0,0.0,0.0,0.0,0.0,0.0,0.0,0.0,0.0,0.0,0.0,0.0,0.0,0.0,0.0,0.0,0.0,0.0,0.0,0.0,0.0,0.0,0.0,0.0,0.0,0.0,0.0,0.0,0.0,0.0,0.0,0.0,0.0,0.0,0.0,0.0,0.0,0.0,0.0,0.0,0.0,0.0,0.0,0.0,0.0,0.0,0.0,0.0,0.0,0.0,0.0,1.0,0.0,0.0,0.0,0.0,0.0,0.0,0.0,0.0,0.0,0.0,0.0,0.0,0.0,0.0,0.0,0.0,0.0,0.0,0.0,0.0,0.0,0.0,0.0,0.0,0.0,0.0,0.0,0.0,1.0,0.0,0.0,0.0,0.0,0.0,0.0,0.0,1.0,0.0
104045,0,0.0,1.0,1.0,1.0,0.0,99000.0,266652.0,19534.5,202500.0,0.009549,25.252054794520543,-905.0,-8882.0,-1886.0,23.0,1.0,2.0,2.0,11.0,0.1772921876137945,0.6732129579514083,0.816092360478441,0.2062,0.1317,0.9876,,,0.2,0.1724,0.375,,0.1024,,0.2089,,,0.2101,0.1367,0.9876,,,0.2014,0.1724,0.375,,0.1047,,0.2177,,,0.2082,0.1317,0.9876,,,0.2,0.1724,0.375,,0.1042,,0.2127,,,0.1717,1.0,0.0,0.0,0.0,0.0,-611.0,0.0,0.0,0.0,0.0,1.0,0.0,1.0,1.0,0.0,1.0,1.0,0.0,0.0,0.0,0.0,0.0,0.0,0.0,0.0,1.0,0.0,0.0,0.0,0.0,0.0,0.0,0.0,0.0,0.0,0.0,0.0,0.0,0.0,0.0,0.0,0.0,0.0,0.0,1.0,0.0,,13410.0,0.0,,0.0,0.0,0.0,-2422.0,1230.0,-8.0,,80.0,-39.5,1.0,8180.145,51700.5,49806.0,5170.5,51700.5,8.0,-611.0,365243.0,-579.0,-369.0,-369.0,-365.0,15.0,0.0,0.1024282110620819,2500.0,9.0,8.0,4.0,-16.0,0.0,0.0,9.0,8180.145,8180.145,-465.0,-459.0,5.0,1.0,0.0,,,,,,,,,,,,,,,,,,,,,8351790606.0,184489083063.0,165665429064.0,52002176905.935,1863.0,1706.0,71125.0,70890.0,9141.0,506380.0,17819.172000002294,17881.373699999112,17332.559599998018,11302.209800000091,11240.011500000095,11187.346900000051,128499.0,663227.0,,,,13535536.904109191,-602326655.0,-922438056.0,-296693455.0,-1536101613.0416667,44042.0,30724.0,11356.313999999187,11232.259999998982,10716.38239999729,22902.29500000974,22824.0807000097,22209.310900008262,67517.58683409718,158132.77554166954,126180.73200376028,35023.066100027965,34963.2423000284,34408.67640002882,,,,3716391.0,8300.861100000162,8405.454300000076,8128.9522000002335,,,,16477.92559999974,16663.245399999698,16259.887199999705,,,,,,,436699.0,431492.0,1263922.0,6428.8180500028975,632335.0,625884.0,,16342.283999999803,154276.97229999068,154279.71989999025,154171.44659998722,,,,80.0,67370594.35499996,,6727724077.41,2213336001.1500006,,711633.5999999999,121.0,14359.0,-21874637.0,9738276.0,-11318746.0,,-39.5,0.0,,13410.0,0.0,,0.0,0.0,0.0,-2422.0,1230.0,-8.0,,238579416.99000007,3394997687.925004,3823957892.2950015,54476298.62999995,3394997687.925004,244265.0,-16779889.0,3896838516.0,171678467.0,877892198.0,380979754.0,918352770.0,242639.0,3831.0,680.4357334375819,5594739.0,2002001.0,1234540.0,-4029416.0,1375400.0,101701.0,2696567345.6401987,2728721233.260137,-161744717.0,-160408637.0,2853382.0,133252.0,,,,,,,,,,,,,,,,,,,,,1468378.0,14816918.0,3234468.0,8560926.0,11614999.0,1416738.0,1059980364.3195012,,72149597460.85464,21692662789.522617,,5792665.7475,689.5,94245.0,-277094249.5,21991231.5,-123856860.5,,-2021782.5,,,,,,,,,,,,,,,,,,,,,4275777.0,2480886.5,-9009179.5,921269.0,37582.5,3736085163.86246,3660771710.9924593,-260786246.5,-257472626.5,2528043.5,269370.5,3928767360.592456,33274851316.31342,36705536462.70013,1730443762.5525494,48116366742.42072,3990679.5,-247731853.5,103151406463.5,1055288565.5,17283782126.5,3505799498.5,18897256646.5,3674353.5,71974.5,20882.030867424823,89829034.0,-35.83866767928827,2.693454545454545,5.06795669200645,127.97632008280397,13.650310988251556,344.6984010375742,99000.0,1.0,0.0,0.0,0.0,0.0,0.0,0.0,0.0,1.0,0.0,0.0,0.0,0.0,0.0,0.0,1.0,0.0,0.0,0.0,0.0,1.0,0.0,0.0,0.0,1.0,0.0,0.0,1.0,0.0,0.0,0.0,0.0,0.0,0.0,0.0,0.0,1.0,0.0,0.0,0.0,0.0,0.0,0.0,0.0,0.0,0.0,0.0,0.0,0.0,0.0,0.0,0.0,0.0,0.0,0.0,1.0,0.0,0.0,0.0,0.0,0.0,0.0,0.0,0.0,0.0,0.0,0.0,0.0,0.0,0.0,0.0,0.0,0.0,0.0,0.0,0.0,0.0,0.0,0.0,0.0,0.0,0.0,0.0,0.0,0.0,0.0,0.0,0.0,0.0,0.0,0.0,0.0,0.0,0.0,0.0,0.0,0.0,0.0,0.0,0.0,0.0,0.0,0.0,0.0,0.0,0.0,0.0,0.0,0.0,0.0,0.0,0.0,1.0,0.0,0.0,0.0,0.0,0.0,0.0,1.0,0.0,0.0
104047,0,0.0,0.0,0.0,0.0,0.0,180000.0,450000.0,14517.0,450000.0,0.0096569999999999,40.706849315068496,-6900.0,-6633.0,-4743.0,,2.0,2.0,2.0,15.0,0.0462918790870061,0.6367037738509876,0.1402431837080297,,,,,,,,,,,,,,,,,,,,,,,,,,,,,,,,,,,,,,,,,,,,,0.0,0.0,0.0,0.0,-2547.0,0.0,0.0,0.0,0.0,2.0,2.0,1.0,1.0,1.0,1.0,1.0,0.0,0.0,0.0,0.0,0.0,0.0,0.0,0.0,1.0,0.0,0.0,0.0,0.0,0.0,0.0,0.0,0.0,0.0,0.0,0.0,0.0,0.0,0.0,0.0,0.0,0.0,0.0,12.0,0.0,0.0,144720.0,0.0,0.0,0.0,0.0,0.0,-1146.5,-67.0,-129.5,-1183.0,467.0,-26.0,3.0,5052.24,0.0,0.0,3150.0,27135.0,6.0,-452.0,365243.0,-2508.0,-2388.0,-2358.0,-2382.0,12.0,1.0,0.1211254585897102,-1.0,6.0,5.0,2.5,-80.5,0.0,0.0,5.0,5052.24,5052.24,-2483.0,-2448.0,3.0,1.0,0.0,,,,,,,,,,,,,,,,,,,,,8351805123.0,184489533063.0,165665879064.0,52002356905.935,1863.0,1706.0,71125.0,70892.0,9141.0,506382.0,,,,,,,128499.0,663229.0,,,,13535577.610958504,-602333555.0,-922442799.0,-296696002.0,-1536108246.0416667,44042.0,30724.0,,,,,,,67517.63312597628,158133.4122454434,126180.872246944,,,,,,,3716406.0,,,,,,,,,,,,,,,,436699.0,431492.0,,6428.827707002898,632337.0,625886.0,,,,,,,,,38.0,67525421.35499996,24835723.919999983,6736413523.41,2218898390.4000006,77792745.41999994,711633.5999999999,121.0,14359.0,-21884185.0,9741620.0,-11321280.5,-12312581.0,-18.5,0.0,0.0,135000.0,0.0,0.0,0.0,0.0,0.0,-2222.0,-930.0,-976.0,-1336.0,238666609.4400001,3395834071.425004,3824950164.7950015,54512811.62999995,3395861206.425004,244331.0,-16782267.0,3897934245.0,171674990.0,878254581.0,380977087.0,918715165.0,242694.0,3833.0,680.6596731827955,5598332.0,2002278.5,1234703.5,-4030078.5,1375400.0,101701.0,2697110981.4602,2729264869.0801373,-161762261.0,-160426013.0,2853510.0,133278.0,,,,,,,,,,,,,,,,,,,,,1468390.0,14817385.0,3234468.0,8560932.0,11615004.0,1416741.0,1059980364.3195012,801892571.8499951,72149742180.85464,21692662789.522617,583105235.7644987,5792665.7475,689.5,94245.0,-277095396.0,21991164.5,-123856990.0,-218834285.5,-2021808.5,,,,,,,,,,,,,,,,,,,,,4275782.0,2480889.0,-9009260.0,921269.0,37582.5,3736090216.102461,3660776763.23246,-260788729.5,-257475074.5,2528046.5,269371.5,3928772412.832455,33274851316.31342,36705536462.70013,1730446912.5525494,48116393877.42072,3990685.5,-247732305.5,103151771706.5,1055286057.5,17283779738.5,3505797140.5,18897254264.5,3674365.5,71975.5,20882.151992883417,89829033.0,-169.50464396284832,2.5,12.399256044637324,504.7346474280037,30.998140111593305,1261.8366185700093,90000.0,-0.2225209339563143,0.9749279121818236,0.0,1.0,0.0,0.0,0.0,0.0,0.0,0.0,0.0,0.0,0.0,0.0,0.0,1.0,0.0,0.0,0.0,0.0,1.0,0.0,1.0,0.0,0.0,0.0,0.0,1.0,0.0,0.0,0.0,0.0,0.0,0.0,0.0,0.0,0.0,0.0,0.0,0.0,0.0,0.0,0.0,0.0,0.0,0.0,0.0,0.0,0.0,0.0,0.0,0.0,0.0,0.0,0.0,0.0,0.0,0.0,0.0,0.0,0.0,1.0,0.0,0.0,0.0,0.0,0.0,0.0,0.0,0.0,0.0,0.0,0.0,0.0,0.0,0.0,0.0,0.0,0.0,0.0,0.0,0.0,0.0,0.0,0.0,0.0,0.0,0.0,0.0,0.0,0.0,0.0,0.0,0.0,0.0,0.0,0.0,0.0,0.0,0.0,0.0,0.0,0.0,0.0,0.0,0.0,0.0,0.0,0.0,0.0,0.0,0.0,0.0,0.0,0.0,0.0,0.0,0.0,0.0,0.0,0.0,0.0
104051,0,0.0,0.0,0.0,1.0,0.0,225000.0,450000.0,28890.0,450000.0,0.026392,65.51506849315068,,-10847.0,-4789.0,,2.0,2.0,2.0,14.0,,0.7351768213073724,,,,,,,,,,,,,,,,,,,,,,,,,,,,,,,,,,,,,,,,,,,,,,0.0,0.0,0.0,0.0,-548.0,,,,,,,1.0,0.0,0.0,1.0,0.0,1.0,0.0,0.0,0.0,0.0,0.0,0.0,0.0,0.0,0.0,0.0,1.0,0.0,0.0,0.0,0.0,0.0,0.0,0.0,0.0,0.0,0.0,0.0,0.0,0.0,0.0,0.0,0.0,,,,,,,,,,,,,0.0,,10.0,32047.4025,86028.5925,86026.5,22479.5925,238027.5,12.0,-249.0,365243.0,-261.0,-200.0,-76.0,-194.5,16.0,0.0,0.1088467906448172,-1.0,23.0,12.0,4.0,-9.0,0.0,0.0,22.0,8400.06,8400.06,-265.5,-260.0,4.0,1.0,0.0,,,,,,,,,,,,,,,,,,,,,8351834013.0,184489983063.0,165666329064.0,52002581905.935,,,,,,,,,,,,,128499.0,663231.0,,,,13535643.126027,,-922447588.0,-296696550.0,-1536119093.0416667,44042.0,30724.0,,,,,,,,158134.1474222647,,,,,,,,3716420.0,,,,,,,,,,,,,,,,436699.0,431492.0,,6428.854099002898,632339.0,625888.0,,,,,,,,,,,,,,,,,,,,,,,,,,,,,,,,,,,238899810.75750005,3399101112.060004,3828536439.7950015,54584375.26499996,3399593526.810004,244535.0,-16799695.0,3901033334.5,172027366.5,879341867.5,382069075.0,920536507.0,242907.0,3833.0,681.191734203716,5602198.5,2004632.0,1236169.0,-4032870.0,1375400.0,101701.0,2699484239.520198,2731640985.495136,-162208602.5,-160870686.5,2868688.0,133413.5,,,,,,,,,,,,,,,,,,,,,1468390.0,14817385.0,3234468.0,8560955.0,11615026.0,1416751.0,,,,,,,,,,,,,,,,,,,,,,,,,,,,,,,,,,4275794.0,2480893.0,-9009269.0,921269.0,37582.5,3736098616.16246,3660785163.29246,-260788995.0,-257475334.5,2528050.5,269372.5,3928804460.234955,33274937344.90592,36705622489.20013,1730469392.145049,48116631904.92072,3990697.5,-247732554.5,103152136949.5,1055285796.5,17283779538.5,3505797064.5,18897254070.0,3674381.5,71975.5,20882.26083967406,89829032.0,,2.0,7.788161993769472,510.24196645755984,15.576323987538943,1020.4839329151196,112500.0,0.6234898018587336,0.7818314824680298,0.0,0.0,0.0,0.0,0.0,0.0,1.0,0.0,0.0,1.0,0.0,0.0,0.0,0.0,0.0,0.0,0.0,0.0,1.0,0.0,1.0,0.0,0.0,0.0,0.0,1.0,0.0,0.0,0.0,0.0,0.0,0.0,0.0,0.0,0.0,0.0,0.0,0.0,0.0,0.0,0.0,0.0,0.0,0.0,0.0,0.0,0.0,0.0,0.0,0.0,0.0,0.0,0.0,0.0,0.0,0.0,0.0,0.0,0.0,0.0,0.0,0.0,0.0,0.0,0.0,0.0,0.0,0.0,0.0,0.0,0.0,0.0,0.0,0.0,0.0,0.0,0.0,0.0,0.0,0.0,0.0,0.0,0.0,0.0,0.0,0.0,0.0,0.0,0.0,0.0,0.0,0.0,0.0,0.0,0.0,0.0,0.0,0.0,0.0,0.0,0.0,0.0,0.0,0.0,0.0,1.0,0.0,0.0,0.0,0.0,0.0,0.0,0.0,0.0,0.0,0.0,0.0,0.0,0.0,0.0
104058,0,0.0,0.0,0.0,1.0,0.0,157500.0,521568.0,22054.5,360000.0,0.020246,64.31232876712329,,-5692.0,-2857.0,,1.0,3.0,3.0,6.0,0.6267332372861333,0.4988155694059046,0.5352762504724826,,,,,,,,,,,,,,,,,,,,,,,,,,,,,,,,,,,,,,,,,,,,,0.0,0.0,0.0,0.0,-577.0,0.0,0.0,0.0,0.0,2.0,0.0,1.0,0.0,0.0,1.0,0.0,0.0,0.0,0.0,0.0,0.0,0.0,0.0,0.0,0.0,0.0,0.0,1.0,0.0,0.0,0.0,0.0,0.0,0.0,0.0,0.0,0.0,0.0,0.0,0.0,0.0,0.0,0.0,2.0,,0.0,69285.80249999999,0.0,0.0,0.0,0.0,0.0,-278.0,-112.0,-171.5,-175.5,19.0,-4.0,1.0,4041.36,43803.0,39420.0,4383.0,43803.0,12.0,-577.0,365243.0,-546.0,-426.0,-216.0,-422.0,12.0,0.0,0.1089762220520387,60.0,6.0,12.0,9.5,-16.5,0.0,0.0,5.0,4041.36,4041.36,-540.0,-486.0,3.0,1.0,0.0,,,,,,,,,,,,,,,,,,,,,8351856067.5,184490504631.0,165666689064.0,52002739405.935,1863.0,1706.0,71125.0,70894.0,9141.0,506382.0,,,,,,,128499.0,663232.0,,,,13535707.438355764,,-922450445.0,-296697127.0,-1536124785.0416667,44042.0,30724.0,,,,,,,67518.25985921356,158134.64623783412,126181.40752319447,,,,,,,3716426.0,,,,,,,,,,,,,,,,436699.0,431492.0,,6428.874345002898,632342.0,625891.0,,,,,,,,,9.5,,24852825.629999984,6746359488.614999,2223771089.5350013,77928709.81499992,711633.5999999999,122.0,14359.0,-21929898.5,9763847.0,-11342538.5,-12335880.5,-4.25,,0.0,52641.0,0.0,0.0,0.0,0.0,0.0,-319.0,-112.0,-233.0,-239.0,239325543.90000004,3405487228.560004,3835432271.2950015,54721296.76499996,3405487228.560004,245017.0,-16830865.0,3908516916.0,172370038.0,880786515.0,383156881.0,922349209.0,243298.0,3840.0,682.3892819422891,5604472.0,2009311.0,1239268.0,-4040429.5,1375403.0,101704.0,2707041147.6602235,2738502277.0651608,-162567304.0,-161227353.0,2876232.0,133658.0,,,,,,,,,,,,,,,,,,,,,1468392.0,14817404.0,3234468.0,8560961.0,11615031.0,1416752.0,,801892571.8499951,72149811466.65715,21692662789.522617,583105235.7644987,5792665.7475,689.5,94245.0,-277095674.0,21991052.5,-123857161.5,-218834461.0,-2021812.5,,,,,,,,,,,,,,,,,,,,,4275806.0,2480902.5,-9009285.5,921269.0,37582.5,3736102657.52246,3660789204.652459,-260789535.0,-257475820.5,2528053.5,269373.5,3928808501.5949545,33274981147.90592,36705661909.20013,1730473775.145049,48116675707.92072,3990709.5,-247733131.5,103152502192.5,1055285250.5,17283779112.5,3505796848.5,18897253648.0,3674393.5,71975.5,20882.369815896112,89829092.0,,3.3115428571428573,7.141399714344011,459.2800462863324,23.649051214037947,1520.9255567077448,157500.0,0.6234898018587336,0.7818314824680298,0.0,0.0,0.0,0.0,0.0,0.0,1.0,0.0,0.0,1.0,0.0,0.0,0.0,0.0,0.0,0.0,0.0,0.0,1.0,0.0,0.0,0.0,0.0,1.0,0.0,1.0,0.0,0.0,0.0,0.0,0.0,0.0,0.0,0.0,0.0,0.0,0.0,0.0,0.0,0.0,0.0,0.0,0.0,0.0,0.0,0.0,0.0,0.0,0.0,0.0,0.0,0.0,0.0,0.0,0.0,0.0,0.0,0.0,0.0,0.0,0.0,0.0,0.0,0.0,0.0,0.0,0.0,0.0,0.0,0.0,0.0,0.0,0.0,0.0,0.0,0.0,0.0,0.0,0.0,0.0,0.0,0.0,0.0,0.0,0.0,0.0,0.0,0.0,0.0,0.0,0.0,0.0,0.0,0.0,0.0,0.0,0.0,0.0,0.0,0.0,0.0,0.0,0.0,0.0,0.0,1.0,0.0,0.0,0.0,0.0,0.0,0.0,0.0,0.0,0.0,0.0,0.0,0.0,0.0,0.0
104063,0,0.0,0.0,0.0,1.0,0.0,135000.0,1024740.0,52452.0,900000.0,0.019101,42.26849315068493,-2462.0,-7767.0,-4722.0,,2.0,2.0,2.0,14.0,,0.7795293944108115,0.8327850252992314,,,,,,,,,,,,,,,,,,,,,,,,,,,,,,,,,,,,,,,,,,,,,0.0,0.0,0.0,0.0,-656.0,0.0,0.0,0.0,0.0,0.0,1.0,1.0,1.0,0.0,1.0,1.0,0.0,0.0,0.0,0.0,0.0,0.0,0.0,0.0,1.0,0.0,0.0,0.0,0.0,0.0,0.0,0.0,0.0,0.0,0.0,0.0,0.0,0.0,0.0,0.0,0.0,0.0,0.0,3.0,0.0,16956.0,152712.0,0.0,0.0,0.0,0.0,0.0,-1652.0,-1348.0,-1104.0,-1168.5,164.0,-27.0,1.0,10362.195,113446.35,102100.5,11345.85,113446.35,12.0,-656.0,365243.0,-625.0,-535.0,-295.0,-526.0,18.0,0.0,0.1089207549728051,53.0,5.0,12.0,10.0,-19.0,0.0,0.0,4.0,10362.195,10362.195,-621.5,-580.0,2.5,1.0,0.0,,,,,,,,,,,,,,,,,,,,,8351908519.5,184491529371.0,165667589064.0,52002874405.935,1863.0,1706.0,71125.0,70894.0,9141.0,506383.0,,,,,,,128499.0,663234.0,,,,13535749.706848918,-602336017.0,-922455167.0,-296697783.0,-1536132552.0416667,44042.0,30724.0,,,,,,,,158135.4257672285,126182.2403082198,,,,,,,3716440.0,,,,,,,,,,,,,,,,436699.0,431492.0,,6428.893446002898,632344.0,625893.0,,,,,,,,,55.0,67604283.85499996,24869781.629999984,6758903491.605,2231600896.0350013,77928709.81499992,711633.5999999999,122.0,14359.0,-21956716.0,9753025.0,-11357010.0,-12349804.5,-27.0,0.0,16956.0,152712.0,0.0,0.0,0.0,0.0,0.0,-1652.0,-1348.0,-1104.0,-1232.0,239665940.77500004,3409837766.910004,3840016052.2950015,54758328.61499996,3409837766.910004,245222.0,-16842950.0,3911804103.0,172361607.0,881144525.0,383152500.0,922707277.0,243473.0,3842.0,683.179022443943,5604952.0,2010005.0,1239756.0,-4042404.0,1375403.0,101704.0,2710162231.9877205,2742301179.6076584,-162621010.5,-161280558.5,2876446.0,133723.5,,,,,,,,,,,,,,,,,,,,,1468395.0,14817568.0,3234468.0,8560966.0,11615035.0,1416753.0,1059980364.3195012,801909527.8499951,72149964178.65715,21692662789.522617,583105235.7644987,5792665.7475,689.5,94245.0,-277097326.0,21989704.5,-123858265.5,-218835629.5,-2021839.5,,,,,,,,,,,,,,,,,,,,,4275818.0,2480912.5,-9009304.5,921269.0,37582.5,3736113019.71746,3660799566.8474593,-260790156.5,-257476400.5,2528056.0,269374.5,3928818863.789956,33275094594.25592,36705764009.70013,1730485120.9950497,48116789154.27071,3990721.5,-247733787.5,103152867435.5,1055284625.5,17283778577.5,3505796553.5,18897253122.0,3674411.5,71975.5,20882.47873665109,89829145.0,-58.246694322011926,7.590666666666666,2.573781743308168,108.7898759883792,19.53671928620453,825.7876853357902,67500.0,1.0,0.0,0.0,1.0,0.0,0.0,0.0,0.0,0.0,0.0,1.0,0.0,0.0,0.0,0.0,0.0,0.0,0.0,0.0,0.0,1.0,0.0,1.0,0.0,0.0,0.0,0.0,1.0,0.0,0.0,0.0,0.0,0.0,0.0,0.0,0.0,0.0,0.0,0.0,0.0,0.0,0.0,0.0,0.0,0.0,0.0,0.0,0.0,0.0,0.0,0.0,0.0,0.0,0.0,0.0,0.0,0.0,0.0,0.0,0.0,0.0,0.0,0.0,0.0,0.0,0.0,0.0,0.0,0.0,0.0,0.0,0.0,0.0,0.0,0.0,0.0,0.0,0.0,0.0,0.0,0.0,0.0,0.0,0.0,0.0,0.0,0.0,0.0,0.0,0.0,0.0,0.0,0.0,0.0,0.0,0.0,0.0,0.0,0.0,0.0,0.0,1.0,0.0,0.0,0.0,0.0,0.0,0.0,0.0,0.0,0.0,0.0,0.0,0.0,0.0,0.0,0.0,0.0,0.0,0.0,0.0,0.0
104066,1,0.0,0.0,1.0,1.0,0.0,180000.0,781920.0,42547.5,675000.0,0.0084739999999999,37.484931506849314,-924.0,-12017.0,-5300.0,2.0,2.0,2.0,2.0,12.0,,0.5494950707996901,0.2276129150623945,,,,,,,,,,,,,,,,,,,,,,,,,,,,,,,,,,,,,,,,,,,,,3.0,0.0,3.0,0.0,-2002.0,0.0,0.0,0.0,0.0,0.0,0.0,1.0,1.0,0.0,1.0,1.0,0.0,0.0,0.0,0.0,0.0,0.0,0.0,0.0,1.0,0.0,0.0,0.0,0.0,0.0,0.0,0.0,0.0,0.0,0.0,0.0,0.0,0.0,0.0,0.0,0.0,0.0,0.0,16.0,0.0,3537.7875,225000.0,0.0,0.0,0.0,0.0,0.0,-603.0,517.0,-219.0,-591.0,579.0,-22.0,10.0,23625.0,312750.0,468238.5,0.0,360000.0,36.0,-1012.0,365243.0,-1266.0,-876.0,-216.0,-870.0,12.0,0.0,0.0,0.0,70.0,36.0,24.0,-47.5,0.0,0.0,114.0,15199.92,15199.92,-1022.0,-1021.0,13.0,1.0,36.0,0.0,0.0,0.0,0.0,0.0,0.0,0.0,831.96,831.96,0.0,0.0,0.0,0.0,0.0,0.0,0.0,9.0,-19.5,0.0,0.0,8351951067.0,184492311291.0,165668264064.0,52003054405.935,1863.0,1706.0,71125.0,70894.0,9141.0,506383.0,,,,,,,128499.0,663236.0,,,,13535787.191780426,-602336941.0,-922460467.0,-296699785.0,-1536144569.0416667,44042.0,30724.0,,,,,,,,158135.97526229933,126182.46792113484,,,,,,,3716452.0,,,,,,,,,,,,,,,,436702.0,431495.0,1263924.0,6428.901920002898,632346.0,625895.0,,,,,,,,,20.5,67604283.85499996,24876857.204999983,6765580581.254997,2233932999.255001,77943741.34499992,711633.5999999999,122.0,14359.0,-21975656.0,9750514.5,-11368233.0,-12362011.0,-9.75,0.0,7075.575,167400.0,0.0,0.0,0.0,0.0,0.0,-2266.0,-2061.0,-1183.0,-2176.0,240013139.22000003,3414710884.410004,3845897750.2950015,54800867.11499996,3414710884.410004,245612.0,-16871183.0,3916916390.0,172705972.0,881859231.0,383507262.0,923060181.0,243785.5,3847.0,684.1463629553236,5607792.5,2013196.0,1241577.0,-4050430.0,1375403.0,101704.0,2714615834.107723,2746705542.3226604,-162891016.5,-161549242.5,2878261.0,133942.0,2517708867.614984,6802947000.0,212636681.685,330962247.8999996,11793509.1,106196807.06999992,142989416.03249943,363386609.5499972,334915735.7249993,2417013180.1800013,2508229171.2149787,2508358268.789978,10958.0,28752.0,156.0,17638.0,821229.5,-1457076.5,590689.0,1362.0,1468411.0,14818147.0,3234504.0,8561036.0,11615149.0,1416763.0,1059980364.3195012,801913065.6374952,72150189178.65715,21692662789.522617,583105235.7644987,5792665.7475,689.5,94245.0,-277097929.0,21990221.5,-123858484.5,-218836220.5,-2021861.5,5926228410.64496,18735160500.0,198873957.825,448254093.8699976,1948107.735,256957208.9100008,309278054.18249863,636918934.6574979,459400091.7599993,5711271075.247535,5889486550.387498,5889729733.1325,13392.5,80925.0,44.0,70426.5,971927.5,-1699499.0,177364.0,6755.0,4275854.0,2480936.5,-9009352.0,921269.0,37582.5,3736128219.63746,3660814766.7674594,-260791178.5,-257477421.5,2528069.0,269375.5,3928842488.789956,33275407344.25592,36706232248.20013,1730485120.9950497,48117149154.27071,3990757.5,-247734799.5,103153232678.5,1055283359.5,17283777701.5,3505796337.5,18897252252.0,3674423.5,71975.5,20882.47873665109,89829145.0,-24.64990498465137,4.343999999999999,4.230565838180857,158.58247067942597,18.377578001057643,688.8822526314266,90000.0,-0.9009688679024191,0.4338837391175582,0.0,0.0,0.0,0.0,0.0,0.0,1.0,0.0,0.0,0.0,0.0,0.0,0.0,1.0,0.0,0.0,0.0,0.0,1.0,0.0,1.0,0.0,0.0,0.0,0.0,1.0,0.0,0.0,0.0,0.0,0.0,0.0,0.0,0.0,0.0,0.0,0.0,0.0,1.0,0.0,0.0,0.0,0.0,0.0,0.0,0.0,0.0,0.0,0.0,0.0,0.0,0.0,0.0,0.0,0.0,0.0,0.0,0.0,0.0,0.0,0.0,0.0,0.0,0.0,0.0,0.0,0.0,0.0,0.0,0.0,1.0,0.0,0.0,0.0,0.0,0.0,0.0,0.0,0.0,0.0,0.0,0.0,0.0,0.0,0.0,0.0,0.0,0.0,0.0,0.0,0.0,0.0,0.0,0.0,0.0,0.0,0.0,0.0,0.0,0.0,0.0,0.0,0.0,0.0,0.0,0.0,0.0,0.0,0.0,0.0,0.0,0.0,0.0,0.0,0.0,0.0,0.0,0.0,0.0,0.0
104087,0,0.0,0.0,1.0,0.0,0.0,607500.0,1272456.0,53910.0,1080000.0,0.032561,51.28767123287671,-2902.0,-6600.0,-2261.0,7.0,2.0,1.0,1.0,13.0,0.7255557170230512,0.6051399475123582,0.4188542886233217,0.0804,0.0671,0.9767,,,0.0,0.1379,0.1667,,0.0328,,0.0684,,0.0,0.0819,0.0696,0.9767,,,0.0,0.1379,0.1667,,0.0336,,0.0713,,0.0,0.0812,0.0671,0.9767,,,0.0,0.1379,0.1667,,0.0334,,0.0696,,0.0,0.06,1.0,0.0,0.0,0.0,0.0,-2443.0,0.0,0.0,0.0,0.0,0.0,0.0,1.0,1.0,0.0,1.0,1.0,0.0,0.0,0.0,0.0,0.0,0.0,0.0,0.0,1.0,0.0,0.0,0.0,0.0,0.0,0.0,0.0,0.0,0.0,0.0,0.0,0.0,0.0,0.0,0.0,0.0,0.0,0.0,8.0,8808.75,0.0,1476110.25,0.0,0.0,0.0,0.0,0.0,-981.0,563.0,-265.5,-764.0,297.0,-19.0,4.0,7543.98,83317.5,51792.75,10845.0,83317.5,12.0,-1626.0,365243.0,-1996.5,-1771.5,-1726.5,-1764.0,17.5,0.0,0.2070613041108464,50.0,22.0,12.0,3.5,-72.5,0.0,0.0,18.0,5192.505,5192.505,-2201.5,-2187.0,5.0,1.0,0.0,,,,,,,,,,,,,,,,,,,,,8352004977.0,184493583747.0,165669344064.0,52003661905.935,1863.0,1706.0,71125.0,70894.0,9141.0,506383.0,17819.252400002293,17881.454899999113,17332.64149999802,11302.276900000095,11240.078600000095,11187.416500000054,128499.0,663238.0,,,,13535838.479451654,-602339843.0,-922462728.0,-296702228.0,-1536151169.0416667,44042.0,30724.0,11356.313999999187,11232.259999998982,10716.38239999729,22902.432900009742,22824.218600009703,22209.448800008267,67518.98541493058,158136.58040224685,126182.88677542348,35023.23280002797,34963.409000028405,34408.84310002882,,,,3716465.0,8300.893900000163,8405.487700000076,8128.985800000232,,,,16477.99399999974,16663.314999999693,16259.958499999702,,,,3916.339800000124,3899.547000000164,3732.19600000016,436702.0,431495.0,1263931.0,6428.934481002898,632347.0,625896.0,,16342.343999999805,154277.94899999068,154280.69659999025,154172.42329998722,,,,33.0,67791698.81999996,24956081.77499998,6790050076.364997,2241981713.6550007,78190578.17999993,711633.5999999999,122.0,14359.0,-22071001.0,9753423.0,-11422890.0,-12418448.0,-16.0,6732.0,0.0,1800000.0,0.0,0.0,0.0,0.0,0.0,-1070.0,5.0,-764.0,-1928.0,241214356.08,3437315666.685004,3871239048.0450015,55060413.38999996,3437315666.685004,247044.0,-16960416.5,3934625957.5,173016395.0,885470206.0,384935345.0,927401747.0,244908.0,3862.0,687.4730661932075,5669321.0,2021311.0,1246853.0,-4066003.0,1375668.0,101913.0,2727611220.9377465,2757397634.2576785,-163629282.0,-162282123.0,2891769.5,134482.5,,,,,,,,,,,,,,,,,,,,,1468419.0,14818444.0,3234504.0,8561058.0,11615167.0,1416767.0,1059989173.0695012,801913065.6374952,72151665288.90715,21692662789.522617,583105235.7644987,5792665.7475,689.5,94245.0,-277098910.0,21990784.5,-123858750.0,-218836984.5,-2021880.5,,,,,,,,,,,,,,,,,,,,,4275866.0,2480940.0,-9009424.5,921269.0,37582.5,3736133412.14246,3660819959.27246,-260793380.0,-257479608.5,2528074.0,269376.5,3928850032.769956,33275490661.75592,36706284040.95013,1730495965.9950497,48117232471.77071,3990769.5,-247736425.5,103153597921.5,1055281363.0,17283775930.0,3505794611.0,18897250488.0,3674441.0,71975.5,20882.6857979552,89829195.0,-56.58279914529915,2.0945777777777783,11.268781302170286,577.9495506208979,23.60333889816361,1210.5602854071856,303750.0,-0.2225209339563143,0.9749279121818236,0.0,0.0,0.0,0.0,0.0,0.0,1.0,0.0,1.0,0.0,0.0,0.0,0.0,0.0,0.0,1.0,0.0,0.0,0.0,0.0,1.0,0.0,0.0,0.0,0.0,1.0,0.0,0.0,0.0,0.0,0.0,0.0,0.0,0.0,0.0,0.0,0.0,0.0,0.0,0.0,1.0,0.0,0.0,0.0,0.0,0.0,0.0,0.0,0.0,0.0,1.0,0.0,0.0,0.0,0.0,0.0,0.0,0.0,0.0,0.0,0.0,0.0,0.0,0.0,0.0,0.0,0.0,0.0,0.0,0.0,0.0,0.0,0.0,0.0,0.0,0.0,0.0,0.0,0.0,0.0,0.0,0.0,0.0,0.0,0.0,0.0,0.0,0.0,0.0,0.0,0.0,0.0,0.0,0.0,0.0,0.0,0.0,0.0,0.0,0.0,0.0,0.0,0.0,0.0,0.0,0.0,0.0,0.0,0.0,0.0,1.0,0.0,0.0,0.0,0.0,0.0,0.0,0.0,1.0,0.0
104089,0,0.0,1.0,1.0,1.0,0.0,180000.0,338832.0,26901.0,292500.0,0.016612,47.465753424657535,-2513.0,-8830.0,-877.0,9.0,2.0,2.0,2.0,14.0,,0.4642874351389268,0.8106180215523969,0.2804,0.0729,0.9846,0.7892,0.0776,0.08,0.0345,0.3333,0.375,0.1129,0.2278,0.0839,0.0039,0.0068,0.2857,0.0757,0.9846,0.7975,0.0783,0.0806,0.0345,0.3333,0.375,0.1154,0.2489,0.0874,0.0039,0.0072,0.2831,0.0729,0.9846,0.792,0.0781,0.08,0.0345,0.3333,0.375,0.1148,0.2317,0.0854,0.0039,0.0069999999999999,0.1099,1.0,0.0,0.0,0.0,0.0,-633.0,0.0,0.0,0.0,0.0,0.0,4.0,1.0,1.0,0.0,1.0,0.0,0.0,0.0,0.0,0.0,0.0,0.0,0.0,0.0,0.0,0.0,0.0,0.0,0.0,1.0,0.0,0.0,0.0,0.0,0.0,0.0,0.0,0.0,0.0,0.0,0.0,0.0,0.0,0.0,,,,,,,,,,,,,0.0,,7.0,11937.240000000002,45000.0,45000.0,,119250.0,12.0,-489.0,365243.0,-274.0,182542.0,236.0,182545.5,11.0,1.0,,-1.0,21.0,12.0,8.0,-13.0,0.0,0.0,18.0,14487.03,14487.03,-358.0,-354.0,4.0,1.0,14.0,0.0,90000.0,,0.0,,,0.0,,0.0,0.0,0.0,0.0,,0.0,,,0.0,-9.5,0.0,0.0,8352031878.0,184493922579.0,165669636564.0,52003841905.935,1863.0,1706.0,71125.0,70894.0,9141.0,506387.0,17819.532800002293,17881.737999999114,17332.92719999802,11302.349800000093,11240.151500000096,11187.492200000052,128499.0,663240.0,4140.623700000116,4138.311700000016,3948.8853000000936,13535885.94520508,-602342356.0,-922463605.0,-296702861.0,-1536159999.0416667,44042.0,30724.0,11356.393999999187,11232.339999998982,10716.46299999729,22902.467400009748,22824.253100009708,22209.483300008265,,158137.044689682,126183.69739344502,35023.566100027965,34963.7423000284,34409.17640002882,22968.0984999959,22941.15029999548,22587.91439999571,3716479.0,8301.006800000163,8405.602500000074,8129.101200000232,9823.274700000718,9938.249000002164,10298.234699999644,16478.077899999742,16663.400399999693,16260.045899999704,828.9563000001767,814.1325000000461,760.0552000000133,3916.346600000125,3899.554000000164,3732.20320000016,436702.0,431495.0,1263940.0,6428.951093002898,632349.0,625898.0,,16342.453899999802,154278.93359999068,154281.68119999024,154173.4078999872,77658.77999999633,77996.81320000657,78398.43180000657,,,,,,,,,,,,,,,,,,,,,,,,,,,241261605.225,3437947025.055004,3871866016.6650014,,3437969525.055004,247122.0,-16971084.0,3936452172.5,173194123.5,886014211.5,385114828.5,927945777.5,245042.0,3865.0,,5678438.0,2021848.0,1247152.0,-4067940.0,1375668.0,101913.0,2727962194.320248,2757728988.27018,-163678119.5,-162330573.5,2891998.5,134523.5,2526515278.3799834,6827436000.0,,331936999.87499964,,,143548638.83999944,,336234084.9299992,2425422662.775001,2516995627.154977,2517124724.729977,,28795.0,,,824845.0,-1463918.0,590697.0,1370.0,1468419.0,14818444.0,3234518.0,8561079.0,11615185.0,1416774.0,,,,,,,,,,,,,,5926228410.64496,18735250500.0,,448254093.8699976,,,309278054.18249863,,459400091.7599993,5711271075.247535,5889486550.387498,5889729733.1325,,80925.0,,,971927.5,-1699508.5,177364.0,6755.0,4275878.0,2480948.0,-9009437.5,921269.0,37582.5,3736147899.172461,3660834446.30246,-260793738.0,-257479962.5,2528078.0,269377.5,3928861970.0099545,33275535661.75592,36706329040.95013,,48117351721.77071,3990781.5,-247736914.5,103153963164.5,1055281089.0,17283958472.0,3505794847.0,18897433033.5,3674452.0,71976.5,,89829194.0,-52.94343434343434,1.8824,6.691201070592173,317.6029001315325,12.595516895282705,597.8556992075968,90000.0,-0.9009688679024191,-0.433883739117558,0.0,0.0,0.0,0.0,0.0,0.0,1.0,0.0,0.0,0.0,0.0,0.0,0.0,1.0,0.0,0.0,0.0,0.0,1.0,0.0,1.0,0.0,0.0,0.0,0.0,1.0,0.0,0.0,0.0,0.0,0.0,0.0,0.0,0.0,0.0,0.0,0.0,0.0,1.0,0.0,0.0,0.0,0.0,0.0,0.0,0.0,0.0,0.0,0.0,0.0,0.0,0.0,0.0,0.0,0.0,0.0,0.0,0.0,0.0,0.0,0.0,0.0,0.0,0.0,0.0,0.0,0.0,0.0,0.0,0.0,0.0,0.0,0.0,0.0,0.0,0.0,0.0,0.0,0.0,0.0,0.0,0.0,0.0,0.0,0.0,0.0,0.0,0.0,0.0,0.0,1.0,0.0,0.0,0.0,0.0,0.0,0.0,0.0,0.0,0.0,0.0,0.0,0.0,0.0,0.0,0.0,0.0,0.0,1.0,0.0,1.0,0.0,0.0,0.0,0.0,0.0,0.0,0.0,1.0,0.0
104095,0,0.0,1.0,1.0,0.0,0.0,211500.0,817560.0,30951.0,675000.0,0.025164,57.72054794520548,-485.0,-14.0,-3588.0,3.0,2.0,2.0,2.0,13.0,0.5873147646273198,0.5565274301796452,0.520897599048938,,,,,,,,,,,,,,,,,,,,,,,,,,,,,,,,,,,,,,,,,,,,,0.0,0.0,0.0,0.0,-916.0,0.0,0.0,0.0,0.0,1.0,2.0,1.0,1.0,0.0,1.0,0.0,0.0,0.0,0.0,0.0,0.0,0.0,0.0,0.0,0.0,0.0,0.0,0.0,0.0,1.0,0.0,0.0,0.0,0.0,0.0,0.0,0.0,0.0,0.0,0.0,0.0,0.0,0.0,17.0,0.0,0.0,248265.0,0.0,0.0,0.0,0.0,0.0,-987.0,-364.0,-792.0,-941.0,741.0,-26.0,5.0,21049.65,112500.0,112500.0,0.0,495000.0,36.0,-916.0,365243.0,-1692.0,-942.0,78.0,-931.0,12.0,1.0,0.0,-1.0,69.0,36.0,27.0,-44.0,0.0,0.0,163.0,3375.0,3375.0,-1951.0,-1947.0,22.0,0.0,94.0,0.0,67500.0,0.0,0.0,0.0,0.0,0.0,155.385,0.0,0.0,0.0,0.0,0.0,0.0,0.0,0.0,45.0,-49.5,0.0,0.0,8352062829.0,184494740139.0,165670311564.0,52004053405.935,1863.0,1706.0,71125.0,70895.0,9141.0,506389.0,,,,,,,128499.0,663242.0,,,,13535943.665753026,-602342841.0,-922467193.0,-296703777.0,-1536160013.0416667,44042.0,30724.0,,,,,,,67519.57272969521,158137.60121711215,126184.21829104408,,,,,,,3716492.0,,,,,,,,,,,,,,,,436702.0,431495.0,1263943.0,6428.976257002898,632351.0,625900.0,,,,,,,,,33.0,67835950.33499996,24956081.77499998,6807250180.799997,2247288315.750001,78195700.79999994,711633.5999999999,123.0,14359.0,-22111945.0,9808131.0,-11446233.0,-12440876.0,-16.0,0.0,0.0,248265.0,0.0,0.0,0.0,0.0,0.0,-2161.0,-1452.0,-1229.0,-1482.0,241874286.57,3446459877.555004,3880891347.1650014,55126477.88999996,3446459877.555004,247684.0,-17008908.0,3943574028.0,173351608.0,888004562.0,385647064.0,929936222.0,245523.0,3873.0,688.1172853549502,5688717.0,2026703.0,1250114.0,-4077079.0,1375668.0,101913.0,2732423215.68025,2762154164.2501826,-164071070.0,-162720437.0,2898055.0,134726.0,2529129816.6299844,6832604250.0,213641531.685,332162925.92999965,11793509.1,106392635.09999992,143689124.6549994,365030885.92499685,336494025.3149992,2427919251.030001,2519587664.279977,2519716761.854977,10993.0,28807.0,156.0,17658.0,826603.5,-1466414.0,590697.0,1370.0,1468436.0,14819185.0,3234612.0,8561148.0,11615348.0,1416779.0,1059989173.0695012,801913065.6374952,72151913553.90715,21692662789.522617,583105235.7644987,5792665.7475,689.5,94245.0,-277099897.0,21990420.5,-123859542.0,-218837925.5,-2021906.5,5926228410.64496,18735318000.0,198873957.825,448254093.8699976,1948107.735,256957208.9100008,309278054.18249863,636919090.0424979,459400091.7599993,5711271075.247535,5889486550.387498,5889729733.1325,13392.5,80925.0,44.0,70426.5,971972.5,-1699558.0,177364.0,6755.0,4275914.0,2480975.0,-9009481.5,921269.0,37582.5,3736151274.172461,3660837821.30246,-260795689.0,-257481909.5,2528100.0,269377.5,3928883019.659957,33275648161.75592,36706441540.95013,1730495965.9950497,48117846721.77071,3990817.5,-247737830.5,103154328407.5,1055279397.0,17283957530.0,3505794925.0,18897432102.5,3674464.0,71977.5,20882.6857979552,89829193.0,-8.402553635845832,3.865531914893616,6.833381797034022,394.42654164359664,26.414655423088107,1524.668384804439,105750.0,1.0,0.0,0.0,1.0,0.0,0.0,0.0,0.0,0.0,0.0,0.0,0.0,0.0,0.0,0.0,1.0,0.0,1.0,0.0,0.0,0.0,0.0,1.0,0.0,0.0,0.0,0.0,1.0,0.0,0.0,0.0,0.0,0.0,0.0,0.0,1.0,0.0,0.0,0.0,0.0,0.0,0.0,0.0,0.0,0.0,0.0,0.0,0.0,0.0,0.0,0.0,0.0,0.0,0.0,0.0,0.0,0.0,0.0,0.0,0.0,0.0,0.0,0.0,0.0,0.0,0.0,0.0,0.0,0.0,0.0,0.0,0.0,0.0,0.0,0.0,0.0,0.0,0.0,0.0,0.0,0.0,0.0,0.0,0.0,0.0,0.0,0.0,0.0,0.0,0.0,0.0,0.0,0.0,0.0,0.0,0.0,0.0,1.0,0.0,0.0,0.0,0.0,0.0,0.0,0.0,0.0,0.0,0.0,0.0,0.0,0.0,0.0,0.0,0.0,0.0,0.0,0.0,0.0,0.0,0.0,0.0,0.0
104098,0,0.0,1.0,1.0,1.0,1.0,202500.0,387144.0,30717.0,342000.0,0.030755,40.38082191780822,-3123.0,-3398.0,-4648.0,4.0,3.0,2.0,2.0,12.0,0.3075954027086491,0.153312084241807,0.5726825047161584,,,,,,,,,,,,,,,,,,,,,,,,,,,,,,,,,,,,,,,,,,,,,0.0,0.0,0.0,0.0,0.0,0.0,0.0,0.0,0.0,0.0,1.0,1.0,1.0,0.0,1.0,0.0,0.0,0.0,0.0,0.0,0.0,1.0,1.0,0.0,0.0,0.0,0.0,1.0,0.0,0.0,0.0,0.0,0.0,0.0,0.0,0.0,0.0,0.0,0.0,0.0,0.0,0.0,0.0,2.0,0.0,,244107.0,0.0,0.0,0.0,0.0,0.0,-1197.5,-499.5,-306.0,-513.0,80.0,-19.5,5.0,10921.3425,30640.5,27490.5,1575.0,59440.5,9.0,-162.0,365243.0,-932.5,181822.0,-692.5,181825.0,12.0,0.5,0.0559820558351913,-1.0,12.0,6.0,5.5,-53.5,0.0,0.0,10.0,5609.07,5609.07,-1631.0,-1614.0,3.0,1.0,0.0,,,,,,,,,,,,,,,,,,,,,8352093546.0,184495127283.0,165670653564.0,52004255905.935,1863.0,1706.0,71125.0,70895.0,9141.0,506390.0,,,,,,,128500.0,663245.0,,,,13535984.046574945,-602345964.0,-922471841.0,-296703777.0,-1536163411.0416667,44042.0,30724.0,,,,,,,67519.88032509793,158137.75452919642,126184.7909735488,,,,,,,3716504.0,,,,,,,,,,,,,,,,436702.0,431495.0,1263947.0,6429.007012002898,632353.0,625902.0,,,,,,,,,40.0,68046077.83499996,,6818226652.799997,2247837189.750001,78195700.79999994,711633.5999999999,123.0,14359.0,-22128015.5,9816803.0,-11454379.5,-12453267.0,-19.5,0.0,,51714.0,0.0,0.0,0.0,0.0,0.0,-1220.0,-919.0,-545.0,-950.0,241947853.065,3447608952.555004,3882065055.1650014,55129627.88999996,3447608952.555004,247798.0,-17015363.0,3945217305.5,173712721.0,888915052.5,386011204.0,930846733.5,245638.0,3874.5,688.2292494666208,5690495.0,2028801.0,1251690.0,-4079270.0,1375668.0,101913.0,2735017402.837756,2765063605.2076874,-164208042.0,-162855968.5,2899588.0,134868.5,,,,,,,,,,,,,,,,,,,,,1468438.0,14819265.0,3234612.0,8561160.0,11615358.0,1416784.0,1059989173.0695012,,72152157660.90715,21692662789.522617,583105235.7644987,5792665.7475,689.5,94245.0,-277101094.5,21989921.0,-123859848.0,-218838438.5,-2021926.0,,,,,,,,,,,,,,,,,,,,,4275920.0,2480980.5,-9009535.0,921269.0,37582.5,3736156883.2424607,3660843430.372461,-260797320.0,-257483523.5,2528103.0,269378.5,3928893941.002456,33275678802.25592,36706469031.45013,1730497540.9950497,48117906162.27071,3990826.5,-247737992.5,103154693650.5,1055278464.5,17284139352.0,3505794232.5,18897613927.5,3674476.0,71978.0,20882.74178001103,89829192.0,-77.33869326277224,1.9118222222222223,6.592440668033987,266.20817261959706,12.603574567828892,508.9427001513152,67500.0,-0.9009688679024191,0.4338837391175582,0.0,0.0,0.0,0.0,0.0,0.0,1.0,0.0,0.0,0.0,0.0,0.0,0.0,1.0,0.0,0.0,0.0,0.0,1.0,0.0,1.0,0.0,0.0,0.0,0.0,1.0,0.0,0.0,0.0,0.0,0.0,0.0,0.0,0.0,0.0,0.0,0.0,0.0,0.0,0.0,0.0,0.0,0.0,0.0,0.0,0.0,1.0,0.0,0.0,1.0,0.0,0.0,0.0,0.0,0.0,0.0,0.0,0.0,0.0,0.0,0.0,0.0,0.0,0.0,0.0,0.0,0.0,0.0,0.0,0.0,0.0,0.0,0.0,0.0,0.0,0.0,0.0,0.0,0.0,0.0,0.0,0.0,0.0,0.0,0.0,0.0,0.0,0.0,0.0,0.0,0.0,0.0,0.0,0.0,0.0,0.0,0.0,0.0,0.0,0.0,0.0,0.0,0.0,0.0,0.0,0.0,0.0,0.0,0.0,0.0,0.0,0.0,0.0,0.0,0.0,0.0,0.0,0.0,0.0,0.0
104104,0,0.0,0.0,0.0,1.0,2.0,135000.0,526837.5,18121.5,337500.0,0.02461,35.73150684931507,-2086.0,-2842.0,-5237.0,,4.0,2.0,2.0,11.0,0.5231127082527203,0.4827825056840683,0.656158373001177,0.0567,0.0171,0.9861,,,0.08,0.0345,0.5417,,0.0308,,0.0517,,0.0132,0.0578,0.0177,0.9861,,,0.0806,0.0345,0.5417,,0.0315,,0.0539,,0.014,0.0573,0.0171,0.9861,,,0.08,0.0345,0.5417,,0.0313,,0.0526,,0.0135,0.0524,1.0,0.0,0.0,0.0,0.0,0.0,0.0,0.0,0.0,0.0,0.0,2.0,1.0,1.0,0.0,1.0,1.0,0.0,0.0,0.0,0.0,0.0,0.0,0.0,0.0,1.0,0.0,0.0,0.0,0.0,0.0,0.0,0.0,0.0,0.0,0.0,0.0,0.0,0.0,0.0,0.0,0.0,0.0,0.0,4.0,0.0,0.0,30915.0,0.0,0.0,0.0,0.0,0.0,-1787.5,-1474.5,-1078.0,-1814.0,230.0,-28.0,4.0,10508.1525,51189.75,73278.0,5170.5,67500.0,9.0,-1549.5,365243.0,-1240.0,-1015.0,-910.0,-1008.5,14.5,0.0,0.1066500041581598,12.0,27.0,12.0,5.0,-51.0,0.0,0.0,28.0,9035.325,8578.372500000001,-1543.0,-1535.0,5.0,1.0,42.0,0.0,450000.0,,0.0,,,0.0,,0.0,0.0,0.0,0.0,,0.0,,,0.0,-24.5,0.0,0.0,8352111667.5,184495654120.5,165670991064.0,52004390905.935,1863.0,1706.0,71125.0,70895.0,9141.0,506392.0,17819.589500002294,17881.795299999114,17332.984999998018,11302.366900000094,11240.168600000095,11187.509900000054,128502.0,663249.0,,,,13536019.778081791,-602348050.0,-922477078.0,-296703777.0,-1536166253.0416667,44042.0,30724.0,11356.473999999189,11232.41999999898,10716.543599997289,22902.501900009745,22824.287600009706,22209.517800008267,67520.40343780618,158138.2373117021,126185.4471319218,35024.10780002797,34964.284000028405,34409.71810002882,,,,3716515.0,8301.037600000163,8405.633800000076,8129.132700000232,,,,16478.129599999742,16663.452999999696,16260.099799999703,,,,3916.359800000124,3899.567500000164,3732.21720000016,436702.0,431495.0,,6429.031622002898,632355.0,625904.0,,16342.506299999804,154279.91969999069,154282.66729999025,154174.3939999872,,,,59.0,68046077.83499996,24976819.84499998,6827040881.864997,2251461961.8900013,78314587.91999994,711633.5999999999,124.0,14359.0,-22170835.0,9894143.0,-11476699.0,-12479203.0,-29.0,0.0,0.0,30915.0,0.0,0.0,0.0,0.0,0.0,-2126.0,-1822.0,-1035.0,-1814.0,242097742.62,3448819713.555004,3884600692.6650014,55142709.38999996,3448853958.555004,248007.0,-17027605.0,3949234978.5,174067463.0,889455759.0,386371976.0,931753123.0,245833.0,3877.0,688.4996452504031,5699673.5,2032036.0,1253770.0,-4082817.0,1375669.0,101914.0,2736516648.442759,2766172561.8076897,-164312892.5,-162958790.0,2900713.5,135100.5,2530318804.1099834,6840963000.0,,332516625.92999965,,,143760597.07499942,,336898215.3149992,2429058581.460001,2520775413.3149757,2520904510.8899746,,28819.0,,,828280.0,-1469248.5,590697.0,1370.0,1468442.0,14819495.0,3234654.0,8561187.0,11615386.0,1416788.0,1059989173.0695012,801913065.6374952,72152188575.90715,21692662789.522617,583105235.7644987,5792665.7475,689.5,94245.0,-277102882.0,21988446.5,-123860926.0,-218840252.5,-2021954.0,5926228410.64496,18735768000.0,,448254093.8699976,,,309278054.18249863,,459400091.7599993,5711271075.247535,5889486550.387498,5889729733.1325,,80925.0,,,971972.5,-1699582.5,177364.0,6755.0,4275932.0,2480985.5,-9009586.0,921269.0,37582.5,3736165918.567461,3660852008.74496,-260798863.0,-257485058.5,2528108.0,269379.5,3928904449.154956,33275729992.00592,36706542309.45013,1730502711.4950497,48117973662.27071,3990835.5,-247739542.0,103155058893.5,1055277224.5,17284138337.0,3505793322.5,18897612919.0,3674490.5,71978.0,20882.84843001519,89829204.0,-58.37984971630118,3.9025,7.449714427613608,266.1895220957169,29.072510553762108,1038.8046099785354,33750.0,-0.9009688679024191,0.4338837391175582,0.0,1.0,0.0,0.0,0.0,0.0,0.0,0.0,0.0,0.0,1.0,0.0,0.0,0.0,0.0,1.0,0.0,0.0,0.0,0.0,1.0,0.0,0.0,0.0,0.0,1.0,0.0,0.0,0.0,0.0,0.0,0.0,0.0,1.0,0.0,0.0,0.0,0.0,0.0,0.0,0.0,0.0,0.0,0.0,0.0,0.0,0.0,0.0,0.0,0.0,0.0,0.0,0.0,0.0,0.0,0.0,0.0,0.0,0.0,0.0,0.0,0.0,0.0,0.0,0.0,0.0,0.0,0.0,0.0,0.0,0.0,0.0,0.0,0.0,0.0,0.0,1.0,0.0,0.0,0.0,0.0,0.0,0.0,0.0,0.0,0.0,0.0,0.0,0.0,0.0,0.0,0.0,0.0,0.0,0.0,0.0,0.0,0.0,0.0,0.0,0.0,0.0,0.0,0.0,0.0,0.0,0.0,0.0,0.0,0.0,1.0,0.0,0.0,0.0,0.0,0.0,0.0,0.0,1.0,0.0
104110,0,0.0,0.0,0.0,1.0,1.0,157500.0,495000.0,25272.0,495000.0,0.031329,27.271232876712325,-1495.0,-2644.0,-2469.0,,3.0,2.0,2.0,14.0,0.4138223988995396,0.1462127992968484,0.0646719558983517,0.0763,0.0805,0.9767,,,0.0,0.1379,0.1667,,0.0519,,0.0541,,0.0341,0.0777,0.0836,0.9767,,,0.0,0.1379,0.1667,,0.0531,,0.0564,,0.0361,0.077,0.0805,0.9767,,,0.0,0.1379,0.1667,,0.0528,,0.0551,,0.0348,0.05,1.0,4.0,0.0,4.0,0.0,0.0,0.0,0.0,0.0,0.0,1.0,4.0,1.0,1.0,0.0,1.0,1.0,0.0,0.0,0.0,0.0,0.0,0.0,0.0,0.0,1.0,0.0,0.0,0.0,0.0,0.0,0.0,0.0,0.0,0.0,0.0,0.0,0.0,0.0,0.0,0.0,0.0,0.0,0.0,3.0,14863.5,0.0,188640.0,90000.0,0.0,0.0,0.0,0.0,-242.0,374.0,-12.0,,24.0,-4.0,6.0,20940.39,176070.6,171486.0,14626.35,527625.0,42.0,-188.0,365243.0,-543.5,182408.0,-63.5,182410.5,13.5,0.0,0.0595022319025479,-1.0,25.0,24.0,12.5,-14.0,0.0,0.0,24.0,14164.515,14006.655,-366.5,-345.0,6.5,1.0,0.0,,,,,,,,,,,,,,,,,,,,,8352136939.5,184496149120.5,165671486064.0,52004548405.935,1863.0,1706.0,71125.0,70896.0,9141.0,506396.0,17819.665800002294,17881.872299999115,17333.062699998016,11302.447400000092,11240.249100000095,11187.593500000054,128503.0,663252.0,,,,13536047.049314668,-602349545.0,-922479547.0,-296703777.0,-1536168897.0416667,44042.0,30724.0,11356.473999999189,11232.41999999898,10716.543599997289,22902.639800009747,22824.425500009707,22209.655700008272,67520.81726020508,158138.3835245014,126185.5118038777,35024.27450002797,34964.450700028414,34409.88480002882,,,,3716529.0,8301.089500000164,8405.686600000074,8129.185800000232,,,,16478.183699999743,16663.508099999694,16260.156199999705,,,,3916.393900000124,3899.602300000164,3732.25330000016,436706.0,431499.0,,6429.0629510028975,632357.0,625906.0,,16342.556299999802,154280.89639999068,154283.64399999025,154175.3706999872,,,,9.0,68071012.33499996,24986353.09499998,6835540396.049997,2252694328.695001,78360419.51999994,711723.5999999999,124.0,14374.0,-22202082.0,9942292.0,-11495655.0,,-4.0,12467.25,0.0,188640.0,90000.0,0.0,0.0,0.0,0.0,-298.0,374.0,-12.0,,242415259.76249987,3452925466.7550035,3889004941.6650014,55211520.23999996,3452883271.1550035,248325.0,-17055591.0,3956174595.5,174045246.5,890897929.5,386356689.5,933195382.0,246172.5,3883.0,689.6514385106464,5705004.5,2033906.0,1255022.0,-4089361.0,1375681.0,101926.0,2739574967.062752,2769852147.547684,-164494849.0,-163138812.0,2901408.0,135279.5,,,,,,,,,,,,,,,,,,,,,1468445.0,14819519.0,3234654.0,8561212.0,11615410.0,1416794.0,1060004036.5695012,801913065.6374952,72152377215.90715,21692752789.522617,583105235.7644987,5792665.7475,689.5,94245.0,-277103124.0,21988820.5,-123860938.0,,-2021958.0,,,,,,,,,,,,,,,,,,,,,4275956.0,2480998.0,-9009600.0,921269.0,37582.5,3736180083.082461,3660866015.39996,-260799229.5,-257485403.5,2528114.5,269380.5,3928925389.544956,33275906062.60591,36706713795.45013,1730517337.8450494,48118501287.27071,3990877.5,-247739730.0,103155424136.5,1055276681.0,17284320745.0,3505793259.0,18897795329.5,3674504.0,71978.0,20882.907932247093,89829203.0,-54.81967048422744,3.1428571428571432,6.232193732193732,169.95960660344218,19.586894586894587,534.1587636108184,52500.0,0.6234898018587336,0.7818314824680298,0.0,0.0,0.0,0.0,0.0,0.0,1.0,0.0,1.0,0.0,0.0,0.0,0.0,0.0,0.0,0.0,0.0,0.0,1.0,0.0,1.0,0.0,0.0,0.0,0.0,1.0,0.0,0.0,0.0,0.0,0.0,0.0,0.0,1.0,0.0,0.0,0.0,0.0,0.0,0.0,0.0,0.0,0.0,0.0,0.0,0.0,0.0,0.0,0.0,0.0,0.0,0.0,0.0,0.0,0.0,0.0,0.0,0.0,0.0,0.0,0.0,0.0,0.0,0.0,0.0,0.0,0.0,0.0,0.0,0.0,0.0,0.0,0.0,0.0,0.0,0.0,0.0,0.0,0.0,0.0,0.0,0.0,0.0,0.0,0.0,0.0,0.0,0.0,0.0,0.0,0.0,0.0,0.0,0.0,0.0,0.0,0.0,0.0,0.0,1.0,0.0,0.0,0.0,0.0,0.0,0.0,0.0,0.0,0.0,0.0,1.0,0.0,0.0,0.0,0.0,0.0,0.0,0.0,1.0,0.0
104120,0,0.0,0.0,0.0,0.0,0.0,45000.0,182448.0,18823.5,157500.0,0.018029,59.46301369863014,,-14358.0,-1133.0,,2.0,3.0,3.0,6.0,0.2017119390350163,0.5798187897864562,0.4974688893052743,,,,,,,,,,,,,,,,,,,,,,,,,,,,,,,,,,,,,,,,,,,,,9.0,0.0,9.0,0.0,-877.0,0.0,0.0,0.0,0.0,0.0,3.0,1.0,0.0,0.0,1.0,0.0,0.0,0.0,0.0,0.0,0.0,0.0,0.0,0.0,0.0,0.0,0.0,1.0,0.0,0.0,0.0,0.0,0.0,0.0,0.0,0.0,0.0,0.0,0.0,0.0,0.0,0.0,0.0,2.0,13756.5,0.0,189000.0,50181.75,0.0,0.0,0.0,0.0,-758.0,-149.5,-284.5,-555.0,51.0,-12.0,5.0,9984.645,229500.0,277969.5,11776.5,294750.0,24.0,-877.0,365243.0,-847.0,-157.0,-157.0,-151.0,7.0,1.0,0.0961038172806052,-1.0,43.0,24.0,11.0,-26.0,0.0,0.0,44.0,21959.865,21419.730000000003,-749.0,-742.0,11.5,1.0,29.0,0.0,180000.0,,0.0,,,0.0,,0.0,0.0,0.0,0.0,,0.0,,,0.0,-15.0,0.0,0.0,8352155763.0,184496331568.5,165671643564.0,52004593405.935,1863.0,1706.0,71125.0,70896.0,9141.0,506399.0,,,,,,,128503.0,663254.0,,,,13536106.512328368,,-922480680.0,-296704654.0,-1536183255.0416667,44042.0,30724.0,,,,,,,67521.01897214411,158138.9633432912,126186.009272767,,,,,,,3716535.0,,,,,,,,,,,,,,,,436715.0,431508.0,,6429.080980002898,632360.0,625909.0,,,,,,,,,25.5,68115139.33499996,24998089.81499998,6847069853.4299965,2256684172.695001,78495419.51999994,711723.5999999999,124.0,14374.0,-22234248.0,9946540.0,-11515400.5,-12516611.0,-12.25,13756.5,0.0,351000.0,100363.5,0.0,0.0,0.0,0.0,-870.0,225.0,-16.0,-555.0,242739842.62499985,3457487445.345004,3894300370.6650014,55311952.67999996,3457372695.345004,248776.0,-17091838.0,3962925472.0,174013196.0,891242099.0,387433781.0,934272261.0,246561.0,3889.0,691.160661923552,5716009.0,2039470.0,1257540.0,-4104378.0,1381680.0,102177.0,2744764333.852747,2774722879.5076733,-165209147.0,-163850472.5,2916110.0,135626.5,2543294115.449982,6873520500.0,,333871945.6499997,,,144488653.10999936,,338663694.2399993,2441501313.9750013,2533741862.624973,2533870960.199973,,29044.0,,,834493.0,-1477599.0,590722.0,1395.0,1468447.0,14819570.0,3234683.0,8561255.0,11615454.0,1416799.0,1060017793.0695012,801913065.6374952,72152566215.90715,21692802971.272617,583105235.7644987,5792665.7475,689.5,94245.0,-277103882.0,21988671.0,-123861222.5,-218840807.5,-2021970.0,5926228410.64496,18735948000.0,,448254093.8699976,,,309278054.18249863,,459400091.7599993,5711271075.247535,5889486550.387498,5889729733.1325,,80925.0,,,971972.5,-1699597.5,177364.0,6755.0,4275980.0,2481009.0,-9009626.0,921269.0,37582.5,3736202042.94746,3660887435.12996,-260799978.5,-257486145.5,2528126.0,269381.5,3928935374.189956,33276135562.60591,36706991764.95013,1730529114.3450494,48118796037.27071,3990901.5,-247740607.0,103155789379.5,1055275834.0,17284320588.0,3505793102.0,18897795178.5,3674511.0,71979.0,20883.00403606437,89829202.0,,4.0544,2.390628735357399,142.15398923889586,9.692565144633036,576.3491339701792,22500.0,-0.9009688679024191,0.4338837391175582,0.0,1.0,0.0,0.0,0.0,0.0,0.0,0.0,0.0,1.0,0.0,0.0,0.0,0.0,0.0,0.0,0.0,0.0,1.0,0.0,1.0,0.0,0.0,0.0,0.0,1.0,0.0,0.0,0.0,0.0,0.0,0.0,0.0,0.0,0.0,0.0,0.0,0.0,0.0,0.0,0.0,0.0,0.0,0.0,0.0,0.0,0.0,0.0,0.0,0.0,0.0,0.0,0.0,0.0,0.0,0.0,0.0,0.0,0.0,0.0,0.0,0.0,0.0,0.0,0.0,0.0,0.0,0.0,0.0,0.0,0.0,0.0,0.0,0.0,0.0,0.0,0.0,0.0,0.0,0.0,0.0,0.0,0.0,0.0,0.0,0.0,0.0,0.0,0.0,0.0,0.0,0.0,0.0,0.0,0.0,0.0,0.0,0.0,0.0,0.0,0.0,0.0,0.0,0.0,0.0,1.0,0.0,0.0,0.0,0.0,0.0,0.0,0.0,0.0,0.0,0.0,0.0,0.0,0.0,0.0
104122,0,0.0,0.0,0.0,1.0,1.0,135000.0,601029.0,47614.5,513000.0,0.04622,28.871232876712327,-2775.0,-5018.0,-1381.0,,3.0,1.0,1.0,17.0,0.6124062998247947,0.7189200201479709,0.5709165417729987,0.066,0.0658,0.9757,0.6668,0.0205,0.0,0.1379,0.1667,0.2083,0.0633,0.0504,0.0506,0.0154,0.086,0.0672,0.0682,0.9757,0.6798,0.0206,0.0,0.1379,0.1667,0.2083,0.0647,0.0551,0.0527,0.0156,0.091,0.0666,0.0658,0.9757,0.6713,0.0206,0.0,0.1379,0.1667,0.2083,0.0644,0.0513,0.0515,0.0155,0.0878,0.0697,1.0,1.0,1.0,1.0,1.0,-1352.0,0.0,0.0,0.0,0.0,0.0,4.0,1.0,1.0,0.0,1.0,0.0,0.0,0.0,0.0,0.0,0.0,0.0,0.0,0.0,1.0,0.0,0.0,0.0,0.0,0.0,0.0,0.0,0.0,0.0,0.0,0.0,0.0,0.0,0.0,0.0,0.0,0.0,0.0,3.0,0.0,,0.0,0.0,0.0,0.0,0.0,0.0,-2443.0,30919.0,-155.0,-183.0,165.0,-39.0,5.0,11250.0,0.0,89523.0,8212.5,82125.0,12.0,-151.0,365243.0,-179.5,365243.0,330.5,365243.0,12.0,0.5,0.0915139237115387,-1.0,12.0,24.0,18.5,-4.5,0.0,0.0,12.0,5316.75,5316.75,-112.5,-104.5,3.5,1.0,0.0,,,,,,,,,,,,,,,,,,,,,8352203377.5,184496932597.5,165672156564.0,52004728405.935,1863.0,1706.0,71125.0,70896.0,9141.0,506403.0,17819.731800002293,17881.93889999911,17333.129899998017,11302.513200000092,11240.314900000096,11187.661700000051,128504.0,663257.0,4140.644200000114,4138.332300000016,3948.905900000093,13536135.383561244,-602352320.0,-922482061.0,-296706006.0,-1536188273.0416667,44043.0,30725.0,11356.473999999189,11232.41999999898,10716.543599997289,22902.777700009752,22824.563400009712,22209.79360000828,67521.63137844394,158139.68226331135,126186.58018930876,35024.44120002797,34964.617400028415,34410.05150002882,22968.3067999959,22941.358599995478,22588.122699995707,3716552.0,8301.152800000164,8405.751000000075,8129.250500000232,9823.32510000072,9938.300300002162,10298.289799999644,16478.23429999974,16663.5595999997,16260.208899999703,828.9717000001767,814.1480000000461,760.0708000000133,3916.479900000124,3899.690100000164,3732.34430000016,436716.0,431509.0,,6429.127200002898,632361.0,625910.0,,16342.625999999802,154281.8720999907,154284.61969999026,154176.3463999872,77659.44679999632,77997.48450000657,78399.11160000657,81.0,68115139.33499996,,6848620955.729997,2256826329.1800013,78603742.03499994,711723.5999999999,124.0,14374.0,-22263788.0,9960111.0,-11534538.0,-12537079.5,-40.0,0.0,,0.0,0.0,0.0,0.0,0.0,0.0,-2443.0,30919.0,-155.0,-183.0,242813787.61499983,3458170743.345004,3895261255.6650014,55320165.17999996,3458400243.345004,248866.0,-17094504.0,3964203822.5,174374692.5,892152388.5,387796792.5,935182567.5,246629.0,3889.5,691.2521758472633,5719217.0,2040057.0,1257907.5,-4106026.0,1381680.0,102177.0,2745088797.600246,2775047343.2551727,-165258179.5,-163898975.0,2916374.5,135660.5,,,,,,,,,,,,,,,,,,,,,1468450.0,14819735.0,3234683.0,8561267.0,11615466.0,1416804.0,1060017793.0695012,,72152566215.90715,21692802971.272617,583105235.7644987,5792665.7475,689.5,94245.0,-277106325.0,22019590.0,-123861377.5,-218840990.5,-2022009.0,,,,,,,,,,,,,,,,,,,,,4276004.0,2481027.5,-9009630.5,921269.0,37582.5,3736207359.69746,3660892751.87996,-260800091.0,-257486250.0,2528129.5,269382.5,3928946624.189956,33276135562.60591,36707081287.95013,1730537326.8450494,48118878162.27071,3990913.5,-247740758.0,103156154622.5,1055275654.5,17284685831.0,3505793432.5,18898160421.5,3674523.0,71979.5,20883.095549988084,89829201.0,-96.1164357563105,4.452066666666667,2.8352707683583778,81.85776262180984,12.622814478782724,364.43621637647215,45000.0,-0.9009688679024191,0.4338837391175582,0.0,0.0,0.0,0.0,0.0,0.0,1.0,0.0,1.0,0.0,0.0,0.0,0.0,0.0,0.0,1.0,0.0,0.0,0.0,0.0,1.0,0.0,0.0,0.0,0.0,1.0,0.0,0.0,0.0,0.0,0.0,0.0,0.0,0.0,0.0,0.0,0.0,0.0,0.0,0.0,0.0,0.0,0.0,0.0,0.0,0.0,0.0,0.0,0.0,0.0,0.0,0.0,0.0,1.0,0.0,0.0,0.0,0.0,0.0,0.0,0.0,0.0,0.0,0.0,0.0,0.0,0.0,0.0,0.0,0.0,0.0,0.0,0.0,0.0,0.0,0.0,0.0,0.0,0.0,0.0,0.0,0.0,0.0,0.0,0.0,0.0,0.0,0.0,0.0,0.0,0.0,0.0,0.0,0.0,0.0,0.0,0.0,0.0,0.0,0.0,0.0,0.0,0.0,0.0,0.0,0.0,0.0,0.0,1.0,0.0,1.0,0.0,0.0,0.0,0.0,0.0,0.0,0.0,1.0,0.0
104131,0,0.0,1.0,1.0,0.0,0.0,382500.0,595386.0,25222.5,513972.0,0.014464,59.42191780821918,-3304.0,-11377.0,-4824.0,18.0,1.0,2.0,2.0,3.0,0.6118669277207414,0.7286075704159239,0.5849900404894085,0.0773,0.0754,0.9826,0.762,0.0071,0.0,0.1724,0.1667,0.2083,0.0608,0.063,0.0696,0.0,0.0,0.063,0.0474,0.9826,0.7713,0.0,0.0,0.1379,0.1667,0.2083,0.0517,0.0551,0.0586,0.0,0.0,0.0781,0.0754,0.9826,0.7652,0.0072,0.0,0.1724,0.1667,0.2083,0.0618,0.0641,0.0709,0.0,0.0,0.0573,1.0,1.0,0.0,1.0,0.0,-2087.0,0.0,0.0,0.0,0.0,0.0,7.0,1.0,1.0,1.0,1.0,1.0,0.0,0.0,0.0,0.0,0.0,1.0,1.0,0.0,1.0,0.0,0.0,0.0,0.0,0.0,0.0,0.0,0.0,0.0,0.0,0.0,0.0,0.0,0.0,0.0,0.0,0.0,0.0,6.0,17680.5,0.0,850500.0,188977.5,0.0,0.0,0.0,0.0,-1296.5,-80.0,-433.0,-1094.0,283.0,-26.0,10.0,29963.43,0.0,0.0,1705.5,668250.0,30.0,-471.5,365243.0,-1048.0,-748.0,-358.0,-746.0,5.5,1.0,0.0999916314305848,-1.0,34.0,30.0,22.0,-24.0,0.0,0.0,32.0,44214.255,44214.255,-759.0,-718.0,6.5,1.0,0.0,,,,,,,,,,,,,,,,,,,,,8352228600.0,184497527983.5,165672670536.0,52005110905.935,1863.0,1706.0,71125.0,70896.0,9141.0,506410.0,17819.809100002294,17882.016999999112,17333.19289999802,11302.588600000092,11240.390300000096,11187.709100000053,128504.0,663258.0,4140.651300000115,4138.339500000016,3948.905900000093,13536194.805479052,-602355624.0,-922486885.0,-296708093.0,-1536199650.0416667,44043.0,30725.0,11356.473999999189,11232.41999999898,10716.543599997289,22902.950100009744,22824.735800009712,22209.931500008275,67522.24324537166,158140.41087088175,126187.16517934926,35024.60790002797,34964.78410002841,34410.218200028816,22968.515099995897,22941.566899995472,22588.330999995705,3716555.0,8301.213600000163,8405.812800000074,8129.302200000232,9823.38810000072,9938.36440000216,10298.344899999644,16478.30389999974,16663.630499999694,16260.267499999703,828.9717000001767,814.1480000000461,760.0708000000133,3916.479900000124,3899.690100000164,3732.34430000016,436717.0,431510.0,1263965.0,6429.141664002898,632363.0,625912.0,,16342.683299999802,154282.85469999068,154285.60229999025,154177.32899998722,77660.20879999633,77998.24970000656,78399.88290000657,43.5,68304003.56999996,25088989.40999998,6872485336.334996,2263209833.970001,78792837.02999994,711723.5999999999,124.0,14374.0,-22332363.5,10007585.5,-11568467.0,-12574567.0,-21.25,15669.0,0.0,765000.0,0.0,0.0,0.0,0.0,0.0,-2169.0,-343.0,-834.0,-1094.0,243671338.3049998,3471082651.845004,3910036285.6650014,55490976.17999996,3471975901.845004,249834.0,-17161368.0,3976804023.0,175062606.0,894127602.0,388864910.0,937159383.0,247502.0,3903.0,693.4782786123086,5745918.5,2047772.0,1262612.5,-4120223.0,1426828.0,102179.0,2751241575.8027525,2781649382.422677,-165624813.5,-164263783.5,2919440.5,136043.5,,,,,,,,,,,,,,,,,,,,,1468456.0,14820018.0,3234683.0,8561301.0,11615498.0,1416814.0,1060035473.5695012,801913065.6374952,72153416715.90715,21692991948.772617,583105235.7644987,5792665.7475,689.5,94245.0,-277107621.5,22019510.0,-123861810.5,-218842084.5,-2022035.0,,,,,,,,,,,,,,,,,,,,,4276034.0,2481049.5,-9009654.5,921269.0,37582.5,3736251573.95246,3660936966.13496,-260800850.0,-257486968.0,2528136.0,269383.5,3928976587.619956,33276135562.60591,36707081287.95013,1730539032.3450494,48119546412.27071,3990943.5,-247741229.5,103156519865.5,1055274606.5,17284685083.0,3505793074.5,18898159675.5,3674528.5,71980.5,20883.19554161952,89829200.0,-55.60237908617271,1.5565647058823529,15.165031222123105,901.1352388400768,23.605352363960748,1402.675308005328,382500.0,0.6234898018587336,0.7818314824680298,0.0,0.0,0.0,0.0,0.0,0.0,1.0,0.0,0.0,0.0,0.0,0.0,0.0,1.0,0.0,0.0,0.0,0.0,1.0,0.0,0.0,0.0,0.0,1.0,0.0,1.0,0.0,0.0,0.0,0.0,0.0,0.0,0.0,0.0,0.0,0.0,0.0,0.0,0.0,0.0,1.0,0.0,0.0,0.0,0.0,0.0,0.0,0.0,0.0,0.0,0.0,0.0,0.0,0.0,0.0,0.0,0.0,0.0,0.0,1.0,0.0,0.0,0.0,0.0,0.0,0.0,0.0,0.0,0.0,0.0,0.0,0.0,0.0,0.0,0.0,0.0,0.0,0.0,0.0,0.0,0.0,0.0,0.0,0.0,0.0,0.0,0.0,0.0,0.0,0.0,0.0,0.0,0.0,0.0,0.0,0.0,0.0,0.0,0.0,0.0,0.0,0.0,0.0,0.0,0.0,0.0,0.0,1.0,0.0,0.0,1.0,0.0,0.0,0.0,0.0,0.0,0.0,1.0,0.0,0.0
104132,0,0.0,0.0,0.0,1.0,0.0,112500.0,237024.0,11403.0,180000.0,0.00733,48.490410958904114,-126.0,-1140.0,-1253.0,,1.0,2.0,2.0,18.0,0.2568036887029385,0.5626979633687937,0.5656079814115492,0.1588,0.0567,0.9801,,,0.04,0.0345,0.3333,,0.0101,,0.0262,,0.0,0.1618,0.0589,0.9801,,,0.0403,0.0345,0.3333,,0.0103,,0.0273,,0.0,0.1603,0.0567,0.9801,,,0.04,0.0345,0.3333,,0.0103,,0.0266,,0.0,0.0782,1.0,0.0,0.0,0.0,0.0,-104.0,0.0,0.0,0.0,0.0,1.0,7.0,1.0,1.0,0.0,1.0,0.0,0.0,0.0,0.0,0.0,0.0,0.0,0.0,0.0,1.0,0.0,0.0,0.0,0.0,0.0,0.0,0.0,0.0,0.0,0.0,0.0,0.0,0.0,0.0,0.0,0.0,0.0,0.0,2.0,0.0,,11250.0,0.0,0.0,0.0,0.0,0.0,-264.5,-43.0,-6.0,-7.5,18.0,-4.0,9.0,13500.0,135000.0,262125.0,1212.75,180000.0,18.0,-1463.0,365243.0,-1141.0,-886.0,-721.0,-879.0,12.0,0.5,0.0500017035775127,-1.0,75.0,18.0,11.0,-40.0,0.0,0.0,71.0,13391.73,13391.73,-1237.0,-1216.0,8.0,1.0,47.0,0.0,270000.0,,0.0,,,0.0,,0.0,0.0,0.0,0.0,,0.0,,,0.0,-25.0,0.0,0.0,8352240003.0,184497765007.5,165672850536.0,52005223405.935,1863.0,1706.0,71125.0,70897.0,9141.0,506417.0,17819.967900002295,17882.177299999108,17333.354699998017,11302.645300000093,11240.447000000093,11187.768000000053,128504.0,663259.0,,,,13536243.29589001,-602355750.0,-922488138.0,-296708197.0,-1536200790.0416667,44043.0,30725.0,11356.513999999186,11232.459999998982,10716.58389999729,22902.98460000975,22824.77030000972,22209.96600000828,67522.50004906037,158140.9735688451,126187.73078733069,35024.94120002797,34965.117400028415,34410.55150002882,,,,3716573.0,8301.223700000162,8405.823100000074,8129.312500000232,,,,16478.33009999974,16663.6570999997,16260.294799999703,,,,3916.479900000124,3899.690100000164,3732.34430000016,436717.0,431510.0,,6429.1489940029,632365.0,625914.0,,16342.761499999802,154283.83479999067,154286.58239999026,154178.30909998718,,,,9.0,68383293.70499997,,6875688211.334996,2265620654.970001,78792837.02999994,711723.5999999999,124.0,14374.0,-22334906.5,10009449.5,-11568536.5,-12575670.5,-4.0,0.0,,11250.0,0.0,0.0,0.0,0.0,0.0,-332.0,-43.0,-1.0,-4.0,243740979.5849998,3472869961.845004,3912394776.1650014,55493401.67999996,3472918420.095004,249948.0,-17172821.0,3978447616.5,175239574.5,894671236.5,389043918.5,937703032.0,247596.0,3905.0,693.5782820194637,5746080.0,2048920.0,1263360.0,-4122029.0,1426828.0,102179.0,2752249209.525254,2782657016.145179,-165676065.0,-164313364.0,2919860.0,136097.0,2544718126.274983,6891970500.0,,334011220.6499997,,,144562315.99499935,,338867096.84999937,2442877966.575001,2535169796.054973,2535298893.629972,,29047.0,,,834667.0,-1482760.0,590722.0,1395.0,1468458.0,14820036.0,3234730.0,8561376.0,11615569.0,1416823.0,1060035473.5695012,,72153427965.90715,21692991948.772617,583105235.7644987,5792665.7475,689.5,94245.0,-277107886.0,22019467.0,-123861816.5,-218842092.0,-2022039.0,5926228410.64496,18736218000.0,,448254093.8699976,,,309278054.18249863,,459400091.7599993,5711271075.247535,5889486550.387498,5889729733.1325,,80925.0,,,971972.5,-1699622.5,177364.0,6755.0,4276052.0,2481060.5,-9009694.5,921269.0,37582.5,3736264965.68246,3660950357.86496,-260802087.0,-257488184.0,2528144.0,269384.5,3928990087.619956,33276270562.60591,36707343412.95013,1730540245.0950494,48119726412.27071,3990961.5,-247742692.5,103156885108.5,1055273465.5,17284684197.0,3505792353.5,18898158796.5,3674540.5,71981.0,20883.24554332309,89829199.0,-2.5984518899372846,2.10688,9.865824782951853,478.39789817387634,20.786108918705608,1007.9269637045768,112500.0,-0.9009688679024191,0.4338837391175582,0.0,0.0,0.0,0.0,0.0,0.0,1.0,0.0,0.0,0.0,0.0,0.0,0.0,1.0,0.0,0.0,0.0,0.0,1.0,0.0,0.0,0.0,1.0,0.0,0.0,1.0,0.0,0.0,0.0,0.0,0.0,0.0,0.0,0.0,0.0,0.0,0.0,0.0,1.0,0.0,0.0,0.0,0.0,0.0,0.0,0.0,0.0,0.0,0.0,0.0,0.0,0.0,0.0,0.0,0.0,0.0,0.0,0.0,0.0,0.0,0.0,0.0,0.0,0.0,0.0,0.0,0.0,0.0,0.0,0.0,0.0,0.0,0.0,0.0,0.0,0.0,0.0,0.0,0.0,0.0,0.0,1.0,0.0,0.0,0.0,0.0,0.0,0.0,0.0,0.0,0.0,0.0,0.0,0.0,0.0,0.0,0.0,0.0,0.0,0.0,0.0,0.0,0.0,0.0,0.0,0.0,0.0,0.0,0.0,0.0,0.0,1.0,0.0,0.0,0.0,0.0,0.0,0.0,1.0,0.0
104135,0,0.0,0.0,1.0,0.0,0.0,175500.0,296280.0,18256.5,225000.0,0.00702,66.91506849315068,,-9552.0,-5032.0,0.0,2.0,2.0,2.0,14.0,,0.2554164846421255,0.633031641417419,0.1845,,0.9866,0.8232,,0.3,0.2586,0.3333,,,0.1505,0.1895,0.0,,0.188,,0.9866,0.8301,,0.2417,0.2069,0.3333,,,0.1644,0.1975,0.0,,0.1863,,0.9866,0.8256,,0.3,0.2586,0.3333,,,0.1531,0.1929,0.0,,0.196,1.0,4.0,0.0,4.0,0.0,-673.0,0.0,0.0,0.0,0.0,0.0,2.0,1.0,0.0,0.0,1.0,0.0,0.0,0.0,0.0,0.0,0.0,0.0,0.0,0.0,1.0,0.0,0.0,0.0,0.0,0.0,0.0,0.0,0.0,0.0,0.0,0.0,0.0,0.0,0.0,0.0,0.0,0.0,0.0,7.0,0.0,0.0,214375.5,0.0,0.0,0.0,0.0,0.0,-1481.0,-1000.0,-742.0,-1000.0,306.0,-27.0,6.0,13405.275,81488.25,79452.0,3600.0,158798.25,24.0,-479.0,365243.0,-1081.0,-901.0,241.0,-889.0,11.0,1.0,0.0533377855691904,-1.0,30.0,24.0,15.5,-22.5,0.0,0.0,28.0,13318.875,13318.875,-447.5,-434.0,5.0,1.0,0.0,,,,,,,,,,,,,,,,,,,,,8352258259.5,184498061287.5,165673075536.0,52005398905.935,1863.0,1706.0,71125.0,70897.0,9141.0,506419.0,17820.152400002295,17882.363599999113,17333.54269999802,,,,128504.0,663261.0,,,,13536310.210958503,,-922493170.0,-296708870.0,-1536210342.0416667,44043.0,30725.0,11356.813999999187,11232.759999998982,10716.82559999729,22903.24320000975,22825.02890000972,22210.17290000828,,158141.22898532974,126188.36381897212,35025.27450002797,34965.450700028414,34410.88480002882,,,,3716587.0,,,,9823.538600000718,9938.51750000216,10298.509299999643,16478.51959999974,16663.849999999697,16260.492299999703,828.9717000001767,814.1480000000461,760.0708000000133,,,,436721.0,431514.0,1263965.0,6429.1560140029,632367.0,625916.0,,16342.957499999802,154284.82139999067,154287.56899999027,154179.29569998718,77661.03199999632,77999.07530000656,78400.71300000657,49.0,68731556.98499997,25088989.40999998,6877256670.224997,2265669254.970001,78792837.02999994,711723.5999999999,124.0,14374.0,-22346336.0,10007942.0,-11574308.0,-12581998.0,-24.0,0.0,0.0,214375.5,0.0,0.0,0.0,0.0,0.0,-1731.0,-1000.0,-957.0,-1000.0,243967980.28499985,3475914681.4200034,3915822633.1650014,55502637.25499996,3476184681.4200034,250286.0,-17186318.5,3981917425.0,175413669.0,895577119.0,389222782.0,938608972.0,247857.5,3911.0,693.7325910863681,5750754.5,2050808.0,1264540.0,-4124928.0,1426828.0,102179.0,2754941216.96275,2785233725.887675,-165759185.5,-164394998.5,2920613.5,136206.5,,,,,,,,,,,,,,,,,,,,,1468465.0,14820342.0,3234730.0,8561406.0,11615597.0,1416829.0,1060035473.5695012,801913065.6374952,72153642341.40715,21692991948.772617,583105235.7644987,5792665.7475,689.5,94245.0,-277109367.0,22018467.0,-123862558.5,-218843092.0,-2022066.0,,,,,,,,,,,,,,,,,,,,,4276076.0,2481076.0,-9009717.0,921269.0,37582.5,3736278284.55746,3660963676.73996,-260802534.5,-257488618.0,2528149.0,269385.5,3929003492.894956,33276352050.85591,36707422864.95013,1730543845.0950494,48119885210.52071,3990985.5,-247743171.5,103157250351.5,1055272384.5,17284683296.0,3505792594.5,18898157907.5,3674551.5,71982.0,20883.298881108654,89829198.0,,1.6882051282051282,9.61301454276559,643.2555265548132,16.228740448607347,1085.9472786761255,87750.0,0.6234898018587336,0.7818314824680298,0.0,0.0,0.0,0.0,0.0,0.0,1.0,0.0,0.0,1.0,0.0,0.0,0.0,0.0,0.0,0.0,0.0,0.0,1.0,0.0,1.0,0.0,0.0,0.0,0.0,1.0,0.0,0.0,0.0,0.0,0.0,0.0,0.0,0.0,0.0,0.0,0.0,0.0,0.0,0.0,0.0,0.0,0.0,0.0,0.0,0.0,0.0,0.0,0.0,0.0,0.0,0.0,0.0,0.0,0.0,0.0,0.0,0.0,0.0,0.0,0.0,0.0,0.0,0.0,0.0,0.0,0.0,0.0,0.0,0.0,0.0,0.0,0.0,0.0,0.0,0.0,0.0,0.0,0.0,0.0,0.0,0.0,0.0,0.0,0.0,0.0,0.0,0.0,0.0,0.0,0.0,0.0,0.0,0.0,0.0,0.0,0.0,0.0,0.0,0.0,0.0,0.0,0.0,0.0,0.0,1.0,0.0,0.0,0.0,0.0,1.0,0.0,0.0,0.0,0.0,0.0,0.0,1.0,0.0,0.0
104136,0,0.0,0.0,0.0,1.0,0.0,225000.0,1457734.5,81526.5,1318500.0,0.01885,54.32054794520548,-741.0,-8191.0,-3362.0,,2.0,2.0,2.0,11.0,,0.6152664780511079,0.7062051096536562,,,,,,,,,,,,,,,,,,,,,,,,,,,,,,,,,,,,,,,,,,,,,4.0,0.0,4.0,0.0,-1153.0,0.0,0.0,0.0,0.0,0.0,1.0,1.0,1.0,0.0,1.0,0.0,0.0,0.0,0.0,0.0,0.0,0.0,0.0,0.0,1.0,0.0,0.0,0.0,0.0,0.0,0.0,0.0,0.0,0.0,0.0,0.0,0.0,0.0,0.0,0.0,0.0,0.0,0.0,13.0,0.0,0.0,60778.8,0.0,0.0,0.0,0.0,0.0,-2496.0,-1985.0,-898.0,-2047.5,978.0,-40.0,4.0,5540.04,27738.0,27119.25,0.0,27738.0,6.0,-195.5,365243.0,-165.5,182551.0,-15.5,182554.0,12.0,0.0,0.0,1405.5,18.0,6.0,4.0,-9.5,0.0,0.0,16.0,6358.905,6358.905,-281.0,-276.0,3.0,1.0,0.0,,,,,,,,,,,,,,,,,,,,,8352339786.0,184499519022.0,165674394036.0,52005623905.935,1863.0,1706.0,71125.0,70897.0,9141.0,506420.0,,,,,,,128504.0,663263.0,,,,13536364.531506447,-602356491.0,-922496532.0,-296710023.0,-1536218533.0416667,44043.0,30725.0,,,,,,,,158141.84425180778,126189.07002408175,,,,,,,3716598.0,,,,,,,,,,,,,,,,436725.0,431518.0,,6429.174864002899,632369.0,625918.0,,,,,,,,,83.0,68754944.96999997,25088989.40999998,6878357260.919996,2265901155.360001,78854615.63999994,711723.5999999999,124.0,14374.0,-22364880.0,10002824.0,-11580976.0,-12597090.0,-41.0,0.0,0.0,60778.8,0.0,0.0,0.0,0.0,0.0,-2619.0,-1985.0,-898.0,-2241.0,243995509.73249972,3476441874.4200034,3916410326.4150014,55506237.25499996,3476441874.4200034,250307.0,-17189799.5,3983195775.5,175411330.5,895942291.5,389221264.5,938974147.5,247915.0,3911.0,693.7859288719372,5756567.5,2051087.0,1264730.0,-4125402.0,1426828.0,102179.0,2755182771.0227504,2785475279.947675,-165772070.5,-164407725.5,2920731.0,136229.5,,,,,,,,,,,,,,,,,,,,,1468478.0,14821320.0,3234730.0,8561424.0,11615613.0,1416833.0,1060035473.5695012,801913065.6374952,72153703120.20715,21692991948.772617,583105235.7644987,5792665.7475,689.5,94245.0,-277111863.0,22016482.0,-123863456.5,-218845139.5,-2022106.0,,,,,,,,,,,,,,,,,,,,,4276082.0,2481080.0,-9009726.5,921269.0,37582.5,3736284643.462461,3660970035.64496,-260802815.5,-257488894.0,2528152.0,269386.5,3929009032.934956,33276379788.85591,36707449984.20013,1730543845.0950494,48119912948.52071,3990991.5,-247743367.0,103157615594.5,1055272219.0,17284865847.0,3505792579.0,18898340461.5,3674563.5,71982.0,20883.298881108654,89830603.5,-13.641246784687548,6.47882,2.759838825412596,149.91595723686447,17.880498978859638,971.2785020653424,112500.0,0.6234898018587336,0.7818314824680298,0.0,0.0,0.0,0.0,0.0,0.0,1.0,0.0,0.0,0.0,0.0,0.0,0.0,1.0,0.0,0.0,0.0,0.0,1.0,0.0,1.0,0.0,0.0,0.0,0.0,1.0,0.0,0.0,0.0,0.0,0.0,0.0,0.0,0.0,0.0,0.0,0.0,0.0,0.0,0.0,0.0,0.0,0.0,0.0,0.0,0.0,0.0,0.0,0.0,0.0,0.0,0.0,0.0,1.0,0.0,0.0,0.0,0.0,0.0,0.0,0.0,0.0,0.0,0.0,0.0,0.0,0.0,0.0,0.0,0.0,0.0,0.0,0.0,0.0,0.0,0.0,0.0,0.0,0.0,0.0,0.0,0.0,0.0,0.0,0.0,0.0,0.0,0.0,0.0,0.0,0.0,0.0,0.0,0.0,0.0,0.0,0.0,0.0,0.0,0.0,0.0,0.0,0.0,0.0,0.0,0.0,0.0,0.0,0.0,0.0,0.0,0.0,0.0,0.0,0.0,0.0,0.0,0.0,0.0,0.0
104149,0,0.0,0.0,1.0,1.0,1.0,247500.0,420588.0,32679.0,360000.0,0.020713,43.97534246575343,-2153.0,-8421.0,-4278.0,15.0,3.0,3.0,3.0,7.0,0.5548578846212892,0.272009866271558,0.6006575372857061,0.101,0.1085,0.9796,0.7212,0.0455,0.0,0.2069,0.1667,0.2083,0.0404,0.0815,0.0923,0.0039,0.0079,0.1029,0.1126,0.9796,0.7321,0.0459,0.0,0.2069,0.1667,0.2083,0.0413,0.0891,0.0962,0.0039,0.0083,0.102,0.1085,0.9796,0.7249,0.0458,0.0,0.2069,0.1667,0.2083,0.0411,0.0829,0.094,0.0039,0.008,0.0743,1.0,3.0,1.0,3.0,0.0,-337.0,0.0,0.0,0.0,0.0,0.0,2.0,1.0,1.0,0.0,1.0,0.0,0.0,0.0,0.0,0.0,0.0,0.0,0.0,0.0,1.0,0.0,0.0,0.0,0.0,0.0,0.0,0.0,0.0,0.0,0.0,0.0,0.0,0.0,0.0,0.0,0.0,0.0,0.0,8.0,7974.0,22.5,155785.5,0.0,0.0,0.0,0.0,0.0,-1256.0,-773.5,-190.0,-1163.0,343.0,-21.0,9.0,23635.845,283500.0,305955.0,2250.0,434250.0,27.0,-1161.0,365243.0,-1595.5,-1415.5,-1295.5,-1402.5,7.0,0.0,0.1020703757348556,-1.0,36.0,10.0,5.5,-49.0,0.0,0.0,33.0,4812.57,4812.57,-1471.0,-1457.0,5.0,1.0,0.0,,,,,,,,,,,,,,,,,,,,,8352372465.0,184499939610.0,165674754036.0,52005871405.935,1863.0,1706.0,71125.0,70897.0,9141.0,506422.0,17820.253400002293,17882.465599999112,17333.645599998017,11302.753800000091,11240.555500000091,11187.880600000051,128505.0,663266.0,4140.696800000114,4138.385300000015,3948.9518000000935,13536408.506848916,-602358644.0,-922500810.0,-296710360.0,-1536226954.0416667,44044.0,30725.0,11356.813999999187,11232.759999998982,10716.82559999729,22903.45010000975,22825.235800009723,22210.37980000828,67523.05490694499,158142.1162616741,126189.67068161904,35025.44120002797,34965.617400028415,34411.05150002882,22968.72339999589,22941.775199995467,22588.539299995704,3716605.0,8301.264100000162,8405.864200000075,8129.353800000232,9823.62010000072,9938.60040000216,10298.598399999642,16478.61189999974,16663.943999999698,16260.588499999703,828.9756000001767,814.1519000000461,760.0747000000133,3916.487800000124,3899.698100000163,3732.35260000016,436728.0,431521.0,1263980.0,6429.195577002899,632372.0,625921.0,,16343.031799999802,154285.80099999064,154288.54859999026,154180.27529998714,77661.75319999632,77999.80020000656,78401.44510000657,42.0,69083314.46999997,25101841.40999998,6926066721.764997,2282439125.4750004,78937605.76499994,784029.5999999999,124.0,14385.0,-22457271.0,10059642.5,-11621867.0,-12647489.0,-20.5,7974.0,0.0,162000.0,0.0,0.0,0.0,0.0,0.0,-1792.0,-693.0,-328.0,-1163.0,244605820.9049998,3484386475.9200034,3925103910.1650014,55641525.25499996,3484397498.6700034,251012.0,-17240015.0,3997437647.5,175733680.0,897734759.0,389559774.0,940766916.0,248545.0,3924.0,696.5467421946787,5772777.0,2055326.0,1267343.0,-4136819.5,1426833.0,102184.0,2761519989.555236,2791490989.815165,-166202707.0,-164833182.0,2926619.0,136548.0,,,,,,,,,,,,,,,,,,,,,1468486.0,14821663.0,3234730.0,8561460.0,11615646.0,1416842.0,1060043447.5695012,801913088.1374952,72153858905.70715,21692991948.772617,583105235.7644987,5792665.7475,689.5,94245.0,-277113119.0,22015708.5,-123863646.5,-218846302.5,-2022127.0,,,,,,,,,,,,,,,,,,,,,4276092.0,2481085.5,-9009775.5,921269.0,37582.5,3736289456.032461,3660974848.214961,-260804286.5,-257490351.0,2528157.0,269387.5,3929032668.779955,33276663288.85591,36707755939.20013,1730546095.0950494,48120347198.52071,3991018.5,-247744528.0,103157980837.5,1055270623.5,17284864431.5,3505791283.5,18898339059.0,3674570.5,71982.0,20883.4009514844,89830602.5,-48.95925487508566,1.6993454545454545,7.573671164968327,333.05478320248403,12.870283668410904,565.9751319497631,82500.0,-0.2225209339563143,0.9749279121818236,0.0,0.0,0.0,0.0,0.0,0.0,1.0,0.0,0.0,0.0,0.0,0.0,0.0,1.0,0.0,0.0,0.0,0.0,1.0,0.0,1.0,0.0,0.0,0.0,0.0,1.0,0.0,0.0,0.0,0.0,0.0,0.0,1.0,0.0,0.0,0.0,0.0,0.0,0.0,0.0,0.0,0.0,0.0,0.0,0.0,0.0,0.0,0.0,0.0,0.0,0.0,0.0,0.0,0.0,0.0,0.0,0.0,0.0,0.0,0.0,0.0,0.0,0.0,0.0,0.0,0.0,0.0,0.0,0.0,0.0,0.0,0.0,0.0,0.0,0.0,0.0,0.0,0.0,1.0,0.0,0.0,0.0,0.0,0.0,0.0,0.0,0.0,0.0,0.0,0.0,0.0,0.0,0.0,0.0,0.0,0.0,0.0,0.0,0.0,0.0,0.0,0.0,0.0,0.0,0.0,0.0,0.0,0.0,1.0,0.0,1.0,0.0,0.0,0.0,0.0,0.0,0.0,1.0,0.0,0.0
104150,0,0.0,0.0,0.0,0.0,0.0,112500.0,573408.0,29277.0,495000.0,0.019101,50.03561643835617,,-841.0,-1821.0,,1.0,2.0,2.0,10.0,,0.5463588319964954,0.6279908192952864,,,,,,,,,,,,,,,,,,,,,,,,,,,,,,,,,,,,,,,,,,,,,0.0,0.0,0.0,0.0,-842.0,0.0,0.0,0.0,0.0,0.0,3.0,1.0,0.0,0.0,1.0,0.0,0.0,0.0,0.0,0.0,0.0,0.0,0.0,0.0,1.0,0.0,0.0,0.0,0.0,0.0,0.0,0.0,0.0,0.0,0.0,0.0,0.0,0.0,0.0,0.0,0.0,0.0,0.0,4.0,5670.0,,139567.5,0.0,0.0,0.0,0.0,0.0,-941.0,-409.0,-14.0,-736.0,115.0,-17.0,1.0,12854.16,107406.0,116856.0,0.0,107406.0,10.0,-619.0,365243.0,-588.0,-318.0,-318.0,-305.0,10.0,0.0,0.0,15.0,11.0,10.0,5.0,-15.0,0.0,0.0,16.0,12854.16,11450.34,-421.5,-423.0,6.5,1.0,0.0,,,,,,,,,,,,,,,,,,,,,8352401742.0,184500513018.0,165675249036.0,52005983905.935,1863.0,1706.0,71125.0,70897.0,9141.0,506425.0,,,,,,,128505.0,663267.0,,,,13536458.542465352,,-922502631.0,-296711202.0,-1536227795.0416667,44044.0,30725.0,,,,,,,,158142.66262050607,126190.29867243837,,,,,,,3716615.0,,,,,,,,,,,,,,,,436728.0,431521.0,,6429.214678002899,632374.0,625923.0,,,,,,,,,31.5,69105184.46999997,,6927084204.614996,2282524814.4750004,79099605.76499994,784029.5999999999,124.0,14385.0,-22463813.0,10056890.5,-11623478.0,-12651436.0,-15.25,0.0,,103635.0,0.0,0.0,0.0,0.0,0.0,-1042.0,-708.0,-14.0,-736.0,244676619.26999977,3485792037.4200034,3926728927.6650014,55643145.25499996,3485792037.4200034,251146.0,-17246218.0,3998350755.0,175730678.0,897732342.0,389557477.0,940764535.0,248593.0,3924.0,696.6370815327599,5772830.0,2055561.0,1267438.0,-4137783.0,1426841.0,102192.0,2761687228.4777336,2791608792.3676643,-166230335.5,-164860515.0,2926761.0,136573.5,,,,,,,,,,,,,,,,,,,,,1468490.0,14821778.0,3234730.0,8561471.0,11615662.0,1416843.0,1060049117.5695012,,72153998473.20715,21692991948.772617,583105235.7644987,5792665.7475,689.5,94245.0,-277114060.0,22015299.5,-123863660.5,-218847038.5,-2022144.0,,,,,,,,,,,,,,,,,,,,,4276102.0,2481090.5,-9009790.5,921269.0,37582.5,3736302310.192461,3660986298.5549607,-260804708.0,-257490774.0,2528163.5,269388.5,3929045522.9399543,33276770694.85591,36707872795.20013,1730546095.0950494,48120454604.52071,3991028.5,-247745147.0,103158346080.5,1055270035.5,17284864113.5,3505790965.5,18898338754.0,3674580.5,71982.0,20883.4009514844,89830617.5,,5.09696,3.842606824469721,192.26720119257672,19.585613280049184,979.9782337905158,112500.0,-0.2225209339563143,0.9749279121818236,0.0,0.0,0.0,0.0,0.0,0.0,1.0,0.0,0.0,1.0,0.0,0.0,0.0,0.0,0.0,0.0,0.0,0.0,1.0,0.0,0.0,1.0,0.0,0.0,0.0,1.0,0.0,0.0,0.0,0.0,0.0,0.0,0.0,0.0,0.0,0.0,0.0,0.0,0.0,0.0,0.0,0.0,0.0,0.0,0.0,0.0,0.0,0.0,0.0,0.0,0.0,0.0,0.0,0.0,0.0,0.0,0.0,0.0,0.0,0.0,0.0,0.0,0.0,0.0,0.0,0.0,0.0,0.0,0.0,0.0,0.0,0.0,0.0,0.0,0.0,0.0,0.0,0.0,0.0,0.0,0.0,0.0,0.0,0.0,0.0,0.0,0.0,0.0,0.0,0.0,0.0,0.0,0.0,0.0,0.0,0.0,0.0,0.0,0.0,0.0,0.0,0.0,0.0,0.0,0.0,1.0,0.0,0.0,0.0,0.0,0.0,0.0,0.0,0.0,0.0,0.0,0.0,0.0,0.0,0.0
104156,1,0.0,0.0,0.0,1.0,1.0,157500.0,550980.0,43659.0,450000.0,0.04622,45.94794520547945,-94.0,-239.0,-251.0,,3.0,1.0,1.0,15.0,0.457435556984406,0.5993044589673225,0.1027820144199289,0.1237,0.1185,0.9781,0.7008,0.0147,0.0,0.2069,0.1667,0.0417,0.0611,0.1009,0.1015,0.0,0.0,0.1261,0.1229,0.9782,0.7125,0.0149,0.0,0.2069,0.1667,0.0417,0.0624,0.1102,0.1058,0.0,0.0,0.1249,0.1185,0.9781,0.7048,0.0148,0.0,0.2069,0.1667,0.0417,0.0621,0.1026,0.1033,0.0,0.0,0.0798,1.0,0.0,0.0,0.0,0.0,-235.0,0.0,0.0,0.0,0.0,0.0,0.0,1.0,1.0,0.0,1.0,0.0,0.0,0.0,0.0,0.0,0.0,1.0,1.0,0.0,1.0,0.0,0.0,0.0,0.0,0.0,0.0,0.0,0.0,0.0,0.0,0.0,0.0,0.0,0.0,0.0,0.0,0.0,0.0,2.0,27000.0,0.0,177300.0,129663.0,5335.7175,0.0,0.0,0.0,-421.5,-247.0,-134.0,-247.0,29.0,-7.0,2.0,8653.7025,89325.0,96381.0,0.0,89325.0,6.0,-235.0,182509.5,-198.0,365243.0,182684.0,365243.0,15.0,0.5,0.0,27.5,7.0,11.0,8.0,-5.0,0.0,0.0,23.0,2302.605,2302.605,-107.0,-107.0,6.0,0.0,7.0,66959.82,76500.0,0.0,5712.66,0.0,5712.66,3390.48,3526.83,3510.0,65547.18,66959.82,66959.82,0.0,3.0,0.0,3.0,3.0,-5.0,0.0,0.0,8352445401.0,184501063998.0,165675699036.0,52006141405.935,1863.0,1706.0,71125.0,70897.0,9141.0,506425.0,17820.377100002293,17882.590499999107,17333.771699998022,11302.872300000094,11240.674000000095,11188.003500000052,128506.0,663270.0,4140.711500000115,4138.400100000015,3948.966700000093,13536504.49041056,-602358738.0,-922502882.0,-296711437.0,-1536228034.0416667,44044.0,30725.0,11356.813999999187,11232.759999998982,10716.82559999729,22903.65700000976,22825.44270000972,22210.58670000828,67523.51234250197,158143.26192496505,126190.40145445276,35025.60790002797,34965.78410002841,34411.218200028816,22968.765099995897,22941.816899995472,22588.580999995705,3716630.0,8301.325200000163,8405.926300000074,8129.416200000232,9823.721000000718,9938.70300000216,10298.708599999642,16478.713399999742,16664.047299999696,16260.694299999705,828.9756000001767,814.1519000000461,760.0747000000133,3916.487800000124,3899.698100000163,3732.35260000016,436728.0,431521.0,,6429.260898002899,632375.0,625924.0,,16343.111599999802,154286.77909999067,154289.52669999027,154181.25349998722,77662.45399999633,78000.50500000657,78402.15760000657,14.5,69231139.46999997,25129717.46999998,6935608188.1799965,2287068949.1250005,79725320.09999995,784029.5999999999,124.0,14385.0,-22496734.0,10042178.0,-11643075.5,-12670529.0,-6.75,27000.0,0.0,84600.0,0.0,0.0,0.0,0.0,0.0,-612.0,-247.0,-241.0,-247.0,244787326.42499977,3486829139.6850038,3927961671.1650014,55649986.01999996,3486829139.6850038,251314.0,-17259817.5,4002733198.0,175720031.5,899003610.5,390099426.5,942401419.5,248869.5,3926.0,696.7882315215975,5785134.0,2057424.0,1268485.0,-4141178.0,1426841.0,102192.0,2762909811.2702327,2792798541.900164,-166328851.0,-164957061.0,2927716.0,136715.0,2555698490.729985,6915523500.0,215297087.085,334498990.4099997,11793509.1,107073144.17999992,145234622.11499935,368374512.95999765,339716081.42999953,2453461199.370003,2546148604.5899744,2546277702.1649733,11105.0,29105.0,156.0,17844.0,838296.0,-1487352.0,590723.0,1396.0,1468492.0,14821807.0,3234737.0,8561478.0,11615685.0,1416845.0,1060076117.5695012,801913088.1374952,72154175773.20715,21693121611.772617,583110571.4819987,5792665.7475,689.5,94245.0,-277114481.5,22015052.5,-123863794.5,-218847285.5,-2022151.0,5926295370.46496,18736294500.0,198873957.825,448259806.5299977,1948107.735,256962921.5700008,309281444.66249865,636922616.8724978,459403601.7599993,5711336622.427534,5889553510.207498,5889796692.9524975,13392.5,80928.0,44.0,70429.5,971975.5,-1699627.5,177364.0,6755.0,4276113.0,2481098.5,-9009795.5,921269.0,37582.5,3736304612.797461,3660988601.1599607,-260804815.0,-257490881.0,2528169.5,269388.5,3929054176.642455,33276860019.85591,36707969176.20013,1730546095.0950494,48120543929.52071,3991034.5,-247745382.0,103158528590.0,1055269837.5,17285229356.5,3505973649.5,18898703997.0,3674595.5,71982.5,20883.4009514844,89830645.0,-2.045793333730845,3.498285714285714,3.6075036075036073,165.7573780861452,12.620078334364049,579.8666677962177,52500.0,-0.2225209339563143,0.9749279121818236,0.0,1.0,0.0,0.0,0.0,0.0,0.0,0.0,1.0,0.0,0.0,0.0,0.0,0.0,0.0,0.0,0.0,0.0,1.0,1.0,0.0,0.0,0.0,0.0,0.0,1.0,0.0,0.0,0.0,0.0,0.0,0.0,0.0,0.0,0.0,0.0,0.0,0.0,0.0,0.0,0.0,0.0,0.0,0.0,1.0,0.0,0.0,0.0,0.0,0.0,0.0,0.0,0.0,0.0,0.0,0.0,0.0,0.0,0.0,0.0,0.0,0.0,0.0,0.0,0.0,0.0,0.0,0.0,0.0,0.0,0.0,0.0,0.0,0.0,0.0,0.0,0.0,0.0,0.0,0.0,0.0,0.0,0.0,0.0,0.0,0.0,0.0,0.0,0.0,0.0,1.0,0.0,0.0,0.0,0.0,0.0,0.0,0.0,0.0,0.0,0.0,0.0,0.0,0.0,0.0,0.0,0.0,0.0,1.0,0.0,1.0,0.0,0.0,0.0,0.0,0.0,0.0,1.0,0.0,0.0
104165,0,0.0,0.0,0.0,1.0,0.0,112500.0,1024740.0,52452.0,900000.0,0.018029,46.85753424657535,-4112.0,-8490.0,-652.0,,2.0,3.0,3.0,6.0,0.473178574218263,0.122711118976778,0.6380435278721609,0.0845,,0.9886,,,0.12,0.1034,0.3333,,,,0.1035,,,0.0861,,0.9886,,,0.1208,0.1034,0.3333,,,,0.1079,,,0.0854,,0.9886,,,0.12,0.1034,0.3333,,,,0.1054,,,0.0814,1.0,18.0,0.0,18.0,0.0,0.0,0.0,0.0,0.0,0.0,0.0,2.0,1.0,1.0,0.0,1.0,0.0,0.0,0.0,0.0,0.0,0.0,0.0,0.0,0.0,1.0,0.0,0.0,0.0,0.0,0.0,0.0,0.0,0.0,0.0,0.0,0.0,0.0,0.0,0.0,0.0,0.0,0.0,0.0,3.0,15086.25,,225000.0,0.0,0.0,0.0,0.0,0.0,-995.0,-630.0,-575.0,-1177.0,135.0,-22.0,3.0,3776.7825,25537.5,22981.5,1278.0,36393.75,11.0,-648.0,365243.0,-720.5,-525.5,-420.5,-518.5,9.0,0.0,0.0545025230276331,513.0,18.0,10.0,6.5,-21.5,0.0,0.0,16.0,5197.5,5197.5,-625.0,-615.5,4.0,1.0,0.0,,,,,,,,,,,,,,,,,,,,,8352497853.0,184502088738.0,165676599036.0,52006253905.935,1863.0,1706.0,71125.0,70897.0,9141.0,506427.0,17820.461600002294,17882.67589999911,17333.857799998026,,,,128506.0,663272.0,,,,13536551.347944804,-602362850.0,-922503534.0,-296711437.0,-1536236524.0416667,44044.0,30725.0,11356.933999999186,11232.879999998982,10716.94639999729,22903.76040000976,22825.54610000972,22210.69010000828,67523.98552107619,158143.38463608405,126191.03949798064,35025.94120002797,34966.117400028415,34411.55150002882,,,,3716636.0,,,,,,,16478.816899999743,16664.152699999693,16260.802199999704,,,,,,,436746.0,431539.0,,6429.278927002899,632378.0,625927.0,,16343.1929999998,154287.76769999068,154290.51529999025,154182.2420999872,,,,33.0,69521398.46999997,,6951209356.304997,2296435392.99,79777428.20999995,784146.5999999999,125.0,14398.0,-22549735.0,10098606.0,-11671046.0,-12700605.5,-16.0,23796.0,,244395.0,0.0,0.0,0.0,0.0,0.0,-2094.0,-1729.0,-1727.0,-1729.0,245154214.4174997,3492631646.6850038,3934731588.1650014,55688911.01999996,3492644415.4350038,251992.0,-17293729.0,4009854865.5,176063593.5,901362272.5,391000702.5,944760163.0,249351.0,3935.0,697.3794956266063,5791801.0,2061509.0,1270947.5,-4149706.0,1426983.0,102195.0,2765360642.6702285,2795094697.680157,-166611151.5,-165237525.0,2930468.0,136954.5,,,,,,,,,,,,,,,,,,,,,1468495.0,14821942.0,3234737.0,8561496.0,11615701.0,1416848.0,1060091203.8195012,,72154400773.20715,21693121611.772617,583110571.4819987,5792665.7475,689.5,94245.0,-277115476.5,22014422.5,-123864369.5,-218848462.5,-2022173.0,,,,,,,,,,,,,,,,,,,,,4276123.0,2481105.0,-9009817.0,921269.0,37582.5,3736309810.297461,3660993798.6599607,-260805440.0,-257491496.5,2528173.5,269389.5,3929057953.424955,33276885557.35591,36707992157.70013,1730547373.0950494,48120580323.27071,3991045.5,-247746030.0,103158893833.0,1055269117.0,17285228831.0,3505973229.0,18898703478.5,3674604.5,71982.5,20883.455454007424,89831158.0,-87.75536455592588,9.1088,2.144818119423473,100.5008884835607,19.53671928620453,915.4424930190576,56250.0,-0.9009688679024191,0.4338837391175582,0.0,0.0,0.0,0.0,0.0,0.0,1.0,0.0,0.0,0.0,0.0,0.0,0.0,1.0,0.0,0.0,0.0,0.0,1.0,0.0,1.0,0.0,0.0,0.0,0.0,1.0,0.0,0.0,0.0,0.0,0.0,0.0,0.0,0.0,0.0,0.0,0.0,0.0,1.0,0.0,0.0,0.0,0.0,0.0,0.0,0.0,0.0,0.0,0.0,0.0,0.0,0.0,0.0,0.0,0.0,0.0,0.0,0.0,0.0,0.0,0.0,0.0,0.0,0.0,0.0,0.0,0.0,0.0,0.0,0.0,0.0,0.0,0.0,0.0,0.0,0.0,0.0,0.0,0.0,0.0,0.0,0.0,0.0,0.0,0.0,0.0,0.0,0.0,0.0,0.0,1.0,0.0,0.0,0.0,0.0,0.0,0.0,0.0,0.0,0.0,0.0,0.0,0.0,0.0,0.0,0.0,0.0,0.0,0.0,0.0,1.0,0.0,0.0,0.0,0.0,0.0,0.0,1.0,0.0,0.0
104175,0,0.0,0.0,0.0,1.0,1.0,103500.0,119893.5,14355.0,103500.0,0.018029,41.27945205479452,-187.0,-4542.0,-4260.0,,3.0,3.0,3.0,10.0,0.4800670314129638,0.6411683617776793,0.5620604831738043,0.1031,0.0968,,,,0.0,0.2069,0.1667,,,,0.0938,,0.0,0.105,0.1005,,,,0.0,0.2069,0.1667,,,,0.0977,,0.0,0.1041,0.0968,,,,0.0,0.2069,0.1667,,,,0.0955,,0.0,0.0738,1.0,0.0,0.0,0.0,0.0,-364.0,0.0,0.0,0.0,0.0,1.0,0.0,1.0,1.0,0.0,1.0,0.0,0.0,0.0,0.0,0.0,0.0,0.0,0.0,0.0,1.0,0.0,0.0,0.0,0.0,0.0,0.0,0.0,0.0,0.0,0.0,0.0,0.0,0.0,0.0,0.0,0.0,0.0,0.0,3.0,10910.25,,145395.0,143014.5,0.0,0.0,0.0,0.0,-1777.0,-1412.0,-1597.0,-1812.0,171.0,-28.0,1.0,11991.375,97035.525,105576.525,0.0,97035.525,10.0,-364.0,365243.0,-322.0,-82.0,-52.0,-76.0,12.0,0.0,0.0,24.0,9.0,10.0,6.0,-8.0,0.0,0.0,9.0,11991.375,11991.375,-225.0,-202.0,5.0,1.0,0.0,,,,,,,,,,,,,,,,,,,,,8352512208.0,184502208631.5,165676702536.0,52006357405.935,1863.0,1706.0,71125.0,70898.0,9141.0,506427.0,17820.564700002295,17882.779999999108,17333.962799998022,11302.969100000091,11240.770800000091,11188.104000000054,128507.0,663275.0,,,,13536592.62739686,-602363037.0,-922507794.0,-296711801.0,-1536241066.0416667,44044.0,30725.0,11356.933999999186,11232.879999998982,10716.94639999729,22903.96730000976,22825.75300000972,22210.89700000828,67524.4655881076,158144.02580444582,126191.6015584638,35026.10790002797,34966.28410002841,34411.718200028816,,,,3716646.0,,,,,,,16478.910699999742,16664.248199999696,16260.899899999704,,,,3916.487800000124,3899.698100000163,3732.35260000016,436746.0,431539.0,,6429.2969560029,632381.0,625930.0,,16343.2667999998,,,,,,,59.0,69548031.71999997,,6964009795.485,2300324817.33,79777428.20999995,784146.5999999999,125.0,14398.0,-22599950.0,10106642.0,-11699053.0,-12731639.5,-29.0,7650.0,,145395.0,0.0,0.0,0.0,0.0,0.0,-1777.0,-1412.0,-1597.0,-2025.0,245548431.4499997,3498629842.7100034,3941062122.6900015,55876610.51999996,3498629842.7100034,252380.0,-17328340.0,4018072833.0,176035075.0,902800147.0,390982549.0,946198170.0,249781.0,3942.0,699.6978553742058,5808316.0,2064963.0,1273172.0,-4158698.0,1427038.0,102206.0,2771124373.305234,2801354800.770163,-166898347.0,-165522610.0,2932116.0,137364.0,,,,,,,,,,,,,,,,,,,,,1468498.0,14822113.0,3234737.0,8561505.0,11615710.0,1416849.0,1060102114.0695012,,72154546168.20715,21693264626.272617,583110571.4819987,5792665.7475,689.5,94245.0,-277117253.5,22013010.5,-123865966.5,-218850274.5,-2022201.0,,,,,,,,,,,,,,,,,,,,,4276133.0,2481111.0,-9009825.0,921269.0,37582.5,3736321801.672461,3661005790.0349607,-260805665.0,-257491698.5,2528178.5,269390.5,3929069944.799955,33276982592.88092,36708097734.225136,1730547373.0950494,48120677358.79572,3991055.5,-247746394.0,103159259076.0,1055268795.0,17285228749.0,3505973177.0,18898703402.5,3674616.5,71982.5,20883.455454007424,89831182.0,-4.530098891617444,1.158391304347826,7.210031347962383,297.62614334177863,8.352037617554858,344.767536393696,34500.0,-0.2225209339563146,-0.9749279121818236,0.0,0.0,0.0,0.0,0.0,0.0,1.0,0.0,0.0,0.0,0.0,0.0,0.0,1.0,0.0,1.0,0.0,0.0,0.0,1.0,0.0,0.0,0.0,0.0,0.0,1.0,0.0,0.0,0.0,0.0,0.0,0.0,0.0,0.0,0.0,0.0,0.0,0.0,1.0,0.0,0.0,0.0,0.0,0.0,0.0,0.0,0.0,0.0,0.0,0.0,0.0,0.0,0.0,0.0,0.0,0.0,0.0,0.0,0.0,0.0,0.0,0.0,0.0,0.0,0.0,0.0,0.0,0.0,0.0,1.0,0.0,0.0,0.0,0.0,0.0,0.0,0.0,0.0,0.0,0.0,0.0,0.0,0.0,0.0,0.0,0.0,0.0,0.0,0.0,0.0,0.0,0.0,0.0,0.0,0.0,0.0,0.0,0.0,0.0,0.0,0.0,0.0,0.0,0.0,0.0,0.0,0.0,0.0,0.0,0.0,1.0,0.0,0.0,0.0,0.0,0.0,0.0,1.0,0.0,0.0
104179,0,0.0,0.0,0.0,0.0,0.0,202500.0,945000.0,54882.0,945000.0,0.018029,51.30684931506849,-4315.0,-9943.0,-2260.0,,1.0,3.0,3.0,8.0,,0.4459387020083136,,0.1546,,0.9737,,,,0.1724,0.1667,,,,0.0533,,0.0269,0.1576,,0.9737,,,,0.1724,0.1667,,,,0.0555,,0.0284,0.1561,,0.9737,,,,0.1724,0.1667,,,,0.0542,,0.0274,0.0478,1.0,0.0,0.0,0.0,0.0,-534.0,,,,,,,1.0,1.0,1.0,1.0,0.0,0.0,0.0,0.0,0.0,0.0,0.0,0.0,0.0,1.0,0.0,0.0,0.0,0.0,0.0,0.0,0.0,0.0,0.0,0.0,0.0,0.0,0.0,0.0,0.0,0.0,0.0,0.0,0.0,,,,,,,,,,,,,0.0,,3.0,19956.555,0.0,0.0,0.0,184203.0,12.0,-384.0,365243.0,-503.0,-353.0,-173.0,-351.0,9.0,0.0,0.0,-1.0,7.0,12.0,9.0,-14.0,0.0,0.0,6.0,19956.555,19956.555,-435.5,-428.0,3.5,1.0,0.0,,,,,,,,,,,,,,,,,,,,,8352567090.0,184503153631.5,165677647536.0,52006559905.935,,,,,,,17820.719300002296,17882.936099999108,17334.120399998017,,,,128507.0,663276.0,,,,13536643.934246177,-602367352.0,-922510054.0,-296712335.0,-1536251009.0416667,44044.0,30725.0,,,,22904.13970000976,22825.92540000972,22211.06940000828,,158144.47174314782,,35026.274600027966,34966.45080002841,34411.884900028825,,,,3716654.0,,,,,,,16478.96399999974,16664.302399999695,16260.955399999704,,,,3916.514700000124,3899.725500000163,3732.38100000016,436746.0,431539.0,,6429.314985002898,632384.0,625933.0,,16343.3145999998,154288.74139999071,154291.48899999025,154183.2157999872,,,,,,,,,,,,,,,,,,,,,,,,,,,,,,245731112.32499972,3501515770.290004,3944342037.6900015,55876611.59999996,3501515770.290004,252572.0,-17335128.0,4020994777.0,176395881.0,903893029.0,391346205.0,947291078.0,249911.0,3946.0,699.6978713267683,5813791.0,2066343.0,1274069.0,-4160046.0,1427038.0,102206.0,2772519359.332734,2802749786.797664,-166934463.0,-165558222.5,2932623.0,137427.5,,,,,,,,,,,,,,,,,,,,,1468498.0,14822113.0,3234737.0,8561512.0,11615716.0,1416852.0,,,,,,,,,,,,,,,,,,,,,,,,,,,,,,,,,,4276145.0,2481120.0,-9009839.0,921269.0,37582.5,3736341758.227461,3661025746.589961,-260806100.5,-257492126.5,2528182.0,269391.5,3929089901.3549542,33276982592.88092,36708097734.225136,1730547373.0950494,48120861561.79572,3991067.5,-247746778.0,103159624319.0,1055268292.0,17285228396.0,3505973004.0,18898703051.5,3674625.5,71982.5,20883.455454007424,89831181.0,-84.10183158007156,4.666666666666667,3.689734339127583,189.30864375025268,17.218760249262054,883.4403375011792,202500.0,-0.9009688679024191,-0.433883739117558,0.0,0.0,0.0,0.0,0.0,0.0,1.0,0.0,0.0,0.0,0.0,0.0,0.0,1.0,0.0,0.0,0.0,0.0,1.0,0.0,0.0,0.0,1.0,0.0,0.0,1.0,0.0,0.0,0.0,0.0,0.0,0.0,0.0,0.0,0.0,0.0,0.0,0.0,0.0,0.0,0.0,0.0,0.0,0.0,1.0,0.0,0.0,0.0,0.0,0.0,0.0,0.0,0.0,0.0,0.0,0.0,0.0,0.0,0.0,0.0,0.0,0.0,0.0,0.0,0.0,0.0,0.0,0.0,0.0,0.0,0.0,0.0,0.0,0.0,0.0,0.0,0.0,0.0,0.0,0.0,0.0,0.0,0.0,0.0,0.0,0.0,0.0,0.0,0.0,0.0,1.0,0.0,0.0,0.0,0.0,0.0,0.0,0.0,0.0,0.0,0.0,0.0,0.0,0.0,0.0,0.0,0.0,0.0,0.0,0.0,1.0,0.0,0.0,0.0,1.0,0.0,0.0,0.0,0.0,0.0
104184,0,0.0,0.0,0.0,1.0,0.0,225000.0,478800.0,16479.0,360000.0,0.022625,59.64383561643836,-14880.0,-9450.0,-3759.0,,1.0,2.0,2.0,17.0,,0.2625800458941655,0.237916079507114,0.0923,0.1351,0.9791,,,0.0,0.1466,0.1667,,,,0.0671,,,0.0714,0.1402,0.9777,,,0.0,0.069,0.1667,,,,0.0481,,,0.0885,0.1351,0.9781,,,0.0,0.1552,0.1667,,,,0.0667,,,0.0538,1.0,3.0,1.0,3.0,0.0,0.0,0.0,0.0,0.0,0.0,0.0,0.0,1.0,1.0,0.0,1.0,0.0,0.0,0.0,0.0,0.0,0.0,0.0,0.0,0.0,1.0,0.0,0.0,0.0,0.0,0.0,0.0,0.0,0.0,0.0,0.0,0.0,0.0,0.0,0.0,0.0,0.0,0.0,0.0,13.0,11600.865000000002,0.0,116055.0,10424.25,0.0,0.0,0.0,0.0,-416.0,538.0,-74.0,-1009.0,256.0,-11.0,13.0,7682.5125,91440.0,91440.0,0.0,113220.0,12.0,-1166.0,365243.0,-1146.0,-1076.0,-652.0,-1069.0,15.0,1.0,0.0,-1.0,114.0,12.0,8.0,-38.0,0.0,0.0,260.0,3375.0,3375.0,-1292.0,-1273.5,43.5,0.0,96.0,54104.2425,67500.0,0.0,0.0,0.0,0.0,3375.0,4500.0,4500.0,52239.645,54104.2425,54104.2425,0.0,0.0,0.0,0.0,41.0,-48.5,0.0,0.0,8352583569.0,184503632431.5,165678007536.0,52006784905.935,1863.0,1706.0,71125.0,70898.0,9141.0,506427.0,17820.811600002296,17883.024599999113,17334.191799998018,11303.10420000009,11240.905900000093,11188.244200000054,128507.0,663277.0,,,,13536703.578081794,-602382232.0,-922513813.0,-296712335.0,-1536260459.0416667,44045.0,30725.0,11356.933999999186,11232.879999998982,10716.94639999729,22904.28630000976,22826.08060000972,22211.13840000828,,158144.73432319373,126191.83947454332,35026.441300027975,34966.61750002841,34412.051600028826,,,,3716671.0,,,,,,,16479.031099999742,16664.369099999694,16261.003499999704,,,,,,,436749.0,431542.0,,6429.337610002898,632386.0,625935.0,,16343.3683999998,154289.72049999068,154292.46709999026,154184.19349998722,,,,14.0,69761239.53749996,25257939.02999998,6986764975.004999,2305585818.2025,79778927.83499995,784146.5999999999,125.0,14398.0,-22640357.0,10187743.0,-11717852.0,-12751455.0,-6.5,14274.405,0.0,148500.0,0.0,0.0,0.0,0.0,0.0,-854.0,-338.0,-363.0,-1024.0,245945108.99249983,3504038636.790004,3947744352.6900015,55884239.09999996,3504061136.790004,252792.0,-17351925.0,4025742192.0,176380014.0,904612849.0,392067885.0,948010994.0,250164.0,3953.0,699.9836451810132,5816169.0,2070088.0,1276319.0,-4165005.5,1427057.0,102221.0,2776745765.4752283,2806687531.305157,-167212748.5,-165833954.5,2941823.5,137656.0,2568900866.174985,6949590750.0,216355937.085,336078682.2449997,11793509.1,107593986.01499993,145827247.76999927,369394423.514998,340593219.67499936,2466193094.730001,2559293797.679975,2559422895.254975,11143.5,29326.5,156.0,18027.0,840506.0,-1490715.5,590724.0,1397.0,1468511.0,14822369.0,3234833.0,8561626.0,11615976.0,1416865.0,1060113714.9345012,801913088.1374952,72154662223.20715,21693275050.522617,583110571.4819987,5792665.7475,689.5,94245.0,-277117669.5,22013548.5,-123866040.5,-218851283.5,-2022212.0,5926349474.70746,18736362000.0,198873957.825,448259806.5299977,1948107.735,256962921.5700008,309284819.66249865,636927116.8724978,459408101.7599993,5711388862.072536,5889607614.449998,5889850797.195,13392.5,80928.0,44.0,70429.5,972016.5,-1699676.0,177364.0,6755.0,4276157.0,2481128.0,-9009877.0,921269.0,37582.5,3736345133.227461,3661029121.589961,-260807392.5,-257493400.0,2528225.5,269391.5,3929097583.867455,33277074032.88092,36708189174.225136,1730547373.0950494,48120974781.79572,3991079.5,-247747944.0,103159989562.0,1055267146.0,17285227320.0,3505972352.0,18898701982.5,3674640.5,71983.5,20883.455454007424,89831180.0,-249.4809370693615,2.128,13.653741125068269,814.3614912129759,29.055161114145275,1732.9612533012128,225000.0,-0.9009688679024191,-0.433883739117558,0.0,0.0,0.0,0.0,0.0,0.0,1.0,0.0,0.0,0.0,0.0,0.0,0.0,1.0,0.0,1.0,0.0,0.0,0.0,0.0,0.0,1.0,0.0,0.0,0.0,1.0,0.0,0.0,0.0,0.0,0.0,0.0,0.0,0.0,0.0,0.0,0.0,0.0,1.0,0.0,0.0,0.0,0.0,0.0,0.0,0.0,0.0,0.0,0.0,0.0,0.0,0.0,0.0,0.0,0.0,0.0,0.0,0.0,0.0,0.0,0.0,0.0,0.0,0.0,0.0,0.0,0.0,0.0,0.0,0.0,0.0,0.0,0.0,0.0,0.0,0.0,0.0,0.0,0.0,0.0,0.0,0.0,0.0,0.0,0.0,0.0,0.0,0.0,0.0,0.0,0.0,0.0,0.0,0.0,0.0,0.0,0.0,0.0,0.0,0.0,0.0,0.0,0.0,1.0,0.0,0.0,0.0,0.0,0.0,0.0,1.0,0.0,0.0,1.0,0.0,0.0,0.0,0.0,0.0,0.0
104206,0,0.0,0.0,0.0,1.0,0.0,135000.0,500490.0,48888.0,450000.0,0.01885,55.30958904109588,,-10912.0,-3660.0,,1.0,2.0,2.0,17.0,0.4902783721804847,0.477842676214481,0.7981372313187245,0.132,,0.9821,,,,0.1379,0.3333,,,,0.0925,,0.1339,0.1345,,0.9821,,,,0.1379,0.3333,,,,0.0964,,0.1417,0.1332,,0.9821,,,,0.1379,0.3333,,,,0.0942,,0.1367,0.1106,1.0,3.0,0.0,3.0,0.0,-3024.0,0.0,0.0,0.0,0.0,1.0,5.0,1.0,0.0,0.0,1.0,0.0,1.0,0.0,0.0,0.0,0.0,0.0,0.0,0.0,1.0,0.0,0.0,0.0,0.0,0.0,0.0,0.0,0.0,0.0,0.0,0.0,0.0,0.0,0.0,0.0,0.0,0.0,0.0,1.0,0.0,,90000.0,,,0.0,0.0,0.0,-2520.0,-1952.0,-1954.0,-1954.0,83.0,-41.0,4.0,9643.365,36000.0,109692.0,,99000.0,12.0,-982.0,365243.0,-465.0,-345.0,-135.0,-340.0,12.0,1.0,,-1.0,39.0,23.0,8.0,-84.0,0.0,0.0,50.0,9643.365,9493.447499999998,-2458.5,-2463.0,11.0,1.0,47.0,0.0,337500.0,,0.0,,,0.0,,0.0,0.0,0.0,0.0,,0.0,,,0.0,-25.0,0.0,0.0,8352632457.0,184504132921.5,165678457536.0,52006919905.935,1863.0,1706.0,71125.0,70899.0,9141.0,506432.0,17820.943600002298,17883.15779999911,17334.326299998018,,,,128507.0,663278.0,,,,13536758.887670835,,-922517473.0,-296715359.0,-1536271371.0416667,44045.0,30725.0,,,,22904.424200009755,22826.21850000972,22211.27630000828,67524.95586647978,158145.21216586995,126192.63761177464,35026.774600027966,34966.95080002841,34412.384900028825,,,,3716688.0,,,,,,,16479.12359999974,16664.463299999694,16261.099899999705,,,,3916.648600000124,3899.862200000163,3732.52270000016,436752.0,431545.0,,6429.356460002898,632388.0,625937.0,,16343.4789999998,154290.70259999068,154293.44919999025,154185.17559998718,,,,83.0,70186865.71499997,,7024860945.54,,,784146.5999999999,126.0,14398.0,-22792473.0,10210464.0,-11803582.0,-12841693.0,-41.0,0.0,,90000.0,,,0.0,0.0,0.0,-2520.0,-1952.0,-1954.0,-1954.0,246943557.135,3516858971.010004,3961951019.1900015,,3516858971.010004,253860.0,-17433220.5,4045830557.0,177785708.0,910049926.0,393494939.0,953815546.0,251356.0,3973.0,,5841960.5,2081023.0,1283021.0,-4188393.0,1427123.0,102239.0,2787697755.33772,2817676913.152652,-167899361.5,-166515068.5,2954620.0,138315.5,2570215157.144984,6960694500.0,,336285191.2949997,,,145913477.57999927,,340845129.67499936,2467448280.225,2560607099.459975,2560736197.0349736,,29341.0,,,842502.0,-1494493.0,590724.0,1397.0,1468512.0,14822452.0,3234880.0,8561665.0,11616026.0,1416869.0,1060113714.9345012,,72154752223.20715,,,5792665.7475,689.5,94245.0,-277120189.5,22011596.5,-123867994.5,-218853237.5,-2022253.0,5926349474.70746,18736699500.0,,448259806.5299977,,,309284819.66249865,,459408101.7599993,5711388862.072536,5889607614.449998,5889850797.195,,80928.0,,,972016.5,-1699701.0,177364.0,6755.0,4276180.0,2481136.0,-9009961.0,921269.0,37582.5,3736354776.59246,3661038615.037461,-260809851.0,-257495863.0,2528236.5,269392.5,3929107227.232455,33277110032.88092,36708298866.225136,,48121073781.79572,3991091.5,-247748926.0,103160354805.0,1055266681.0,17285226975.0,3505972217.0,18898701642.5,3674652.5,71984.5,,89831179.0,,3.707333333333333,2.7614138438880707,152.7326648778421,10.237481590574372,566.2308995904533,135000.0,-0.9009688679024191,0.4338837391175582,0.0,0.0,0.0,0.0,0.0,0.0,1.0,0.0,0.0,1.0,0.0,0.0,0.0,0.0,0.0,0.0,0.0,0.0,1.0,0.0,0.0,0.0,1.0,0.0,0.0,1.0,0.0,0.0,0.0,0.0,0.0,0.0,0.0,0.0,0.0,0.0,0.0,0.0,0.0,0.0,0.0,0.0,0.0,0.0,0.0,0.0,0.0,0.0,0.0,0.0,0.0,0.0,0.0,0.0,0.0,0.0,0.0,0.0,0.0,0.0,0.0,0.0,0.0,0.0,0.0,0.0,0.0,0.0,0.0,0.0,0.0,0.0,0.0,0.0,0.0,0.0,0.0,0.0,0.0,0.0,0.0,0.0,0.0,0.0,0.0,0.0,0.0,0.0,0.0,0.0,0.0,0.0,0.0,0.0,0.0,0.0,0.0,0.0,0.0,0.0,0.0,0.0,0.0,0.0,0.0,1.0,0.0,0.0,0.0,0.0,1.0,0.0,0.0,0.0,0.0,0.0,0.0,0.0,1.0,0.0
104216,0,0.0,0.0,0.0,0.0,0.0,72000.0,296280.0,15255.0,225000.0,0.008068,57.509589041095886,-1547.0,-8744.0,-3640.0,,1.0,3.0,3.0,4.0,,0.2039591856153096,0.0701088438273582,0.0773,0.0879,0.9846,,,,0.1724,0.1667,,,,0.0749,,0.0244,0.0788,0.0913,0.9846,,,,0.1724,0.1667,,,,0.0781,,0.0258,0.0781,0.0879,0.9846,,,,0.1724,0.1667,,,,0.0763,,0.0249,0.0794,1.0,2.0,0.0,2.0,0.0,-500.0,0.0,0.0,0.0,0.0,0.0,3.0,1.0,1.0,1.0,1.0,0.0,0.0,0.0,0.0,0.0,0.0,1.0,1.0,0.0,0.0,0.0,0.0,1.0,0.0,0.0,0.0,0.0,0.0,0.0,0.0,0.0,0.0,0.0,0.0,0.0,0.0,0.0,0.0,4.0,2610.0,8864.325,61422.75,8012.25,0.0,0.0,0.0,0.0,-97.0,315.0,-38.5,-263.0,32.0,-4.5,17.0,12004.2,0.0,0.0,0.0,225000.0,36.0,-160.0,365243.0,-466.0,-106.0,44.0,-100.0,8.0,0.0,0.0,-1.0,14.0,18.0,11.5,-9.5,0.0,0.0,13.0,9416.07,9416.07,-298.0,-286.0,7.0,1.0,0.0,,,,,,,,,,,,,,,,,,,,,8352647712.0,184504429201.5,165678682536.0,52006991905.935,1863.0,1706.0,71125.0,70899.0,9141.0,506435.0,17821.0209000023,17883.235899999112,17334.405099998017,11303.192100000091,11240.993800000091,11188.335500000054,128507.0,663279.0,,,,13536816.397259874,-602383779.0,-922521113.0,-296715859.0,-1536280115.0416667,44045.0,30725.0,,,,22904.596600009754,22826.39090000972,22211.44870000828,,158145.41612505555,126192.70772061846,35026.941300027975,34967.11750002841,34412.551600028826,,,,3716692.0,,,,,,,16479.19849999974,16664.539599999694,16261.177999999703,,,,3916.673000000124,3899.887100000163,3732.54850000016,436754.0,431547.0,,6429.3645280029,632391.0,625940.0,,16343.558399999802,154291.68719999067,154294.43379999025,154186.16019998718,,,,4.0,70258649.71499997,25328463.88499998,7031342828.339999,2313391374.7200003,81155534.26499996,784146.5999999999,126.0,14398.0,-22830623.0,10207827.0,-11826781.5,-12867036.0,-1.5,2610.0,8864.325,118710.0,0.0,0.0,0.0,0.0,0.0,-628.0,-263.0,-261.0,-263.0,247489392.59999985,3524866036.965003,3970704666.6900015,56235784.27499995,3524515036.965003,254368.0,-17467020.0,4055326556.0,178486875.0,912584555.0,394572869.0,956350308.0,251890.0,3980.0,703.6432538973163,5858030.0,2085478.0,1285758.0,-4198690.0,1427209.0,102239.0,2793755309.7601967,2823575497.605136,-168212468.0,-166825998.0,2956661.0,138594.0,,,,,,,,,,,,,,,,,,,,,1468516.0,14822484.0,3234880.0,8561679.0,11616039.0,1416886.0,1060116324.9345012,801921952.4624952,72154813645.95715,21693283062.772617,583110571.4819987,5792665.7475,689.5,94245.0,-277120286.5,22011911.5,-123868033.0,-218853500.5,-2022257.5,,,,,,,,,,,,,,,,,,,,,4276198.0,2481147.5,-9009970.5,921269.0,37582.5,3736364192.66246,3661048031.107461,-260810149.0,-257496149.0,2528243.5,269393.5,3929119231.432454,33277110032.88092,36708298866.225136,1730547373.0950494,48121298781.79572,3991127.5,-247749086.0,103160720048.0,1055266215.0,17285226869.0,3505972261.0,18898701542.5,3674660.5,71984.5,20883.455454007424,89831178.0,-26.899861845552856,4.115,4.71976401179941,271.43168868953813,19.421828908554573,1116.9413989574496,72000.0,0.6234898018587334,-0.7818314824680299,0.0,0.0,0.0,0.0,0.0,0.0,1.0,0.0,0.0,0.0,0.0,0.0,0.0,1.0,0.0,1.0,0.0,0.0,0.0,0.0,0.0,0.0,0.0,1.0,0.0,1.0,0.0,0.0,0.0,0.0,0.0,0.0,0.0,0.0,0.0,0.0,0.0,0.0,0.0,0.0,0.0,0.0,0.0,0.0,0.0,0.0,0.0,0.0,0.0,0.0,0.0,0.0,0.0,1.0,0.0,0.0,0.0,0.0,0.0,0.0,0.0,0.0,0.0,0.0,0.0,0.0,0.0,0.0,0.0,0.0,0.0,0.0,0.0,0.0,0.0,0.0,0.0,0.0,0.0,0.0,0.0,0.0,0.0,0.0,0.0,0.0,0.0,0.0,0.0,0.0,0.0,0.0,0.0,0.0,0.0,0.0,0.0,0.0,0.0,0.0,0.0,0.0,0.0,0.0,0.0,0.0,0.0,0.0,0.0,0.0,1.0,0.0,0.0,0.0,0.0,0.0,0.0,1.0,0.0,0.0
104230,0,0.0,1.0,0.0,1.0,0.0,157500.0,440784.0,28300.5,360000.0,0.020713,31.66575342465753,-1698.0,-279.0,-4108.0,,2.0,3.0,2.0,14.0,0.0862173169921294,0.5853067302739583,0.6642482627052363,,,,,,,,,,,,,,,,,,,,,,,,,,,,,,,,,,,,,,,,,,,,,0.0,0.0,0.0,0.0,-660.0,0.0,0.0,0.0,0.0,0.0,1.0,1.0,1.0,0.0,1.0,0.0,0.0,0.0,0.0,0.0,0.0,0.0,0.0,0.0,1.0,0.0,0.0,0.0,0.0,0.0,0.0,0.0,0.0,0.0,0.0,0.0,0.0,0.0,0.0,0.0,0.0,0.0,0.0,1.0,,225.0,76064.535,0.0,0.0,0.0,0.0,0.0,-1152.0,-728.0,-723.0,-728.0,38.0,-18.5,2.0,9117.405,90434.25,100656.0,0.0,180868.5,24.0,-344.5,365243.0,-629.0,365243.0,61.0,365243.0,13.5,0.0,0.0,1749.5,20.0,24.0,14.5,-11.5,0.0,0.0,21.0,9117.405,9117.405,-335.0,-329.0,11.0,1.0,0.0,,,,,,,,,,,,,,,,,,,,,8352676012.5,184504869985.5,165679042536.0,52007149405.935,1863.0,1706.0,71125.0,70899.0,9141.0,506436.0,,,,,,,128507.0,663281.0,,,,13536848.0630133,-602385477.0,-922525221.0,-296716519.0,-1536280394.0416667,44045.0,30725.0,,,,,,,67525.04208379678,158146.0014317858,126193.37196888115,,,,,,,3716706.0,,,,,,,,,,,,,,,,436754.0,431547.0,,6429.385241002898,632394.0,625942.0,,,,,,,,,38.0,,25334313.88499998,7045735719.959998,2319468073.4700003,81324324.76499996,784146.5999999999,128.0,14398.0,-22894938.0,10215503.0,-11857319.0,-12905053.0,-18.5,,225.0,76064.535,0.0,0.0,0.0,0.0,0.0,-1152.0,-728.0,-723.0,-728.0,248614578.62999973,3543729324.075003,3991431167.1900015,56455749.13499995,3543819758.325003,255718.0,-17536234.0,4069568369.0,179538015.0,916203718.0,396004848.0,959604391.0,253213.5,3982.0,706.6901169799538,5883611.0,2091322.0,1289301.5,-4212928.0,1427246.0,102258.0,2802640686.165201,2833093115.730141,-169029374.0,-167638553.0,2976577.0,139110.0,,,,,,,,,,,,,,,,,,,,,1468517.0,14822522.0,3234880.0,8561699.0,11616060.0,1416888.0,,801922177.4624952,72154889710.49216,21693283062.772617,583110571.4819987,5792665.7475,689.5,94245.0,-277121438.5,22011183.5,-123868756.0,-218854228.5,-2022276.0,,,,,,,,,,,,,,,,,,,,,4276222.0,2481162.0,-9009982.0,921269.0,37582.5,3736373310.067461,3661057148.5124607,-260810484.0,-257496478.0,2528254.5,269394.5,3929128348.837455,33277200467.13092,36708399522.225136,1730547373.0950494,48121479650.29572,3991151.5,-247749430.5,103161085291.0,1055265586.0,17285592112.0,3505972322.0,18899066785.5,3674674.0,71984.5,20883.455454007424,89832927.5,-53.622599065582286,2.7986285714285715,5.565272698362219,176.22855300731655,15.575131181427892,493.1982635477906,78750.0,0.6234898018587336,0.7818314824680298,0.0,0.0,0.0,0.0,0.0,0.0,1.0,0.0,0.0,0.0,0.0,0.0,0.0,1.0,0.0,0.0,0.0,0.0,1.0,1.0,0.0,0.0,0.0,0.0,0.0,0.0,0.0,0.0,0.0,1.0,0.0,0.0,0.0,0.0,1.0,0.0,0.0,0.0,0.0,0.0,0.0,0.0,0.0,0.0,0.0,0.0,0.0,0.0,0.0,0.0,0.0,0.0,0.0,1.0,0.0,0.0,0.0,0.0,0.0,0.0,0.0,0.0,0.0,0.0,0.0,0.0,0.0,0.0,0.0,0.0,0.0,0.0,0.0,0.0,0.0,0.0,0.0,0.0,0.0,0.0,0.0,0.0,0.0,0.0,0.0,0.0,0.0,0.0,0.0,0.0,0.0,0.0,0.0,0.0,0.0,0.0,0.0,0.0,0.0,0.0,0.0,0.0,0.0,0.0,0.0,0.0,0.0,0.0,0.0,0.0,0.0,0.0,0.0,0.0,0.0,0.0,0.0,0.0,0.0,0.0
104257,0,0.0,0.0,1.0,0.0,0.0,292500.0,1885536.0,103455.0,1800000.0,0.00496,34.40821917808219,-4283.0,-5262.0,-3995.0,11.0,2.0,2.0,2.0,15.0,0.3437942432373427,0.5708592226501256,0.4740512892789932,0.1113,,0.9826,,,0.12,0.0803,0.375,,,,,,,0.0756,,0.9806,,,0.0806,0.0345,0.3333,,,,,,,0.1124,,0.9811,,,0.12,0.069,0.3333,,,,,,,0.0378,1.0,5.0,2.0,5.0,0.0,-662.0,0.0,0.0,0.0,0.0,0.0,3.0,1.0,1.0,0.0,1.0,1.0,0.0,0.0,0.0,0.0,0.0,0.0,0.0,0.0,0.0,0.0,0.0,0.0,0.0,1.0,0.0,0.0,0.0,0.0,0.0,0.0,0.0,0.0,0.0,0.0,0.0,0.0,0.0,2.0,4500.0,,238500.0,29515.5,0.0,0.0,0.0,0.0,-887.0,875.0,-97.5,,60.0,-14.5,3.0,5873.22,65434.5,57870.0,13090.5,65434.5,12.0,-662.0,365243.0,-443.5,-353.5,-113.5,-348.5,13.0,0.0,0.200910993375956,82.0,12.0,12.0,10.0,-13.5,0.0,0.0,8.0,10623.555,10623.555,-413.5,-398.5,2.5,1.0,0.0,,,,,,,,,,,,,,,,,,,,,8352779467.5,184506755521.5,165680842536.0,52007441905.935,1863.0,1706.0,71125.0,70899.0,9141.0,506439.0,17821.1322000023,17883.348299999114,17334.480699998017,,,,128507.0,663283.0,,,,13536882.471232478,-602389760.0,-922529216.0,-296717181.0,-1536285656.0416667,44047.0,30725.0,11357.053999999189,11232.999999998983,10717.02699999729,22904.67690000976,22826.459900009715,22211.48320000828,67525.38587804,158146.57229100846,126193.84602017044,35027.316300027975,34967.45080002841,34412.884900028825,,,,3716721.0,,,,,,,,,,,,,,,,436759.0,431552.0,1263991.0,6429.390201002899,632396.0,625944.0,,16343.596199999802,154292.66979999063,154295.41489999025,154187.14079998722,,,,30.0,70493555.65499999,,7096602612.329995,2336275093.590001,82527778.25999998,784146.5999999999,131.0,14398.0,-23122051.0,10135708.0,-11993697.0,,-14.5,4500.0,,342000.0,59031.0,0.0,0.0,0.0,0.0,-1104.0,1012.0,-12.0,,250462750.3199997,3567440559.510002,4019403690.8100014,56992988.69999996,3567440559.510002,257443.0,-17688939.0,4100425230.5,181264146.0,922332906.0,399591870.0,966466723.0,255249.0,4009.0,713.6537937866808,5928394.0,2101446.0,1295419.0,-4243983.0,1427446.0,102318.0,2817889278.3001924,2848130358.255132,-170349330.0,-168952831.0,2996289.0,139980.0,,,,,,,,,,,,,,,,,,,,,1468519.0,14822582.0,3234880.0,8561711.0,11616068.0,1416891.0,1060120824.9345012,,72155128210.49216,21693312578.272617,583110571.4819987,5792665.7475,689.5,94245.0,-277122325.5,22012058.5,-123868853.5,,-2022290.5,,,,,,,,,,,,,,,,,,,,,4276234.0,2481172.0,-9009995.5,921269.0,37582.5,3736383933.622461,3661067772.067461,-260810897.5,-257496876.5,2528257.0,269395.5,3929134222.057454,33277265901.63092,36708457392.225136,1730560463.5950494,48121545084.79572,3991163.5,-247750092.5,103161450534.0,1055265142.5,17285591758.5,3505972208.5,18899066437.0,3674687.0,71984.5,20883.6563650008,89833009.5,-124.47607293574328,6.446276923076924,2.827316224445411,97.2829163364655,18.225663331883432,627.1126185893808,146250.0,0.6234898018587336,0.7818314824680298,0.0,0.0,0.0,0.0,0.0,0.0,1.0,0.0,0.0,0.0,1.0,0.0,0.0,0.0,0.0,1.0,0.0,0.0,0.0,0.0,1.0,0.0,0.0,0.0,0.0,0.0,0.0,0.0,0.0,1.0,0.0,0.0,0.0,1.0,0.0,0.0,0.0,0.0,0.0,0.0,0.0,0.0,0.0,0.0,0.0,0.0,0.0,0.0,0.0,0.0,0.0,0.0,0.0,0.0,0.0,0.0,0.0,0.0,0.0,0.0,0.0,0.0,0.0,0.0,0.0,0.0,0.0,0.0,0.0,0.0,0.0,0.0,0.0,0.0,0.0,0.0,0.0,0.0,0.0,0.0,0.0,0.0,0.0,0.0,0.0,0.0,0.0,1.0,0.0,0.0,0.0,0.0,0.0,0.0,0.0,0.0,0.0,0.0,0.0,0.0,0.0,0.0,0.0,0.0,0.0,0.0,0.0,0.0,0.0,0.0,1.0,0.0,0.0,0.0,0.0,0.0,0.0,1.0,0.0,0.0
104272,0,0.0,0.0,0.0,1.0,1.0,315000.0,479700.0,50503.5,450000.0,0.072508,37.81095890410959,-1334.0,-7904.0,-4877.0,,2.0,1.0,1.0,10.0,0.4783661610581058,0.6443267457709344,0.4329616670974407,0.5361,0.2113,0.9841,0.7824,0.3891,0.72,0.2069,0.875,0.9167,0.0392,0.4304,0.3923,0.0309,0.0242,0.5462,0.2192,0.9841,0.7909,0.3926,0.725,0.2069,0.875,0.9167,0.0401,0.4702,0.4088,0.0311,0.0257,0.5413,0.2113,0.9841,0.7853,0.3915,0.72,0.2069,0.875,0.9167,0.0399,0.4378,0.3994,0.0311,0.0247,0.5266,1.0,1.0,0.0,1.0,0.0,-284.0,0.0,0.0,0.0,0.0,1.0,0.0,1.0,1.0,0.0,1.0,1.0,1.0,0.0,0.0,0.0,0.0,0.0,0.0,0.0,1.0,0.0,0.0,0.0,0.0,0.0,0.0,0.0,0.0,0.0,0.0,0.0,0.0,0.0,0.0,0.0,0.0,0.0,0.0,6.0,19948.5,0.0,144000.0,118185.75,0.0,0.0,0.0,0.0,-495.0,-148.0,-98.5,-451.5,103.0,-8.0,3.0,7900.065,66096.0,66096.0,0.0,66096.0,10.0,-284.0,365243.0,-254.0,-14.0,16.0,-10.0,17.0,0.0,0.0,1100.0,9.0,10.0,6.0,-5.0,0.0,0.0,9.0,7547.49,7547.49,-142.0,-134.0,5.0,1.0,0.0,,,,,,,,,,,,,,,,,,,,,8352829971.0,184507235221.5,165681292536.0,52007756905.935,1863.0,1706.0,71125.0,70900.0,9141.0,506439.0,17821.6683000023,17883.889599999115,17335.026899998018,11303.403400000092,11241.205100000096,11188.554700000052,128508.0,663285.0,4141.100600000114,4138.791600000015,3949.359300000093,13536920.28219138,-602391094.0,-922534093.0,-296717465.0,-1536293560.0416667,44047.0,30725.0,11357.773999999186,11233.719999998984,10717.75199999729,22904.88380000976,22826.66680000972,22211.690100008287,67525.86424420106,158147.21661775422,126194.27898183756,35028.191300027975,34968.32580002841,34413.759900028825,22969.6817999959,22942.733599995478,22589.497699995707,3716731.0,8301.364400000162,8405.966200000075,8129.456300000232,9824.151400000716,9939.14080000216,10299.17879999964,16479.59079999974,16664.938999999693,16261.586799999704,829.0065000001767,814.183000000046,760.1058000000132,3916.6972000001233,3899.911800000163,3732.57420000016,436760.0,431553.0,,6429.462709002899,632397.0,625945.0,,16344.1227999998,154293.65389999063,154296.39899999026,154188.12489998722,77663.23639999633,78001.29030000657,78402.94850000658,16.5,70832224.16999999,25500031.96499998,7132375279.889996,2353055738.3550005,82548530.68499996,784146.5999999999,131.0,14398.0,-23228096.5,10358508.0,-12052761.5,-13097316.5,-7.75,19948.5,0.0,40500.0,0.0,0.0,0.0,0.0,0.0,-537.0,-259.0,-144.0,-604.0,251234316.0449997,3576321098.010002,4029659582.3100014,57363217.19999996,3576321098.010002,258015.0,-17735962.0,4111930099.0,181228108.0,923400883.0,399933866.0,967534896.0,255864.0,4016.0,716.5570264786759,5940176.0,2108747.0,1299635.0,-4260722.0,1427456.0,102328.0,2826669761.415174,2856811439.6551127,-170819306.0,-169419582.0,2999572.0,140350.0,,,,,,,,,,,,,,,,,,,,,1468525.0,14822685.0,3234880.0,8561720.0,11616077.0,1416894.0,1060140773.4345012,801922177.4624952,72155272210.49216,21693430764.022617,583110571.4819987,5792665.7475,689.5,94245.0,-277122820.5,22011910.5,-123868952.0,-218854680.0,-2022298.5,,,,,,,,,,,,,,,,,,,,,4276244.0,2481178.0,-9010000.5,921269.0,37582.5,3736391481.11246,3661075319.557461,-260811039.5,-257497010.5,2528262.0,269396.5,3929142122.1224537,33277331997.63092,36708523488.225136,1730560463.5950494,48121611180.79572,3991173.5,-247750376.5,103161815777.0,1055264888.5,17285591744.5,3505972224.5,18899066427.0,3674704.0,71984.5,20883.6563650008,89834109.5,-35.280776755307585,1.522857142857143,6.237191481778492,235.8341907945889,9.498351599394102,359.141781981474,157500.0,-0.2225209339563143,0.9749279121818236,0.0,0.0,0.0,0.0,0.0,0.0,1.0,0.0,1.0,0.0,0.0,0.0,0.0,0.0,0.0,1.0,0.0,0.0,0.0,0.0,0.0,1.0,0.0,0.0,0.0,0.0,1.0,0.0,0.0,0.0,0.0,0.0,0.0,0.0,0.0,0.0,0.0,0.0,0.0,0.0,0.0,0.0,0.0,0.0,0.0,0.0,0.0,0.0,0.0,0.0,0.0,0.0,0.0,0.0,0.0,0.0,0.0,0.0,0.0,0.0,0.0,0.0,0.0,0.0,0.0,0.0,0.0,0.0,0.0,0.0,0.0,0.0,0.0,0.0,0.0,0.0,0.0,0.0,0.0,0.0,0.0,1.0,0.0,0.0,0.0,0.0,0.0,0.0,0.0,0.0,0.0,0.0,0.0,0.0,0.0,0.0,0.0,0.0,0.0,0.0,0.0,0.0,0.0,0.0,0.0,0.0,0.0,0.0,1.0,0.0,1.0,0.0,0.0,0.0,0.0,0.0,0.0,1.0,0.0,0.0
104273,0,0.0,1.0,1.0,0.0,0.0,225000.0,728460.0,62523.0,675000.0,0.007114,50.14246575342465,-870.0,-9542.0,-1819.0,12.0,2.0,2.0,2.0,8.0,,0.3128916550188253,0.5937175866150576,0.0928,0.0923,0.9811,0.7416,0.0104,0.0,0.2069,0.1667,,0.0832,0.0731,0.0769,0.0116,0.0112,0.0945,0.0957,0.9811,0.7517,0.0105,0.0,0.2069,0.1667,,0.0851,0.0799,0.0801,0.0117,0.0119,0.0937,0.0923,0.9811,0.7451,0.0104,0.0,0.2069,0.1667,,0.0846,0.0744,0.0783,0.0116,0.0115,0.0605,1.0,0.0,0.0,0.0,0.0,-1528.0,0.0,0.0,0.0,0.0,2.0,2.0,1.0,1.0,1.0,1.0,1.0,0.0,0.0,0.0,0.0,0.0,0.0,0.0,0.0,0.0,0.0,0.0,0.0,0.0,1.0,0.0,0.0,0.0,0.0,0.0,0.0,0.0,0.0,0.0,0.0,0.0,0.0,0.0,4.0,0.0,,272587.5,0.0,0.0,0.0,0.0,0.0,-1175.0,-606.5,-635.0,-1127.0,203.0,-25.0,7.0,6750.0,34020.0,30982.5,3915.0,135000.0,6.0,-545.0,365243.0,-589.0,-484.0,-349.0,-480.0,13.0,0.0,0.1221804114647442,-1.0,31.0,12.0,5.0,-16.0,0.0,0.0,34.0,36927.045,19311.3,-430.5,-415.0,4.0,1.0,0.0,,,,,,,,,,,,,,,,,,,,,8352892494.0,184507963681.5,165681967536.0,52007981905.935,1863.0,1706.0,71125.0,70902.0,9141.0,506441.0,17821.7611000023,17883.983299999116,17335.121399998017,11303.495700000092,11241.297400000096,11188.650400000051,128508.0,663287.0,4141.1110000001145,4138.802000000015,3949.369800000093,13536970.424657134,-602391964.0,-922535912.0,-296718993.0,-1536303102.0416667,44047.0,30725.0,11357.773999999186,11233.719999998984,10717.75199999729,22905.09070000976,22826.87370000972,22211.897000008285,,158147.52950940924,126194.87269942414,35028.358000027976,34968.49250002841,34413.926600028826,,,,3716739.0,8301.447600000161,8406.050800000074,8129.541400000232,9824.224500000715,9939.21520000216,10299.258699999642,16479.66769999974,16665.017299999694,16261.666899999704,829.0181000001767,814.1946000000462,760.1175000000135,3916.708400000123,3899.923300000163,3732.58610000016,436760.0,431553.0,1264003.0,6429.469823002899,632399.0,625947.0,,16344.1832999998,154294.6349999907,154297.38009999026,154189.1059999872,77663.97799999632,78002.03540000657,78403.70020000657,39.5,70869911.66999999,,7134701221.889996,2354599047.1050005,82548530.68499996,784146.5999999999,131.0,14398.0,-23233653.0,10356595.0,-12056712.5,-13099779.0,-19.25,0.0,,95175.0,0.0,0.0,0.0,0.0,0.0,-1187.0,-1066.0,-1127.0,-1186.0,251356557.55499968,3577523714.010002,4030857095.3100014,57368320.19999996,3577523714.010002,258043.0,-17738659.0,4112843206.5,181226697.5,923399847.5,399933100.5,967533871.0,255940.0,4016.5,716.7203901150395,5941314.0,2108940.0,1299758.0,-4260991.0,1427456.0,102328.0,2828038139.932674,2858939351.2801127,-170827933.5,-169427952.5,2999656.0,140382.5,,,,,,,,,,,,,,,,,,,,,1468529.0,14822888.0,3234880.0,8561751.0,11616111.0,1416901.0,1060140773.4345012,,72155544797.99216,21693430764.022617,583110571.4819987,5792665.7475,689.5,94245.0,-277123995.5,22011304.0,-123869587.0,-218855807.0,-2022323.5,,,,,,,,,,,,,,,,,,,,,4276256.0,2481183.0,-9010016.5,921269.0,37582.5,3736428408.15746,3661094630.857461,-260811470.0,-257497425.5,2528266.0,269397.5,3929148872.1224537,33277366017.63092,36708554470.725136,1730564378.5950494,48121746180.79572,3991179.5,-247750921.5,103162181020.0,1055264299.5,17285591260.5,3505971875.5,18899065947.0,3674717.0,71984.5,20883.778545412264,89834108.5,-17.350562780024042,3.2376,3.598675687347056,180.44647241048168,11.651072405354832,584.2134990761756,112500.0,0.6234898018587336,0.7818314824680298,0.0,0.0,0.0,0.0,0.0,0.0,1.0,0.0,0.0,0.0,0.0,0.0,0.0,1.0,0.0,0.0,0.0,0.0,1.0,0.0,1.0,0.0,0.0,0.0,0.0,1.0,0.0,0.0,0.0,0.0,0.0,0.0,0.0,0.0,0.0,0.0,0.0,0.0,1.0,0.0,0.0,0.0,0.0,0.0,0.0,0.0,0.0,0.0,0.0,0.0,0.0,0.0,0.0,1.0,0.0,0.0,0.0,0.0,0.0,0.0,0.0,0.0,0.0,0.0,0.0,0.0,0.0,0.0,0.0,0.0,0.0,0.0,0.0,0.0,0.0,0.0,0.0,0.0,0.0,0.0,0.0,0.0,0.0,0.0,0.0,0.0,0.0,0.0,0.0,0.0,0.0,0.0,0.0,0.0,0.0,0.0,0.0,0.0,0.0,0.0,0.0,0.0,0.0,0.0,0.0,0.0,0.0,0.0,1.0,0.0,1.0,0.0,0.0,0.0,0.0,0.0,0.0,1.0,0.0,0.0
104278,0,0.0,0.0,0.0,1.0,0.0,58500.0,192024.0,8068.5,135000.0,0.010276,64.33972602739726,,-2636.0,-4834.0,,1.0,2.0,2.0,11.0,,0.6481062521004881,,0.0907,0.1057,0.9806,0.7348,0.0446,0.0,0.2069,0.1667,0.2083,0.0,0.074,0.0887,0.0,0.0,0.0924,0.1097,0.9806,0.7452,0.0451,0.0,0.2069,0.1667,0.2083,0.0,0.0808,0.0924,0.0,0.0,0.0916,0.1057,0.9806,0.7383,0.0449,0.0,0.2069,0.1667,0.2083,0.0,0.0752,0.0903,0.0,0.0,0.0942,1.0,4.0,0.0,4.0,0.0,-1525.0,,,,,,,1.0,0.0,0.0,1.0,1.0,0.0,0.0,0.0,0.0,0.0,0.0,0.0,0.0,1.0,0.0,0.0,0.0,0.0,0.0,0.0,0.0,0.0,0.0,0.0,0.0,0.0,0.0,0.0,0.0,0.0,0.0,0.0,0.0,,,,,,,,,,,,,0.0,,1.0,13541.715,96637.5,104611.5,0.0,96637.5,10.0,-1525.0,365243.0,-1494.0,-1254.0,-1224.0,-1245.0,13.0,0.0,0.0,2170.0,10.0,10.0,5.5,-45.5,0.0,0.0,9.0,13541.715,13541.715,-1411.0,-1374.0,5.0,1.0,0.0,,,,,,,,,,,,,,,,,,,,,8352900562.5,184508155705.5,165682102536.0,52008040405.935,,,,,,,17821.8518000023,17884.074899999116,17335.213799998022,11303.601400000092,11241.403100000096,11188.760100000054,128508.0,663288.0,4141.155600000116,4138.846900000015,3949.414900000093,13537034.76438316,,-922540746.0,-296720518.0,-1536305738.0416667,44047.0,30725.0,11357.773999999186,11233.719999998984,10717.75199999729,22905.29760000976,22827.08060000972,22212.10390000829,,158148.17761566135,,35028.524700027985,34968.659200028414,34414.093300028835,22969.890099995897,22942.941899995472,22589.705999995705,3716750.0,8301.447600000161,8406.050800000074,8129.541400000232,9824.298500000716,9939.29040000216,10299.339499999642,16479.75639999974,16665.107599999694,16261.759299999703,829.0181000001767,814.1946000000462,760.1175000000135,3916.708400000123,3899.923300000163,3732.58610000016,436764.0,431557.0,,6429.480099002899,632401.0,625949.0,,16344.2774999998,154295.61559999068,154298.36069999027,154190.0865999872,77664.71279999633,78002.77370000657,78404.44540000657,,,,,,,,,,,,,,,,,,,,,,,,,,,251753375.24999967,3586085152.6950026,4040761189.995001,57403123.19999996,3586085152.6950026,258535.0,-17767355.0,4117039522.0,181574758.0,923753075.0,401019881.0,968620493.0,256288.0,4020.0,717.5828098160849,5948241.0,2111487.0,1301104.5,-4266662.5,1427483.0,102355.0,2831350321.530179,2862038440.845116,-171238153.0,-169835768.0,3010810.0,140573.0,,,,,,,,,,,,,,,,,,,,,1468529.0,14822888.0,3234880.0,8561761.0,11616120.0,1416902.0,,,,,,,,,,,,,,,,,,,,,,,,,,,,,,,,,,4276266.0,2481188.5,-9010062.0,921269.0,37582.5,3736441949.872461,3661108172.572461,-260812881.0,-257498799.5,2528271.0,269398.5,3929162413.837455,33277462655.13092,36708659082.225136,1730564378.5950494,48121842818.29572,3991189.5,-247752446.5,103162546263.0,1055262805.5,17285590006.5,3505970651.5,18899064702.0,3674730.0,71984.5,20883.778545412264,89836278.5,,3.2824615384615385,7.2504182933630785,466.4899265790097,23.79921918572225,1531.2352420753464,58500.0,-0.2225209339563146,-0.9749279121818236,0.0,0.0,0.0,0.0,0.0,0.0,1.0,0.0,0.0,1.0,0.0,0.0,0.0,0.0,0.0,1.0,0.0,0.0,0.0,0.0,0.0,0.0,0.0,1.0,0.0,1.0,0.0,0.0,0.0,0.0,0.0,0.0,0.0,0.0,0.0,0.0,0.0,0.0,0.0,0.0,0.0,0.0,0.0,0.0,0.0,0.0,0.0,0.0,0.0,0.0,0.0,0.0,0.0,0.0,0.0,0.0,0.0,0.0,0.0,0.0,0.0,0.0,0.0,0.0,0.0,0.0,0.0,0.0,0.0,0.0,0.0,0.0,0.0,0.0,0.0,0.0,0.0,0.0,0.0,0.0,0.0,0.0,0.0,0.0,0.0,0.0,0.0,0.0,0.0,0.0,0.0,0.0,0.0,0.0,0.0,0.0,0.0,0.0,0.0,0.0,0.0,0.0,0.0,0.0,0.0,1.0,0.0,0.0,1.0,0.0,1.0,0.0,0.0,0.0,0.0,0.0,0.0,1.0,0.0,0.0
104294,0,0.0,0.0,1.0,0.0,1.0,112500.0,225000.0,17905.5,225000.0,0.031329,33.717808219178075,-2307.0,-10684.0,-2074.0,17.0,3.0,2.0,2.0,15.0,,0.1504111262473146,0.6075573001388961,0.1423,0.1365,0.9806,0.7348,0.014,0.0,0.2759,0.1667,0.2083,0.1285,0.1143,0.1311,0.0077,0.0163,0.145,0.1416,0.9806,0.7452,0.0141,0.0,0.2759,0.1667,0.2083,0.1315,0.1249,0.1366,0.0078,0.0172,0.1436,0.1365,0.9806,0.7383,0.0141,0.0,0.2759,0.1667,0.2083,0.1308,0.1163,0.1335,0.0078,0.0166,0.1067,1.0,8.0,3.0,8.0,1.0,-272.0,0.0,0.0,0.0,0.0,2.0,6.0,1.0,1.0,1.0,1.0,0.0,0.0,0.0,0.0,0.0,0.0,0.0,0.0,0.0,1.0,0.0,0.0,0.0,0.0,0.0,0.0,0.0,0.0,0.0,0.0,0.0,0.0,0.0,0.0,0.0,0.0,0.0,0.0,4.0,0.0,0.0,27666.0,0.0,0.0,0.0,0.0,0.0,-1722.5,-1662.0,-964.5,-1637.0,209.0,-26.0,20.0,11250.0,25965.0,24165.0,0.0,137070.0,6.0,-232.0,365243.0,-536.0,-29.0,-29.0,-218.0,10.0,0.0,0.0,-1.0,39.0,9.0,4.5,-18.0,0.0,0.0,36.0,23371.785,23371.785,-497.0,-494.0,5.5,1.0,33.0,0.0,225000.0,,0.0,,,0.0,,0.0,0.0,0.0,0.0,,0.0,,,0.0,-16.0,0.0,0.0,8352918468.0,184508380705.5,165682327536.0,52008152905.935,1863.0,1706.0,71125.0,70904.0,9141.0,506447.0,17821.9941000023,17884.218499999115,17335.358799998026,11303.737900000093,11241.539600000096,11188.901700000057,128509.0,663291.0,4141.169600000116,4138.861000000015,3949.429000000093,13537068.48219138,-602394271.0,-922542820.0,-296720790.0,-1536316422.0416667,44050.0,30726.0,11357.773999999186,11233.719999998984,10717.75199999729,22905.57350000976,22827.35650000972,22212.37980000829,,158148.32802678758,126195.4802567243,35028.69140002799,34968.825900028416,34414.26000002883,22970.09839999589,22943.150199995467,22589.914299995704,3716765.0,8301.576100000162,8406.181600000074,8129.672900000231,9824.412800000717,9939.40670000216,10299.464399999642,16479.887499999742,16665.241099999694,16261.895899999705,829.0258000001767,814.2024000000463,760.1253000000132,3916.724700000123,3899.939900000163,3732.60330000016,436772.0,431565.0,1264020.0,6429.511428002899,632403.0,625951.0,,16344.3841999998,154296.59619999072,154299.34129999028,154191.0671999872,77665.44759999633,78003.51200000657,78405.19060000658,57.0,71393212.16999999,25556758.10999998,7163733233.339995,2362905639.0000005,83467063.12499996,784146.5999999999,133.0,14398.0,-23353106.0,10335090.0,-12115847.0,-13165937.0,-28.0,0.0,0.0,36972.0,0.0,0.0,0.0,0.0,0.0,-1846.0,-1662.0,-1041.0,-1637.0,252380511.62999967,3593784811.635002,4049272150.3800015,57623077.75499996,3593784811.635002,259349.0,-17848780.0,4134936000.0,181873504.0,926255197.0,401704966.0,970760321.0,257124.0,4036.0,721.147306549268,5965937.5,2118136.0,1305206.5,-4287871.0,1427629.0,102368.0,2838914439.4126744,2869728890.962612,-171869807.0,-170460720.5,3013991.5,141112.5,2608530285.959973,7086550500.0,,340351184.6099997,,,148040841.32999927,,345231696.68999994,2504326339.845001,2598828759.494966,2598957857.069965,,29729.0,,,859441.0,-1524606.0,671997.0,1420.0,1468533.0,14823097.0,3234913.0,8561800.0,11616156.0,1416922.0,1060140773.4345012,801922177.4624952,72155572463.99216,21693430764.022617,583110571.4819987,5792665.7475,689.5,94245.0,-277125718.0,22009642.0,-123870551.5,-218857444.0,-2022349.5,5926349474.70746,18736924500.0,,448259806.5299977,,,309284819.66249865,,459408101.7599993,5711388862.072536,5889607614.449998,5889850797.195,,80928.0,,,972016.5,-1699717.0,177364.0,6755.0,4276275.0,2481193.0,-9010080.0,921269.0,37582.5,3736465321.65746,3661131544.357461,-260813378.0,-257499293.5,2528276.5,269399.5,3929173663.837455,33277488620.13092,36708683247.225136,1730564378.5950494,48121979888.29572,3991195.5,-247752678.5,103162911506.0,1055262269.5,17285589977.5,3505970622.5,18899064484.0,3674740.0,71984.5,20883.778545412264,89836277.5,-68.42081742097993,2.0,6.282985674792662,211.8485060265021,12.565971349585324,423.6970120530043,37500.0,-0.9009688679024191,0.4338837391175582,0.0,0.0,0.0,0.0,0.0,1.0,0.0,0.0,0.0,0.0,0.0,0.0,0.0,1.0,0.0,0.0,0.0,0.0,1.0,1.0,0.0,0.0,0.0,0.0,0.0,1.0,0.0,0.0,0.0,0.0,0.0,0.0,0.0,0.0,0.0,0.0,0.0,0.0,0.0,0.0,0.0,0.0,1.0,0.0,0.0,0.0,0.0,0.0,0.0,0.0,0.0,0.0,0.0,0.0,0.0,0.0,0.0,0.0,0.0,0.0,0.0,0.0,0.0,0.0,0.0,0.0,0.0,0.0,0.0,0.0,0.0,0.0,0.0,0.0,0.0,0.0,0.0,0.0,0.0,0.0,0.0,0.0,0.0,0.0,0.0,0.0,0.0,0.0,0.0,0.0,1.0,0.0,0.0,0.0,0.0,0.0,0.0,0.0,0.0,0.0,0.0,0.0,0.0,0.0,0.0,0.0,0.0,0.0,1.0,0.0,1.0,0.0,0.0,1.0,0.0,0.0,0.0,0.0,0.0,0.0
104295,0,0.0,0.0,1.0,1.0,1.0,112500.0,156384.0,16551.0,135000.0,0.0105,27.197260273972606,-727.0,-2677.0,-836.0,3.0,3.0,3.0,3.0,16.0,0.7414201334470991,0.4768770199566782,,0.0674,0.0401,0.9826,,,,0.1293,0.1667,,,,0.0164,,,0.0315,0.0416,0.9816,,,,0.069,0.1667,,,,0.0171,,,0.0791,0.0401,0.9821,,,,0.1207,0.1667,,,,0.0167,,,0.0214,1.0,2.0,0.0,2.0,0.0,-517.0,0.0,0.0,0.0,0.0,1.0,3.0,1.0,1.0,0.0,1.0,0.0,0.0,0.0,0.0,0.0,0.0,0.0,0.0,0.0,1.0,0.0,0.0,0.0,0.0,0.0,0.0,0.0,0.0,0.0,0.0,0.0,0.0,0.0,0.0,0.0,0.0,0.0,0.0,1.0,87799.5,,90000.0,89640.0,,0.0,0.0,0.0,-522.0,574.0,-2.0,,18.0,-8.5,3.0,6560.1,57757.5,57757.5,0.0,57757.5,10.0,-517.0,365243.0,-479.0,365243.0,75.0,365243.0,14.0,0.0,0.0,52.0,36.0,10.0,9.0,-11.5,0.0,0.0,33.0,6560.1,6560.1,-308.0,-299.0,6.0,1.0,0.0,,,,,,,,,,,,,,,,,,,,,8352935019.0,184508537089.5,165682462536.0,52008265405.935,1863.0,1706.0,71125.0,70905.0,9141.0,506450.0,17822.0615000023,17884.297599999114,17335.390299998024,11303.778000000091,11241.579700000097,11188.943300000055,128510.0,663294.0,,,,13537095.679451656,-602394998.0,-922543656.0,-296721307.0,-1536319099.0416667,44050.0,30726.0,,,,22905.70280000976,22827.47720000972,22212.44880000829,67526.60566433451,158148.80490380753,,35028.85810002798,34968.99260002842,34414.42670002883,,,,3716781.0,,,,,,,16479.903899999743,16665.257799999694,16261.912999999702,,,,,,,436774.0,431567.0,1264023.0,6429.5219280029005,632406.0,625954.0,,16344.4055999998,154297.57879999068,154300.32339999027,154192.0487999872,,,,18.0,71481011.66999999,,7163841723.839995,2362995279.0000005,,784146.5999999999,133.0,14398.0,-23356150.0,10334002.0,-12116717.0,,-8.5,87799.5,,90000.0,89640.0,,0.0,0.0,0.0,-522.0,574.0,-2.0,,252486768.28499964,3595894479.135002,4051685855.8800015,57625732.75499996,3595894479.135002,259549.0,-17854329.0,4136762215.0,182235759.0,927350897.0,402068089.0,971853258.0,257250.0,4039.0,721.2486892624843,5966135.0,2118613.0,1305437.0,-4289419.5,1427629.0,102368.0,2839372584.075175,2870187035.6251125,-171910000.0,-170500630.0,3014242.0,141171.0,,,,,,,,,,,,,,,,,,,,,1468534.0,14823115.0,3234913.0,8561836.0,11616189.0,1416925.0,1060228572.9345012,,72155662463.99216,21693520404.022617,,5792665.7475,689.5,94245.0,-277126240.0,22010216.0,-123870553.5,,-2022358.0,,,,,,,,,,,,,,,,,,,,,4276285.0,2481202.0,-9010091.5,921269.0,37582.5,3736471881.75746,3661138104.457461,-260813686.0,-257499592.5,2528282.5,269400.5,3929180223.9374537,33277546377.63092,36708741004.725136,1730564378.5950494,48122037645.79572,3991205.5,-247753195.5,103163276749.0,1055261790.5,17285955220.5,3505970697.5,18899429727.0,3674754.0,71984.5,20883.778545412264,89836329.5,-26.73063362546591,1.39008,6.797172376291464,184.86446624505567,9.448613376835237,256.9763972379272,37500.0,-0.9009688679024191,-0.433883739117558,0.0,0.0,0.0,0.0,0.0,0.0,1.0,0.0,0.0,0.0,0.0,0.0,0.0,1.0,0.0,1.0,0.0,0.0,0.0,1.0,0.0,0.0,0.0,0.0,0.0,1.0,0.0,0.0,0.0,0.0,0.0,0.0,0.0,0.0,0.0,0.0,0.0,0.0,0.0,0.0,0.0,0.0,0.0,0.0,1.0,0.0,0.0,0.0,0.0,0.0,0.0,0.0,0.0,0.0,0.0,1.0,0.0,0.0,0.0,0.0,0.0,0.0,0.0,0.0,0.0,0.0,0.0,0.0,0.0,0.0,0.0,0.0,0.0,0.0,0.0,0.0,0.0,0.0,0.0,0.0,0.0,0.0,0.0,0.0,0.0,0.0,0.0,0.0,0.0,0.0,0.0,0.0,0.0,0.0,0.0,0.0,0.0,0.0,0.0,0.0,0.0,0.0,0.0,0.0,0.0,0.0,0.0,0.0,0.0,0.0,1.0,0.0,0.0,0.0,0.0,0.0,0.0,0.0,1.0,0.0
104297,0,0.0,0.0,1.0,0.0,1.0,157500.0,675000.0,28728.0,675000.0,0.015221,33.115068493150694,-980.0,-4406.0,-264.0,7.0,3.0,2.0,2.0,16.0,0.7431516886532299,0.6112574397912578,,0.0186,0.012,0.9836,0.7756,0.0034,0.0,0.1034,0.0417,0.0417,0.0139,0.0151,0.0121,0.0,0.0268,0.0189,0.0125,0.9836,0.7844,0.0034,0.0,0.1034,0.0417,0.0417,0.0142,0.0165,0.0126,0.0,0.0284,0.0187,0.012,0.9836,0.7786,0.0034,0.0,0.1034,0.0417,0.0417,0.0142,0.0154,0.0123,0.0,0.0274,0.0154,1.0,2.0,0.0,2.0,0.0,-912.0,,,,,,,1.0,1.0,0.0,1.0,0.0,0.0,0.0,0.0,0.0,1.0,1.0,0.0,0.0,1.0,0.0,0.0,0.0,0.0,0.0,0.0,0.0,0.0,0.0,0.0,0.0,0.0,0.0,0.0,0.0,0.0,0.0,0.0,0.0,,,,,,,,,,,,,0.0,,1.0,15944.58,135000.0,173839.5,,135000.0,18.0,-912.0,365243.0,-882.0,-372.0,-372.0,-365.0,8.0,1.0,,-1.0,19.0,18.0,9.0,-21.0,0.0,0.0,20.0,15944.58,15944.58,-656.5,-657.0,8.5,1.0,0.0,,,,,,,,,,,,,,,,,,,,,8352963747.0,184509212089.5,165683137536.0,52008422905.935,,,,,,,17822.0801000023,17884.316299999115,17335.409199998026,11303.790000000095,11241.591700000095,11188.955800000056,128511.0,663297.0,4141.173000000114,4138.864400000015,3949.432400000093,13537128.794520147,-602395978.0,-922543920.0,-296722219.0,-1536323505.0416667,44050.0,30726.0,11357.773999999186,11233.719999998984,10717.75199999729,22905.80620000976,22827.58060000972,22212.55220000829,67527.34881602316,158149.41616124733,,35028.89980002798,34969.03430002842,34414.46840002883,22970.140099995897,22943.191899995472,22589.955999995705,3716797.0,8301.590000000162,8406.195800000074,8129.687100000232,9824.427900000715,9939.42210000216,10299.480899999642,16479.915999999743,16665.270099999692,16261.925599999702,829.0258000001767,814.2024000000463,760.1253000000132,3916.751500000123,3899.967300000163,3732.63170000016,436776.0,431569.0,1264030.0,6429.537149002899,632408.0,625956.0,,16344.4209999998,154298.56239999068,154301.30699999028,154193.03239998722,77666.22319999633,78004.29060000657,78405.97500000657,,,,,,,,,,,,,,,,,,,,,,,,,,,252543191.48999965,3596474056.635002,4052321638.3800015,,3596474056.635002,259627.0,-17859257.0,4138588430.0,182231215.0,927710632.0,402065524.0,972213016.0,257308.0,4041.0,,5968415.0,2119473.0,1305951.0,-4290824.0,1427641.0,102380.0,2840086915.8751683,2870835570.9451075,-171959424.0,-170549392.0,3014616.5,141227.5,,,,,,,,,,,,,,,,,,,,,1468534.0,14823115.0,3234913.0,8561855.0,11616209.0,1416926.0,,,,,,,,,,,,,,,,,,,,,,,,,,,,,,,,,,4276303.0,2481211.0,-9010112.5,921269.0,37582.5,3736487826.33746,3661154049.037461,-260814342.5,-257500249.5,2528291.0,269401.5,3929196168.5174537,33277681377.63092,36708914844.225136,,48122172645.79572,3991223.5,-247754107.5,103163641992.0,1055260908.5,17285954848.5,3505970325.5,18899429362.0,3674762.0,71985.5,,89836328.5,-29.593778439645902,4.285714285714286,5.482456140350879,181.55191059841383,23.496240601503764,778.0796168503451,52500.0,1.0,0.0,0.0,0.0,0.0,0.0,0.0,0.0,1.0,0.0,0.0,0.0,0.0,0.0,0.0,1.0,0.0,1.0,0.0,0.0,0.0,0.0,1.0,0.0,0.0,0.0,0.0,1.0,0.0,0.0,0.0,0.0,0.0,0.0,0.0,0.0,0.0,0.0,0.0,0.0,0.0,0.0,0.0,0.0,0.0,0.0,0.0,0.0,0.0,0.0,0.0,0.0,0.0,1.0,0.0,0.0,0.0,0.0,0.0,0.0,0.0,0.0,0.0,0.0,0.0,0.0,0.0,0.0,0.0,0.0,0.0,0.0,0.0,0.0,0.0,0.0,0.0,0.0,0.0,0.0,0.0,0.0,0.0,0.0,0.0,0.0,0.0,0.0,0.0,0.0,0.0,0.0,0.0,0.0,0.0,0.0,0.0,0.0,0.0,0.0,0.0,0.0,0.0,0.0,0.0,0.0,0.0,0.0,0.0,0.0,1.0,0.0,1.0,0.0,0.0,0.0,0.0,0.0,0.0,0.0,1.0,0.0
104298,0,0.0,0.0,0.0,1.0,1.0,103500.0,307152.0,18918.0,243000.0,0.0105,27.389041095890413,-830.0,-2906.0,-1524.0,,3.0,3.0,3.0,17.0,,0.5269875610130074,0.6144143775673561,,,,,,,,,,,,,,,,,,,,,,,,,,,,,,,,,,,,,,,,,,,,,7.0,0.0,7.0,0.0,-694.0,0.0,0.0,0.0,0.0,1.0,1.0,1.0,1.0,0.0,1.0,0.0,0.0,0.0,0.0,0.0,1.0,1.0,0.0,0.0,1.0,0.0,0.0,0.0,0.0,0.0,0.0,0.0,0.0,0.0,0.0,0.0,0.0,0.0,0.0,0.0,0.0,0.0,0.0,6.0,65218.5,0.0,47250.0,0.0,0.0,0.0,0.0,0.0,-1483.5,175.5,-391.0,-628.0,240.0,-28.5,5.0,22241.745000000006,0.0,0.0,,495000.0,42.0,-473.0,365243.0,-552.0,-327.0,678.0,-320.5,14.0,0.5,,-1.0,19.0,48.0,39.0,-15.0,0.0,0.0,17.0,31251.15,31251.15,-446.0,-443.0,5.0,1.0,0.0,,,,,,,,,,,,,,,,,,,,,8352982665.0,184509519241.5,165683380536.0,52008526405.935,1863.0,1706.0,71125.0,70906.0,9141.0,506451.0,,,,,,,128512.0,663300.0,,,,13537156.183561243,-602396808.0,-922545444.0,-296722913.0,-1536326411.0416667,44050.0,30726.0,,,,,,,,158149.94314880835,126196.09467110188,,,,,,,3716814.0,,,,,,,,,,,,,,,,436783.0,431576.0,,6429.5476490029005,632411.0,625959.0,,,,,,,,,49.5,71577280.16999999,25559716.40999998,7170797821.589995,2369200041.0000005,83467063.12499996,784146.5999999999,133.0,14398.0,-23364610.0,10335727.0,-12121533.0,-13172866.0,-24.25,65218.5,0.0,49500.0,0.0,0.0,0.0,0.0,0.0,-1925.0,-1376.0,-1833.0,-1833.0,252572049.40499967,3597464056.635002,4053503963.8800015,,3597081556.635002,259687.0,-17860896.0,4139136294.5,182230441.5,927710143.5,402066505.5,972212537.0,257354.0,4042.0,,5968412.0,2120012.0,1306395.0,-4291187.0,1427641.0,102380.0,2840712784.9201684,2871453558.960108,-171968972.0,-170558880.0,3014760.0,141247.0,,,,,,,,,,,,,,,,,,,,,1468540.0,14823355.0,3234913.0,8561874.0,11616226.0,1416931.0,1060293791.4345012,801922177.4624952,72155709713.99216,21693520404.022617,583110571.4819987,5792665.7475,689.5,94245.0,-277127723.5,22010391.5,-123870944.5,-218858072.0,-2022386.5,,,,,,,,,,,,,,,,,,,,,4276351.0,2481250.0,-9010127.5,921269.0,37582.5,3736519077.48746,3661185300.187461,-260814788.5,-257500692.5,2528296.0,269402.5,3929218410.262454,33277681377.63092,36708914844.225136,,48122667645.79572,3991265.5,-247754580.5,103164007235.0,1055260356.5,17285954521.5,3505971003.5,18899429041.5,3674776.0,71986.0,,89836327.5,-30.30409122736821,2.967652173913044,5.470980019029496,149.84489657599414,16.235965746907706,444.68753307352415,34500.0,0.6234898018587336,0.7818314824680298,0.0,0.0,0.0,0.0,0.0,0.0,1.0,0.0,0.0,0.0,0.0,0.0,0.0,1.0,0.0,0.0,1.0,0.0,0.0,0.0,1.0,0.0,0.0,0.0,0.0,1.0,0.0,0.0,0.0,0.0,0.0,0.0,0.0,1.0,0.0,0.0,0.0,0.0,0.0,0.0,0.0,0.0,0.0,0.0,0.0,0.0,0.0,0.0,0.0,0.0,1.0,0.0,0.0,0.0,0.0,0.0,0.0,0.0,0.0,0.0,0.0,0.0,0.0,0.0,0.0,0.0,0.0,0.0,0.0,0.0,0.0,0.0,0.0,0.0,0.0,0.0,0.0,0.0,0.0,0.0,0.0,0.0,0.0,0.0,0.0,0.0,0.0,0.0,0.0,0.0,0.0,0.0,0.0,0.0,0.0,0.0,0.0,0.0,0.0,0.0,0.0,0.0,0.0,0.0,0.0,0.0,0.0,0.0,0.0,0.0,0.0,0.0,0.0,0.0,0.0,0.0,0.0,0.0,0.0,0.0
104308,0,0.0,0.0,1.0,0.0,0.0,135000.0,225000.0,17775.0,225000.0,0.010643,38.704109589041096,-2899.0,-4469.0,-5431.0,5.0,2.0,2.0,2.0,18.0,0.5581456309295246,0.2294821002977537,0.5567274263630174,,,,,,,,,,,,,,,,,,,,,,,,,,,,,,,,,,,,,,,,,,,,,1.0,0.0,1.0,0.0,-1072.0,0.0,0.0,0.0,0.0,0.0,2.0,1.0,1.0,1.0,1.0,1.0,0.0,0.0,0.0,0.0,0.0,1.0,1.0,0.0,1.0,0.0,0.0,0.0,0.0,0.0,0.0,0.0,0.0,0.0,0.0,0.0,0.0,0.0,0.0,0.0,0.0,0.0,0.0,9.0,14652.0,0.0,135000.0,0.0,0.0,0.0,0.0,0.0,-1708.0,-882.5,-423.0,-1342.0,496.0,-30.0,10.0,21878.325,23492.25,18792.0,17761.5,247500.0,12.0,-394.5,365243.0,-683.0,-353.0,-353.0,-351.0,16.0,0.0,0.1089311696868333,-1.0,27.0,10.0,5.0,-16.0,0.0,0.0,25.0,19157.31,19157.31,-467.0,-443.0,5.0,1.0,0.0,,,,,,,,,,,,,,,,,,,,,8353000440.0,184509744241.5,165683605536.0,52008661405.935,1863.0,1706.0,71125.0,70906.0,9141.0,506453.0,,,,,,,128512.0,663302.0,,,,13537194.887670832,-602399707.0,-922550875.0,-296723985.0,-1536330880.0416667,44050.0,30726.0,,,,,,,67527.9069616541,158150.17263090867,126196.65139852824,,,,,,,3716832.0,,,,,,,,,,,,,,,,436784.0,431577.0,1264035.0,6429.558292002899,632413.0,625961.0,,,,,,,,,57.0,71743121.95499998,25633739.60999998,7185857195.699995,2373584316.840001,83901223.70999996,784146.5999999999,133.0,14398.0,-23436884.0,10481058.0,-12155306.0,-13214855.0,-28.0,14652.0,0.0,157500.0,0.0,0.0,0.0,0.0,0.0,-2012.0,-1342.0,-625.0,-2286.0,253324027.4849997,3609061168.275003,4066140272.2200017,57803421.55499996,3609398668.275003,260510.0,-17909784.5,4148084285.0,182568111.0,929880306.0,402779098.0,974382827.0,258001.5,4046.0,723.5383771830649,5980897.5,2125323.0,1309812.0,-4301272.0,1427768.0,102412.0,2847543289.785165,2877659978.715108,-172262750.0,-170849977.0,3017407.0,141538.0,,,,,,,,,,,,,,,,,,,,,1468549.0,14823851.0,3234913.0,8561901.0,11616251.0,1416941.0,1060308443.4345012,801922177.4624952,72155844713.99216,21693520404.022617,583110571.4819987,5792665.7475,689.5,94245.0,-277129431.5,22009509.0,-123871367.5,-218859414.0,-2022416.5,,,,,,,,,,,,,,,,,,,,,4276361.0,2481255.0,-9010143.5,921269.0,37582.5,3736538234.79746,3661204457.497461,-260815255.5,-257501135.5,2528301.0,269403.5,3929240288.587454,33277704869.88092,36708933636.225136,1730582140.0950494,48122915145.79572,3991277.5,-247754975.0,103164372478.0,1055259673.5,17285954168.5,3505970650.5,18899428690.5,3674792.0,71986.0,20883.88747658195,89836326.5,-74.90160685212712,1.6666666666666667,7.594936708860758,293.95526270157785,12.658227848101266,489.9254378359632,67500.0,0.6234898018587334,-0.7818314824680299,0.0,0.0,0.0,0.0,0.0,0.0,1.0,0.0,0.0,0.0,0.0,0.0,0.0,1.0,0.0,0.0,0.0,0.0,1.0,0.0,1.0,0.0,0.0,0.0,0.0,1.0,0.0,0.0,0.0,0.0,0.0,0.0,0.0,0.0,0.0,0.0,0.0,0.0,0.0,0.0,0.0,0.0,0.0,0.0,1.0,0.0,0.0,0.0,0.0,0.0,0.0,0.0,0.0,0.0,0.0,0.0,0.0,0.0,0.0,0.0,0.0,0.0,0.0,0.0,0.0,0.0,0.0,0.0,0.0,0.0,0.0,0.0,0.0,0.0,0.0,0.0,0.0,0.0,0.0,0.0,0.0,0.0,0.0,0.0,0.0,0.0,0.0,0.0,0.0,0.0,1.0,0.0,0.0,0.0,0.0,0.0,0.0,0.0,0.0,0.0,0.0,0.0,0.0,0.0,0.0,0.0,0.0,0.0,0.0,0.0,0.0,0.0,0.0,0.0,0.0,0.0,0.0,0.0,0.0,0.0
104318,0,0.0,0.0,0.0,1.0,0.0,81000.0,360000.0,18508.5,360000.0,0.026392,36.12328767123287,-1158.0,-7176.0,-2571.0,,1.0,2.0,2.0,9.0,0.7131528255668017,0.6372094460772728,0.5867400085415683,0.0928,0.1006,0.9826,,,0.0,0.2069,0.1667,,0.0667,,0.087,,0.0,0.0945,0.1044,0.9826,,,0.0,0.2069,0.1667,,0.0682,,0.0907,,0.0,0.0937,0.1006,0.9826,,,0.0,0.2069,0.1667,,0.0679,,0.0886,,0.0,0.0685,1.0,3.0,0.0,3.0,0.0,-704.0,0.0,0.0,0.0,0.0,0.0,0.0,1.0,1.0,0.0,1.0,0.0,0.0,0.0,0.0,0.0,0.0,0.0,0.0,0.0,1.0,0.0,0.0,0.0,0.0,0.0,0.0,0.0,0.0,0.0,0.0,0.0,0.0,0.0,0.0,0.0,0.0,0.0,0.0,1.0,0.0,,78993.0,0.0,,0.0,0.0,0.0,-359.0,-231.0,-217.0,-231.0,12.0,-5.5,1.0,9478.89,48690.0,51259.5,0.0,48690.0,6.0,-704.0,365243.0,-669.0,-669.0,-519.0,-661.0,10.0,0.0,0.0,20.0,3.0,3.5,3.0,-23.0,0.0,0.0,1.0,52824.15,52824.15,-679.0,-669.0,1.0,2.0,0.0,,,,,,,,,,,,,,,,,,,,,8353018948.5,184510104241.5,165683965536.0,52008742405.935,1863.0,1706.0,71125.0,70906.0,9141.0,506453.0,17822.172900002293,17884.409999999116,17335.503699998022,11303.890600000092,11241.692300000095,11189.060200000056,128512.0,663303.0,,,,13537231.010958502,-602400865.0,-922553446.0,-296724689.0,-1536338056.0416667,44050.0,30726.0,11357.773999999186,11233.719999998984,10717.75199999729,22906.01310000976,22827.787500009723,22212.759100008287,67528.62011447968,158150.80984035472,126197.23813853678,35029.066500027984,34969.20100002842,34414.63510002884,,,,3716841.0,8301.656700000161,8406.263700000074,8129.755300000232,,,,16480.002999999742,16665.35869999969,16262.016299999705,,,,3916.751500000123,3899.967300000163,3732.63170000016,436787.0,431580.0,,6429.584684002899,632415.0,625963.0,,16344.4894999998,154299.54499999067,154302.28959999027,154194.0149999872,,,,12.0,71836523.95499998,,7206067748.249995,2384002166.895001,,784146.5999999999,133.0,14398.0,-23499071.0,10560665.0,-12182977.0,-13240554.0,-5.5,0.0,,78993.0,0.0,,0.0,0.0,0.0,-359.0,-231.0,-217.0,-231.0,253770045.20999968,3615801727.275003,4073198094.7200017,57962096.05499996,3615801727.275003,261014.0,-17945848.0,4157945846.0,182906605.0,931686980.0,402762212.0,976189633.0,258578.0,4050.0,726.3643928513812,6004883.0,2129110.5,1312057.0,-4309392.0,1427773.0,102417.0,2852600751.990149,2882682408.690094,-172647823.0,-171232196.0,3024381.0,141797.0,,,,,,,,,,,,,,,,,,,,,1468550.0,14823863.0,3234913.0,8561904.0,11616252.0,1416942.0,1060308443.4345012,,72155923706.99216,21693520404.022617,,5792665.7475,689.5,94245.0,-277129790.5,22009278.0,-123871584.5,-218859645.0,-2022422.0,,,,,,,,,,,,,,,,,,,,,4276364.5,2481258.0,-9010166.5,921269.0,37582.5,3736591058.94746,3661257281.647461,-260815934.5,-257501804.5,2528302.0,269405.5,3929249767.477453,33277753559.88092,36708984895.725136,1730582140.0950494,48122963835.79572,3991283.5,-247755679.0,103164737721.0,1055259004.5,17285953499.5,3505970131.5,18899428029.5,3674802.0,71986.0,20883.88747658195,89836346.5,-32.056882821387944,4.4444444444444455,4.3763676148796495,158.08878630736487,19.450522732798444,702.6168280327327,81000.0,-0.2225209339563143,0.9749279121818236,0.0,1.0,0.0,0.0,0.0,0.0,0.0,0.0,0.0,0.0,0.0,0.0,0.0,1.0,0.0,0.0,0.0,0.0,1.0,0.0,0.0,0.0,1.0,0.0,0.0,1.0,0.0,0.0,0.0,0.0,0.0,0.0,0.0,0.0,0.0,0.0,1.0,0.0,0.0,0.0,0.0,0.0,0.0,0.0,0.0,0.0,0.0,0.0,0.0,0.0,0.0,0.0,1.0,0.0,0.0,0.0,0.0,0.0,0.0,0.0,0.0,0.0,0.0,0.0,0.0,0.0,0.0,0.0,0.0,0.0,0.0,0.0,0.0,0.0,0.0,0.0,0.0,0.0,0.0,0.0,0.0,0.0,0.0,0.0,0.0,0.0,0.0,0.0,0.0,0.0,0.0,0.0,0.0,0.0,0.0,0.0,0.0,0.0,0.0,0.0,0.0,0.0,0.0,0.0,0.0,0.0,0.0,0.0,0.0,0.0,1.0,0.0,0.0,0.0,0.0,0.0,0.0,1.0,0.0,0.0
104319,0,0.0,0.0,0.0,0.0,0.0,247500.0,900000.0,36135.0,900000.0,0.035792,60.580821917808215,,-1118.0,-2267.0,,2.0,2.0,2.0,13.0,,0.588900780040256,0.3344541255096772,0.0247,,0.9801,,,0.0,0.069,0.125,,,,0.0261,,,0.0252,,0.9801,,,0.0,0.069,0.125,,,,0.0272,,,0.025,,0.9801,,,0.0,0.069,0.125,,,,0.0266,,,0.0206,1.0,1.0,1.0,1.0,1.0,-771.0,0.0,0.0,0.0,0.0,0.0,0.0,1.0,0.0,0.0,1.0,1.0,0.0,0.0,0.0,0.0,0.0,0.0,0.0,0.0,1.0,0.0,0.0,0.0,0.0,0.0,0.0,0.0,0.0,0.0,0.0,0.0,0.0,0.0,0.0,0.0,0.0,0.0,0.0,4.0,0.0,5497.155,285750.0,163962.0,0.0,0.0,0.0,0.0,-1311.0,-891.0,-104.5,-1104.0,166.0,-22.0,1.0,29129.805,337500.0,368685.0,,337500.0,24.0,-771.0,365243.0,-741.0,-561.0,-51.0,-556.0,10.0,1.0,,-1.0,8.0,24.0,20.5,-22.5,0.0,0.0,8.0,29129.805,29129.805,-652.0,-636.0,4.5,1.0,0.0,,,,,,,,,,,,,,,,,,,,,8353055083.5,184511004241.5,165684865536.0,52008989905.935,1863.0,1706.0,71125.0,70906.0,9141.0,506453.0,17822.1976000023,17884.434999999117,17335.528899998022,,,,128512.0,663305.0,,,,13537291.59178042,,-922555713.0,-296725460.0,-1536339174.0416667,44051.0,30727.0,11357.773999999186,11233.719999998984,10717.75199999729,22906.08210000976,22827.85650000972,22212.82810000829,,158151.39874113473,126197.57259266228,35029.191500027984,34969.32600002842,34414.76010002884,,,,3716854.0,,,,,,,16480.029099999738,16665.385299999693,16262.043499999703,,,,,,,436788.0,431581.0,,6429.6204760029,632417.0,625965.0,,16344.5100999998,154300.52509999066,154303.26969999023,154194.9950999872,,,,43.5,71836523.95499998,25672135.252499983,7206915998.249995,2384569360.395001,84152550.86999997,784146.5999999999,133.0,14398.0,-23501399.0,10559572.0,-12183190.0,-13241860.0,-21.25,0.0,3847.905,225000.0,0.0,0.0,0.0,0.0,0.0,-1458.0,-1378.0,-201.0,-1804.0,253799175.0149997,3616139227.275003,4073566779.7200017,,3616139227.275003,261038.0,-17946619.0,4158311089.0,182905864.0,931686419.0,402762161.0,976189077.0,258588.0,4051.0,,6004882.0,2129202.0,1312130.5,-4309513.5,1427773.0,102417.0,2852731836.112649,2882799843.300093,-172650853.0,-171235200.5,3024396.5,141801.5,,,,,,,,,,,,,,,,,,,,,1468554.0,14824029.0,3234913.0,8561912.0,11616260.0,1416943.0,1060308443.4345012,801927674.6174952,72156209456.99216,21693684366.022617,583110571.4819987,5792665.7475,689.5,94245.0,-277131101.5,22008387.0,-123871689.0,-218860749.0,-2022444.0,,,,,,,,,,,,,,,,,,,,,4276388.5,2481278.5,-9010189.0,921269.0,37582.5,3736620188.75246,3661286411.452461,-260816586.5,-257502440.5,2528306.5,269406.5,3929278897.282453,33278091059.88092,36709353580.725136,,48123301335.79572,3991307.5,-247756450.0,103165102964.0,1055258263.5,17285952938.5,3505970080.5,18899427473.5,3674812.0,71987.0,,89836345.5,,3.636363636363636,6.849315068493151,414.937136423344,24.90660024906601,1508.8623142667057,123750.0,0.6234898018587336,0.7818314824680298,0.0,0.0,0.0,0.0,0.0,0.0,1.0,0.0,0.0,1.0,0.0,0.0,0.0,0.0,0.0,0.0,0.0,0.0,1.0,0.0,1.0,0.0,0.0,0.0,0.0,1.0,0.0,0.0,0.0,0.0,0.0,0.0,0.0,0.0,0.0,0.0,0.0,0.0,0.0,0.0,0.0,0.0,0.0,0.0,0.0,0.0,0.0,0.0,0.0,0.0,0.0,0.0,0.0,0.0,0.0,0.0,0.0,0.0,0.0,0.0,0.0,0.0,0.0,0.0,0.0,0.0,0.0,0.0,0.0,0.0,0.0,0.0,0.0,0.0,0.0,0.0,0.0,0.0,0.0,0.0,0.0,0.0,0.0,0.0,0.0,0.0,0.0,0.0,0.0,0.0,0.0,0.0,0.0,0.0,0.0,0.0,0.0,0.0,0.0,0.0,0.0,0.0,0.0,0.0,0.0,1.0,0.0,0.0,0.0,0.0,1.0,0.0,0.0,0.0,0.0,0.0,0.0,0.0,1.0,0.0
104320,0,0.0,1.0,1.0,1.0,0.0,135000.0,711454.5,56340.0,643500.0,0.003813,47.32876712328767,-537.0,-110.0,-825.0,16.0,2.0,2.0,2.0,8.0,,0.6985864160740857,0.3672910183026313,,,,,,,,,,,,,,,,,,,,,,,,,,,,,,,,,,,,,,,,,,,,,1.0,0.0,1.0,0.0,-403.0,0.0,0.0,0.0,0.0,0.0,1.0,1.0,1.0,0.0,1.0,0.0,0.0,0.0,0.0,0.0,0.0,1.0,1.0,0.0,1.0,0.0,0.0,0.0,0.0,0.0,0.0,0.0,0.0,0.0,0.0,0.0,0.0,0.0,0.0,0.0,0.0,0.0,0.0,17.0,0.0,0.0,69220.71,0.0,0.0,0.0,0.0,0.0,-964.0,-625.5,-453.0,-625.0,490.0,-15.0,4.0,5593.77,34605.0,34605.0,0.0,34605.0,6.0,-377.0,365243.0,-348.0,-198.0,-198.0,365243.0,9.0,0.0,0.0,50.0,24.0,6.0,2.5,-7.0,0.0,0.0,16.0,5593.77,5593.77,-264.5,-253.5,3.0,1.0,0.0,,,,,,,,,,,,,,,,,,,,,8353111423.5,184511715696.0,165685509036.0,52009124905.935,1863.0,1706.0,71125.0,70906.0,9141.0,506454.0,,,,,,,128512.0,663307.0,,,,13537338.920547543,-602401402.0,-922556538.0,-296725863.0,-1536339284.0416667,44051.0,30727.0,,,,,,,,158152.09732755087,126197.9398836806,,,,,,,3716862.0,,,,,,,,,,,,,,,,436789.0,431582.0,1264051.0,6429.624289002899,632419.0,625967.0,,,,,,,,,32.0,71871173.95499998,25674059.204999983,7207613220.959995,2384733322.395001,84152550.86999997,784146.5999999999,133.0,14398.0,-23511532.0,10553324.0,-12190621.0,-13248589.0,-15.5,0.0,0.0,73872.0,0.0,0.0,0.0,0.0,0.0,-1101.0,-844.0,-796.0,-844.0,253824745.8149997,3616291664.775003,4073719217.2200017,57962096.05499996,3616291664.775003,261054.0,-17947336.5,4159041575.0,182905401.0,932051245.0,402761942.0,976919373.0,258611.5,4051.0,726.3643928513812,6005575.0,2129361.0,1312225.0,-4309682.0,1427773.0,102417.0,2853274803.345149,2883327330.240094,-172655042.0,-171239283.0,3024440.5,141814.5,,,,,,,,,,,,,,,,,,,,,1468571.0,14824519.0,3234913.0,8561936.0,11616276.0,1416947.0,1060308443.4345012,801927674.6174952,72156278677.70216,21693684366.022617,583110571.4819987,5792665.7475,689.5,94245.0,-277132065.5,22007761.5,-123872142.0,-218861374.0,-2022459.0,,,,,,,,,,,,,,,,,,,,,4276394.5,2481281.0,-9010196.0,921269.0,37582.5,3736625782.52246,3661292005.2224607,-260816851.0,-257502694.0,2528309.5,269407.5,3929284491.052453,33278125664.88092,36709388185.725136,1730582140.0950494,48123335940.79572,3991313.5,-247756827.0,103165468207.0,1055257915.5,17285952740.5,3505969882.5,18899792716.5,3674821.0,71987.0,20883.88747658195,89836395.5,-11.346164978292329,5.270033333333333,2.396166134185304,113.4075889535647,12.627875399361024,597.6617740382511,67500.0,1.0,0.0,0.0,0.0,0.0,0.0,0.0,0.0,1.0,0.0,0.0,0.0,0.0,0.0,0.0,1.0,0.0,0.0,0.0,0.0,1.0,0.0,1.0,0.0,0.0,0.0,0.0,1.0,0.0,0.0,0.0,0.0,0.0,0.0,1.0,0.0,0.0,0.0,0.0,0.0,0.0,0.0,0.0,0.0,0.0,0.0,0.0,0.0,0.0,0.0,0.0,0.0,0.0,0.0,0.0,0.0,0.0,0.0,0.0,0.0,0.0,0.0,0.0,0.0,0.0,0.0,0.0,0.0,0.0,0.0,0.0,0.0,0.0,0.0,0.0,0.0,0.0,0.0,0.0,0.0,0.0,0.0,0.0,0.0,0.0,0.0,0.0,0.0,0.0,0.0,0.0,0.0,1.0,0.0,0.0,0.0,0.0,0.0,0.0,0.0,0.0,0.0,0.0,0.0,0.0,0.0,0.0,0.0,0.0,0.0,0.0,0.0,0.0,0.0,0.0,0.0,0.0,0.0,0.0,0.0,0.0,0.0
104327,0,0.0,1.0,1.0,0.0,0.0,135000.0,319500.0,16335.0,319500.0,0.014464,36.484931506849314,-900.0,-7101.0,-4834.0,20.0,2.0,2.0,2.0,10.0,,0.5875607250393726,,0.1072,0.0891,0.9831,,,0.16,0.1379,0.3333,,,,0.1436,,0.018,0.1092,0.0925,0.9831,,,0.1611,0.1379,0.3333,,,,0.1496,,0.0191,0.1083,0.0891,0.9831,,,0.16,0.1379,0.3333,,,,0.1462,,0.0184,0.1129,1.0,2.0,1.0,2.0,1.0,-481.0,0.0,0.0,0.0,0.0,0.0,4.0,1.0,1.0,1.0,1.0,0.0,0.0,0.0,0.0,0.0,1.0,1.0,1.0,0.0,1.0,0.0,0.0,0.0,0.0,0.0,0.0,0.0,0.0,0.0,0.0,0.0,0.0,0.0,0.0,0.0,0.0,0.0,0.0,1.0,67099.5,65326.5,2250000.0,,,0.0,0.0,0.0,-736.0,1090.0,-33.0,,25.0,-12.0,4.0,18788.985,0.0,0.0,20250.0,202495.5,12.0,-445.0,365243.0,-451.0,-361.0,-121.0,-356.0,4.0,1.0,0.101103871991358,-1.0,5.0,12.0,10.0,-14.0,0.0,0.0,4.0,18788.985,18788.985,-416.0,-406.0,2.5,1.0,0.0,,,,,,,,,,,,,,,,,,,,,8353127758.5,184512035196.0,165685828536.0,52009259905.935,1863.0,1706.0,71125.0,70906.0,9141.0,506458.0,17822.304800002294,17884.543299999117,17335.638099998017,11303.979700000093,11241.781400000094,11189.152700000055,128512.0,663309.0,,,,13537375.40547905,-602402302.0,-922561372.0,-296726344.0,-1536346385.0416667,44052.0,30728.0,11357.933999999186,11233.879999998982,10717.91309999729,22906.22000000976,22827.99440000972,22212.966000008288,,158152.6848882759,,35029.52480002798,34969.65930002842,34415.09340002883,,,,3716872.0,,,,,,,16480.172699999737,16665.53149999969,16262.193099999704,,,,3916.769500000123,3899.985700000163,3732.65080000016,436791.0,431584.0,1264071.0,6429.638753002899,632421.0,625969.0,,16344.6229999998,154301.5081999907,154304.25279999027,154195.9781999872,,,,25.0,72368585.95499998,25752448.664999984,7215694939.214995,,,784146.5999999999,133.0,16969.0,-23556456.0,10529473.0,-12217050.0,,-12.0,67099.5,65326.5,2250000.0,,,0.0,0.0,0.0,-736.0,1090.0,-33.0,,254020630.90499973,3618317966.175003,4075865645.2200017,58032773.95499995,3618317966.175003,261326.0,-17967875.0,4165250706.0,182887593.0,932768053.0,402750520.0,977636269.0,258919.0,4054.0,727.3571957628978,6011752.5,2132016.0,1313903.0,-4316153.0,1427808.0,102428.0,2854979378.482646,2885014805.107592,-172832905.0,-171415356.5,3025414.5,141974.5,,,,,,,,,,,,,,,,,,,,,1468572.0,14824544.0,3234913.0,8561941.0,11616280.0,1416951.0,1060375542.9345012,801993001.1174952,72158528677.70216,,,5792665.7475,689.5,94245.0,-277132801.5,22008851.5,-123872175.0,,-2022471.0,,,,,,,,,,,,,,,,,,,,,4276406.5,2481291.0,-9010210.0,921269.0,37582.5,3736644571.50746,3661310794.207461,-260817267.0,-257503100.0,2528312.0,269408.5,3929303280.037453,33278125664.88092,36709388185.725136,1730602390.0950494,48123538436.29572,3991325.5,-247757272.0,103165833450.0,1055257464.5,17285952379.5,3505969761.5,18899792360.5,3674825.0,71988.0,20883.98858045394,89836394.5,-24.66771795449425,2.3666666666666667,8.264462809917353,301.5283595607381,19.55922865013774,713.6171176270802,67500.0,-0.9009688679024191,-0.433883739117558,0.0,0.0,0.0,0.0,0.0,0.0,1.0,0.0,0.0,0.0,0.0,0.0,0.0,1.0,0.0,0.0,0.0,0.0,1.0,0.0,1.0,0.0,0.0,0.0,0.0,1.0,0.0,0.0,0.0,0.0,0.0,0.0,0.0,0.0,0.0,0.0,0.0,0.0,0.0,0.0,0.0,0.0,0.0,0.0,0.0,0.0,1.0,0.0,0.0,0.0,0.0,0.0,0.0,1.0,0.0,0.0,0.0,0.0,0.0,0.0,0.0,0.0,0.0,0.0,0.0,0.0,0.0,0.0,0.0,0.0,0.0,0.0,0.0,0.0,0.0,0.0,0.0,0.0,0.0,0.0,0.0,0.0,0.0,0.0,0.0,0.0,0.0,0.0,0.0,0.0,0.0,0.0,0.0,0.0,0.0,0.0,0.0,0.0,0.0,0.0,0.0,0.0,0.0,0.0,0.0,0.0,0.0,0.0,0.0,0.0,1.0,0.0,0.0,0.0,0.0,0.0,0.0,0.0,1.0,0.0
104334,0,0.0,0.0,0.0,0.0,1.0,157500.0,118512.0,8622.0,90000.0,0.019101,23.86849315068493,-1336.0,-1379.0,-1395.0,,3.0,2.0,2.0,11.0,0.3945285038348983,0.6916676343381298,,0.0165,0.0208,0.9752,0.66,0.0013,0.0,0.069,0.0417,0.0417,0.0101,0.0134,0.0124,0.0,0.0,0.0168,0.0216,0.9752,0.6733,0.0013,0.0,0.069,0.0417,0.0417,0.0103,0.0147,0.013,0.0,0.0,0.0167,0.0208,0.9752,0.6645,0.0013,0.0,0.069,0.0417,0.0417,0.0103,0.0137,0.0127,0.0,0.0,0.0105,1.0,0.0,0.0,0.0,0.0,-455.0,,,,,,,1.0,1.0,1.0,1.0,0.0,0.0,0.0,0.0,0.0,0.0,0.0,0.0,0.0,1.0,0.0,0.0,0.0,0.0,0.0,0.0,0.0,0.0,0.0,0.0,0.0,0.0,0.0,0.0,0.0,0.0,0.0,0.0,0.0,,,,,,,,,,,,,0.0,,1.0,4716.0,41521.5,41521.5,0.0,41521.5,10.0,-455.0,365243.0,-387.0,-177.0,-117.0,-173.0,12.0,0.0,0.0,61.0,11.0,10.0,6.0,-10.0,0.0,0.0,8.0,4716.0,4716.0,-345.0,-282.0,4.5,1.0,0.0,,,,,,,,,,,,,,,,,,,,,8353136380.5,184512153708.0,165685918536.0,52009417405.935,,,,,,,17822.3213000023,17884.559999999117,17335.654899998022,11304.000500000093,11241.802200000096,11189.174300000055,128513.0,663312.0,4141.174300000115,4138.865700000015,3949.433700000093,13537399.273972198,-602403638.0,-922562767.0,-296726799.0,-1536347764.0416667,44052.0,30728.0,11357.933999999186,11233.879999998982,10717.91309999729,22906.28900000976,22828.063400009723,22213.035000008287,67529.0146429835,158153.37655591025,,35029.566500027984,34969.70100002842,34415.13510002884,22970.1817999959,22943.233599995478,22589.997699995707,3716883.0,8301.666800000161,8406.274000000074,8129.765600000232,9824.441300000715,9939.435800002158,10299.495599999642,16480.185099999737,16665.54419999969,16262.206099999705,829.0258000001767,814.2024000000463,760.1253000000132,3916.769500000123,3899.985700000163,3732.65080000016,436791.0,431584.0,,6429.6578540029,632423.0,625971.0,,16344.6334999998,154302.48339999066,154305.22799999025,154196.9533999872,77666.88319999633,78004.95510000657,78406.64830000658,,,,,,,,,,,,,,,,,,,,,,,,,,,254341448.8199997,3622256340.075003,4080082585.3200016,58096864.75499995,3622256340.075003,261604.0,-17994134.0,4172552688.0,183601634.0,935679664.0,403838814.0,980548645.0,259377.0,4060.0,728.3769325899945,6027553.0,2134902.0,1315841.0,-4320397.0,1427808.0,102428.0,2857474330.425141,2887582142.070086,-173077832.5,-171658215.5,3030737.0,142155.5,,,,,,,,,,,,,,,,,,,,,1468572.0,14824544.0,3234913.0,8561952.0,11616288.0,1416952.0,,,,,,,,,,,,,,,,,,,,,,,,,,,,,,,,,,4276416.5,2481297.0,-9010220.0,921269.0,37582.5,3736649287.50746,3661315510.207461,-260817612.0,-257503382.0,2528316.5,269409.5,3929307996.037453,33278167186.38092,36709429707.225136,1730602390.0950494,48123579957.79572,3991335.5,-247757727.0,103166198693.0,1055257077.5,17285952202.5,3505969644.5,18899792187.5,3674837.0,71988.0,20883.98858045394,89836455.5,-55.97337006427916,0.7524571428571428,18.26722338204593,436.01109617639486,13.745302713987474,328.079663682901,52500.0,-0.9009688679024191,-0.433883739117558,0.0,0.0,0.0,0.0,0.0,0.0,1.0,0.0,0.0,0.0,0.0,0.0,0.0,1.0,0.0,0.0,0.0,0.0,1.0,0.0,1.0,0.0,0.0,0.0,0.0,1.0,0.0,0.0,0.0,0.0,0.0,0.0,0.0,1.0,0.0,0.0,0.0,0.0,0.0,0.0,0.0,0.0,0.0,0.0,0.0,0.0,0.0,0.0,0.0,0.0,0.0,0.0,0.0,0.0,0.0,0.0,0.0,0.0,0.0,0.0,0.0,0.0,0.0,0.0,0.0,0.0,0.0,0.0,0.0,0.0,0.0,0.0,0.0,0.0,0.0,0.0,0.0,0.0,0.0,0.0,0.0,0.0,0.0,0.0,0.0,0.0,0.0,0.0,0.0,0.0,1.0,0.0,0.0,0.0,0.0,0.0,0.0,0.0,0.0,0.0,0.0,0.0,0.0,0.0,0.0,0.0,0.0,0.0,1.0,0.0,1.0,0.0,0.0,0.0,0.0,0.0,0.0,0.0,1.0,0.0
104344,0,0.0,1.0,0.0,1.0,0.0,103500.0,573408.0,29407.5,495000.0,0.0066709999999999,52.865753424657534,-2798.0,-9375.0,-2796.0,,2.0,2.0,2.0,12.0,,0.4321470176965849,0.7583930617144343,,,,,,,,,,,,,,,,,,,,,,,,,,,,,,,,,,,,,,,,,,,,1.0,2.0,0.0,2.0,0.0,0.0,0.0,0.0,0.0,0.0,0.0,0.0,1.0,1.0,0.0,1.0,0.0,0.0,0.0,0.0,0.0,0.0,1.0,1.0,0.0,1.0,0.0,0.0,0.0,0.0,0.0,0.0,0.0,0.0,0.0,0.0,0.0,0.0,0.0,0.0,0.0,0.0,0.0,0.0,1.0,40945.5,0.0,1368000.0,,,0.0,0.0,0.0,-306.0,1521.0,-32.0,,11.0,-5.0,2.0,17250.5475,208784.25,205566.75,20880.0,208784.25,14.0,-1660.0,365243.0,-1627.5,-1252.5,-1237.5,-1248.5,14.0,0.5,0.1006988150271552,10.0,28.0,18.0,7.5,-19.5,0.0,0.0,27.0,20767.455,20767.455,-592.0,-581.0,7.0,1.0,0.0,,,,,,,,,,,,,,,,,,,,,8353165788.0,184512727116.0,165686413536.0,52009520905.935,1863.0,1706.0,71125.0,70906.0,9141.0,506458.0,,,,,,,128513.0,663314.0,,,,13537452.139725626,-602406436.0,-922565563.0,-296726799.0,-1536357139.0416667,44052.0,30728.0,,,,,,,,158153.80870292793,126198.6982767423,,,,,,,3716895.0,,,,,,,,,,,,,,,,436793.0,431586.0,,6429.6645250029,632425.0,625973.0,,,,,,,,,11.0,72456164.95499998,25756620.569999985,7242056346.149995,,,784146.5999999999,133.0,16969.0,-23605436.0,10548117.0,-12239220.0,,-5.0,40945.5,0.0,1368000.0,,,0.0,0.0,0.0,-306.0,1521.0,-32.0,,254690166.3974998,3628762190.325003,4086929918.0700016,58154793.25499995,3628762190.325003,261991.0,-18016419.0,4178944378.5,183949131.5,936396544.5,404196856.5,981265615.0,259734.0,4068.0,729.2382940652435,6030486.0,2138619.0,1318467.0,-4325596.5,1427808.0,102428.0,2863980149.5801315,2895846602.9850783,-173227159.0,-171805499.0,3032015.0,142353.0,,,,,,,,,,,,,,,,,,,,,1468573.0,14824555.0,3234913.0,8561980.0,11616315.0,1416954.0,1060416488.4345012,801993001.1174952,72159896677.70216,,,5792665.7475,689.5,94245.0,-277133107.5,22010372.5,-123872207.0,,-2022476.0,,,,,,,,,,,,,,,,,,,,,4276434.5,2481304.5,-9010239.5,921269.0,37582.5,3736670054.96246,3661336277.662461,-260818204.0,-257503963.0,2528323.5,269410.5,3929325246.584954,33278375970.63092,36709635273.975136,1730623270.0950494,48123788742.04572,3991349.5,-247759387.0,103166563936.0,1055255450.0,17285950950.0,3505968407.0,18899790939.0,3674851.0,71988.5,20884.089279268966,89836465.5,-52.92651326699835,5.540173913043478,3.519510328997705,186.061565228328,19.498699311400152,1030.81342989802,51750.0,-0.2225209339563146,-0.9749279121818236,0.0,0.0,0.0,0.0,0.0,1.0,0.0,0.0,0.0,0.0,0.0,0.0,0.0,1.0,0.0,0.0,0.0,0.0,1.0,0.0,1.0,0.0,0.0,0.0,0.0,1.0,0.0,0.0,0.0,0.0,0.0,0.0,0.0,0.0,0.0,0.0,0.0,0.0,0.0,0.0,0.0,0.0,0.0,0.0,0.0,0.0,0.0,0.0,0.0,0.0,0.0,0.0,0.0,0.0,0.0,0.0,0.0,0.0,0.0,0.0,0.0,0.0,0.0,0.0,0.0,0.0,0.0,0.0,0.0,0.0,0.0,0.0,0.0,0.0,0.0,0.0,0.0,0.0,0.0,0.0,0.0,1.0,0.0,0.0,0.0,0.0,0.0,0.0,0.0,0.0,0.0,0.0,0.0,0.0,0.0,0.0,0.0,0.0,0.0,0.0,0.0,0.0,0.0,0.0,0.0,0.0,0.0,0.0,0.0,0.0,0.0,0.0,0.0,0.0,0.0,0.0,0.0,0.0,0.0,0.0
104350,0,0.0,0.0,0.0,1.0,0.0,112500.0,296280.0,19062.0,225000.0,0.025164,47.865753424657534,-550.0,-4710.0,-1021.0,,2.0,2.0,2.0,11.0,,0.584356325094285,0.8327850252992314,,,,,,,,,,,,,,,,,,,,,,,,,,,,,,,,,,,,,,,,,,,,,0.0,0.0,0.0,0.0,0.0,0.0,0.0,0.0,0.0,1.0,1.0,1.0,1.0,0.0,1.0,1.0,0.0,0.0,0.0,0.0,0.0,0.0,0.0,0.0,1.0,0.0,0.0,0.0,0.0,0.0,0.0,0.0,0.0,0.0,0.0,0.0,0.0,0.0,0.0,0.0,0.0,0.0,0.0,1.0,0.0,,58032.0,0.0,0.0,0.0,0.0,0.0,-1994.0,-1781.0,-1772.0,-1869.0,66.0,-32.5,3.0,16013.835,135000.0,143910.0,2565.0,135000.0,12.0,-1743.0,365243.0,-1713.0,-1533.0,-1383.0,-1530.0,9.0,1.0,0.0999648660518225,-1.0,42.0,30.0,9.0,-21.5,0.0,0.0,46.0,24659.415,23481.81,-529.0,-529.0,8.5,1.0,0.0,,,,,,,,,,,,,,,,,,,,,8353184850.0,184513023396.0,165686638536.0,52009633405.935,1863.0,1706.0,71125.0,70907.0,9141.0,506459.0,,,,,,,128513.0,663316.0,,,,13537500.00547905,-602406986.0,-922566584.0,-296726799.0,-1536361849.0416667,44052.0,30728.0,,,,,,,,158154.39305925302,126199.5310617676,,,,,,,3716906.0,,,,,,,,,,,,,,,,436793.0,431586.0,,6429.689689002898,632427.0,625975.0,,,,,,,,,66.0,72484664.98499998,,7252262300.519996,2407520343.510001,84534407.14499997,784146.5999999999,133.0,16969.0,-23652070.0,10538191.0,-12264976.0,-13324797.0,-32.5,0.0,,58032.0,0.0,0.0,0.0,0.0,0.0,-1994.0,-1781.0,-1772.0,-1869.0,255044347.3349998,3633459893.055003,4091833556.370002,58284386.68499996,3633459893.055003,262352.0,-18045149.0,4186431113.0,184292498.0,937843371.0,404915486.0,982712550.0,260116.0,4075.0,730.5037876416043,6042837.0,2142553.0,1320809.5,-4332774.0,1427811.0,102431.0,2870094633.0751176,2902031112.195065,-173482229.5,-172057623.0,3036411.5,142628.0,,,,,,,,,,,,,,,,,,,,,1468574.0,14824621.0,3234913.0,8562022.0,11616361.0,1416957.0,1060416488.4345012,,72159954709.70216,21693684366.022617,583110571.4819987,5792665.7475,689.5,94245.0,-277135101.5,22008591.5,-123873979.0,-218863243.0,-2022508.5,,,,,,,,,,,,,,,,,,,,,4276464.5,2481313.5,-9010261.0,921269.0,37582.5,3736694714.37746,3661359759.4724607,-260818733.0,-257504492.0,2528332.0,269411.5,3929341260.419954,33278510970.63092,36709779183.975136,1730625835.0950494,48123923742.04572,3991361.5,-247761130.0,103166929179.0,1055253737.0,17285949417.0,3505967024.0,18899789409.0,3674860.0,71989.5,20884.189244135017,89836464.5,-11.49046992158434,2.6336,5.901794145420207,282.4938233277711,15.54296506137866,743.9757331160181,56250.0,-0.9009688679024191,0.4338837391175582,0.0,0.0,0.0,0.0,0.0,0.0,1.0,0.0,0.0,0.0,0.0,0.0,0.0,1.0,0.0,1.0,0.0,0.0,0.0,0.0,1.0,0.0,0.0,0.0,0.0,1.0,0.0,0.0,0.0,0.0,0.0,0.0,0.0,0.0,0.0,0.0,0.0,0.0,1.0,0.0,0.0,0.0,0.0,0.0,0.0,0.0,0.0,0.0,0.0,0.0,0.0,0.0,0.0,0.0,0.0,0.0,0.0,0.0,0.0,0.0,0.0,0.0,0.0,0.0,0.0,0.0,0.0,0.0,0.0,0.0,0.0,0.0,0.0,0.0,0.0,0.0,0.0,0.0,0.0,0.0,0.0,1.0,0.0,0.0,0.0,0.0,0.0,0.0,0.0,0.0,0.0,0.0,0.0,0.0,0.0,0.0,0.0,0.0,0.0,0.0,0.0,0.0,0.0,0.0,0.0,0.0,0.0,0.0,0.0,0.0,0.0,0.0,0.0,0.0,0.0,0.0,0.0,0.0,0.0,0.0
104351,0,0.0,0.0,0.0,1.0,1.0,112500.0,225000.0,23755.5,225000.0,0.006296,30.2054794520548,-789.0,-2974.0,-2708.0,,2.0,3.0,3.0,11.0,,0.2263000533376964,,0.0534,0.0319,0.9752,0.66,,0.0,0.1172,0.1417,0.1833,0.042,0.042,0.0416,0.0069,0.0087,0.0378,0.0,0.9747,0.6668,,0.0,0.1034,0.125,0.1667,0.0118,0.0312,0.0311,0.0078,0.0,0.05,0.0312,0.9752,0.6645,,0.0,0.1034,0.125,0.1667,0.0499,0.041,0.0396,0.0078,0.006,0.0329,1.0,2.0,0.0,2.0,0.0,0.0,0.0,0.0,0.0,0.0,2.0,2.0,1.0,1.0,0.0,1.0,0.0,0.0,0.0,0.0,0.0,0.0,0.0,0.0,0.0,1.0,0.0,0.0,0.0,0.0,0.0,0.0,0.0,0.0,0.0,0.0,0.0,0.0,0.0,0.0,0.0,0.0,0.0,0.0,1.0,,,27536.94,0.0,,0.0,0.0,0.0,-2009.0,-1797.0,-18.0,-1826.0,66.0,-33.5,1.0,6639.03,31455.0,31914.0,3145.5,31455.0,6.0,-494.0,365243.0,-464.0,-344.0,-314.0,-337.0,16.0,1.0,0.0977120453670318,24.0,6.0,6.0,3.5,-13.5,0.0,0.0,5.0,6639.03,6639.03,-412.0,-404.0,3.0,1.0,0.0,,,,,,,,,,,,,,,,,,,,,8353208605.5,184513248396.0,165686863536.0,52009745905.935,1863.0,1706.0,71125.0,70909.0,9141.0,506461.0,17822.3747000023,17884.609999999117,17335.692699998017,11304.032400000093,11241.833400000096,11189.174300000055,128514.0,663318.0,,,,13537530.210958503,-602407775.0,-922569292.0,-296726799.0,-1536364823.0416667,44052.0,30728.0,11357.933999999186,11233.879999998982,10717.91309999729,22906.40620000976,22828.166800009723,22213.138400008287,,158154.61935930635,,35029.708200027984,34969.82600002842,34415.26010002884,22970.3650999959,22943.40029999548,22590.16439999571,3716917.0,8301.70880000016,8406.323900000074,8129.777400000232,9824.483300000717,9939.476800002158,10299.52679999964,16480.226699999737,16665.58379999969,16262.237199999705,829.0327000001766,814.210200000046,760.1331000000133,3916.778200000123,3899.991700000163,3732.65080000016,436795.0,431588.0,,6429.695985002898,632430.0,625978.0,,16344.6663999998,154303.45859999064,154306.20319999027,154197.92809998716,77667.54319999633,78005.61960000657,78407.31510000657,66.0,,,7252289837.459993,2407520343.510001,,784146.5999999999,133.0,16969.0,-23654079.0,10536394.0,-12264994.0,-13326623.0,-33.5,,,27536.94,0.0,,0.0,0.0,0.0,-2009.0,-1797.0,-18.0,-1826.0,255075645.7799998,3633941348.055003,4092382439.370002,58287532.18499996,3633941348.055003,262388.0,-18046397.0,4187161599.0,184291310.0,938206275.0,404915172.0,983075464.0,260144.0,4077.0,730.6014996869715,6042861.0,2143188.5,1321204.0,-4333102.5,1427811.0,102431.0,2870701137.990117,2902805204.130065,-173491148.0,-172066335.0,3036736.0,142680.0,,,,,,,,,,,,,,,,,,,,,1468575.0,14824687.0,3234913.0,8562028.0,11616366.0,1416958.0,,,72159982246.64218,21693684366.022617,,5792665.7475,689.5,94245.0,-277137110.5,22006794.5,-123873997.0,-218865069.0,-2022542.0,,,,,,,,,,,,,,,,,,,,,4276470.5,2481317.0,-9010274.5,921269.0,37582.5,3736701353.40746,3661366398.502461,-260819145.0,-257504896.0,2528335.0,269412.5,3929347899.449954,33278542425.63092,36709811097.975136,1730628980.5950494,48123955197.04572,3991367.5,-247761624.0,103167294422.0,1055253273.0,17285949073.0,3505966710.0,18899789072.0,3674876.0,71990.5,20884.286956180385,89836488.5,-26.12108843537415,2.0,4.735745406326956,143.04546056097175,9.471490812653911,286.0909211219435,56250.0,1.0,0.0,0.0,1.0,0.0,0.0,0.0,0.0,0.0,0.0,0.0,0.0,1.0,0.0,0.0,0.0,0.0,0.0,1.0,0.0,0.0,0.0,0.0,0.0,1.0,0.0,0.0,1.0,0.0,0.0,0.0,0.0,0.0,0.0,0.0,0.0,0.0,1.0,0.0,0.0,0.0,0.0,0.0,0.0,0.0,0.0,0.0,0.0,0.0,0.0,0.0,0.0,0.0,0.0,1.0,0.0,0.0,0.0,0.0,0.0,0.0,0.0,0.0,0.0,0.0,0.0,0.0,0.0,0.0,0.0,0.0,0.0,0.0,0.0,0.0,0.0,0.0,0.0,0.0,0.0,0.0,0.0,0.0,0.0,0.0,0.0,0.0,0.0,0.0,0.0,0.0,0.0,0.0,0.0,0.0,0.0,0.0,0.0,0.0,0.0,0.0,0.0,0.0,0.0,0.0,0.0,0.0,0.0,0.0,0.0,1.0,0.0,1.0,0.0,0.0,0.0,0.0,0.0,0.0,0.0,1.0,0.0
104354,0,0.0,1.0,1.0,1.0,0.0,202500.0,149256.0,17712.0,135000.0,0.030755,27.736986301369864,-2106.0,-4357.0,-2603.0,65.0,1.0,2.0,2.0,13.0,0.6760561966933212,0.4205791737251993,0.6986675550534175,,,,,,,,,,,,,,,,,,,,,,,,,,,,,,,,,,,,,,,,,,,,,3.0,1.0,3.0,1.0,-2289.0,0.0,0.0,0.0,0.0,1.0,3.0,1.0,1.0,0.0,1.0,0.0,0.0,0.0,0.0,0.0,0.0,1.0,1.0,0.0,1.0,0.0,0.0,0.0,0.0,0.0,0.0,0.0,0.0,0.0,0.0,0.0,0.0,0.0,0.0,0.0,0.0,0.0,0.0,10.0,0.0,0.0,27000.0,0.0,0.0,0.0,0.0,0.0,-59.5,-7.5,-20.0,-23.0,106.0,-10.0,6.0,7875.0,84873.15,83887.65,2250.0,84873.15,10.0,-932.0,365243.0,-840.0,-780.0,-540.0,-774.5,11.5,0.0,0.0504603655243862,29.0,17.0,9.0,7.0,-67.0,0.0,0.0,17.0,5548.14,10176.795,-2007.0,-2007.0,3.0,1.0,28.0,0.0,157500.0,,0.0,,,0.0,,0.0,0.0,0.0,0.0,,0.0,,,0.0,-17.5,0.0,0.0,8353226317.5,184513397652.0,165686998536.0,52009948405.935,1863.0,1706.0,71125.0,70910.0,9141.0,506464.0,,,,,,,128514.0,663319.0,,,,13537557.947944803,-602409881.0,-922571895.0,-296729088.0,-1536369180.0416667,44053.0,30729.0,,,,,,,67529.6906991802,158155.03993848007,126200.22972932266,,,,,,,3716930.0,,,,,,,,,,,,,,,,436798.0,431591.0,1264136.0,6429.726740002898,632432.0,625980.0,,,,,,,,,2.5,72659669.17499998,25772699.969999984,7257091260.689994,2408041813.7250013,84574575.38249996,784146.5999999999,133.0,16969.0,-23663890.5,10533933.5,-12269529.5,-13329489.0,-0.75,10800.0,0.0,80336.475,0.0,0.0,0.0,0.0,0.0,-747.0,-23.0,-36.0,-916.0,255634416.22499985,3641322954.555003,4100560471.620002,58309595.68499996,3641322954.555003,262792.0,-18083957.5,4195014323.5,184807392.5,939093613.5,405439174.5,983597663.0,260522.0,4088.0,731.0694446822507,6048855.0,2146970.0,1323291.0,-4344435.0,1427843.0,102436.0,2878661323.935125,2910534641.640073,-173816072.0,-172389442.0,3038483.0,142932.0,2629570226.579972,7145894250.0,,343376525.96999973,,,149200445.29499927,,348308265.915,2524631744.2499976,2619747496.214966,2619876593.7899647,,29982.0,,,866923.0,-1544224.5,672014.0,1437.0,1468585.0,14824793.0,3234941.0,8562045.0,11616383.0,1416964.0,1060416488.4345012,801993001.1174952,72160009246.64218,21693684366.022617,583110571.4819987,5792665.7475,689.5,94245.0,-277137170.0,22006787.0,-123874017.0,-218865092.0,-2022552.0,5926349474.70746,18737082000.0,,448259806.5299977,,,309284819.66249865,,459408101.7599993,5711388862.072536,5889607614.449998,5889850797.195,,80928.0,,,972016.5,-1699734.5,177364.0,6755.0,4276479.5,2481324.0,-9010341.5,921269.0,37582.5,3736706901.54746,3661376575.297461,-260821152.0,-257506903.0,2528338.0,269413.5,3929355774.449954,33278627298.78092,36709894985.625145,1730631230.5950494,48124040070.19571,3991377.5,-247762556.0,103167659665.0,1055252433.0,17285948293.0,3505966170.0,18899788297.5,3674887.5,71990.5,20884.33741654591,89836517.5,-75.92749901224812,0.7370666666666666,11.432926829268292,317.11493484797865,8.426829268292684,233.73484797861684,202500.0,1.0,0.0,0.0,0.0,0.0,0.0,0.0,0.0,1.0,0.0,0.0,0.0,0.0,0.0,0.0,1.0,0.0,1.0,0.0,0.0,0.0,0.0,0.0,0.0,1.0,0.0,0.0,1.0,0.0,0.0,0.0,0.0,0.0,0.0,0.0,0.0,0.0,0.0,0.0,0.0,1.0,0.0,0.0,0.0,0.0,0.0,0.0,0.0,0.0,0.0,0.0,0.0,0.0,0.0,0.0,0.0,0.0,1.0,0.0,0.0,0.0,0.0,0.0,0.0,0.0,0.0,0.0,0.0,0.0,0.0,0.0,0.0,0.0,0.0,0.0,0.0,0.0,0.0,0.0,0.0,0.0,0.0,0.0,0.0,0.0,0.0,0.0,0.0,0.0,0.0,0.0,0.0,0.0,0.0,0.0,0.0,0.0,0.0,0.0,0.0,0.0,0.0,0.0,0.0,0.0,0.0,0.0,0.0,0.0,0.0,0.0,0.0,0.0,0.0,0.0,0.0,0.0,0.0,0.0,0.0,0.0,0.0
104369,0,0.0,1.0,0.0,0.0,0.0,108000.0,74628.0,8568.0,67500.0,0.005084,46.06027397260274,-2583.0,-8814.0,-362.0,,1.0,2.0,2.0,10.0,0.4141247678480041,0.6030636759298853,0.1929422277169508,,,,,,,,,,,,,,,,,,,,,,,,,,,,,,,,,,,,,,,,,,,0.044,1.0,0.0,0.0,0.0,0.0,-1550.0,0.0,0.0,0.0,0.0,1.0,6.0,1.0,1.0,0.0,1.0,1.0,0.0,0.0,0.0,0.0,0.0,0.0,0.0,0.0,1.0,0.0,0.0,0.0,0.0,0.0,0.0,0.0,0.0,0.0,0.0,0.0,0.0,0.0,0.0,0.0,0.0,0.0,0.0,11.0,0.0,0.0,22500.0,0.0,41901.255,0.0,0.0,0.0,-191.0,-124.0,-94.0,-190.0,161.0,-11.0,18.0,10497.6225,44646.75,69851.25,5816.25,112500.0,12.0,-458.0,365243.0,-760.0,-700.0,-430.0,-690.0,12.0,1.0,0.0997720965527798,-1.0,71.0,12.0,7.0,-44.0,0.0,0.0,109.0,8430.48,8430.48,-546.0,-546.0,10.0,1.0,24.0,7774.852500000001,450000.0,0.0,6614.032499999998,0.0,2150.7075,715.77,5319.7425,2475.0,7774.852500000001,7774.852500000001,7774.852500000001,0.0,1.0,0.0,1.0,3.0,-12.5,0.0,0.0,8353234885.5,184513472280.0,165687066036.0,52010056405.935,1863.0,1706.0,71125.0,70911.0,9141.0,506470.0,,,,,,,128514.0,663320.0,,,,13537604.008218778,-602412464.0,-922572257.0,-296730638.0,-1536377994.0416667,44053.0,30729.0,,,,,,,67530.10482394804,158155.643002156,126200.42267155038,,,,,,,3716940.0,,,,,,,,,,,,,,,,436798.0,431591.0,,6429.731824002898,632434.0,625982.0,,16344.7103999998,,,,,,,7.0,72711033.34499998,25779847.859999985,7264838450.159994,2409539336.9100013,84656644.87499996,784146.5999999999,133.0,16969.0,-23712719.0,10552452.5,-12296749.0,-13359311.0,-3.0,0.0,0.0,22500.0,32310.0,41901.255,0.0,0.0,0.0,-1248.0,-476.0,-323.0,-451.0,256119944.7374998,3647220724.170003,4107982015.1700025,58438551.73499996,3647355724.170003,263432.0,-18132335.5,4205419139.0,185320739.0,942173043.0,407428569.0,987042853.0,261256.0,4100.0,733.2508261539882,6056797.5,2152027.0,1326351.0,-4355001.0,1427855.0,102448.0,2885294575.3951306,2917443329.100082,-174276983.0,-172845520.0,3049391.0,143331.0,2650097243.8124714,7177482000.0,221944712.085,345302277.7499997,11829252.6,111170979.89999992,150246981.58499932,380337246.71999866,350940912.74999994,2544310973.5424986,2640223152.112466,2640352249.6874657,11502.0,30148.5,158.0,18488.5,870953.0,-1548850.0,672015.0,1438.0,1468596.0,14824954.0,3234965.0,8562116.0,11616492.0,1416982.0,1060416488.4345012,801993001.1174952,72160031746.64218,21693684366.022617,583152472.7369987,5792665.7475,689.5,94245.0,-277137361.0,22006663.0,-123874111.0,-218865282.0,-2022563.0,5926357249.55996,18737532000.0,198873957.825,448266420.5624977,1948107.735,256965072.2775008,309285535.43249863,636932436.6149979,459410576.7599993,5711396636.9250345,5889615389.302498,5889858572.0475,13392.5,80929.0,44.0,70430.5,972019.5,-1699747.0,177364.0,6755.0,4276491.5,2481331.0,-9010385.5,921269.0,37582.5,3736715332.02746,3661385005.777461,-260821698.0,-257507449.0,2528348.0,269414.5,3929366272.072454,33278671945.53092,36709964836.875145,1730637046.8450494,48124152570.19571,3991389.5,-247763014.0,103168024908.0,1055251673.0,17285947593.0,3505965740.0,18899787607.5,3674899.5,71991.5,20884.437188642463,89836516.5,-56.0786937901499,0.691,12.605042016806722,580.5916887302866,8.710084033613446,401.188856912628,108000.0,-0.2225209339563143,0.9749279121818236,0.0,0.0,0.0,0.0,0.0,0.0,1.0,0.0,1.0,0.0,0.0,0.0,0.0,0.0,0.0,0.0,0.0,0.0,1.0,0.0,0.0,1.0,0.0,0.0,0.0,0.0,0.0,0.0,0.0,1.0,0.0,0.0,0.0,0.0,0.0,0.0,1.0,0.0,0.0,0.0,0.0,0.0,0.0,0.0,0.0,0.0,0.0,0.0,0.0,0.0,0.0,0.0,0.0,1.0,0.0,0.0,0.0,0.0,0.0,0.0,0.0,0.0,0.0,0.0,0.0,0.0,0.0,0.0,0.0,0.0,0.0,0.0,0.0,0.0,0.0,0.0,0.0,0.0,0.0,0.0,0.0,0.0,0.0,0.0,0.0,0.0,0.0,0.0,0.0,0.0,0.0,0.0,0.0,0.0,0.0,0.0,0.0,0.0,0.0,0.0,0.0,0.0,0.0,0.0,0.0,0.0,0.0,0.0,0.0,0.0,0.0,0.0,0.0,0.0,0.0,0.0,0.0,0.0,0.0,0.0
104376,0,0.0,1.0,0.0,1.0,1.0,180000.0,1296000.0,53613.0,1296000.0,0.026392,34.005479452054786,-632.0,-9127.0,-1973.0,,3.0,2.0,2.0,16.0,,0.5348296437518405,,0.4505,,0.9876,,,0.16,0.4483,0.3333,,0.4163,,0.5379999999999999,,,0.459,,0.9876,,,0.1611,0.4483,0.3333,,0.4258,,0.5605,,,0.4549,,0.9876,,,0.16,0.4483,0.3333,,0.4236,,0.5476,,,0.4765,1.0,0.0,0.0,0.0,0.0,0.0,,,,,,,1.0,1.0,0.0,1.0,1.0,0.0,0.0,0.0,0.0,0.0,0.0,0.0,0.0,0.0,0.0,0.0,0.0,0.0,0.0,0.0,0.0,0.0,0.0,0.0,0.0,0.0,0.0,0.0,0.0,0.0,0.0,0.0,0.0,,,,,,,,,,,,,0.0,,0.0,,,,,,,,,,,,,,,,,0.0,,,,,,0.0,,,,,,,0.0,,,,,,,,,,,,,,,,,,,,,8353288498.5,184514768280.0,165688362036.0,52010236405.935,,,,,,,17822.8252000023,17885.064899999117,17336.151699998016,,,,128515.0,663323.0,,,,13537638.01369823,-602413096.0,-922574230.0,-296730638.0,-1536387121.0416667,44053.0,30729.0,11358.093999999188,11234.039999998982,10718.074199997289,22906.85450000976,22828.615100009723,22213.586700008287,,158156.17783179975,,35030.04150002798,34970.15930002842,34415.59340002883,,,,3716956.0,8302.125100000161,8406.747500000074,8130.203200000232,,,,16480.764699999738,16666.131399999693,16262.797699999704,,,,,,,436798.0,431591.0,,6429.758216002898,632436.0,625984.0,,16345.1868999998,154304.44619999063,154307.19079999026,154198.91569998718,,,,,,,,,,,,,,,,,,,,,,,,,,,,,,,,,,,,,,,,,,,,,,,,,,,,,,,,,,,,,,,,,,,,,,,,,,,,,1468596.0,14824954.0,3234965.0,8562116.0,11616492.0,1416982.0,,,,,,,,,,,,,,,,,,,,,,,,,,,,,,,,,,,,,,,,,,,,,,,,,,,,,,,,,,,,,-18.585240090235256,7.2,3.357394661742488,114.16981518232262,24.173241564545908,822.0226693127229,60000.0,0.6234898018587336,0.7818314824680298,0.0,0.0,0.0,0.0,0.0,0.0,1.0,0.0,0.0,0.0,0.0,0.0,0.0,1.0,0.0,0.0,0.0,0.0,1.0,1.0,0.0,0.0,0.0,0.0,0.0,1.0,0.0,0.0,0.0,0.0,0.0,0.0,0.0,0.0,0.0,0.0,0.0,0.0,0.0,0.0,0.0,0.0,0.0,0.0,0.0,0.0,0.0,0.0,0.0,0.0,0.0,0.0,0.0,1.0,0.0,0.0,0.0,0.0,0.0,0.0,0.0,0.0,0.0,0.0,0.0,0.0,0.0,0.0,0.0,0.0,0.0,0.0,0.0,0.0,0.0,0.0,0.0,0.0,0.0,0.0,0.0,0.0,0.0,0.0,0.0,0.0,0.0,0.0,0.0,0.0,0.0,0.0,0.0,0.0,0.0,0.0,0.0,0.0,0.0,0.0,0.0,0.0,0.0,0.0,0.0,0.0,0.0,0.0,0.0,0.0,1.0,0.0,0.0,0.0,0.0,0.0,0.0,1.0,0.0,0.0
104381,0,0.0,1.0,1.0,0.0,2.0,337500.0,1800000.0,55872.0,1800000.0,0.035792,52.84931506849315,-5619.0,-3256.0,-2807.0,10.0,4.0,2.0,2.0,16.0,0.5655158837316812,0.5947115491363896,0.4223696523543468,,,,,,,,,,,,,,,,,,,,,,,,,,,,,,,,,,,,,,,,,,,,,0.0,0.0,0.0,0.0,-684.0,0.0,0.0,0.0,0.0,1.0,0.0,1.0,1.0,1.0,1.0,0.0,0.0,0.0,0.0,0.0,0.0,0.0,0.0,0.0,1.0,0.0,0.0,0.0,0.0,0.0,0.0,0.0,0.0,0.0,0.0,0.0,0.0,0.0,0.0,0.0,0.0,0.0,0.0,3.0,50427.8775,75097.395,1349779.5,0.0,0.0,0.0,0.0,0.0,-965.0,15.0,-3.0,-877.0,97.0,-16.0,1.0,8896.5,86778.0,86778.0,0.0,86778.0,12.0,-684.0,365243.0,-652.0,-502.0,-322.0,-494.0,11.0,0.0,0.0,114.0,7.0,12.0,9.0,-19.0,0.0,0.0,6.0,8896.5,8896.5,-604.5,-577.0,3.5,1.0,0.0,,,,,,,,,,,,,,,,,,,,,8353344370.5,184516568280.0,165690162036.0,52010573905.935,1863.0,1706.0,71125.0,70912.0,9141.0,506470.0,,,,,,,128517.0,663327.0,,,,13537690.863013295,-602418715.0,-922577037.0,-296731322.0,-1536390377.0416667,44053.0,30729.0,,,,,,,67530.67033983178,158156.7725433489,126200.84504120272,,,,,,,3716972.0,,,,,,,,,,,,,,,,436798.0,431591.0,1264146.0,6429.7940080028975,632438.0,625986.0,,,,,,,,,32.0,72828109.28249998,25880093.054999985,7275553229.564994,2412735875.9100013,84709819.61999996,784146.5999999999,133.0,16969.0,-23753064.0,10608584.0,-12314885.0,-13381327.0,-15.5,0.0,75097.395,1349779.5,0.0,0.0,0.0,0.0,0.0,-965.0,15.0,-3.0,-877.0,256679219.51999983,3654904258.170003,4116631150.1700025,58537281.73499996,3654904258.170003,264085.0,-18176413.0,4217106404.0,186018994.0,945075369.0,408871769.0,989945342.0,262048.0,4112.0,734.6549336306384,6080111.0,2158788.0,1330088.0,-4366763.0,1427855.0,102448.0,2890503258.615125,2922468895.080079,-174667219.5,-173232092.0,3053238.0,143738.5,,,,,,,,,,,,,,,,,,,,,1468599.0,14825051.0,3234965.0,8562123.0,11616498.0,1416983.0,1060466916.3120012,802068098.5124952,72161381526.14218,21693684366.022617,583152472.7369987,5792665.7475,689.5,94245.0,-277138326.0,22006678.0,-123874114.0,-218866159.0,-2022579.0,,,,,,,,,,,,,,,,,,,,,4276503.5,2481340.0,-9010404.5,921269.0,37582.5,3736724228.52746,3661393902.277461,-260822302.5,-257508026.0,2528351.5,269415.5,3929375168.572454,33278758723.53092,36710051614.875145,1730637046.8450494,48124239348.19571,3991401.5,-247763698.0,103168390151.0,1055251021.0,17285947091.0,3505965418.0,18899787113.5,3674910.5,71991.5,20884.437188642463,89836630.5,-106.32115085536547,5.333333333333333,6.040592783505153,319.24119121592986,32.21649484536083,1702.61968648496,84375.0,-0.2225209339563143,0.9749279121818236,0.0,0.0,0.0,0.0,0.0,0.0,1.0,0.0,1.0,0.0,0.0,0.0,0.0,0.0,0.0,1.0,0.0,0.0,0.0,0.0,1.0,0.0,0.0,0.0,0.0,1.0,0.0,0.0,0.0,0.0,0.0,0.0,0.0,0.0,0.0,0.0,0.0,0.0,0.0,0.0,0.0,0.0,0.0,0.0,0.0,0.0,0.0,0.0,0.0,0.0,0.0,0.0,0.0,1.0,0.0,0.0,0.0,0.0,0.0,0.0,0.0,0.0,0.0,0.0,0.0,0.0,0.0,0.0,0.0,0.0,0.0,0.0,0.0,0.0,0.0,0.0,0.0,0.0,0.0,0.0,0.0,0.0,0.0,0.0,0.0,0.0,0.0,0.0,0.0,0.0,0.0,0.0,0.0,0.0,0.0,0.0,0.0,0.0,0.0,0.0,0.0,0.0,0.0,0.0,0.0,0.0,0.0,0.0,0.0,0.0,0.0,0.0,0.0,0.0,0.0,0.0,0.0,0.0,0.0,0.0
104384,0,0.0,1.0,0.0,1.0,1.0,90000.0,601470.0,30838.5,450000.0,0.031329,43.98630136986301,-2128.0,-8868.0,-1883.0,,3.0,2.0,2.0,11.0,0.6162472951165444,0.6298071990838382,0.6577838002083306,0.0351,,0.9667,,,,0.1724,0.0417,,,,0.028,,,0.0357,,0.9667,,,,0.1724,0.0417,,,,0.0292,,,0.0354,,0.9667,,,,0.1724,0.0417,,,,0.0285,,,0.0248,1.0,1.0,0.0,1.0,0.0,-1977.0,0.0,0.0,0.0,0.0,0.0,1.0,1.0,1.0,0.0,1.0,0.0,0.0,0.0,0.0,0.0,0.0,0.0,0.0,0.0,1.0,0.0,0.0,0.0,0.0,0.0,0.0,0.0,0.0,0.0,0.0,0.0,0.0,0.0,0.0,0.0,0.0,0.0,0.0,2.0,4257.0,0.0,135000.0,42699.06,2300.94,0.0,0.0,0.0,-539.5,5853.5,-15.5,,36.0,-8.5,2.0,3291.4800000000005,57206.25,56283.75,922.5,57206.25,17.0,-1144.5,365243.0,-1076.5,181731.0,-596.5,181735.0,10.0,0.0,0.0545876861524783,80.0,16.0,24.0,16.5,-8.5,0.0,0.0,14.0,4324.185,4324.185,-212.5,-207.0,4.0,1.0,0.0,,,,,,,,,,,,,,,,,,,,,8353375209.0,184517169750.0,165690612036.0,52010663905.935,1863.0,1706.0,71125.0,70912.0,9141.0,506471.0,17822.8603000023,17885.100299999118,17336.187399998016,,,,128518.0,663330.0,,,,13537734.849314667,-602420843.0,-922578920.0,-296733299.0,-1536399245.0416667,44053.0,30729.0,,,,22907.02690000976,22828.787500009723,22213.759100008287,67531.28658712689,158157.402350548,126201.50282500294,35030.083200027984,34970.20100002842,34415.63510002884,,,,3716983.0,,,,,,,16480.792699999736,16666.159899999693,16262.826899999704,,,,,,,436799.0,431592.0,,6429.825337002898,632440.0,625988.0,,16345.2116999998,154305.41289999062,154308.15749999022,154199.88239998714,,,,18.0,72884285.90999998,25880093.054999985,7278202285.064994,2413510185.9600005,84712120.55999996,784146.5999999999,133.0,16969.0,-23754995.0,10619587.0,-12314942.0,,-8.5,2983.5,0.0,45000.0,42699.06,2300.94,0.0,0.0,0.0,-599.0,10361.0,-19.0,,256732369.49249983,3655439427.420003,4117171206.4200025,58548261.73499996,3655439427.420003,264147.0,-18180956.0,4219115240.5,186014918.0,945620051.5,408869388.0,990490056.5,262123.5,4114.0,734.8650336147143,6080776.0,2159199.0,1330331.5,-4367747.5,1427877.0,102470.0,2891142018.2476277,2922983049.26258,-174697570.5,-173261887.0,3053663.5,143789.5,,,,,,,,,,,,,,,,,,,,,1468601.0,14825087.0,3234965.0,8562139.0,11616512.0,1416985.0,1060471173.3120012,802068098.5124952,72161516526.14218,21693727065.082623,583154773.6769989,5792665.7475,689.5,94245.0,-277138865.5,22012531.5,-123874129.5,,-2022587.5,,,,,,,,,,,,,,,,,,,,,4276527.5,2481356.5,-9010413.0,921269.0,37582.5,3736728552.71246,3661398226.462461,-260822515.0,-257508233.0,2528355.5,269416.5,3929378460.052454,33278815929.78092,36710107898.625145,1730637969.3450494,48124296554.44571,3991418.5,-247764842.5,103168755394.0,1055249944.5,17286128822.0,3505964821.5,18899968848.5,3674920.5,71991.5,20884.49177632861,89836710.5,-48.37869822485207,6.683,2.91842988472202,128.37093643619733,19.50386691959725,857.9029682031066,30000.0,0.6234898018587336,0.7818314824680298,1.0,0.0,0.0,0.0,0.0,0.0,0.0,0.0,0.0,0.0,0.0,0.0,0.0,1.0,0.0,0.0,0.0,0.0,1.0,0.0,1.0,0.0,0.0,0.0,0.0,1.0,0.0,0.0,0.0,0.0,0.0,0.0,0.0,0.0,0.0,0.0,0.0,0.0,0.0,0.0,0.0,0.0,0.0,0.0,0.0,0.0,0.0,0.0,0.0,0.0,0.0,0.0,0.0,0.0,0.0,0.0,0.0,0.0,0.0,0.0,0.0,0.0,0.0,0.0,0.0,0.0,0.0,0.0,0.0,0.0,0.0,0.0,1.0,0.0,0.0,0.0,0.0,0.0,0.0,0.0,0.0,0.0,0.0,0.0,0.0,0.0,0.0,0.0,0.0,0.0,0.0,0.0,0.0,0.0,0.0,0.0,0.0,0.0,0.0,0.0,0.0,0.0,0.0,0.0,0.0,0.0,0.0,0.0,0.0,0.0,1.0,0.0,0.0,1.0,0.0,0.0,0.0,0.0,0.0,0.0
104391,0,0.0,0.0,0.0,1.0,0.0,81000.0,252531.0,25105.5,234000.0,0.010032,59.55616438356165,,-7407.0,-4481.0,,2.0,2.0,2.0,6.0,,0.2686970125282933,0.7517237147741489,0.1649,0.0864,0.9891,0.8504,0.0566,0.16,0.1379,0.375,0.4167,0.0987,0.1345,0.1645,0.0,0.0,0.1681,0.0897,0.9891,0.8563,0.0571,0.1611,0.1379,0.375,0.4167,0.101,0.1469,0.1714,0.0,0.0,0.1665,0.0864,0.9891,0.8524,0.0569,0.16,0.1379,0.375,0.4167,0.1004,0.1368,0.1675,0.0,0.0,0.1604,1.0,4.0,1.0,4.0,1.0,0.0,0.0,0.0,0.0,0.0,1.0,0.0,1.0,0.0,0.0,1.0,0.0,0.0,0.0,0.0,0.0,0.0,0.0,0.0,0.0,0.0,0.0,0.0,1.0,0.0,0.0,0.0,0.0,0.0,0.0,0.0,0.0,0.0,0.0,0.0,0.0,0.0,0.0,0.0,2.0,0.0,,193050.0,0.0,0.0,0.0,0.0,0.0,-1586.0,-761.5,-681.5,-1199.0,105.0,-26.0,4.0,21374.9775,225000.0,239850.0,3577.5,225000.0,12.0,-1885.0,365243.0,-1852.5,-1372.5,-1342.5,-1368.0,7.0,0.5,0.0499467708524529,897.0,84.0,12.0,4.5,-58.5,0.0,0.0,76.0,24344.82,17551.305,-1678.0,-1657.5,8.0,1.0,0.0,,,,,,,,,,,,,,,,,,,,,8353400314.5,184517422281.0,165690846036.0,52010744905.935,1863.0,1706.0,71125.0,70913.0,9141.0,506471.0,17823.0252000023,17885.266799999117,17336.35549999802,11304.118800000091,11241.919800000096,11189.264000000056,128518.0,663332.0,4141.230900000115,4138.922600000014,3949.490800000093,13537794.405479051,,-922583401.0,-296733299.0,-1536406652.0416667,44054.0,30730.0,11358.253999999188,11234.199999998982,10718.235299997288,22907.164800009767,22828.92540000972,22213.897000008285,,158157.67104756052,126202.25454871774,35030.458200027984,34970.57600002842,34416.01010002884,22970.781799995897,22943.81699999548,22590.581099995707,3716989.0,8302.223800000162,8406.847900000073,8130.30420000023,9824.617800000717,9939.613600002158,10299.67369999964,16480.957199999735,16666.327399999693,16262.998299999705,829.0327000001766,814.210200000046,760.1331000000133,3916.778200000123,3899.991700000163,3732.65080000016,436803.0,431596.0,,6429.835369002898,632442.0,625990.0,,16345.3720999998,154306.40199999063,154309.14659999026,154200.87149998714,77668.39359999633,78006.47200000657,78408.17140000657,52.5,72893153.15999998,,7294068961.064994,2422126065.9600005,84712120.55999996,784146.5999999999,135.0,16969.0,-23795471.0,10621515.0,-12335444.0,-13408262.0,-25.75,0.0,,296100.0,0.0,0.0,0.0,0.0,0.0,-2122.0,-1832.0,-1196.0,-1199.0,257208686.07749987,3662199637.920003,4124216401.9200025,58599237.73499996,3662199637.920003,264516.0,-18210172.0,4227881072.5,186721662.0,947610469.0,409220936.0,992480599.0,262529.0,4123.0,735.6564232969981,6092273.5,2162871.5,1332719.0,-4375928.0,1427884.0,102477.0,2897253622.147624,2930104759.972577,-174911516.5,-173472909.0,3055071.0,144089.5,,,,,,,,,,,,,,,,,,,,,1468603.0,14825192.0,3234965.0,8562223.0,11616588.0,1416989.0,1060471173.3120012,,72161709576.14218,21693727065.082623,583154773.6769989,5792665.7475,689.5,94245.0,-277140451.5,22011770.0,-123874811.0,-218867358.0,-2022613.5,,,,,,,,,,,,,,,,,,,,,4276539.5,2481361.0,-9010471.5,921269.0,37582.5,3736752897.53246,3661415777.767461,-260824193.0,-257509890.5,2528363.5,269417.5,3929399835.029954,33279040929.78092,36710347748.625145,1730641546.8450494,48124521554.44571,3991430.5,-247766727.5,103169120637.0,1055248092.0,17286127449.5,3505963479.0,18899967480.5,3674927.5,71992.0,20884.541723099468,89837607.5,,3.1176666666666666,3.2263846567485213,192.1510949819161,10.05879189818964,599.0630637886202,40500.0,-0.2225209339563143,0.9749279121818236,0.0,0.0,0.0,0.0,0.0,0.0,1.0,0.0,0.0,1.0,0.0,0.0,0.0,0.0,0.0,0.0,0.0,0.0,1.0,0.0,1.0,0.0,0.0,0.0,0.0,1.0,0.0,0.0,0.0,0.0,0.0,0.0,0.0,0.0,0.0,0.0,0.0,0.0,0.0,0.0,0.0,0.0,0.0,0.0,0.0,0.0,0.0,0.0,0.0,0.0,0.0,0.0,0.0,0.0,0.0,0.0,0.0,0.0,0.0,0.0,0.0,0.0,0.0,0.0,0.0,0.0,0.0,0.0,0.0,0.0,0.0,0.0,0.0,0.0,0.0,0.0,0.0,0.0,0.0,0.0,0.0,0.0,0.0,0.0,0.0,0.0,0.0,0.0,0.0,0.0,0.0,0.0,0.0,0.0,0.0,0.0,0.0,0.0,0.0,0.0,0.0,0.0,0.0,0.0,0.0,1.0,0.0,0.0,0.0,0.0,1.0,0.0,0.0,0.0,0.0,0.0,0.0,1.0,0.0,0.0
104394,0,0.0,1.0,1.0,1.0,1.0,180000.0,817560.0,30951.0,675000.0,0.030755,43.73698630136986,-3456.0,-8596.0,-5287.0,35.0,3.0,2.0,2.0,12.0,,0.7384420432222493,0.7076993447402619,,,,,,,,,,,,,,,,,,,,,,,,,,,,,,,,,,,,,,,,,,,,,4.0,0.0,4.0,0.0,-1677.0,0.0,0.0,0.0,0.0,0.0,2.0,1.0,1.0,0.0,1.0,1.0,0.0,0.0,0.0,0.0,1.0,1.0,1.0,0.0,1.0,0.0,0.0,0.0,0.0,0.0,0.0,0.0,0.0,0.0,0.0,0.0,0.0,0.0,0.0,0.0,0.0,0.0,0.0,3.0,0.0,0.0,20205.0,0.0,0.0,0.0,0.0,0.0,-1836.0,-1744.0,-1036.0,-1738.0,130.0,-28.0,3.0,27686.025,315000.0,290673.0,509850.0,547425.0,18.0,-506.0,365243.0,-1059.0,-759.0,-549.0,-754.0,14.0,0.5,0.6936377842985149,-1.0,24.0,12.0,10.5,-43.5,0.0,0.0,22.0,34168.32,34168.32,-1331.0,-1327.0,6.0,1.0,0.0,,,,,,,,,,,,,,,,,,,,,8353431265.5,184518239841.0,165691521036.0,52010924905.935,1863.0,1706.0,71125.0,70913.0,9141.0,506473.0,,,,,,,128519.0,663335.0,,,,13537838.142465351,-602424299.0,-922588688.0,-296734976.0,-1536415248.0416667,44054.0,30730.0,,,,,,,,158158.40948960374,126202.96224806244,,,,,,,3717001.0,,,,,,,,,,,,,,,,436807.0,431600.0,1264181.0,6429.866124002898,632444.0,625992.0,,,,,,,,,61.0,72960945.65999998,25921592.054999985,7297513509.104994,2422996608.9600005,84712120.55999996,784146.5999999999,135.0,16969.0,-23808391.0,10647040.0,-12342500.0,-13413546.5,-30.0,0.0,0.0,20205.0,0.0,0.0,0.0,0.0,0.0,-1836.0,-1744.0,-1036.0,-1738.0,257304034.66499984,3663853897.410003,4125475040.6700025,59123063.47499996,3663463972.410003,264588.0,-18219400.0,4229707287.5,186713430.0,947603812.0,409214714.0,992474559.5,262601.0,4125.0,736.5424670888202,6095356.0,2163912.0,1333135.5,-4380249.0,1428062.0,102493.0,2898802011.78012,2931292607.2650805,-175035933.5,-173597618.0,3055565.5,144161.5,,,,,,,,,,,,,,,,,,,,,1468606.0,14825322.0,3234965.0,8562247.0,11616610.0,1416992.0,1060471173.3120012,802068098.5124952,72161729781.14218,21693727065.082623,583154773.6769989,5792665.7475,689.5,94245.0,-277142287.5,22010026.0,-123875847.0,-218869096.0,-2022641.5,,,,,,,,,,,,,,,,,,,,,4276551.5,2481371.5,-9010515.0,921269.0,37582.5,3736787065.852461,3661449946.087461,-260825524.0,-257511217.5,2528369.5,269418.5,3929427521.054954,33279355929.78092,36710638421.625145,1731151396.8450494,48125068979.44571,3991448.5,-247767233.5,103169485880.0,1055247033.0,17286126690.5,3505962930.0,18899966726.5,3674941.5,71992.5,20885.23536088377,89837606.5,-79.01779002756201,4.542,5.815644082582146,254.358745573538,26.414655423088107,1155.2974223950096,60000.0,-0.9009688679024191,-0.433883739117558,0.0,0.0,0.0,0.0,0.0,0.0,1.0,0.0,0.0,0.0,0.0,0.0,0.0,1.0,0.0,0.0,0.0,0.0,1.0,0.0,1.0,0.0,0.0,0.0,0.0,1.0,0.0,0.0,0.0,0.0,0.0,0.0,0.0,0.0,0.0,0.0,0.0,0.0,0.0,0.0,0.0,0.0,0.0,0.0,0.0,0.0,0.0,0.0,0.0,0.0,0.0,0.0,0.0,1.0,0.0,0.0,0.0,0.0,0.0,0.0,0.0,0.0,0.0,0.0,0.0,0.0,0.0,0.0,0.0,0.0,0.0,0.0,0.0,0.0,0.0,0.0,0.0,0.0,0.0,0.0,0.0,0.0,0.0,0.0,0.0,0.0,0.0,0.0,0.0,0.0,0.0,0.0,0.0,0.0,0.0,0.0,0.0,0.0,0.0,0.0,0.0,0.0,0.0,0.0,0.0,0.0,0.0,0.0,0.0,0.0,0.0,0.0,0.0,0.0,0.0,0.0,0.0,0.0,0.0,0.0
104398,1,0.0,1.0,0.0,1.0,1.0,135000.0,338832.0,26901.0,292500.0,0.020246,31.41369863013699,-2127.0,-1441.0,-3681.0,,3.0,3.0,3.0,9.0,,0.2688259407822213,,0.0082,,0.9583,,,0.0,0.0345,0.0,,,,0.0061,,,0.0084,,0.9583,,,0.0,0.0345,0.0,,,,0.0063,,,0.0083,,0.9583,,,0.0,0.0345,0.0,,,,0.0062,,,0.0048,2.0,1.0,1.0,1.0,0.0,0.0,,,,,,,1.0,1.0,0.0,1.0,0.0,0.0,0.0,0.0,0.0,0.0,0.0,0.0,0.0,0.0,0.0,0.0,0.0,0.0,1.0,0.0,0.0,0.0,0.0,0.0,0.0,0.0,0.0,0.0,0.0,0.0,0.0,0.0,0.0,,,,,,,,,,,,,0.0,,15.0,6648.21,58239.0,58239.0,0.0,69806.25,13.0,-836.0,365243.0,-1010.5,-537.0,-537.0,-533.0,8.0,0.0,0.0,40.0,94.0,14.0,9.0,-25.0,0.0,0.0,84.0,5751.0,5751.0,-751.0,-738.5,6.0,1.0,0.0,,,,,,,,,,,,,,,,,,,,,8353458166.5,184518578673.0,165691813536.0,52011059905.935,,,,,,,17823.0334000023,17885.27509999912,17336.363899998018,,,,128520.0,663338.0,,,,13537869.556163983,-602426426.0,-922592369.0,-296734976.0,-1536416689.0416667,44055.0,30730.0,11358.253999999188,11234.199999998982,10718.235299997288,22907.199300009765,22828.95990000973,22213.93150000829,,158158.67831554453,,35030.458200027984,34970.57600002842,34416.01010002884,,,,3717010.0,,,,,,,16480.963299999734,16666.333599999693,16263.004599999704,,,,,,,436808.0,431601.0,,6429.886370002898,632447.0,625995.0,,16345.3768999998,154307.36029999066,154310.10489999026,154201.82979998714,,,,,,,,,,,,,,,,,,,,,,,,,,,,,,257451772.92749983,3665809651.905003,4127622359.6700025,59150779.46999995,3665842900.155003,264835.0,-18236769.0,4233359442.5,186701847.0,947960485.0,409573713.5,992831298.5,262821.0,4127.0,737.157838399535,6115197.0,2166126.0,1334586.0,-4383991.5,1428062.0,102493.0,2900898812.5201225,2933255158.200081,-175147955.5,-173708243.0,3056642.0,144283.5,,,,,,,,,,,,,,,,,,,,,1468606.0,14825322.0,3234965.0,8562341.0,11616694.0,1417007.0,,,,,,,,,,,,,,,,,,,,,,,,,,,,,,,,,,4276565.5,2481380.5,-9010540.0,921269.0,37582.5,3736792816.852461,3661455697.087461,-260826275.0,-257511956.0,2528375.5,269419.5,3929434169.264954,33279414168.78092,36710696660.625145,1731151396.8450494,48125138785.69571,3991461.5,-247768069.5,103169851123.0,1055246022.5,17286126153.5,3505962393.0,18899966193.5,3674949.5,71992.5,20885.23536088377,89837646.5,-67.70931449502878,2.5098666666666665,5.018400802944129,157.64653042892436,12.595516895282705,395.6717718392096,45000.0,1.0,0.0,0.0,0.0,0.0,0.0,0.0,0.0,1.0,0.0,0.0,0.0,0.0,0.0,0.0,1.0,0.0,0.0,0.0,0.0,1.0,0.0,1.0,0.0,0.0,0.0,0.0,1.0,0.0,0.0,0.0,0.0,0.0,0.0,0.0,0.0,1.0,0.0,0.0,0.0,0.0,0.0,0.0,0.0,0.0,0.0,0.0,0.0,0.0,0.0,0.0,1.0,0.0,0.0,0.0,0.0,0.0,0.0,0.0,0.0,0.0,0.0,0.0,0.0,0.0,0.0,0.0,0.0,0.0,0.0,0.0,0.0,0.0,0.0,0.0,0.0,0.0,0.0,0.0,0.0,0.0,0.0,0.0,0.0,0.0,0.0,0.0,0.0,0.0,0.0,0.0,0.0,0.0,0.0,0.0,0.0,0.0,0.0,0.0,0.0,0.0,0.0,0.0,0.0,0.0,0.0,0.0,0.0,0.0,0.0,0.0,0.0,1.0,0.0,0.0,0.0,0.0,0.0,0.0,0.0,0.0,1.0
104402,0,0.0,1.0,1.0,1.0,0.0,315000.0,481176.0,23278.5,360000.0,0.022625,33.26575342465753,-4723.0,-6273.0,-4279.0,4.0,2.0,2.0,2.0,14.0,0.7404903640567325,0.7436620489790843,0.5902333386185574,0.0742,0.0,0.9781,0.7008,0.1097,0.08,0.069,0.3333,0.375,0.0,0.0605,0.0523,0.0,0.0,0.0756,0.0,0.9782,0.7125,0.1107,0.0806,0.069,0.3333,0.375,0.0,0.0661,0.0545,0.0,0.0,0.0749,0.0,0.9781,0.7048,0.1104,0.08,0.069,0.3333,0.375,0.0,0.0616,0.0533,0.0,0.0,0.06,1.0,0.0,0.0,0.0,0.0,0.0,0.0,0.0,0.0,0.0,0.0,2.0,1.0,1.0,0.0,1.0,0.0,0.0,0.0,0.0,0.0,0.0,0.0,0.0,0.0,1.0,0.0,0.0,0.0,0.0,0.0,0.0,0.0,0.0,0.0,0.0,0.0,0.0,0.0,0.0,0.0,0.0,0.0,0.0,9.0,0.0,0.0,145354.5,0.0,0.0,0.0,0.0,0.0,-1814.0,-1510.0,-1013.0,-1838.0,556.0,-33.0,5.0,7504.56,80329.5,89356.5,742.5,80329.5,12.0,-1336.0,365243.0,-1040.0,-575.0,-530.0,-569.5,18.0,0.0,0.0464341085271317,2301.0,64.0,24.0,10.0,-25.5,0.0,0.0,63.0,7504.56,7504.56,-773.0,-745.0,8.0,1.0,0.0,,,,,,,,,,,,,,,,,,,,,8353481445.0,184519059849.0,165692173536.0,52011374905.935,1863.0,1706.0,71125.0,70913.0,9141.0,506475.0,17823.1076000023,17885.349999999118,17336.439499998018,11304.118800000091,11241.919800000096,11189.264000000056,128520.0,663340.0,4141.340600000115,4139.033000000014,3949.601500000093,13537902.821917407,-602431149.0,-922596648.0,-296734976.0,-1536422962.0416667,44055.0,30730.0,11358.333999999188,11234.279999998982,10718.315899997287,22907.268300009764,22829.02890000972,22214.00050000829,67532.02707749094,158159.4219775935,126203.55248140109,35030.79150002798,34970.90930002842,34416.34340002883,22971.156799995897,22944.19199999548,22590.956099995707,3717024.0,8302.223800000162,8406.847900000073,8130.30420000023,9824.678300000716,9939.67520000216,10299.73979999964,16481.015599999733,16666.386899999692,16263.059099999704,829.0327000001766,814.210200000046,760.1331000000133,3916.778200000123,3899.991700000163,3732.65080000016,436808.0,431601.0,1264185.0,6429.9089950028965,632449.0,625997.0,,16345.4368999998,154308.33839999064,154311.08299999026,154202.80799998716,77669.09439999633,78007.17680000658,78408.88390000658,60.0,73032788.15999998,25983623.069999985,7321754901.149994,2438143046.7300005,84926156.66999996,784146.5999999999,136.0,16969.0,-23850710.0,10707476.0,-12359760.0,-13433142.5,-29.5,0.0,0.0,145354.5,0.0,0.0,0.0,0.0,0.0,-2420.0,-1635.0,-1206.0,-2044.0,257714397.7649999,3668970748.905003,4130905766.6700025,59218751.96999995,3668970748.905003,265126.0,-18262242.0,4238837895.5,186688503.5,949778048.5,409931746.5,994648926.5,263296.0,4132.0,738.2432840473798,6121869.0,2168616.0,1336057.0,-4388177.5,1428064.0,102493.0,2902389041.02512,2934733634.955077,-175265840.0,-173823334.0,3057878.0,144454.0,,,,,,,,,,,,,,,,,,,,,1468615.0,14825878.0,3234965.0,8562405.0,11616757.0,1417012.0,1060471173.3120012,802068098.5124952,72161875135.64218,21693727065.082623,583154773.6769989,5792665.7475,689.5,94245.0,-277144101.5,22008516.0,-123876860.0,-218870934.0,-2022674.5,,,,,,,,,,,,,,,,,,,,,4276589.5,2481390.5,-9010565.5,921269.0,37582.5,3736800321.41246,3661463201.647461,-260827048.0,-257512701.0,2528383.5,269420.5,3929441673.824954,33279494498.28092,36710786017.125145,1731152139.3450494,48125219115.19571,3991473.5,-247769405.5,103170216366.0,1055244982.5,17286125578.5,3505961863.0,18899965624.0,3674967.5,71992.5,20885.281794992294,89839947.5,-141.97784549497612,1.527542857142857,13.531799729364009,450.1455131888705,20.67040402087764,687.6165633465649,157500.0,-0.2225209339563146,-0.9749279121818236,0.0,0.0,0.0,0.0,0.0,0.0,1.0,0.0,0.0,0.0,0.0,0.0,0.0,1.0,0.0,1.0,0.0,0.0,0.0,1.0,0.0,0.0,0.0,0.0,0.0,1.0,0.0,0.0,0.0,0.0,0.0,0.0,0.0,0.0,0.0,0.0,0.0,0.0,1.0,0.0,0.0,0.0,0.0,0.0,0.0,0.0,0.0,0.0,0.0,0.0,0.0,0.0,1.0,0.0,0.0,0.0,0.0,0.0,0.0,0.0,0.0,0.0,0.0,0.0,0.0,0.0,0.0,0.0,0.0,0.0,0.0,0.0,0.0,0.0,0.0,0.0,0.0,0.0,0.0,0.0,0.0,0.0,0.0,0.0,0.0,0.0,0.0,0.0,0.0,0.0,0.0,0.0,0.0,0.0,0.0,0.0,0.0,0.0,0.0,0.0,0.0,0.0,0.0,0.0,0.0,0.0,0.0,0.0,1.0,0.0,1.0,0.0,0.0,0.0,0.0,0.0,0.0,1.0,0.0,0.0
104408,0,0.0,0.0,0.0,0.0,0.0,117000.0,126000.0,5427.0,126000.0,0.0145199999999999,64.14794520547945,,-4412.0,-5041.0,,1.0,2.0,2.0,12.0,,0.6157270701746601,0.2636468134452008,,,,,,,,,,,,,,,,,,,,,,,,,,,,,,,,,,,,,,,,,,,,,0.0,0.0,0.0,0.0,-743.0,0.0,0.0,0.0,0.0,0.0,3.0,1.0,0.0,0.0,1.0,0.0,0.0,0.0,0.0,0.0,0.0,0.0,0.0,0.0,1.0,0.0,0.0,0.0,0.0,0.0,0.0,0.0,0.0,0.0,0.0,0.0,0.0,0.0,0.0,0.0,0.0,0.0,0.0,7.0,0.0,0.0,157500.0,0.0,0.0,0.0,0.0,0.0,-1277.0,-229.0,-402.0,-966.0,310.0,-26.0,8.0,9592.29,14310.0,12847.5,2925.0,202500.0,45.0,-602.0,365243.0,-642.5,182515.5,857.5,182518.0,8.5,0.5,0.1113064608347627,-1.0,54.0,48.0,41.5,-13.0,0.0,0.0,49.0,14296.32,14296.32,-377.0,-362.0,7.0,1.0,0.0,,,,,,,,,,,,,,,,,,,,,8353486872.0,184519185849.0,165692299536.0,52011491905.935,1863.0,1706.0,71125.0,70913.0,9141.0,506478.0,,,,,,,128520.0,663341.0,,,,13537966.969862612,,-922601689.0,-296735719.0,-1536427374.0416667,44055.0,30730.0,,,,,,,,158160.03770466367,126203.81612821452,,,,,,,3717036.0,,,,,,,,,,,,,,,,436808.0,431601.0,,6429.923515002897,632451.0,625999.0,,,,,,,,,42.0,73050788.15999998,26075636.459999982,7329246458.219994,2439976441.0950003,84926156.66999996,784146.5999999999,136.0,16969.0,-23883545.0,10753158.0,-12378285.0,-13451062.0,-20.5,0.0,0.0,135000.0,0.0,0.0,0.0,0.0,0.0,-2405.0,-2101.0,-1777.0,-2131.0,257960528.8649999,3672285822.405003,4134973532.6700025,59250841.46999995,3672195822.405003,265467.0,-18286464.5,4245410057.5,187400725.0,951957201.0,411020474.0,997193961.5,263610.0,4138.5,739.1141430236571,6133956.5,2173030.0,1339154.0,-4393878.0,1428068.0,102493.0,2906878770.045109,2938846370.580069,-175519629.0,-174073924.0,3062783.0,144681.0,,,,,,,,,,,,,,,,,,,,,1468622.0,14826188.0,3234965.0,8562459.0,11616806.0,1417020.0,1060471173.3120012,802068098.5124952,72162032635.64218,21693727065.082623,583154773.6769989,5792665.7475,689.5,94245.0,-277145378.5,22008287.0,-123877262.0,-218871900.0,-2022700.5,,,,,,,,,,,,,,,,,,,,,4276637.5,2481432.0,-9010578.5,921269.0,37582.5,3736814617.732461,3661477497.967461,-260827425.0,-257513063.0,2528390.5,269421.5,3929451266.114954,33279508808.28092,36710798864.625145,1731155064.3450494,48125421615.19571,3991518.5,-247770007.5,103170581609.0,1055244340.0,17286308094.0,3505962720.5,18900148142.0,3674976.0,71993.0,20885.393101453134,89839946.5,,1.0769230769230769,21.55887230514096,1382.957359322111,23.21724709784411,1489.3386946545804,117000.0,-0.9009688679024191,0.4338837391175582,0.0,0.0,0.0,0.0,0.0,0.0,1.0,0.0,0.0,1.0,0.0,0.0,0.0,0.0,0.0,0.0,0.0,1.0,0.0,0.0,0.0,0.0,0.0,1.0,0.0,1.0,0.0,0.0,0.0,0.0,0.0,0.0,0.0,0.0,0.0,0.0,0.0,0.0,0.0,0.0,0.0,0.0,0.0,0.0,0.0,0.0,0.0,0.0,0.0,0.0,0.0,0.0,0.0,0.0,0.0,0.0,0.0,0.0,0.0,0.0,0.0,0.0,0.0,0.0,0.0,0.0,0.0,0.0,0.0,0.0,0.0,0.0,0.0,0.0,0.0,0.0,0.0,0.0,0.0,0.0,0.0,0.0,0.0,0.0,0.0,0.0,0.0,0.0,0.0,0.0,0.0,0.0,0.0,0.0,0.0,0.0,0.0,0.0,0.0,0.0,0.0,0.0,0.0,0.0,0.0,1.0,0.0,0.0,0.0,0.0,0.0,0.0,0.0,0.0,0.0,0.0,0.0,0.0,0.0,0.0
104409,0,0.0,0.0,0.0,1.0,0.0,180000.0,646749.0,24511.5,481500.0,0.006207,60.29041095890411,,-9350.0,-4461.0,,2.0,2.0,2.0,12.0,,0.5083107993478022,0.7503751495159068,0.1918,0.2628,0.9866,0.8164,,0.2,0.1724,0.3333,0.375,0.1105,0.1563,0.1617,0.0,0.1426,0.1954,0.2727,0.9866,0.8236,,0.2014,0.1724,0.3333,0.375,0.113,0.1708,0.1685,0.0,0.1509,0.1936,0.2628,0.9866,0.8189,,0.2,0.1724,0.3333,0.375,0.1124,0.159,0.1646,0.0,0.1456,0.1741,1.0,0.0,0.0,0.0,0.0,-1378.0,0.0,0.0,0.0,0.0,0.0,0.0,1.0,0.0,0.0,1.0,0.0,1.0,0.0,0.0,0.0,0.0,0.0,0.0,0.0,1.0,0.0,0.0,0.0,0.0,0.0,0.0,0.0,0.0,0.0,0.0,0.0,0.0,0.0,0.0,0.0,0.0,0.0,0.0,3.0,,0.0,135000.0,0.0,0.0,0.0,0.0,0.0,-1749.0,-1384.0,-1434.0,-1440.0,167.0,-27.0,10.0,6617.655,37768.5,34024.5,4500.0,45000.0,8.0,-455.5,365243.0,-464.0,-400.0,-160.0,-393.0,12.0,1.0,0.1969422982081208,-1.0,48.0,12.0,10.0,-16.0,0.0,0.0,75.0,10620.54,22500.0,-463.0,-460.0,5.0,9.0,10.0,0.0,225000.0,,0.0,,,0.0,,0.0,0.0,0.0,0.0,,0.0,,,0.0,-6.5,0.0,0.0,8353511383.5,184519832598.0,165692781036.0,52011671905.935,1863.0,1706.0,71125.0,70913.0,9141.0,506478.0,17823.2994000023,17885.543599999117,17336.63489999802,11304.381600000092,11242.182600000096,11189.536700000055,128520.0,663343.0,,,,13538027.26027357,,-922606150.0,-296737097.0,-1536436724.0416667,44055.0,30730.0,11358.533999999188,11234.479999998985,10718.517299997287,22907.440700009767,22829.20130000972,22214.17290000829,,158160.546015463,126204.56650336404,35031.12480002798,34971.24260002842,34416.67670002883,22971.531799995897,22944.56699999548,22591.331099995707,3717048.0,8302.334300000162,8406.960300000073,8130.417200000232,9824.834600000717,9939.834200002158,10299.91059999964,16481.177299999734,16666.551499999692,16263.227599999704,829.0327000001766,814.210200000046,760.1331000000133,3916.920800000123,3900.137300000162,3732.80170000016,436808.0,431601.0,,6429.9297220028975,632453.0,626001.0,,16345.6109999998,154309.32499999064,154312.06959999027,154203.79459998722,77669.91079999633,78007.99570000658,78409.70750000657,58.0,,26075636.459999982,7330036793.219994,2440151191.8450003,84926156.66999996,784146.5999999999,136.0,16969.0,-23890399.0,10748772.0,-12383094.0,-13456060.0,-28.5,,0.0,135000.0,0.0,0.0,0.0,0.0,0.0,-1749.0,-1384.0,-1434.0,-1440.0,258011169.02999988,3672961119.405003,4135739774.6700025,59264341.46999995,3672983619.405003,265578.0,-18291806.0,4247418894.0,187760930.0,952685490.0,411385432.0,997557847.0,263710.0,4142.0,739.5497640220824,6134033.5,2175057.0,1340758.0,-4394725.5,1428068.0,102493.0,2907727003.170112,2940045719.040073,-175547967.0,-174101433.0,3063301.0,145107.0,2662587700.064971,7220421000.0,,346908347.4149997,,,150831839.47499928,,352004657.04,2556218585.340001,2652645629.789966,2652774727.364965,,30532.0,,,873411.0,-1553999.0,672017.0,1440.0,1468625.0,14826355.0,3234975.0,8562507.0,11616881.0,1417030.0,,802068098.5124952,72162167635.64218,21693727065.082623,583154773.6769989,5792665.7475,689.5,94245.0,-277147127.5,22006903.0,-123878696.0,-218873340.0,-2022727.5,5926357249.55996,18737757000.0,,448266420.5624977,,,309285535.43249863,,459410576.7599993,5711396636.9250345,5889615389.302498,5889858572.0475,,80929.0,,,972019.5,-1699753.5,177364.0,6755.0,4276649.5,2481442.0,-9010594.5,921269.0,37582.5,3736825238.272461,3661499997.967461,-260827888.0,-257513523.0,2528395.5,269430.5,3929457883.7699537,33279546576.78092,36710832889.125145,1731159564.3450494,48125466615.19571,3991526.5,-247770463.0,103170946852.0,1055243876.0,17286307694.0,3505962560.5,18900147749.0,3674988.0,71994.0,20885.59004375134,89839945.5,,3.59305,7.343491830365338,442.74214032608114,26.38553332109418,1590.7946472986262,90000.0,1.0,0.0,0.0,0.0,0.0,0.0,0.0,0.0,1.0,0.0,0.0,1.0,0.0,0.0,0.0,0.0,0.0,0.0,0.0,0.0,1.0,0.0,1.0,0.0,0.0,0.0,0.0,1.0,0.0,0.0,0.0,0.0,0.0,0.0,0.0,0.0,0.0,0.0,0.0,0.0,0.0,0.0,0.0,0.0,0.0,0.0,0.0,0.0,0.0,0.0,0.0,0.0,0.0,0.0,0.0,0.0,0.0,0.0,0.0,0.0,0.0,0.0,0.0,0.0,0.0,0.0,0.0,0.0,0.0,0.0,0.0,0.0,0.0,0.0,0.0,0.0,0.0,0.0,0.0,0.0,0.0,0.0,0.0,0.0,0.0,0.0,0.0,0.0,0.0,0.0,0.0,0.0,0.0,0.0,0.0,0.0,0.0,0.0,0.0,0.0,0.0,0.0,0.0,0.0,0.0,0.0,0.0,1.0,0.0,0.0,1.0,0.0,1.0,0.0,0.0,0.0,0.0,0.0,0.0,0.0,1.0,0.0
104410,1,0.0,0.0,0.0,0.0,1.0,157500.0,435276.0,34519.5,355500.0,0.002042,43.12328767123286,-1596.0,-4186.0,-4194.0,,3.0,3.0,3.0,10.0,0.3179114456970752,0.1573544988346644,,,,,,,,,,,,,,,,,,,,,,,,,,,,,,,,,,,,,,,,,,,,,,0.0,0.0,0.0,0.0,-476.0,,,,,,,1.0,1.0,0.0,1.0,0.0,0.0,0.0,0.0,0.0,0.0,1.0,1.0,0.0,1.0,0.0,0.0,0.0,0.0,0.0,0.0,0.0,0.0,0.0,0.0,0.0,0.0,0.0,0.0,0.0,0.0,0.0,0.0,0.0,,,,,,,,,,,,,0.0,,2.0,6802.245,70337.25,75388.5,0.0,70337.25,6.0,-370.5,182383.5,-332.0,365243.0,182669.0,365243.0,14.5,0.5,0.0,35.0,8.0,12.0,8.5,-5.5,0.0,0.0,42.0,2250.0,2250.0,-190.5,-195.0,13.5,0.0,15.0,50145.165,45000.0,0.0,0.0,0.0,0.0,2250.0,2889.1575000000007,2745.0,44517.735,46120.995,46120.995,0.0,0.0,0.0,0.0,6.0,-9.0,0.0,0.0,8353545903.0,184520267874.0,165693136536.0,52011829405.935,,,,,,,,,,,,,128521.0,663346.0,,,,13538070.38356124,-602432745.0,-922610344.0,-296737573.0,-1536440910.0416667,44055.0,30730.0,,,,,,,67532.34498893665,158160.70336996185,,,,,,,,3717058.0,,,,,,,,,,,,,,,,436808.0,431601.0,,6429.931764002898,632456.0,626004.0,,,,,,,,,,,,,,,,,,,,,,,,,,,,,,,,,,,258057067.45499983,3673632775.905003,4136496971.6700025,59264341.46999995,3673632775.905003,265658.0,-18294495.0,4248879628.0,187760480.5,953597756.5,411568540.5,998469247.5,263788.5,4145.0,739.5497640220824,6134166.0,2175644.0,1341220.0,-4395127.5,1428072.0,102497.0,2908200621.465109,2940854246.8650703,-175570637.0,-174123658.5,3063996.5,145466.0,2662970958.2699714,7221852000.0,222794762.085,346958762.26499975,11829252.6,111977414.41499992,150848764.60499927,381499447.5449988,352026792.54,2556574335.315001,2653022509.4249663,2653151606.9999657,11567.0,30534.0,158.0,18809.0,873455.0,-1554104.0,672017.0,1440.0,1468625.0,14826355.0,3234990.0,8562515.0,11616923.0,1417032.0,,,,,,,,,,,,,,5926407394.72496,18737802000.0,198873957.825,448266420.5624977,1948107.735,256965072.2775008,309287785.43249863,636935325.7724979,459413321.7599993,5711441154.660034,5889661510.297498,5889904693.0425,13392.5,80929.0,44.0,70430.5,972025.5,-1699762.5,177364.0,6755.0,4276661.5,2481450.5,-9010600.0,921269.0,37582.5,3736827488.272461,3661502247.967461,-260828078.5,-257513718.0,2528409.0,269430.5,3929464686.014954,33279616914.03092,36710908277.625145,1731159564.3450494,48125536952.44571,3991532.5,-247770833.5,103171129235.5,1055243544.0,17286672937.0,3506145229.5,18900512992.0,3675002.5,71994.5,20885.59004375134,89839980.5,-37.01016518424397,2.7636571428571437,4.562638508669012,196.7559729491788,12.60956850475818,543.7660500408048,52500.0,0.6234898018587336,0.7818314824680298,0.0,0.0,0.0,0.0,0.0,0.0,1.0,0.0,0.0,0.0,0.0,0.0,0.0,1.0,0.0,0.0,0.0,0.0,1.0,0.0,1.0,0.0,0.0,0.0,0.0,1.0,0.0,0.0,0.0,0.0,0.0,0.0,1.0,0.0,0.0,0.0,0.0,0.0,0.0,0.0,0.0,0.0,0.0,0.0,0.0,0.0,0.0,0.0,0.0,0.0,0.0,0.0,0.0,0.0,0.0,0.0,0.0,0.0,0.0,0.0,0.0,0.0,0.0,0.0,0.0,0.0,0.0,0.0,0.0,0.0,0.0,0.0,0.0,0.0,0.0,0.0,0.0,0.0,0.0,0.0,0.0,0.0,0.0,0.0,0.0,0.0,0.0,0.0,0.0,0.0,1.0,0.0,0.0,0.0,0.0,0.0,0.0,0.0,0.0,0.0,0.0,0.0,0.0,0.0,0.0,0.0,0.0,0.0,0.0,0.0,0.0,0.0,0.0,0.0,0.0,0.0,0.0,0.0,0.0,0.0
104412,0,0.0,0.0,0.0,0.0,0.0,85500.0,568800.0,20560.5,450000.0,0.020246,58.41643835616439,,-13622.0,-4721.0,,2.0,3.0,3.0,12.0,0.6319006857920605,0.1078531525825155,0.7076993447402619,0.0619,0.0663,0.9732,0.6328,0.0061,0.0,0.1379,0.125,0.1667,0.0412,0.0488,0.0457,0.0077,0.0083,0.063,0.0688,0.9732,0.6472,0.0062,0.0,0.1379,0.125,0.1667,0.0422,0.0533,0.0476,0.0078,0.0088,0.0625,0.0663,0.9732,0.6377,0.0062,0.0,0.1379,0.125,0.1667,0.0419,0.0496,0.0465,0.0078,0.0085,0.0377,1.0,5.0,2.0,5.0,0.0,0.0,0.0,0.0,0.0,0.0,0.0,1.0,1.0,0.0,0.0,1.0,0.0,0.0,0.0,0.0,0.0,0.0,0.0,0.0,0.0,0.0,0.0,0.0,1.0,0.0,0.0,0.0,0.0,0.0,0.0,0.0,0.0,0.0,0.0,0.0,0.0,0.0,0.0,0.0,5.0,0.0,0.0,121500.0,0.0,0.0,0.0,0.0,0.0,-1251.0,-887.0,-793.0,-1196.0,201.0,-25.0,2.0,5018.9175,25852.5,26298.0,0.0,25852.5,6.0,-1462.0,365243.0,-1426.5,-1276.5,-1276.5,-1272.5,10.5,0.5,0.0,35.0,14.0,6.0,3.0,-45.0,0.0,0.0,12.0,5017.905000000002,5017.905000000002,-1373.5,-1351.5,3.5,1.0,0.0,,,,,,,,,,,,,,,,,,,,,8353566463.5,184520836674.0,165693586536.0,52011914905.935,1863.0,1706.0,71125.0,70913.0,9141.0,506479.0,17823.3613000023,17885.606099999117,17336.697899998017,11304.447900000096,11242.248900000095,11189.605500000056,128521.0,663348.0,4141.346700000115,4139.039200000014,3949.607700000093,13538128.799999597,,-922615065.0,-296737573.0,-1536454532.0416667,44057.0,30730.0,11358.533999999188,11234.479999998985,10718.517299997287,22907.578600009765,22829.339200009726,22214.31080000829,67532.97688962244,158160.81122311446,126205.27420270877,35031.24980002798,34971.36760002842,34416.80170002883,22971.698499995902,22944.73369999548,22591.497799995712,3717070.0,8302.375500000162,8407.002200000074,8130.459400000232,9824.883400000715,9939.88380000216,10299.96389999964,16481.222999999733,16666.597999999693,16263.275199999704,829.0404000001766,814.2180000000461,760.1409000000133,3916.929100000123,3900.1458000001626,3732.81050000016,436813.0,431606.0,,6429.952010002898,632459.0,626007.0,,16345.6486999998,154310.29819999065,154313.04279999025,154204.7677999872,77670.54359999634,78008.63340000657,78410.35470000659,42.0,73076334.65999998,26100611.459999982,7333929368.009994,2441384137.8450003,84926156.66999996,784146.5999999999,136.0,16969.0,-23909831.0,10837639.0,-12391520.0,-13467083.0,-20.5,0.0,0.0,180000.0,0.0,0.0,0.0,0.0,0.0,-1563.0,-1198.0,-793.0,-1196.0,258361984.14749983,3680006220.180003,4143859925.4450026,59274844.46999995,3680006220.180003,266103.0,-18311523.0,4252349198.5,187747112.5,953770251.5,411742973.5,998641789.0,263998.5,4151.5,739.7511825734821,6134323.0,2178053.0,1342733.0,-4399691.0,1428105.0,102530.0,2911289092.267613,2943562520.317573,-175737666.5,-174290017.5,3065315.5,145604.5,,,,,,,,,,,,,,,,,,,,,1468630.0,14826556.0,3234990.0,8562529.0,11616935.0,1417034.0,1060471173.3120012,802068098.5124952,72162289135.64218,21693727065.082623,583154773.6769989,5792665.7475,689.5,94245.0,-277148378.5,22006016.0,-123879489.0,-218874536.0,-2022752.5,,,,,,,,,,,,,,,,,,,,,4276667.5,2481453.5,-9010645.0,921269.0,37582.5,3736832506.177461,3661507265.872461,-260829452.0,-257515069.5,2528412.5,269431.5,3929469704.932454,33279642766.53092,36710934575.625145,1731159564.3450494,48125562804.94571,3991538.5,-247772295.5,103171494478.5,1055242117.5,17286671660.5,3506143953.0,18900511719.5,3675013.0,71995.0,20885.59004375134,89840015.5,,6.652631578947369,4.15845918144014,242.9223744292237,27.664696870212303,1616.073059360731,42750.0,0.6234898018587336,0.7818314824680298,0.0,0.0,0.0,0.0,0.0,0.0,1.0,0.0,0.0,1.0,0.0,0.0,0.0,0.0,0.0,0.0,0.0,0.0,1.0,0.0,1.0,0.0,0.0,0.0,0.0,0.0,1.0,0.0,0.0,0.0,0.0,0.0,0.0,0.0,0.0,0.0,0.0,0.0,0.0,0.0,0.0,0.0,0.0,0.0,0.0,0.0,0.0,0.0,0.0,0.0,0.0,0.0,0.0,0.0,0.0,0.0,0.0,0.0,0.0,0.0,0.0,0.0,0.0,0.0,0.0,0.0,0.0,0.0,0.0,0.0,0.0,0.0,0.0,0.0,0.0,0.0,0.0,0.0,0.0,0.0,0.0,0.0,0.0,0.0,0.0,0.0,0.0,0.0,0.0,0.0,0.0,0.0,0.0,0.0,0.0,0.0,0.0,0.0,0.0,0.0,0.0,0.0,0.0,0.0,0.0,1.0,0.0,0.0,1.0,0.0,1.0,0.0,0.0,0.0,0.0,0.0,0.0,0.0,1.0,0.0
104417,0,0.0,1.0,0.0,0.0,0.0,112500.0,156384.0,18688.5,135000.0,0.015221,30.58904109589041,-2805.0,-512.0,-3767.0,,2.0,2.0,2.0,14.0,,0.2391997519643201,0.470456116119975,0.0072,0.0,0.9871,0.8232,0.0,0.0,0.0,0.0,0.0417,0.0242,0.0059,0.0062,0.0,0.0,0.0074,0.0,0.9871,0.8301,0.0,0.0,0.0,0.0,0.0417,0.0247,0.0064,0.0064,0.0,0.0,0.0073,0.0,0.9871,0.8256,0.0,0.0,0.0,0.0,0.0417,0.0246,0.006,0.0063,0.0,0.0,0.0049,1.0,0.0,0.0,0.0,0.0,-3.0,0.0,0.0,0.0,0.0,0.0,0.0,1.0,1.0,0.0,1.0,1.0,0.0,0.0,0.0,0.0,0.0,0.0,0.0,0.0,0.0,0.0,0.0,0.0,0.0,1.0,0.0,0.0,0.0,0.0,0.0,0.0,0.0,0.0,0.0,0.0,0.0,0.0,0.0,2.0,4500.0,0.0,36258.75,18914.625,3585.375,0.0,0.0,0.0,-1060.5,12759.5,-867.5,-1719.0,71.0,-24.0,2.0,8072.1675,71614.125,57514.5,14324.625,71614.125,8.0,-1236.0,365243.0,-1202.0,-1142.0,-992.0,-1136.0,14.5,0.0,0.2174394874726282,35.0,9.0,4.0,2.0,-41.0,0.0,0.0,6.0,6860.835,6860.835,-1263.0,-1255.0,2.0,1.0,0.0,,,,,,,,,,,,,,,,,,,,,8353585152.0,184520993058.0,165693721536.0,52012027405.935,1863.0,1706.0,71125.0,70913.0,9141.0,506479.0,17823.3685000023,17885.613399999118,17336.705299998015,11304.447900000096,11242.248900000095,11189.605500000056,128521.0,663350.0,4141.346700000115,4139.039200000014,3949.607700000093,13538159.389040692,-602435550.0,-922618832.0,-296737576.0,-1536455044.0416667,44057.0,30730.0,11358.533999999188,11234.479999998985,10718.517299997287,22907.578600009765,22829.339200009726,22214.31080000829,,158161.0504228664,126205.74465882489,35031.24980002798,34971.36760002842,34416.80170002883,22971.740199995904,22944.775399995484,22591.53949999572,3717084.0,8302.399700000162,8407.026800000074,8130.484100000232,9824.889300000716,9939.889800002158,10299.97029999964,16481.229199999732,16666.604299999693,16263.281599999704,829.0404000001766,814.2180000000461,760.1409000000133,3916.929100000123,3900.1458000001626,3732.81050000016,436813.0,431606.0,,6429.967231002896,632461.0,626009.0,,16345.6535999998,154311.28529999065,154314.02989999024,154205.7548999872,77671.36679999634,78009.45900000657,78411.1848000066,35.5,73165016.15999998,26100611.459999982,7339192212.959992,2443611906.315,84929742.04499996,784146.5999999999,136.0,16969.0,-23933974.0,10849548.0,-12402455.0,-13479188.0,-17.25,4500.0,0.0,50017.5,18914.625,3585.375,0.0,0.0,0.0,-1799.0,-1719.0,-1719.0,-1719.0,258494995.59749985,3681699929.055003,4145607518.4450026,59312305.84499995,3681699929.055003,266242.0,-18324156.5,4256001384.5,187736817.0,954858153.0,412101990.0,999729734.5,264206.0,4154.0,740.3751002461437,6138545.0,2179471.0,1343626.0,-4402350.0,1428105.0,102530.0,2912527067.242612,2944987739.5725718,-175812106.0,-174363337.0,3065989.5,145787.5,,,,,,,,,,,,,,,,,,,,,1468632.0,14826627.0,3234990.0,8562538.0,11616941.0,1417036.0,1060475673.3120012,802068098.5124952,72162325394.39218,21693745979.707623,583158359.0519989,5792665.7475,689.5,94245.0,-277149439.0,22018775.5,-123880356.5,-218876255.0,-2022776.5,,,,,,,,,,,,,,,,,,,,,4276671.5,2481455.5,-9010686.0,921269.0,37582.5,3736839367.0124607,3661514126.707461,-260830715.0,-257516324.5,2528414.5,269432.5,3929477777.099954,33279714380.65592,36710992090.125145,1731173888.9700494,48125634419.07071,3991546.5,-247773531.5,103171859721.5,1055240915.5,17286670518.5,3506142961.0,18900510583.5,3675027.5,71995.0,20885.80748323881,89840050.5,-91.69950738916256,1.39008,6.019744762822057,184.13821993673497,8.367926799903682,255.9668567696565,56250.0,-0.9009688679024191,0.4338837391175582,0.0,0.0,0.0,0.0,0.0,0.0,1.0,0.0,0.0,0.0,0.0,0.0,0.0,1.0,0.0,1.0,0.0,0.0,0.0,0.0,1.0,0.0,0.0,0.0,0.0,0.0,0.0,1.0,0.0,0.0,0.0,0.0,0.0,0.0,0.0,0.0,0.0,0.0,1.0,0.0,0.0,0.0,0.0,0.0,0.0,0.0,0.0,0.0,0.0,0.0,0.0,0.0,0.0,1.0,0.0,0.0,0.0,0.0,0.0,0.0,0.0,0.0,0.0,0.0,0.0,0.0,0.0,0.0,0.0,0.0,0.0,0.0,0.0,0.0,0.0,0.0,0.0,0.0,0.0,0.0,0.0,0.0,0.0,0.0,0.0,0.0,0.0,0.0,0.0,0.0,0.0,0.0,0.0,0.0,0.0,0.0,0.0,0.0,0.0,0.0,0.0,0.0,0.0,0.0,0.0,0.0,0.0,0.0,1.0,0.0,0.0,0.0,1.0,0.0,1.0,0.0,0.0,0.0,0.0,0.0
104424,0,0.0,1.0,0.0,0.0,1.0,225000.0,224149.5,23665.5,193500.0,0.002134,47.14794520547945,-252.0,-20.0,-703.0,,3.0,3.0,3.0,7.0,,0.6115224137945563,0.3876253444214701,,,,,,,,,,,,,,,,,,,,,,,,,,,,,,,,,,,,,,,,,,,,,0.0,0.0,0.0,0.0,-691.0,0.0,0.0,0.0,0.0,1.0,4.0,1.0,1.0,0.0,1.0,0.0,0.0,0.0,0.0,0.0,0.0,0.0,0.0,0.0,0.0,0.0,0.0,1.0,0.0,0.0,0.0,0.0,0.0,0.0,0.0,0.0,0.0,0.0,0.0,0.0,0.0,0.0,0.0,7.0,0.0,0.0,738000.0,0.0,0.0,0.0,0.0,0.0,-1654.0,150.0,-33.0,-757.0,367.0,-31.0,10.0,15749.73,178155.0,185040.0,8280.0,225900.0,21.0,-1044.5,365243.0,-914.0,-674.0,-138.0,-666.0,10.0,0.0,0.0988022190401515,50.0,115.0,36.0,20.0,-23.0,0.0,0.0,116.0,26197.47,26197.47,-681.5,-669.5,9.0,1.0,0.0,,,,,,,,,,,,,,,,,,,,,8353608817.5,184521217207.5,165693915036.0,52012252405.935,1863.0,1706.0,71125.0,70914.0,9141.0,506483.0,,,,,,,128522.0,663353.0,,,,13538206.536985897,-602435802.0,-922619535.0,-296738267.0,-1536455064.0416667,44057.0,30730.0,,,,,,,,158161.66194528018,126206.1322841693,,,,,,,3717091.0,,,,,,,,,,,,,,,,436813.0,431606.0,,6429.969365002898,632464.0,626012.0,,,,,,,,,55.0,73345016.15999998,26138215.34999999,7354896582.824994,2447390612.9700003,84929742.04499996,784146.5999999999,136.0,16969.0,-23967345.0,10858931.0,-12420987.0,-13493887.0,-27.0,0.0,25920.0,900000.0,0.0,0.0,0.0,0.0,0.0,-2771.0,-949.0,-1462.0,-1462.0,258992845.1549998,3688252989.930003,4152547492.6950026,59850770.21999995,3688140039.930003,266617.0,-18362155.5,4264218637.0,187704483.0,956296326.0,412444796.0,1001168031.0,264505.0,4162.0,743.3661242123977,6144237.0,2185100.0,1346869.0,-4413026.0,1428116.0,102541.0,2918351460.532624,2950713763.76258,-176161132.5,-174708072.5,3069643.5,146097.5,,,,,,,,,,,,,,,,,,,,,1468639.0,14826994.0,3234990.0,8562653.0,11617057.0,1417046.0,1060475673.3120012,802068098.5124952,72163063394.39218,21693745979.707623,583158359.0519989,5792665.7475,689.5,94245.0,-277151093.0,22018925.5,-123880389.5,-218877012.0,-2022807.5,,,,,,,,,,,,,,,,,,,,,4276707.5,2481475.5,-9010709.0,921269.0,37582.5,3736865564.482461,3661540324.177461,-260831396.5,-257516994.0,2528423.5,269433.5,3929493526.8299537,33279892535.65592,36711177130.125145,1731182168.9700494,48125860319.07071,3991567.5,-247774576.0,103172224964.5,1055240001.5,17286669844.5,3506142823.0,18900509917.5,3675037.5,71995.0,20885.906285457848,89840100.5,-5.344877680283573,0.99622,9.507510933637574,448.2596045396412,9.471572542308424,446.56518323448125,75000.0,1.0,0.0,0.0,0.0,0.0,0.0,0.0,0.0,1.0,0.0,1.0,0.0,0.0,0.0,0.0,0.0,0.0,1.0,0.0,0.0,0.0,0.0,1.0,0.0,0.0,0.0,0.0,1.0,0.0,0.0,0.0,0.0,0.0,0.0,0.0,1.0,0.0,0.0,0.0,0.0,0.0,0.0,0.0,0.0,0.0,0.0,0.0,0.0,0.0,0.0,0.0,0.0,0.0,0.0,0.0,0.0,0.0,0.0,0.0,0.0,0.0,0.0,0.0,0.0,0.0,0.0,0.0,0.0,0.0,0.0,0.0,0.0,0.0,0.0,0.0,0.0,0.0,0.0,0.0,0.0,0.0,0.0,0.0,1.0,0.0,0.0,0.0,0.0,0.0,0.0,0.0,0.0,0.0,0.0,0.0,0.0,0.0,0.0,0.0,0.0,0.0,0.0,0.0,0.0,0.0,0.0,0.0,0.0,0.0,0.0,0.0,0.0,0.0,0.0,0.0,0.0,0.0,0.0,0.0,0.0,0.0,0.0
104426,0,0.0,0.0,0.0,1.0,0.0,112500.0,156384.0,16155.0,135000.0,0.032561,54.336986301369855,,-3979.0,-3348.0,,1.0,1.0,1.0,13.0,,0.6144223862780301,,0.0619,0.0918,0.9732,0.6328,0.0089,0.0,0.1379,0.1667,0.2083,0.0205,0.0504,0.0549,0.0,0.0,0.063,0.0953,0.9732,0.6472,0.0089,0.0,0.1379,0.1667,0.2083,0.0209,0.0551,0.0572,0.0,0.0,0.0625,0.0918,0.9732,0.6377,0.0089,0.0,0.1379,0.1667,0.2083,0.0208,0.0513,0.0559,0.0,0.0,0.0432,1.0,1.0,0.0,1.0,0.0,-1091.0,,,,,,,1.0,0.0,0.0,1.0,0.0,0.0,0.0,0.0,0.0,0.0,0.0,0.0,0.0,1.0,0.0,0.0,0.0,0.0,0.0,0.0,0.0,0.0,0.0,0.0,0.0,0.0,0.0,0.0,0.0,0.0,0.0,0.0,0.0,,,,,,,,,,,,,0.0,,9.0,15629.625,68796.0,68598.0,6750.0,180000.0,12.0,-358.0,365243.0,-890.0,-575.0,-560.0,-567.5,12.0,0.5,0.0975654780002605,-1.0,33.0,12.0,7.0,-28.0,0.0,0.0,30.0,15629.625,15629.625,-915.0,-836.0,5.5,1.0,24.0,0.0,720000.0,,0.0,,,0.0,,0.0,0.0,0.0,0.0,,0.0,,,0.0,-13.5,0.0,0.0,8353624972.5,184521373591.5,165694050036.0,52012364905.935,,,,,,,17823.4304000023,17885.675899999118,17336.768299998013,11304.539700000096,11242.340700000095,11189.700800000055,128522.0,663354.0,4141.3556000001145,4139.048100000014,3949.6166000000926,13538260.873972198,,-922622883.0,-296739358.0,-1536459043.0416667,44057.0,30730.0,11358.533999999188,11234.479999998985,10718.517299997287,22907.716500009767,22829.477100009728,22214.44870000829,,158162.27636766643,,35031.41650002798,34971.53430002842,34416.96840002883,22971.948499995902,22944.98369999548,22591.747799995712,3717104.0,8302.420200000162,8407.047600000074,8130.505000000232,9824.939700000716,9939.941100002156,10300.02539999964,16481.28409999973,16666.660199999693,16263.338799999705,829.0404000001766,814.2180000000461,760.1409000000133,3916.929100000123,3900.1458000001626,3732.81050000016,436814.0,431607.0,,6430.001926002898,632465.0,626013.0,,16345.6967999998,154312.25849999065,154315.00309999025,154206.7280999872,77671.99959999634,78010.09670000659,78411.8320000066,,,,,,,,,,,,,,,,,,,,,,,,,,,259143808.1399998,3690998786.430003,4155370934.4450026,59884245.71999995,3690998786.430003,266804.0,-18372635.0,4266957959.5,188061229.5,957385160.5,412805774.5,1001892003.0,264635.0,4164.5,743.6702137105203,6146349.0,2188073.0,1348737.0,-4415633.0,1428175.0,102541.0,2920992884.280124,2953214676.990079,-176238718.0,-174784763.5,3070831.5,146195.5,2665320130.5749702,7248681000.0,,347338229.26499975,,,150968104.42499927,,352380346.56000006,2558831470.695001,2655349774.8299646,2655478872.4049644,,30544.0,,,873767.0,-1554741.0,672035.0,1458.0,1468639.0,14826994.0,3235014.0,8562686.0,11617087.0,1417055.0,,,,,,,,,,,,,,5926407394.72496,18738522000.0,,448266420.5624977,,,309287785.43249863,,459413321.7599993,5711441154.660034,5889661510.297498,5889904693.0425,,80929.0,,,972025.5,-1699776.0,177364.0,6755.0,4276719.5,2481482.5,-9010737.0,921269.0,37582.5,3736881194.107461,3661555953.802461,-260832311.5,-257517830.0,2528429.0,269434.5,3929509156.4549537,33279961331.65592,36711245728.125145,1731188918.9700494,48126040319.07071,3991579.5,-247774934.0,103172590207.5,1055239111.5,17286669269.5,3506142263.0,18900509350.0,3675049.5,71995.5,20886.003850935853,89840099.5,,1.39008,6.963788300835653,378.3912695081466,9.680222841225628,525.9941359178845,112500.0,-0.9009688679024191,0.4338837391175582,0.0,0.0,0.0,0.0,0.0,0.0,1.0,0.0,0.0,1.0,0.0,0.0,0.0,0.0,0.0,0.0,0.0,0.0,1.0,0.0,0.0,1.0,0.0,0.0,0.0,1.0,0.0,0.0,0.0,0.0,0.0,0.0,0.0,0.0,0.0,0.0,0.0,0.0,0.0,0.0,0.0,0.0,0.0,0.0,0.0,0.0,0.0,0.0,0.0,0.0,0.0,0.0,0.0,0.0,0.0,0.0,0.0,0.0,0.0,0.0,0.0,0.0,0.0,0.0,0.0,0.0,0.0,0.0,0.0,0.0,0.0,0.0,0.0,0.0,0.0,0.0,0.0,0.0,0.0,0.0,0.0,0.0,0.0,0.0,0.0,0.0,0.0,0.0,0.0,0.0,0.0,0.0,0.0,0.0,0.0,0.0,0.0,0.0,0.0,0.0,0.0,0.0,0.0,0.0,0.0,1.0,0.0,0.0,0.0,1.0,1.0,0.0,0.0,0.0,0.0,0.0,0.0,1.0,0.0,0.0
104435,0,0.0,0.0,0.0,1.0,0.0,63000.0,526491.0,23319.0,454500.0,0.005144,57.72054794520548,,-12139.0,-4107.0,,2.0,2.0,2.0,10.0,,0.5012155319615265,0.3807996826489149,,,,,,,,,,,,,,,,,,,,,,,,,,,,,,,,,,,,,,,,,,,,,0.0,0.0,0.0,0.0,-374.0,0.0,0.0,0.0,0.0,0.0,2.0,1.0,0.0,0.0,1.0,1.0,0.0,0.0,0.0,0.0,0.0,0.0,0.0,0.0,1.0,0.0,0.0,0.0,0.0,0.0,0.0,0.0,0.0,0.0,0.0,0.0,0.0,0.0,0.0,0.0,0.0,0.0,0.0,8.0,2757.7575,0.0,52318.125,0.0,0.0,0.0,0.0,0.0,-957.5,-314.5,-59.0,-647.5,251.0,-21.0,3.0,7875.0,59490.9,64201.5,0.9,59490.9,0.0,-374.0,365243.0,365243.0,365243.0,365243.0,-202.0,12.0,0.0,1.5267058835523562e-05,120.0,6.0,6.0,3.5,-9.5,0.0,0.0,5.0,12002.625,12002.625,-305.0,-265.0,3.0,1.0,15.0,0.0,45000.0,,0.0,,,0.0,,0.0,0.0,0.0,0.0,,0.0,,,0.0,-6.0,0.0,0.0,8353648291.5,184521900082.5,165694504536.0,52012427905.935,1863.0,1706.0,71125.0,70914.0,9141.0,506485.0,,,,,,,128522.0,663356.0,,,,13538318.594520142,,-922626990.0,-296739732.0,-1536471182.0416667,44057.0,30730.0,,,,,,,,158162.77758319842,126206.51308385195,,,,,,,3717114.0,,,,,,,,,,,,,,,,436814.0,431607.0,,6430.007070002896,632467.0,626015.0,,,,,,,,,32.0,73420889.08499998,26171740.34999999,7367270101.019994,2451469999.860001,84929742.04499996,784146.5999999999,136.0,16969.0,-24024070.0,10843606.0,-12445054.5,-13525935.5,-15.5,3360.015,6885.09,29115.0,0.0,0.0,0.0,0.0,0.0,-1255.0,-1073.0,-108.0,-921.0,259560688.90499976,3699922917.3300033,4164850085.4450026,59911278.11999995,3699922917.3300033,267984.0,-18400160.0,4272984469.0,188778917.0,959202675.0,413166380.0,1003343796.0,265232.0,4170.0,744.3018626411576,6147490.0,2191909.0,1351444.0,-4421053.0,1428220.0,102586.0,2923799017.860132,2956322103.525085,-176403022.0,-174947022.0,3072638.0,146435.0,2665320130.5749702,7257321000.0,,347338229.26499975,,,150968104.42499927,,352380346.56000006,2558831470.695001,2655349774.8299646,2655478872.4049644,,30544.0,,,873767.0,-1554957.0,672035.0,1458.0,1468647.0,14827245.0,3235029.0,8562692.0,11617092.0,1417058.0,1060478431.0695012,802068098.5124952,72163115712.51718,21693745979.707623,583158359.0519989,5792665.7475,689.5,94245.0,-277152050.5,22018611.0,-123880448.5,-218877659.5,-2022828.5,5926407394.72496,18738567000.0,,448266420.5624977,,,309287785.43249863,,459413321.7599993,5711441154.660034,5889661510.297498,5889904693.0425,,80929.0,,,972025.5,-1699782.0,177364.0,6755.0,4276725.5,2481486.0,-9010746.5,921269.0,37582.5,3736893196.732461,3661567956.427461,-260832616.5,-257518095.0,2528432.0,269435.5,3929517031.4549537,33280020822.55592,36711309929.625145,1731188919.8700497,48126099809.97071,3991579.5,-247775308.0,103172955450.5,1055604354.5,17287034512.5,3506507506.0,18900509148.0,3675061.5,71995.5,20886.00386620291,89840219.5,,8.357000000000001,2.7016595908915475,155.94127194767978,22.577769201080667,1303.2012096667602,31500.0,-0.2225209339563146,-0.9749279121818236,0.0,0.0,0.0,0.0,0.0,0.0,1.0,0.0,0.0,1.0,0.0,0.0,0.0,0.0,0.0,0.0,0.0,0.0,1.0,0.0,1.0,0.0,0.0,0.0,0.0,0.0,1.0,0.0,0.0,0.0,0.0,0.0,0.0,0.0,0.0,0.0,0.0,0.0,0.0,0.0,0.0,0.0,0.0,0.0,0.0,0.0,0.0,0.0,0.0,0.0,0.0,0.0,0.0,0.0,0.0,0.0,0.0,0.0,0.0,0.0,0.0,0.0,0.0,0.0,0.0,0.0,0.0,0.0,0.0,0.0,0.0,0.0,0.0,0.0,0.0,0.0,0.0,0.0,0.0,0.0,0.0,0.0,0.0,0.0,0.0,0.0,0.0,0.0,0.0,0.0,0.0,0.0,0.0,0.0,0.0,0.0,0.0,0.0,0.0,0.0,0.0,0.0,0.0,0.0,0.0,1.0,0.0,0.0,0.0,0.0,0.0,0.0,0.0,0.0,0.0,0.0,0.0,0.0,0.0,0.0
104445,0,0.0,1.0,0.0,1.0,0.0,112500.0,202500.0,10467.0,202500.0,0.028663,51.58904109589041,,-3325.0,-2375.0,,2.0,2.0,2.0,8.0,0.6363694144303064,0.7561804674533091,0.7407990879702335,0.0082,,0.9776,,,,0.0345,0.0417,,0.0197,,0.0069,,,0.0084,,0.9777,,,,0.0345,0.0417,,0.0201,,0.0072,,,0.0083,,0.9776,,,,0.0345,0.0417,,0.02,,0.0069999999999999,,,0.0059,1.0,2.0,1.0,2.0,1.0,0.0,0.0,0.0,0.0,0.0,0.0,2.0,1.0,0.0,0.0,1.0,0.0,0.0,0.0,0.0,0.0,1.0,0.0,0.0,0.0,1.0,0.0,0.0,0.0,0.0,0.0,0.0,0.0,0.0,0.0,0.0,0.0,0.0,0.0,0.0,0.0,0.0,0.0,0.0,4.0,46530.0,0.0,1890000.0,488511.2925,0.0,0.0,0.0,0.0,-1227.5,329.0,-313.0,-1087.5,178.0,-22.0,5.0,21751.74,279000.0,309937.5,0.0,279000.0,18.0,-2551.0,365243.0,-2255.5,-1910.5,-1745.5,-1905.5,8.0,1.0,0.0,-1.0,61.0,18.0,7.0,-66.0,0.0,0.0,60.0,21751.74,21751.74,-2058.0,-2041.0,6.5,1.0,0.0,,,,,,,,,,,,,,,,,,,,,8353658758.5,184522102582.5,165694707036.0,52012540405.935,1863.0,1706.0,71125.0,70914.0,9141.0,506487.0,17823.4386000023,17885.68419999912,17336.776699998012,,,,128522.0,663358.0,,,,13538370.183561238,,-922629365.0,-296739732.0,-1536474507.0416667,44058.0,30731.0,,,,22907.751000009765,22829.511600009733,22214.48320000829,67533.61325903688,158163.53376366588,126207.25388293991,35031.458200027984,34971.57600002842,34417.01010002884,,,,3717122.0,8302.439900000163,8407.067600000075,8130.525100000232,,,,16481.290999999732,16666.667199999694,16263.345999999705,,,,,,,436816.0,431609.0,,6430.035733002896,632469.0,626017.0,,16345.702699999802,154313.2360999907,154315.98069999026,154207.70579998722,,,,41.0,73482193.34999998,26178625.439999983,7373268128.654992,2453831705.902501,84974742.04499996,784146.5999999999,136.0,16969.0,-24052698.0,10833005.5,-12458539.5,-13541315.5,-20.0,46530.0,0.0,2025000.0,0.0,0.0,0.0,0.0,0.0,-1291.0,-4.0,-611.0,-1037.0,259923873.41999984,3703992946.425003,4169404719.9450026,60010201.21499995,3703992946.425003,268356.0,-18433411.0,4281202229.5,189482907.5,961738434.5,414242866.5,1005879422.0,265679.0,4180.5,745.4476773218066,6155141.0,2194892.0,1353059.0,-4430086.0,1428245.0,102611.0,2927327262.7501264,2959632323.86508,-176680088.5,-175221641.0,3074438.0,146660.5,,,,,,,,,,,,,,,,,,,,,1468651.0,14827423.0,3235029.0,8562753.0,11617152.0,1417063.0,1060524961.0695012,802068098.5124952,72165005712.51718,21694234491.00012,583158359.0519989,5792665.7475,689.5,94245.0,-277153278.0,22018940.0,-123880761.5,-218878747.0,-2022850.5,,,,,,,,,,,,,,,,,,,,,4276743.5,2481493.0,-9010812.5,921269.0,37582.5,3736914948.47246,3661589708.167461,-260834674.5,-257520136.0,2528438.5,269436.5,3929538783.194954,33280299822.55592,36711619867.125145,1731188919.8700497,48126378809.97071,3991597.5,-247777859.0,103173320693.5,1055602099.0,17287032602.0,3506505760.5,18900507242.5,3675069.5,71996.5,20886.00386620291,89840218.5,,1.8,10.748065348237317,554.4823849515305,19.34651762682717,998.0682929127552,56250.0,-0.9009688679024191,-0.433883739117558,0.0,0.0,0.0,0.0,0.0,0.0,1.0,0.0,0.0,1.0,0.0,0.0,0.0,0.0,0.0,0.0,0.0,0.0,1.0,0.0,1.0,0.0,0.0,0.0,0.0,1.0,0.0,0.0,0.0,0.0,0.0,0.0,0.0,0.0,0.0,0.0,0.0,0.0,0.0,0.0,0.0,0.0,0.0,0.0,0.0,0.0,0.0,0.0,0.0,0.0,0.0,0.0,0.0,0.0,0.0,0.0,0.0,0.0,0.0,0.0,0.0,0.0,0.0,0.0,0.0,0.0,0.0,0.0,0.0,0.0,0.0,0.0,0.0,0.0,0.0,0.0,0.0,0.0,0.0,0.0,0.0,0.0,0.0,0.0,0.0,0.0,0.0,0.0,0.0,0.0,0.0,0.0,0.0,0.0,0.0,0.0,0.0,0.0,0.0,0.0,0.0,0.0,0.0,0.0,0.0,1.0,0.0,0.0,0.0,0.0,1.0,0.0,0.0,0.0,0.0,0.0,0.0,0.0,1.0,0.0
104458,0,0.0,0.0,0.0,1.0,0.0,450000.0,810000.0,35680.5,810000.0,0.028663,63.53150684931507,-10984.0,-10980.0,-4815.0,,2.0,2.0,2.0,14.0,,0.6874358822599852,0.5531646987710016,0.0722,0.002,0.9776,0.6940000000000001,0.0078,0.0,0.1379,0.1667,0.0,0.0701,0.0588,0.0677,0.0,0.0016,0.0735,0.002,0.9777,0.706,0.0079,0.0,0.1379,0.1667,0.0,0.0717,0.0643,0.0706,0.0,0.0017,0.0729,0.002,0.9776,0.6981,0.0079,0.0,0.1379,0.1667,0.0,0.0713,0.0599,0.0689,0.0,0.0016,0.0579,1.0,1.0,0.0,1.0,0.0,-1211.0,0.0,0.0,0.0,0.0,1.0,2.0,1.0,1.0,0.0,1.0,0.0,0.0,0.0,0.0,0.0,0.0,0.0,0.0,0.0,1.0,0.0,0.0,0.0,0.0,0.0,0.0,0.0,0.0,0.0,0.0,0.0,0.0,0.0,0.0,0.0,0.0,0.0,0.0,7.0,0.0,0.0,2186496.0,50247.0,0.0,0.0,0.0,0.0,-1133.0,147.0,-422.0,-541.0,269.0,-20.0,3.0,21473.775,270000.0,270000.0,,580500.0,24.0,-449.0,365243.0,182193.0,182388.0,182898.0,182392.0,12.0,0.0,,-1.0,15.0,48.0,41.0,-22.0,0.0,0.0,15.0,29447.55,29447.55,-688.0,-677.0,7.0,1.0,11.0,0.0,270000.0,,0.0,,,0.0,,0.0,0.0,0.0,0.0,,0.0,,,0.0,-9.0,0.0,0.0,8353694439.0,184522912582.5,165695517036.0,52012990405.935,1863.0,1706.0,71125.0,70915.0,9141.0,506489.0,17823.5108000023,17885.75709999912,17336.85019999801,11304.541700000094,11242.342700000096,11189.702800000056,128522.0,663360.0,4141.363400000115,4139.056000000013,3949.6245000000927,13538433.715068089,-602446786.0,-922634180.0,-296740943.0,-1536485487.0416667,44058.0,30731.0,11358.533999999188,11234.479999998985,10718.517299997287,22907.88890000977,22829.64950000973,22214.62110000829,,158164.22119954813,126207.8070476387,35031.624900027986,34971.742700028415,34417.17680002884,22971.948499995902,22944.98369999548,22591.747799995712,3717136.0,8302.510000000164,8407.138900000074,8130.596800000232,9824.998500000718,9940.001000002158,10300.08969999964,16481.35869999973,16666.736099999693,16263.416599999702,829.0404000001766,814.2180000000461,760.1409000000133,3916.930700000123,3900.147400000162,3732.81220000016,436817.0,431610.0,,6430.0643960028965,632471.0,626019.0,,16345.7605999998,154314.21369999068,154316.95829999028,154208.68349998718,77672.69359999635,78010.79480000657,78412.5380000066,38.0,73679018.84999998,26218042.10999999,7402486284.944992,2464812009.405001,84990492.04499996,784146.5999999999,136.0,16969.0,-24100163.0,10862083.0,-12481777.0,-13567745.5,-18.5,0.0,0.0,2186496.0,0.0,0.0,0.0,0.0,0.0,-1254.0,-28.0,-520.0,-533.0,260560253.15999988,3711773516.400003,4178275011.9450026,,3711908516.400003,268918.0,-18489611.0,4292156680.5,189991871.5,964447492.5,415497343.5,1008224591.5,266468.0,4193.0,,6171742.0,2200321.0,1356639.0,-4440853.0,1428268.0,102634.0,2934622997.685119,2967488750.790074,-177364867.0,-175901517.0,3094803.0,147172.0,2676310809.7499714,7297348500.0,,348932769.4799997,,,151604306.72999918,,353868297.61500007,2569273263.2250004,2666283988.814966,2666414576.429965,,30634.0,,,879970.0,-1564509.0,672049.0,1472.0,1468658.0,14827692.0,3235040.0,8562768.0,11617167.0,1417066.0,1060524961.0695012,802068098.5124952,72167192208.51718,21694284738.00012,583158359.0519989,5792665.7475,689.5,94245.0,-277154411.0,22019087.0,-123881183.5,-218879288.0,-2022870.5,5926407394.72496,18738837000.0,,448266420.5624977,,,309287785.43249863,,459413321.7599993,5711441154.660034,5889661510.297498,5889904693.0425,,80929.0,,,972025.5,-1699791.0,177364.0,6755.0,4276791.5,2481534.0,-9010834.5,921269.0,37582.5,3736944396.022461,3661619155.717461,-260835362.5,-257520813.0,2528445.5,269437.5,3929560256.969954,33280569822.55592,36711889867.125145,,48126959309.97071,3991621.5,-247778308.0,103173685936.5,1055784292.0,17287214990.0,3506688658.5,18900689634.5,3675081.5,71996.5,,89840217.5,-172.89059467851138,1.8,12.611930886618742,801.2549735063069,22.70147559591373,1442.2589523113525,225000.0,-0.9009688679024191,0.4338837391175582,0.0,1.0,0.0,0.0,0.0,0.0,0.0,0.0,0.0,0.0,1.0,0.0,0.0,0.0,0.0,1.0,0.0,0.0,0.0,0.0,1.0,0.0,0.0,0.0,0.0,1.0,0.0,0.0,0.0,0.0,0.0,0.0,0.0,0.0,0.0,0.0,0.0,0.0,0.0,0.0,1.0,0.0,0.0,0.0,0.0,0.0,0.0,0.0,0.0,0.0,0.0,0.0,0.0,0.0,0.0,0.0,0.0,0.0,0.0,0.0,0.0,0.0,0.0,0.0,0.0,0.0,0.0,0.0,0.0,0.0,0.0,0.0,0.0,0.0,0.0,0.0,0.0,0.0,1.0,0.0,0.0,0.0,0.0,0.0,0.0,0.0,0.0,0.0,0.0,0.0,0.0,0.0,0.0,0.0,0.0,0.0,0.0,0.0,0.0,0.0,0.0,0.0,0.0,0.0,0.0,0.0,0.0,0.0,1.0,0.0,1.0,0.0,0.0,0.0,0.0,0.0,0.0,0.0,1.0,0.0
104460,0,0.0,0.0,0.0,1.0,0.0,180000.0,761872.5,53154.0,675000.0,0.035792,48.06575342465754,-2036.0,-4400.0,-1075.0,,2.0,2.0,2.0,12.0,,0.6312997922315267,0.5172965813614878,,,,,,,,,,,,,,,,,,,,,,,,,,,,,,,,,,,,,,,,,,,,,0.0,0.0,0.0,0.0,-1998.0,0.0,0.0,0.0,0.0,0.0,0.0,1.0,1.0,0.0,1.0,0.0,0.0,0.0,0.0,0.0,0.0,0.0,0.0,0.0,1.0,0.0,0.0,0.0,0.0,0.0,0.0,0.0,0.0,0.0,0.0,0.0,0.0,0.0,0.0,0.0,0.0,0.0,0.0,9.0,10948.5,0.0,135000.0,0.0,0.0,0.0,0.0,0.0,-906.0,-730.0,-730.0,-730.0,338.0,-21.0,1.0,10712.025,120915.0,56587.5,64327.5,120915.0,6.0,-1998.0,365243.0,-1953.0,-1803.0,-1803.0,-1770.0,14.0,0.0,0.5794028487329568,24.0,14.0,6.0,2.5,-64.5,0.0,0.0,12.0,10712.025,7974.6975,-1953.5,-1938.0,4.0,1.0,0.0,,,,,,,,,,,,,,,,,,,,,8353747593.0,184523674455.0,165696192036.0,52013170405.935,1863.0,1706.0,71125.0,70915.0,9141.0,506489.0,,,,,,,128522.0,663362.0,,,,13538481.780821512,-602448822.0,-922635255.0,-296742941.0,-1536489887.0416667,44058.0,30731.0,,,,,,,,158164.85249934034,126208.32434422006,,,,,,,3717148.0,,,,,,,,,,,,,,,,436817.0,431610.0,,6430.100188002897,632473.0,626021.0,,,,,,,,,30.0,73850059.34999998,26222775.502499983,7411130969.444992,2467905070.905001,84996172.97999996,784146.5999999999,136.0,16969.0,-24109342.0,10860218.0,-12486128.0,-13570732.0,-14.5,8397.0,0.0,73710.0,0.0,0.0,0.0,0.0,0.0,-2669.0,-2357.0,-2139.0,-850.0,260630119.79999983,3712580060.400003,4179026340.9450026,60275685.68999995,3712580060.400003,268956.0,-18493768.0,4294530760.0,190537243.0,965723767.0,415678455.0,1009500904.0,266616.0,4197.0,748.5658162874596,6173423.0,2200752.0,1356969.5,-4441552.0,1428268.0,102634.0,2935080142.0426216,2967935172.4575768,-177384016.0,-175920317.5,3094900.0,147198.5,,,,,,,,,,,,,,,,,,,,,1468667.0,14828030.0,3235040.0,8562782.0,11617179.0,1417067.0,1060535909.5695012,802068098.5124952,72167327208.51718,21694284738.00012,583158359.0519989,5792665.7475,689.5,94245.0,-277155317.0,22018357.0,-123881913.5,-218880018.0,-2022891.5,,,,,,,,,,,,,,,,,,,,,4276797.5,2481536.5,-9010899.0,921269.0,37582.5,3736955108.047461,3661627130.414961,-260837316.0,-257522751.0,2528449.5,269438.5,3929570968.994954,33280690737.55592,36711946454.625145,1731253247.3700497,48127080224.97071,3991627.5,-247780306.0,103174051179.5,1055782339.0,17287213187.0,3506686855.5,18900687864.5,3675095.5,71996.5,20886.583269051644,89840241.5,-42.35864113087095,4.232625,3.3863867253640367,162.76922934188127,14.333305113443954,688.9411093431802,90000.0,-0.2225209339563146,-0.9749279121818236,0.0,0.0,0.0,0.0,0.0,0.0,1.0,0.0,0.0,0.0,0.0,0.0,0.0,1.0,0.0,0.0,0.0,0.0,1.0,0.0,1.0,0.0,0.0,0.0,0.0,1.0,0.0,0.0,0.0,0.0,0.0,0.0,0.0,0.0,0.0,1.0,0.0,0.0,0.0,0.0,0.0,0.0,0.0,0.0,0.0,0.0,0.0,0.0,0.0,0.0,0.0,0.0,0.0,0.0,0.0,0.0,0.0,0.0,0.0,0.0,0.0,1.0,0.0,0.0,0.0,0.0,0.0,0.0,0.0,0.0,0.0,0.0,0.0,0.0,0.0,0.0,0.0,0.0,0.0,0.0,0.0,0.0,0.0,0.0,0.0,0.0,0.0,0.0,0.0,0.0,0.0,0.0,0.0,0.0,0.0,0.0,0.0,0.0,0.0,0.0,0.0,0.0,0.0,0.0,0.0,0.0,0.0,0.0,0.0,0.0,0.0,0.0,0.0,0.0,0.0,0.0,0.0,0.0,0.0,0.0
104466,0,0.0,0.0,0.0,0.0,1.0,157500.0,415408.5,41215.5,373500.0,0.007114,34.410958904109584,-1616.0,-6658.0,-2499.0,,3.0,2.0,2.0,17.0,0.6656220597210143,0.7379771783152894,0.475849908720221,0.1237,0.0855,0.9831,0.7008,0.0,0.0,0.2759,0.1667,0.2083,,0.1009,0.1213,0.0,0.0,0.1261,0.0888,0.9831,0.7125,0.0,0.0,0.2759,0.1667,0.2083,,0.1102,0.1264,0.0,0.0,0.1249,0.0855,0.9831,0.7048,0.0,0.0,0.2759,0.1667,0.2083,,0.1026,0.1235,0.0,0.0,0.0954,1.0,0.0,0.0,0.0,0.0,-2691.0,0.0,0.0,0.0,0.0,1.0,2.0,1.0,1.0,0.0,1.0,0.0,1.0,0.0,0.0,0.0,0.0,0.0,0.0,0.0,1.0,0.0,0.0,0.0,0.0,0.0,0.0,0.0,0.0,0.0,0.0,0.0,0.0,0.0,0.0,0.0,0.0,0.0,0.0,5.0,0.0,,107581.5,0.0,0.0,0.0,0.0,0.0,-1361.0,-1057.0,-892.0,-1208.0,221.0,-22.0,2.0,40321.9125,517500.0,553155.75,,517500.0,21.0,-777.0,365243.0,-747.0,182307.5,-147.0,182317.0,12.5,1.0,,-1.0,32.0,24.0,13.5,-17.5,0.0,0.0,142.0,4500.0,4500.0,-1114.5,-1114.5,36.5,0.0,95.0,0.0,90000.0,0.0,0.0,0.0,0.0,0.0,43.2,0.0,0.0,0.0,0.0,0.0,0.0,0.0,0.0,40.5,-49.0,0.0,0.0,8353788808.5,184524089863.5,165696565536.0,52013327905.935,1863.0,1706.0,71125.0,70916.0,9141.0,506491.0,17823.6345000023,17885.881999999117,17336.976299998012,11304.627200000095,11242.428200000097,11189.791600000057,128523.0,663365.0,4141.363400000115,4139.056000000013,3949.6245000000927,13538516.191780414,-602450438.0,-922637754.0,-296745632.0,-1536496545.0416667,44058.0,30731.0,11358.533999999188,11234.479999998985,10718.517299997287,22908.16480000977,22829.92540000973,22214.89700000829,67534.27888109659,158165.59047651867,126208.80019412877,35031.79160002799,34971.909400028424,34417.34350002884,22972.156799995897,22945.19199999548,22591.956099995707,3717165.0,,,,9825.099400000718,9940.103600002158,10300.19989999964,16481.47999999973,16666.859599999694,16263.5429999997,829.0404000001766,814.2180000000461,760.1409000000133,3916.930700000123,3900.147400000162,3732.81220000016,436817.0,431610.0,,6430.107302002897,632475.0,626023.0,,16345.8559999998,154315.1967999907,154317.9413999903,154209.66659998722,77673.39439999635,78011.49960000659,78413.2505000066,45.0,73874809.34999998,,7416842555.609992,2469561231.6000013,85356533.92499995,784146.5999999999,136.0,16969.0,-24145842.0,10840541.0,-12505350.0,-13631230.0,-22.0,0.0,,107581.5,0.0,0.0,0.0,0.0,0.0,-1361.0,-1057.0,-892.0,-1208.0,261076282.98749992,3719876142.9150033,4187121987.9600015,,3719876142.9150033,269588.0,-18518690.0,4300191463.5,190524010.0,966994394.5,416040127.0,1011137193.5,267045.0,4204.5,,6178701.5,2204866.0,1359603.5,-4447499.5,1428268.0,102634.0,2939011609.7251096,2971619581.3650656,-177837917.5,-176369459.5,3108649.5,147401.0,2685756565.799971,7326666000.0,224894687.085,349327644.4799997,11881865.385000002,112193654.21999994,152224431.6599992,384663155.03999937,354938970.33000004,2578233528.405,2675725741.5749664,2675856329.1899657,11657.0,30658.0,160.0,18841.0,885320.0,-1571861.0,672073.0,1496.0,1468672.0,14828251.0,3235135.0,8562814.0,11617321.0,1417069.0,1060535909.5695012,,72167434790.01718,21694284738.00012,583158359.0519989,5792665.7475,689.5,94245.0,-277156678.0,22017300.0,-123882805.5,-218881226.0,-2022913.5,5926407394.72496,18738927000.0,198873957.825,448266420.5624977,1948107.735,256965072.2775008,309287785.43249863,636935368.9724978,459413321.7599993,5711441154.660034,5889661510.297498,5889904693.0425,13392.5,80929.0,44.0,70430.5,972066.0,-1699840.0,177364.0,6755.0,4276821.5,2481550.0,-9010916.5,921269.0,37582.5,3736959608.047461,3661631630.414961,-260838430.5,-257523865.5,2528486.0,269438.5,3929611290.907454,33281208237.55592,36712499610.375145,,48127597724.97071,3991648.5,-247781083.0,103174416422.5,1055781592.0,17287395494.5,3506686708.5,18900870181.5,3675108.0,71997.5,,89840240.5,-46.96178343949043,2.6375142857142864,3.821377879681188,131.4972771747828,10.0789387487717,346.8259470810208,52500.0,-0.9009688679024191,-0.433883739117558,0.0,0.0,0.0,0.0,0.0,0.0,1.0,0.0,0.0,0.0,0.0,0.0,0.0,1.0,0.0,0.0,0.0,0.0,1.0,0.0,1.0,0.0,0.0,0.0,0.0,1.0,0.0,0.0,0.0,0.0,0.0,0.0,0.0,0.0,0.0,0.0,0.0,0.0,0.0,0.0,0.0,0.0,0.0,0.0,0.0,0.0,0.0,0.0,0.0,0.0,0.0,0.0,0.0,1.0,0.0,0.0,0.0,0.0,0.0,0.0,0.0,0.0,0.0,0.0,0.0,0.0,0.0,0.0,0.0,0.0,0.0,0.0,0.0,0.0,0.0,0.0,0.0,0.0,0.0,0.0,0.0,0.0,0.0,0.0,0.0,0.0,0.0,0.0,0.0,0.0,0.0,0.0,0.0,0.0,0.0,0.0,0.0,0.0,0.0,0.0,0.0,0.0,0.0,0.0,0.0,0.0,0.0,0.0,1.0,0.0,1.0,0.0,0.0,0.0,0.0,0.0,0.0,1.0,0.0,0.0
104472,0,0.0,1.0,0.0,1.0,0.0,225000.0,454500.0,45081.0,454500.0,0.026392,34.30684931506849,-3199.0,-396.0,-4072.0,,2.0,2.0,2.0,10.0,,0.2384841714777382,0.7001838506835805,0.1485,0.0706,0.9846,,,0.04,0.0345,0.3333,,,,0.1107,,0.0,0.1513,0.0733,0.9846,,,0.0403,0.0345,0.3333,,,,0.1153,,0.0,0.1499,0.0706,0.9846,,,0.04,0.0345,0.3333,,,,0.1127,,0.0,0.0871,1.0,0.0,0.0,0.0,0.0,0.0,0.0,0.0,0.0,0.0,0.0,1.0,1.0,1.0,0.0,1.0,0.0,0.0,0.0,0.0,0.0,0.0,0.0,0.0,0.0,1.0,0.0,0.0,0.0,0.0,0.0,0.0,0.0,0.0,0.0,0.0,0.0,0.0,0.0,0.0,0.0,0.0,0.0,0.0,1.0,,,0.0,0.0,0.0,0.0,0.0,0.0,-196.0,300.0,-23.0,,7.0,-3.0,10.0,13232.835,101250.0,120790.3725,0.0,113311.3725,12.0,-1481.5,365243.0,-1950.5,-1315.5,-1240.5,-1311.0,13.0,1.0,0.0,0.0,74.0,12.0,5.0,-68.5,0.0,0.0,162.0,9000.0,9000.0,-1449.0,-1448.0,12.0,0.0,83.0,0.0,180000.0,0.0,0.0,0.0,0.0,0.0,302.535,0.0,0.0,0.0,0.0,0.0,0.0,0.0,0.0,40.0,-42.0,0.0,0.0,8353833889.5,184524544363.5,165697020036.0,52013552905.935,1863.0,1706.0,71125.0,70916.0,9141.0,506492.0,17823.7830000023,17886.031899999118,17337.127599998013,11304.697800000093,11242.498800000096,11189.864900000057,128523.0,663367.0,,,,13538550.498629732,-602453637.0,-922641826.0,-296745632.0,-1536496941.0416667,44058.0,30731.0,11358.57399999919,11234.519999998984,10718.557599997288,22908.199300009765,22829.959900009733,22214.931500008297,,158165.82896069015,126209.50037797944,35032.124900027986,34972.242700028415,34417.67680002884,,,,3717175.0,,,,,,,16481.59069999973,16666.972299999696,16263.6582999997,,,,3916.930700000123,3900.147400000162,3732.81220000016,436817.0,431610.0,,6430.133694002897,632477.0,626025.0,,16345.943099999802,154316.18139999072,154318.9259999903,154210.65119998722,,,,7.0,,,7419988321.739992,2470917653.1000013,85424033.92499995,784146.5999999999,136.0,16969.0,-24158870.0,10929639.0,-12511487.0,,-3.0,,,0.0,0.0,0.0,0.0,0.0,0.0,-196.0,300.0,-23.0,,261665224.5149999,3728670560.4150033,4196663292.9600015,60367332.68999995,3728772621.7875032,270100.0,-18548286.0,4307493808.5,190865666.0,968619147.0,416754524.0,1012762061.5,267516.5,4210.5,749.8897826028611,6190283.0,2208507.0,1361786.0,-4454380.0,1428337.0,102691.0,2944938663.0451035,2977427451.8250623,-178166009.0,-176694215.0,3114632.0,147610.0,2689432091.594972,7338726000.0,225070187.085,349503144.4799997,11881865.385000002,112193654.21999994,152465579.0099992,385060543.42499983,355316970.33000004,2581755523.605001,2679402202.244967,2679534049.8599663,11664.0,30665.0,160.0,18841.0,888203.0,-1575724.0,672081.0,1504.0,1468673.0,14828258.0,3235218.0,8562888.0,11617483.0,1417079.0,,,72167434790.01718,21694284738.00012,583158359.0519989,5792665.7475,689.5,94245.0,-277156874.0,22017600.0,-123882828.5,,-2022916.5,5926407394.72496,18739107000.0,198873957.825,448266420.5624977,1948107.735,256965072.2775008,309287785.43249863,636935671.5074979,459413321.7599993,5711441154.660034,5889661510.297498,5889904693.0425,13392.5,80929.0,44.0,70430.5,972106.0,-1699882.0,177364.0,6755.0,4276833.5,2481555.0,-9010985.0,921269.0,37582.5,3736968608.047461,3661640630.414961,-260839879.5,-257525313.5,2528498.0,269438.5,3929624523.742454,33281309487.55592,36712620400.74764,1731253247.3700497,48127711036.343216,3991660.5,-247782564.5,103174781665.5,1055779641.5,17287394179.0,3506685468.0,18900868870.5,3675121.0,71998.5,20886.583269051644,89840240.5,-93.24668583293406,2.02,4.991016170892394,171.22603970387547,10.081852665202636,345.8766002018285,112500.0,0.6234898018587336,0.7818314824680298,0.0,0.0,0.0,0.0,0.0,0.0,1.0,0.0,0.0,0.0,0.0,0.0,0.0,1.0,0.0,0.0,0.0,0.0,1.0,0.0,1.0,0.0,0.0,0.0,0.0,1.0,0.0,0.0,0.0,0.0,0.0,0.0,0.0,0.0,0.0,0.0,0.0,0.0,1.0,0.0,0.0,0.0,0.0,0.0,0.0,0.0,0.0,0.0,0.0,0.0,0.0,0.0,0.0,1.0,0.0,0.0,0.0,0.0,0.0,0.0,0.0,0.0,0.0,0.0,0.0,0.0,0.0,0.0,0.0,0.0,0.0,0.0,0.0,0.0,0.0,0.0,0.0,0.0,0.0,0.0,0.0,0.0,0.0,0.0,0.0,0.0,0.0,0.0,0.0,0.0,0.0,0.0,0.0,0.0,0.0,0.0,0.0,0.0,0.0,0.0,0.0,0.0,0.0,0.0,0.0,0.0,0.0,0.0,0.0,0.0,1.0,0.0,0.0,0.0,0.0,0.0,0.0,0.0,1.0,0.0
104473,0,0.0,1.0,1.0,0.0,1.0,202500.0,225000.0,25447.5,225000.0,0.030755,32.010958904109586,-233.0,-3559.0,-4197.0,11.0,3.0,2.0,2.0,14.0,0.4880054841247458,0.5716197625863495,0.237916079507114,,,,,,,,,,,,,,,,,,,,,,,,,,,,,,,,,,,,,,,,,,,,,1.0,0.0,1.0,0.0,-2099.0,0.0,0.0,0.0,0.0,1.0,1.0,1.0,1.0,0.0,1.0,1.0,0.0,0.0,0.0,0.0,0.0,0.0,0.0,0.0,1.0,0.0,0.0,0.0,0.0,0.0,0.0,0.0,0.0,0.0,0.0,0.0,0.0,0.0,0.0,0.0,0.0,0.0,0.0,8.0,0.0,6406.515,93105.0,0.0,0.0,0.0,0.0,0.0,-1011.0,-688.5,-530.0,-547.0,309.0,-22.0,2.0,8197.695,30352.5,29571.75,6070.5,60705.0,10.0,-1327.0,365243.0,-2068.0,-1798.0,-1798.0,-1790.0,15.0,0.0,0.1013789426141068,66.5,11.0,10.0,5.0,-64.0,0.0,0.0,10.0,8197.695,8197.695,-1940.5,-1933.0,5.5,1.0,0.0,,,,,,,,,,,,,,,,,,,,,8353859337.0,184524769363.5,165697245036.0,52013755405.935,1863.0,1706.0,71125.0,70917.0,9141.0,506493.0,,,,,,,128524.0,663370.0,,,,13538582.509588636,-602453870.0,-922646023.0,-296747731.0,-1536500500.0416667,44058.0,30731.0,,,,,,,67534.7668865807,158166.40058045273,126209.73829405896,,,,,,,3717189.0,,,,,,,,,,,,,,,,436818.0,431611.0,1264196.0,6430.164449002897,632479.0,626027.0,,,,,,,,,34.0,74075280.39,26232261.61499999,7420619080.664992,2470917653.1000013,85424033.92499995,784146.5999999999,136.0,16969.0,-24165263.5,10924475.5,-12516358.5,-13639078.0,-16.5,0.0,6406.515,95625.0,0.0,0.0,0.0,0.0,0.0,-1494.0,-1128.0,-903.0,-1194.0,261725974.8299999,3729155663.160002,4197160588.455002,60380310.68999995,3729186015.660002,270150.0,-18557345.5,4309137402.0,190858075.0,968614762.0,416750319.0,1012757689.0,267595.5,4213.0,750.0456249611931,6195348.0,2208900.0,1361978.0,-4456461.0,1428337.0,102691.0,2945810535.952605,2978265107.857563,-178298925.0,-176826450.0,3116569.5,147663.5,,,,,,,,,,,,,,,,,,,,,1468681.0,14828567.0,3235218.0,8562899.0,11617493.0,1417081.0,1060535909.5695012,802074505.0274951,72167527895.01718,21694284738.00012,583158359.0519989,5792665.7475,689.5,94245.0,-277157885.0,22016911.5,-123883358.5,-218881773.0,-2022938.5,,,,,,,,,,,,,,,,,,,,,4276843.5,2481560.0,-9011049.0,921269.0,37582.5,3736976805.7424607,3661648828.1099615,-260841820.0,-257527246.5,2528503.5,269439.5,3929632721.4374537,33281339840.05592,36712649972.49764,1731259317.8700497,48127771741.343216,3991670.5,-247783891.5,103175146908.5,1055777573.5,17287392381.0,3506683670.0,18900867080.5,3675136.0,71998.5,20886.68464799425,89840307.0,-7.278757274905856,1.1111111111111112,7.957559681697612,254.7291159478216,8.841732979664013,283.0323510531352,67500.0,-0.9009688679024191,-0.433883739117558,0.0,0.0,0.0,0.0,0.0,0.0,1.0,0.0,1.0,0.0,0.0,0.0,0.0,0.0,0.0,0.0,0.0,0.0,1.0,0.0,1.0,0.0,0.0,0.0,0.0,0.0,0.0,0.0,0.0,1.0,0.0,0.0,0.0,0.0,0.0,0.0,0.0,0.0,0.0,0.0,0.0,0.0,0.0,0.0,0.0,0.0,0.0,0.0,0.0,0.0,0.0,0.0,0.0,1.0,0.0,0.0,0.0,0.0,0.0,0.0,0.0,0.0,0.0,0.0,0.0,0.0,0.0,0.0,0.0,0.0,0.0,0.0,0.0,0.0,0.0,0.0,0.0,0.0,0.0,0.0,0.0,0.0,0.0,0.0,0.0,0.0,0.0,0.0,0.0,0.0,0.0,0.0,0.0,0.0,0.0,0.0,0.0,0.0,0.0,0.0,0.0,0.0,0.0,0.0,0.0,0.0,0.0,0.0,0.0,0.0,0.0,0.0,0.0,0.0,0.0,0.0,0.0,0.0,0.0,0.0
104479,0,0.0,0.0,0.0,1.0,0.0,90000.0,337500.0,25362.0,337500.0,0.028663,55.23013698630137,,-2535.0,-3530.0,,1.0,2.0,2.0,12.0,,0.7320786905913668,0.7922644738669378,0.0825,0.0799,0.9781,0.7008,0.0088,0.0,0.1379,0.1667,0.0417,0.0944,0.0672,0.0709,0.0,0.0,0.084,0.0829,0.9782,0.7125,0.0088,0.0,0.1379,0.1667,0.0417,0.0966,0.0735,0.0739,0.0,0.0,0.0833,0.0799,0.9781,0.7048,0.0088,0.0,0.1379,0.1667,0.0417,0.096,0.0684,0.0722,0.0,0.0,0.0605,1.0,1.0,0.0,1.0,0.0,-200.0,0.0,0.0,0.0,0.0,0.0,0.0,1.0,0.0,0.0,1.0,0.0,0.0,0.0,0.0,0.0,0.0,0.0,0.0,0.0,0.0,0.0,0.0,1.0,0.0,0.0,0.0,0.0,0.0,0.0,0.0,0.0,0.0,0.0,0.0,0.0,0.0,0.0,0.0,4.0,0.0,5309.505,216000.0,0.0,0.0,0.0,0.0,0.0,-2371.5,-1688.5,-1332.0,-2054.5,305.0,-38.0,3.0,22196.295,0.0,0.0,20677.5,206752.5,10.0,-200.0,365243.0,-2420.0,-2150.0,-2150.0,-2141.0,10.0,1.0,0.1021467326762068,-1.0,10.0,10.0,5.5,-75.5,0.0,0.0,10.0,22196.295,22196.295,-2286.5,-2285.0,5.5,1.0,0.0,,,,,,,,,,,,,,,,,,,,,8353884699.0,184525106863.5,165697582536.0,52013845405.935,1863.0,1706.0,71125.0,70917.0,9141.0,506493.0,17823.8655000023,17886.115199999116,17337.211599998012,11304.777700000091,11242.578700000096,11189.947800000056,128524.0,663371.0,4141.372200000114,4139.064800000013,3949.6333000000927,13538637.739725623,,-922649553.0,-296747931.0,-1536503035.0416667,44058.0,30731.0,11358.57399999919,11234.519999998984,10718.557599997288,22908.33720000977,22830.09780000973,22215.069400008302,,158167.13265914333,126210.53055853285,35032.29160002799,34972.409400028424,34417.84350002884,22972.198499995902,22945.23369999548,22591.997799995712,3717201.0,8302.604400000164,8407.234900000074,8130.693400000232,9825.166600000715,9940.172000002158,10300.273399999642,16481.66159999973,16667.044499999694,16263.7321999997,829.0404000001766,814.2180000000461,760.1409000000133,3916.930700000123,3900.147400000162,3732.81220000016,436819.0,431612.0,,6430.193112002897,632481.0,626029.0,,16346.003599999802,154317.1594999907,154319.9040999903,154211.6293999872,77674.09519999637,78012.2044000066,78413.9630000066,78.5,74103175.89,26294075.54999999,7424675376.074992,2472406194.6000013,85431647.02499995,784146.5999999999,136.0,16969.0,-24194864.0,10972908.5,-12532189.5,-13656635.0,-38.75,0.0,1305.0,216000.0,0.0,0.0,0.0,0.0,0.0,-2421.0,-2056.0,-1343.0,-2056.0,262221426.80999985,3735546779.160002,4204271981.205002,60456441.68999995,3735546779.160002,270504.0,-18580297.0,4315344771.0,190838909.0,971159022.0,417472721.0,1015302038.0,267982.0,4222.0,750.560342802102,6215282.0,2212899.0,1364788.0,-4461796.0,1428337.0,102691.0,2952091933.807607,2984976745.4925666,-178506789.5,-177032438.0,3121188.5,147879.5,,,,,,,,,,,,,,,,,,,,,1468685.0,14828872.0,3235218.0,8562909.0,11617503.0,1417084.0,1060535909.5695012,802079814.5324951,72167743895.01718,21694284738.00012,583158359.0519989,5792665.7475,689.5,94245.0,-277160256.5,22015223.0,-123884690.5,-218883827.5,-2022976.5,,,,,,,,,,,,,,,,,,,,,4276853.5,2481565.5,-9011124.5,921269.0,37582.5,3736999002.037461,3661671024.4049616,-260844106.5,-257529531.5,2528509.0,269440.5,3929654917.732455,33281339840.05592,36712649972.49764,1731279995.3700497,48127978493.843216,3991680.5,-247784091.5,103175512151.5,1055775153.5,17287390231.0,3506681520.0,18900864939.5,3675146.0,71999.5,20886.78679472693,89840306.0,,3.75,3.5486160397445,195.99054998687492,13.307310149041871,734.9645624507813,90000.0,-0.2225209339563146,-0.9749279121818236,0.0,0.0,0.0,0.0,0.0,0.0,1.0,0.0,0.0,1.0,0.0,0.0,0.0,0.0,0.0,0.0,0.0,0.0,1.0,0.0,0.0,0.0,0.0,1.0,0.0,1.0,0.0,0.0,0.0,0.0,0.0,0.0,0.0,0.0,0.0,0.0,0.0,0.0,0.0,0.0,0.0,0.0,0.0,0.0,0.0,0.0,0.0,0.0,0.0,0.0,0.0,0.0,0.0,0.0,0.0,0.0,0.0,0.0,0.0,0.0,0.0,0.0,0.0,0.0,0.0,0.0,0.0,0.0,0.0,0.0,0.0,0.0,0.0,0.0,0.0,0.0,0.0,0.0,0.0,0.0,0.0,0.0,0.0,0.0,0.0,0.0,0.0,0.0,0.0,0.0,0.0,0.0,0.0,0.0,0.0,0.0,0.0,0.0,0.0,0.0,0.0,0.0,0.0,0.0,0.0,1.0,0.0,0.0,1.0,0.0,1.0,0.0,0.0,0.0,0.0,0.0,0.0,1.0,0.0,0.0
104480,0,0.0,1.0,1.0,1.0,1.0,450000.0,758214.0,38844.0,603000.0,0.04622,42.77808219178083,-2702.0,-896.0,-2713.0,7.0,3.0,1.0,1.0,10.0,0.5195612990942425,0.7473668550122247,,,,,,,,,,,,,,,,,,,,,,,,,,,,,,,,,,,,,,,,,,,,,,3.0,0.0,3.0,0.0,-546.0,0.0,0.0,0.0,0.0,0.0,1.0,1.0,1.0,0.0,1.0,0.0,1.0,0.0,0.0,0.0,1.0,1.0,1.0,0.0,0.0,0.0,0.0,0.0,0.0,1.0,0.0,0.0,0.0,0.0,0.0,0.0,0.0,0.0,0.0,0.0,0.0,0.0,0.0,1.0,29463.3,1975.005,2369264.4,1905341.355,0.0,0.0,0.0,0.0,-605.0,1210.0,-8.0,,20.0,-9.5,6.0,25137.63,177720.75,131287.5,50843.25,188955.0,6.0,-215.0,365243.0,-160.5,365243.0,79.5,365243.0,13.0,0.5,0.3031447936769446,29.0,20.0,6.0,5.0,-5.5,0.0,0.0,17.0,25137.63,25137.63,-151.0,-139.0,3.0,1.0,18.0,0.0,45000.0,,0.0,,,0.0,,0.0,0.0,0.0,0.0,,0.0,,,0.0,-9.5,0.0,0.0,8353923543.0,184525865077.5,165698185536.0,52014295405.935,1863.0,1706.0,71125.0,70917.0,9141.0,506494.0,,,,,,,128525.0,663374.0,,,,13538680.517807815,-602456572.0,-922652266.0,-296748477.0,-1536503931.0416667,44058.0,30731.0,,,,,,,67535.2864478798,158167.88002599837,,,,,,,,3717211.0,,,,,,,,,,,,,,,,436822.0,431615.0,1264203.0,6430.239332002897,632482.0,626030.0,,,,,,,,,20.0,74132639.19,26300707.55999999,7427386640.474992,2474311535.9550014,85431647.02499995,784146.5999999999,136.0,16969.0,-24198732.0,10973458.0,-12534537.0,,-9.5,29463.3,1975.005,2369264.4,1905341.355,0.0,0.0,0.0,0.0,-605.0,1210.0,-8.0,,262302602.66999984,3736401743.160002,4205132990.955002,60529784.93999995,3736496220.660002,270552.0,-18581324.0,4316257878.5,191021051.5,971706704.0,417655188.0,1015849723.0,268034.5,4223.0,751.0032687530922,6215367.5,2213007.0,1364860.0,-4462243.5,1428337.0,102691.0,2952412040.160109,2985296851.845068,-178519612.0,-177045161.0,3121243.0,147893.0,2702548998.854972,7362868500.0,,350723349.5399997,,,153134473.99499917,,356255256.96000016,2594382099.389998,2692457417.519968,2692589265.134968,,30752.0,,,890115.0,-1578578.5,672081.0,1504.0,1468686.0,14828892.0,3235236.0,8562929.0,11617520.0,1417090.0,1060565372.8695012,802081789.5374951,72170113159.41716,21696190079.35512,583158359.0519989,5792665.7475,689.5,94245.0,-277160861.5,22016433.0,-123884698.5,,-2022986.0,5926407394.72496,18739152000.0,,448266420.5624977,,,309287785.43249863,,459413321.7599993,5711441154.660034,5889661510.297498,5889904693.0425,,80929.0,,,972106.0,-1699891.5,177364.0,6755.0,4276859.5,2481570.5,-9011130.0,921269.0,37582.5,3737024139.667461,3661696162.0349617,-260844257.5,-257529670.5,2528512.0,269441.5,3929680055.362455,33281517560.80592,36712781259.99764,1731330838.6200497,48128167448.843216,3991686.5,-247784306.5,103175877394.5,1055774993.0,17287755474.0,3506681599.5,18901230182.5,3675159.0,72000.0,20887.08993952061,89840335.0,-63.16318688356603,1.68492,11.584800741427248,495.57555829217824,19.519462465245603,835.005169677657,150000.0,0.6234898018587336,0.7818314824680298,0.0,1.0,0.0,0.0,0.0,0.0,0.0,0.0,1.0,0.0,0.0,0.0,0.0,0.0,0.0,1.0,0.0,0.0,0.0,0.0,1.0,0.0,0.0,0.0,0.0,1.0,0.0,0.0,0.0,0.0,0.0,0.0,0.0,0.0,0.0,0.0,0.0,0.0,0.0,0.0,1.0,0.0,0.0,0.0,0.0,0.0,0.0,0.0,0.0,0.0,0.0,0.0,0.0,0.0,0.0,0.0,0.0,0.0,0.0,0.0,0.0,0.0,0.0,0.0,0.0,0.0,0.0,0.0,0.0,0.0,0.0,0.0,0.0,0.0,0.0,0.0,0.0,0.0,0.0,0.0,0.0,0.0,0.0,0.0,0.0,0.0,0.0,0.0,0.0,0.0,1.0,0.0,0.0,0.0,0.0,0.0,0.0,0.0,0.0,0.0,0.0,0.0,0.0,0.0,0.0,0.0,0.0,0.0,0.0,0.0,0.0,0.0,0.0,0.0,0.0,0.0,0.0,0.0,0.0,0.0
104482,0,0.0,1.0,1.0,1.0,0.0,126000.0,52128.0,5602.5,45000.0,0.016612,50.00821917808219,-1520.0,-4468.0,-1806.0,7.0,2.0,2.0,2.0,16.0,,0.4004681258625184,0.2678689358444539,,,,,,,,,,,,,,,,,,,,,,,,,,,,,,,,,,,,,,,,,,,,,1.0,1.0,1.0,1.0,-2574.0,0.0,0.0,0.0,0.0,0.0,0.0,1.0,1.0,0.0,1.0,0.0,1.0,0.0,0.0,0.0,0.0,1.0,1.0,0.0,1.0,0.0,0.0,0.0,0.0,0.0,0.0,0.0,0.0,0.0,0.0,0.0,0.0,0.0,0.0,0.0,0.0,0.0,0.0,4.0,9761.175,1853.37,55851.75,24669.0,0.0,0.0,0.0,0.0,-829.0,-648.0,-531.0,-1002.0,133.0,-16.0,4.0,6965.055,46568.25,46568.25,0.0,46568.25,5.0,-543.0,365243.0,-508.5,-388.5,-388.5,-384.0,13.5,0.0,0.0,2625.0,22.0,6.0,2.0,-20.5,0.0,0.0,19.0,10567.575,10567.575,-631.0,-616.0,4.0,1.0,13.0,0.0,45000.0,,0.0,,,0.0,,0.0,0.0,0.0,0.0,,0.0,,,0.0,-8.0,0.0,0.0,8353929145.5,184525917205.5,165698230536.0,52014421405.935,1863.0,1706.0,71125.0,70917.0,9141.0,506494.0,,,,,,,128525.0,663376.0,,,,13538730.526026996,-602458092.0,-922654072.0,-296751051.0,-1536508399.0416667,44059.0,30732.0,,,,,,,,158168.2804941242,126210.79842746868,,,,,,,3717227.0,,,,,,,,,,,,,,,,436823.0,431616.0,1264210.0,6430.255944002896,632484.0,626032.0,,,,,,,,,28.0,74176298.865,26303838.92999999,7428330960.974992,2475055714.4550014,85455761.48999995,784146.5999999999,136.0,16969.0,-24203103.5,10973240.0,-12536422.5,-13661459.0,-13.5,7345.35,1853.37,38250.0,0.0,0.0,0.0,0.0,0.0,-829.0,-648.0,-637.0,-1356.0,262445209.24499983,3737799956.6100025,4206606671.205002,60585038.63999996,3737799956.6100025,270671.0,-18590626.5,4318814579.5,191199232.5,972616891.5,417835129.5,1016759933.5,268198.5,4226.0,751.4855066605014,6222134.0,2214010.0,1365397.5,-4464001.5,1428337.0,102691.0,2953432377.8101068,2986296621.345066,-178569242.0,-177094146.0,3121724.0,147968.0,2702548998.854972,7363566000.0,,350723349.5399997,,,153134473.99499917,,356255256.96000016,2594382099.389998,2692457417.519968,2692589265.134968,,30752.0,,,890115.0,-1578736.0,672081.0,1504.0,1468690.0,14829025.0,3235249.0,8562951.0,11617539.0,1417094.0,1060575134.0445012,802083642.9074951,72170169011.16716,21696214748.35512,583158359.0519989,5792665.7475,689.5,94245.0,-277161690.5,22015785.0,-123885229.5,-218884829.5,-2023002.0,5926407394.72496,18739197000.0,,448266420.5624977,,,309287785.43249863,,459413321.7599993,5711441154.660034,5889661510.297498,5889904693.0425,,80929.0,,,972106.0,-1699899.5,177364.0,6755.0,4276865.5,2481572.5,-9011150.5,921269.0,37582.5,3737034707.2424607,3661706729.6099615,-260844888.5,-257530286.5,2528516.0,269442.5,3929687020.417455,33281564129.05592,36712827828.24764,1731330838.6200497,48128214017.093216,3991691.5,-247784849.5,103176242637.5,1055774484.5,17287755085.5,3506681211.0,18901229798.5,3675172.5,72000.0,20887.08993952061,89842960.0,-30.395003561058456,0.4137142857142857,22.48995983935743,1124.6828409528523,9.304417670682732,465.297358199923,63000.0,-0.2225209339563146,-0.9749279121818236,0.0,1.0,0.0,0.0,0.0,0.0,0.0,0.0,0.0,0.0,0.0,0.0,0.0,1.0,0.0,0.0,0.0,0.0,1.0,0.0,1.0,0.0,0.0,0.0,0.0,1.0,0.0,0.0,0.0,0.0,0.0,0.0,0.0,0.0,0.0,0.0,0.0,0.0,0.0,0.0,0.0,0.0,0.0,0.0,0.0,0.0,1.0,0.0,0.0,0.0,0.0,0.0,0.0,0.0,0.0,0.0,0.0,0.0,0.0,0.0,0.0,0.0,0.0,0.0,0.0,0.0,0.0,0.0,0.0,0.0,0.0,0.0,0.0,0.0,0.0,0.0,0.0,0.0,0.0,0.0,0.0,1.0,0.0,0.0,0.0,0.0,0.0,0.0,0.0,0.0,0.0,0.0,0.0,0.0,0.0,0.0,0.0,0.0,0.0,0.0,0.0,0.0,0.0,0.0,0.0,0.0,0.0,0.0,0.0,0.0,0.0,0.0,0.0,0.0,0.0,0.0,0.0,0.0,0.0,0.0
104499,0,0.0,0.0,0.0,1.0,0.0,162000.0,450000.0,25258.5,450000.0,0.028663,47.2,,-1059.0,-749.0,,2.0,2.0,2.0,9.0,0.8430970130837594,0.4684452196979276,0.8327850252992314,,,,,,,,,,,,,,,,,,,,,,,,,,,,,,,,,,,,,,,,,,,,,0.0,0.0,0.0,0.0,-3030.0,0.0,0.0,0.0,0.0,0.0,1.0,1.0,0.0,0.0,1.0,0.0,0.0,0.0,0.0,0.0,0.0,0.0,0.0,0.0,0.0,0.0,0.0,1.0,0.0,0.0,0.0,0.0,0.0,0.0,0.0,0.0,0.0,0.0,0.0,0.0,0.0,0.0,0.0,10.0,0.0,0.0,268906.5,0.0,0.0,0.0,0.0,0.0,-1871.5,-571.0,-970.0,-1393.0,561.0,-29.0,0.0,,,,,,,,,,,,,,,,,6.0,10.0,3.5,-93.5,0.0,0.0,9.0,6845.895,6845.49,-2819.0,-2819.0,7.0,1.0,0.0,,,,,,,,,,,,,,,,,,,,,8353954404.0,184526367205.5,165698680536.0,52014583405.935,1863.0,1706.0,71125.0,70917.0,9141.0,506495.0,,,,,,,128525.0,663378.0,,,,13538777.726026991,,-922654821.0,-296754081.0,-1536509458.0416667,44059.0,30732.0,,,,,,,67536.12954489289,158168.7489393439,126211.63121249394,,,,,,,3717236.0,,,,,,,,,,,,,,,,436823.0,431616.0,,6430.284607002896,632486.0,626034.0,,,,,,,,,62.5,74456757.72,26326668.50999999,7443781898.669991,2480025717.315001,85498808.71499994,784146.5999999999,136.0,16969.0,-24265718.5,11052174.5,-12571415.5,-13698592.5,-30.75,0.0,0.0,87813.0,0.0,0.0,0.0,0.0,0.0,-2228.0,-1133.0,-1429.0,-2443.0,,,,,,,,,,,,,,,,,2221271.0,1369670.5,-4482052.5,1458334.0,102768.0,2962612024.6501174,2994961684.5000787,-179057064.0,-177577914.0,3126556.0,148496.0,,,,,,,,,,,,,,,,,,,,,1468700.0,14829586.0,3235249.0,8562957.0,11617548.0,1417094.0,1060575134.0445012,802083642.9074951,72170437917.66716,21696214748.35512,583158359.0519989,5792665.7475,689.5,94245.0,-277163562.0,22015214.0,-123886199.5,-218886222.5,-2023031.0,,,,,,,,,,,,,,,,,,,,,4276875.5,2481576.0,-9011244.0,921269.0,37582.5,3737041553.1374607,3661713575.099961,-260847707.5,-257533105.5,2528523.0,269443.5,,,,,,,,,,,,,,,,,,2.7777777777777777,6.413682522715126,302.72581507215403,17.815784785319792,840.9050418670943,81000.0,-0.9009688679024191,0.4338837391175582,0.0,0.0,0.0,0.0,0.0,0.0,1.0,0.0,0.0,1.0,0.0,0.0,0.0,0.0,0.0,1.0,0.0,0.0,0.0,0.0,1.0,0.0,0.0,0.0,0.0,1.0,0.0,0.0,0.0,0.0,0.0,0.0,0.0,0.0,0.0,0.0,0.0,0.0,0.0,0.0,0.0,0.0,0.0,0.0,0.0,0.0,0.0,0.0,0.0,0.0,0.0,0.0,0.0,0.0,0.0,0.0,0.0,0.0,0.0,0.0,0.0,0.0,0.0,0.0,0.0,0.0,0.0,0.0,0.0,0.0,0.0,0.0,0.0,0.0,0.0,0.0,0.0,0.0,0.0,0.0,0.0,0.0,0.0,0.0,0.0,0.0,0.0,0.0,0.0,0.0,0.0,0.0,0.0,0.0,0.0,0.0,0.0,0.0,0.0,0.0,0.0,0.0,0.0,0.0,0.0,1.0,0.0,0.0,0.0,0.0,0.0,0.0,0.0,0.0,0.0,0.0,0.0,0.0,0.0,0.0
104501,0,0.0,0.0,0.0,0.0,0.0,135000.0,260640.0,26838.0,225000.0,0.008575,64.96164383561644,,-8958.0,-3997.0,,2.0,2.0,2.0,16.0,,0.7150730075527092,0.7016957740576931,0.1227,0.134,0.9806,0.7348,,0.0,0.2759,0.1667,0.2083,,0.0992,0.0742,0.0051,0.0099,0.0945,0.0925,0.9772,0.6994,,0.0,0.2069,0.1667,0.2083,,0.0826,0.0641,0.0,0.0,0.1239,0.1282,0.9771,0.6914,,0.0,0.2759,0.1667,0.2083,,0.0992,0.0812,0.0039,0.0119,0.0699,1.0,7.0,0.0,7.0,0.0,-2501.0,0.0,0.0,0.0,0.0,0.0,0.0,1.0,0.0,0.0,1.0,1.0,0.0,0.0,0.0,0.0,0.0,0.0,0.0,0.0,1.0,0.0,0.0,0.0,0.0,0.0,0.0,0.0,0.0,0.0,0.0,0.0,0.0,0.0,0.0,0.0,0.0,0.0,0.0,3.0,0.0,0.0,98095.5,0.0,0.0,0.0,0.0,0.0,-907.0,-693.0,-687.0,-693.0,110.0,-22.0,1.0,16861.68,147780.0,147780.0,0.0,147780.0,12.0,-2501.0,365243.0,-2470.0,-2200.0,-2140.0,-2192.0,15.0,0.0,0.0,2128.0,10.0,10.0,5.5,-78.5,0.0,0.0,12.0,16861.68,16861.68,-2339.0,-2335.0,5.5,1.0,0.0,,,,,,,,,,,,,,,,,,,,,8353981242.0,184526627845.5,165698905536.0,52014718405.935,1863.0,1706.0,71125.0,70917.0,9141.0,506495.0,17823.9882000023,17886.239099999115,17337.30609999801,11304.911700000092,11242.706900000096,11190.040300000055,128525.0,663380.0,,,,13538842.687670829,,-922658818.0,-296756582.0,-1536518416.0416667,44059.0,30732.0,11358.57399999919,11234.519999998984,10718.557599997288,22908.61310000977,22830.37370000973,22215.2763000083,,158169.4640123515,126212.33290826804,35032.45830002799,34972.576100028426,34418.01020002884,22972.406799995897,22945.44199999548,22592.206099995707,3717252.0,,,,9825.265800000718,9940.271200002158,10300.35599999964,16481.735799999733,16667.125699999695,16263.7962999997,829.0455000001767,814.2219000000463,760.1409000000133,3916.940600000123,3900.159300000162,3732.81220000016,436830.0,431623.0,,6430.293182002897,632488.0,626036.0,,16346.073499999802,154318.1400999907,154320.88119999028,154212.6065999872,77674.82999999636,78012.89580000659,78414.66240000661,30.0,74510329.14,26326668.50999999,7452304066.03499,2480411448.315001,85988586.59999995,784146.5999999999,136.0,16969.0,-24278083.0,11046605.0,-12580401.0,-13707376.0,-14.5,0.0,0.0,450000.0,0.0,0.0,0.0,0.0,0.0,-2127.0,-1397.0,-1497.0,-1500.0,263621198.96999988,3755188843.1100025,4225902284.205002,60783803.63999996,3755188843.1100025,271948.0,-18662055.0,4336528044.0,191513994.0,976596811.0,418899720.0,1021106804.0,269283.0,4239.0,754.8537580447847,6244724.0,2222208.0,1370183.5,-4483803.0,1458334.0,102768.0,2964012459.705116,2996321550.4800773,-179113756.0,-177633197.0,3127033.0,148562.5,,,,,,,,,,,,,,,,,,,,,1468703.0,14829696.0,3235249.0,8562967.0,11617560.0,1417095.0,1060575134.0445012,802083642.9074951,72170536013.16716,21696214748.35512,583158359.0519989,5792665.7475,689.5,94245.0,-277164469.0,22014521.0,-123886886.5,-218886915.5,-2023053.0,,,,,,,,,,,,,,,,,,,,,4276885.5,2481581.5,-9011322.5,921269.0,37582.5,3737058414.817461,3661730436.779961,-260850046.5,-257535440.5,2528528.5,269444.5,3929703882.097454,33281711909.05592,36712975608.24764,1731330838.6200497,48128361797.093216,3991703.5,-247787350.5,103176607880.5,1055772014.5,17287752885.5,3506679071.0,18901227606.5,3675187.5,72000.0,20887.08993952061,89845088.0,,1.9306666666666668,5.030181086519113,326.76883217110884,9.711602951039572,630.8816919783543,67500.0,1.0,0.0,0.0,0.0,0.0,0.0,0.0,0.0,1.0,0.0,0.0,1.0,0.0,0.0,0.0,0.0,0.0,0.0,0.0,0.0,1.0,0.0,1.0,0.0,0.0,0.0,0.0,1.0,0.0,0.0,0.0,0.0,0.0,0.0,0.0,0.0,0.0,0.0,0.0,0.0,0.0,0.0,0.0,0.0,0.0,0.0,0.0,0.0,0.0,0.0,0.0,0.0,0.0,0.0,0.0,0.0,0.0,0.0,0.0,0.0,0.0,0.0,0.0,0.0,0.0,0.0,0.0,0.0,0.0,0.0,0.0,0.0,0.0,0.0,0.0,0.0,0.0,0.0,0.0,0.0,0.0,0.0,0.0,0.0,0.0,0.0,0.0,0.0,0.0,0.0,0.0,0.0,0.0,0.0,0.0,0.0,0.0,0.0,0.0,0.0,0.0,0.0,0.0,0.0,0.0,0.0,0.0,1.0,0.0,0.0,1.0,0.0,1.0,0.0,0.0,0.0,0.0,0.0,0.0,1.0,0.0,0.0
104502,0,0.0,0.0,1.0,0.0,1.0,292500.0,454500.0,20020.5,454500.0,0.015221,38.22191780821917,-4414.0,-5690.0,-4687.0,7.0,3.0,2.0,2.0,14.0,0.6284005212218327,0.4517594493884417,0.5370699579791587,0.0918,0.1006,0.9836,0.7756,0.0119,0.0,0.2069,0.1667,0.2083,0.0645,0.074,0.084,0.0039,0.0077,0.0935,0.1044,0.9836,0.7844,0.012,0.0,0.2069,0.1667,0.2083,0.0659,0.0808,0.0875,0.0039,0.0081,0.0926,0.1006,0.9836,0.7786,0.012,0.0,0.2069,0.1667,0.2083,0.0656,0.0752,0.0855,0.0039,0.0078,0.0743,1.0,3.0,0.0,3.0,0.0,-285.0,0.0,0.0,0.0,0.0,1.0,2.0,1.0,1.0,1.0,1.0,1.0,0.0,0.0,0.0,0.0,0.0,0.0,0.0,0.0,1.0,0.0,0.0,0.0,0.0,0.0,0.0,0.0,0.0,0.0,0.0,0.0,0.0,0.0,0.0,0.0,0.0,0.0,0.0,5.0,0.0,,103500.0,0.0,0.0,0.0,0.0,0.0,-2574.0,-2186.0,-683.0,-2186.0,403.0,-40.0,7.0,11093.76,76500.0,79024.5,6795.0,76500.0,10.0,-664.0,365243.0,-634.0,-484.0,-484.0,-477.0,15.0,0.0,0.1066103868212739,5.0,57.0,12.0,5.0,-41.0,0.0,0.0,64.0,6751.305,6751.305,-1829.0,-1819.0,5.0,1.0,0.0,,,,,,,,,,,,,,,,,,,,,8354001262.5,184527082345.5,165699360036.0,52015010905.935,1863.0,1706.0,71125.0,70918.0,9141.0,506497.0,17824.080000002294,17886.331699999115,17337.39959999801,11305.012300000091,11242.807500000095,11190.144700000055,128526.0,663383.0,4141.384100000115,4139.076800000013,3949.645300000093,13538880.909588637,-602462506.0,-922663505.0,-296756867.0,-1536524106.0416667,44059.0,30732.0,11358.57399999919,11234.519999998984,10718.557599997288,22908.82000000977,22830.580600009736,22215.4832000083,67536.75794541411,158169.91577180085,126212.869978226,35032.62500002799,34972.742800028434,34418.17690002884,22972.6150999959,22945.65029999548,22592.41439999571,3717266.0,8302.668900000164,8407.300500000074,8130.759300000232,9825.339800000718,9940.346400002158,10300.43679999964,16481.819799999732,16667.211199999696,16263.8837999997,829.0494000001767,814.2258000000462,760.1448000000132,3916.9483000001233,3900.1671000001625,3732.82030000016,436833.0,431626.0,1264217.0,6430.308403002897,632490.0,626038.0,,16346.147799999802,154319.1236999907,154321.8647999903,154213.5901999872,77675.60559999637,78013.6744000066,78415.4468000066,85.0,74511422.64,,7452623348.41499,2480411448.315001,85988586.59999995,784146.5999999999,136.0,16969.0,-24286124.0,11040247.0,-12583330.0,-13713905.0,-42.0,0.0,,103500.0,0.0,0.0,0.0,0.0,0.0,-2574.0,-2186.0,-683.0,-2186.0,263674195.51499987,3755743185.510002,4226416540.6050014,60835558.13999996,3755743185.510002,271992.0,-18665863.0,4337989016.0,191873659.0,976957466.0,419260645.0,1021467479.0,269343.0,4241.0,755.2806861738069,6245119.0,2222564.0,1370386.5,-4485339.0,1458334.0,102768.0,2964619015.920113,2996909393.445076,-179174413.0,-177693605.5,3127248.5,148601.5,,,,,,,,,,,,,,,,,,,,,1468708.0,14830099.0,3235249.0,8563024.0,11617624.0,1417102.0,1060575134.0445012,,72170639513.16716,21696214748.35512,583158359.0519989,5792665.7475,689.5,94245.0,-277167043.0,22012335.0,-123887569.5,-218889101.5,-2023093.0,,,,,,,,,,,,,,,,,,,,,4276897.5,2481586.5,-9011363.5,921269.0,37582.5,3737065166.122461,3661737188.084961,-260851875.5,-257537259.5,2528533.5,269445.5,3929714975.857455,33281788409.05592,36713054632.74764,1731337633.6200497,48128438297.093216,3991713.5,-247788014.5,103176973123.5,1055771380.5,17287752401.5,3506678587.0,18901227129.5,3675202.5,72000.0,20887.196549907432,89845093.0,-115.48347788688984,1.553846153846154,14.610024724657226,558.4231642018983,22.701730726005845,867.7036859137191,97500.0,-0.9009688679024191,-0.433883739117558,0.0,0.0,0.0,0.0,0.0,0.0,1.0,0.0,0.0,0.0,0.0,0.0,0.0,1.0,0.0,0.0,0.0,0.0,1.0,0.0,1.0,0.0,0.0,0.0,0.0,1.0,0.0,0.0,0.0,0.0,0.0,0.0,0.0,0.0,0.0,0.0,0.0,0.0,0.0,0.0,1.0,0.0,0.0,0.0,0.0,0.0,0.0,0.0,0.0,0.0,0.0,0.0,0.0,1.0,0.0,0.0,0.0,0.0,0.0,0.0,0.0,0.0,0.0,0.0,0.0,0.0,0.0,0.0,0.0,0.0,0.0,0.0,0.0,0.0,0.0,0.0,0.0,0.0,0.0,0.0,0.0,0.0,0.0,0.0,0.0,0.0,0.0,0.0,0.0,0.0,0.0,0.0,0.0,0.0,0.0,0.0,0.0,0.0,0.0,0.0,0.0,0.0,0.0,0.0,0.0,0.0,0.0,1.0,0.0,0.0,1.0,0.0,0.0,0.0,0.0,0.0,0.0,1.0,0.0,0.0
104506,0,0.0,0.0,0.0,0.0,0.0,135000.0,450000.0,35554.5,450000.0,0.009175,32.824657534246576,-652.0,-4784.0,-2278.0,,2.0,2.0,2.0,10.0,,0.6442866536445991,0.3360615207658242,0.1258,0.1626,0.9856,,,0.0,0.2069,0.1667,,,,0.1311,,0.0,0.1282,0.1687,0.9856,,,0.0,0.2069,0.1667,,,,0.1366,,0.0,0.127,0.1626,0.9856,,,0.0,0.2069,0.1667,,,,0.1335,,0.0,0.1031,1.0,0.0,0.0,0.0,0.0,-388.0,0.0,0.0,0.0,0.0,1.0,2.0,1.0,1.0,1.0,1.0,1.0,0.0,0.0,0.0,0.0,0.0,0.0,0.0,0.0,1.0,0.0,0.0,0.0,0.0,0.0,0.0,0.0,0.0,0.0,0.0,0.0,0.0,0.0,0.0,0.0,0.0,0.0,0.0,4.0,4095.0,0.0,103860.0,0.0,829.755,0.0,0.0,0.0,-1207.0,-857.5,-866.0,-1032.0,133.0,-19.0,2.0,11697.345,67500.0,88825.5,,135000.0,24.0,-388.0,365243.0,-358.0,-268.0,332.0,-264.0,15.0,1.0,,-1.0,5.0,24.0,22.0,-11.0,0.0,0.0,7.0,11682.855,22500.0,-337.0,-328.0,2.0,5.0,0.0,,,,,,,,,,,,,,,,,,,,,8354036817.0,184527532345.5,165699810036.0,52015145905.935,1863.0,1706.0,71125.0,70919.0,9141.0,506499.0,17824.2058000023,17886.458699999115,17337.52779999801,11305.174900000093,11242.970100000091,11190.313400000055,128526.0,663385.0,,,,13538913.73424617,-602463158.0,-922665783.0,-296757255.0,-1536528890.0416667,44059.0,30732.0,11358.57399999919,11234.519999998984,10718.557599997288,22909.026900009776,22830.787500009737,22215.6901000083,,158170.5600584545,126213.20603974676,35032.791700027985,34972.90950002844,34418.343600028835,,,,3717276.0,,,,,,,16481.95089999973,16667.344699999696,16264.0203999997,,,,3916.9483000001233,3900.1671000001625,3732.82030000016,436833.0,431626.0,,6430.317578002897,632492.0,626040.0,,16346.250899999804,154320.10929999073,154322.8503999903,154214.5757999872,,,,39.5,74515517.64,26326668.50999999,7455827327.714993,2480762290.815001,86038916.35499996,784146.5999999999,136.0,16969.0,-24300526.0,11033407.0,-12590724.5,-13720945.0,-19.75,0.0,0.0,72720.0,0.0,0.0,0.0,0.0,0.0,-1276.0,-911.0,-870.0,-1032.0,263959052.6699999,3758296805.010002,4229471262.1050014,,3758364305.010002,272226.0,-18689783.0,4342736077.0,191859779.0,977677731.0,419617341.0,1022188004.0,269678.5,4249.0,,6254599.5,2224322.0,1371362.0,-4490603.0,1458334.0,102768.0,2967050240.685123,2999236203.225084,-179369721.0,-177887883.0,3129684.0,148765.0,,,,,,,,,,,,,,,,,,,,,1468712.0,14830232.0,3235249.0,8563029.0,11617631.0,1417104.0,1060579229.0445012,802083642.9074951,72170743373.16716,21696214748.35512,583159188.8069987,5792665.7475,689.5,94245.0,-277168250.0,22011477.5,-123888435.5,-218890133.5,-2023112.0,,,,,,,,,,,,,,,,,,,,,4276921.5,2481608.5,-9011374.5,921269.0,37582.5,3737076848.977461,3661759688.084961,-260852212.5,-257537587.5,2528535.5,269450.5,3929726673.202454,33281855909.05592,36713143458.24764,,48128573297.093216,3991737.5,-247788402.5,103177338366.5,1055771022.5,17287752133.5,3506678919.0,18901226865.5,3675217.5,72001.0,,89845092.0,-19.863116601285373,3.333333333333333,3.7969877230730287,124.63482167161084,12.656625743576765,415.4494055720362,67500.0,0.6234898018587336,0.7818314824680298,0.0,0.0,0.0,0.0,0.0,0.0,1.0,0.0,1.0,0.0,0.0,0.0,0.0,0.0,0.0,0.0,1.0,0.0,0.0,1.0,0.0,0.0,0.0,0.0,0.0,1.0,0.0,0.0,0.0,0.0,0.0,0.0,0.0,0.0,0.0,0.0,0.0,0.0,0.0,0.0,0.0,0.0,0.0,0.0,1.0,0.0,0.0,0.0,0.0,0.0,0.0,0.0,0.0,0.0,0.0,0.0,0.0,0.0,0.0,0.0,0.0,0.0,0.0,0.0,0.0,0.0,0.0,0.0,0.0,0.0,0.0,0.0,0.0,0.0,0.0,0.0,0.0,0.0,0.0,0.0,0.0,0.0,0.0,0.0,0.0,0.0,0.0,0.0,0.0,0.0,1.0,0.0,0.0,0.0,0.0,0.0,0.0,0.0,0.0,0.0,0.0,0.0,0.0,0.0,0.0,0.0,0.0,0.0,0.0,0.0,1.0,0.0,0.0,0.0,0.0,0.0,0.0,1.0,0.0,0.0
104510,0,0.0,1.0,1.0,1.0,1.0,202500.0,600988.5,58675.5,553500.0,0.014464,36.44657534246576,-1845.0,-7117.0,-4272.0,7.0,3.0,2.0,2.0,5.0,0.6470166086996416,0.7035267253938883,0.7352209993926424,0.0619,0.0853,0.9826,0.7416,,0.0,0.1379,0.1667,0.2083,0.066,0.0504,0.0555,0.0,0.028,0.063,0.0885,0.9811,0.7517,,0.0,0.1379,0.1667,0.2083,0.0675,0.0551,0.0578,0.0,0.0296,0.0625,0.0853,0.9826,0.7451,,0.0,0.1379,0.1667,0.2083,0.0672,0.0513,0.0565,0.0,0.0285,0.0482,1.0,0.0,0.0,0.0,0.0,-1578.0,0.0,0.0,0.0,0.0,0.0,3.0,1.0,1.0,0.0,1.0,0.0,1.0,0.0,0.0,0.0,0.0,0.0,0.0,0.0,0.0,0.0,0.0,0.0,0.0,1.0,0.0,0.0,0.0,0.0,0.0,0.0,0.0,0.0,0.0,0.0,0.0,0.0,0.0,6.0,27351.0,0.0,145530.0,0.0,0.0,0.0,0.0,0.0,-2612.0,-178.0,-153.5,-2248.0,383.0,-42.0,5.0,13351.5,112500.0,112500.0,16362.0,112500.0,12.0,-1112.0,365243.0,-1082.0,-752.0,-752.0,-748.0,5.0,0.0,0.2178541313448062,63.0,51.0,12.0,7.0,-30.0,0.0,0.0,46.0,15883.335,15883.335,-945.0,-917.0,5.0,1.0,0.0,,,,,,,,,,,,,,,,,,,,,8354095492.5,184528133334.0,165700363536.0,52015348405.935,1863.0,1706.0,71125.0,70919.0,9141.0,506502.0,17824.2677000023,17886.521199999115,17337.590799998008,11305.260200000092,11243.055400000096,11190.401900000055,128527.0,663388.0,,,,13538950.180821512,-602465003.0,-922670055.0,-296758833.0,-1536536007.0416667,44059.0,30732.0,11358.57399999919,11234.519999998984,10718.557599997288,22909.16480000977,22830.925400009743,22215.828000008307,67537.4049620228,158171.26358517987,126213.94126074616,35032.958400028,34973.07620002843,34418.51030002884,22972.823399995897,22945.858599995478,22592.622699995707,3717281.0,8302.734900000165,8407.367700000073,8130.826800000232,9825.390200000718,9940.397700002157,10300.49189999964,16482.006399999726,16667.401199999695,16264.0781999997,829.0494000001767,814.2258000000462,760.1448000000132,3916.976300000124,3900.195600000162,3732.84990000016,436833.0,431626.0,1264224.0,6430.332042002897,632494.0,626042.0,,16346.299099999802,154321.09189999072,154323.8329999903,154215.55689998722,77676.34719999635,78014.4195000066,78416.19850000659,86.0,74546963.64,26326668.50999999,7465162269.104992,2485550660.175001,86326101.80999996,784146.5999999999,136.0,16969.0,-24316115.5,11036675.0,-12594360.0,-13727690.0,-42.5,54702.0,0.0,202500.0,0.0,0.0,0.0,0.0,0.0,-2733.0,-2248.0,-130.0,-2248.0,264064982.4899999,3759565679.010002,4230885220.6050014,60978883.13999996,3759565679.010002,272382.0,-18699326.0,4345658021.0,191851361.0,978036595.0,419612283.0,1022546902.0,269829.0,4251.0,756.8640465477,6257724.0,2225538.0,1372073.0,-4493162.0,1458334.0,102768.0,2967774545.6101213,2999994574.995081,-179440332.0,-177957012.0,3130169.0,148850.5,,,,,,,,,,,,,,,,,,,,,1468718.0,14830615.0,3235249.0,8563080.0,11617677.0,1417109.0,1060606580.0445012,802083642.9074951,72170888903.16716,21696214748.35512,583159188.8069987,5792665.7475,689.5,94245.0,-277170862.0,22011299.5,-123888589.0,-218892381.5,-2023154.0,,,,,,,,,,,,,,,,,,,,,4276933.5,2481615.5,-9011404.5,921269.0,37582.5,3737092732.312461,3661775571.419961,-260853157.5,-257538504.5,2528540.5,269451.5,3929740024.702454,33281968409.05592,36713255958.24764,1731353995.6200497,48128685797.093216,3991749.5,-247789514.5,103177703609.5,1055769940.5,17287751381.5,3506678167.0,18901226117.5,3675222.5,72001.0,20887.414404038776,89845155.0,-50.62204014132151,2.9678444444444443,3.4511849068180074,125.78387072712316,10.242579952450342,373.3069619382107,67500.0,-0.2225209339563146,-0.9749279121818236,0.0,0.0,0.0,0.0,0.0,0.0,1.0,0.0,1.0,0.0,0.0,0.0,0.0,0.0,0.0,1.0,0.0,0.0,0.0,0.0,1.0,0.0,0.0,0.0,0.0,1.0,0.0,0.0,0.0,0.0,0.0,0.0,0.0,0.0,0.0,0.0,0.0,0.0,0.0,0.0,0.0,0.0,0.0,0.0,0.0,0.0,0.0,0.0,0.0,0.0,0.0,0.0,0.0,1.0,0.0,0.0,0.0,0.0,0.0,0.0,0.0,0.0,0.0,0.0,0.0,0.0,0.0,0.0,0.0,0.0,0.0,0.0,0.0,0.0,0.0,0.0,0.0,0.0,0.0,0.0,0.0,0.0,0.0,0.0,0.0,0.0,0.0,0.0,0.0,0.0,0.0,0.0,0.0,0.0,0.0,0.0,0.0,0.0,0.0,0.0,0.0,0.0,0.0,0.0,0.0,0.0,0.0,0.0,1.0,0.0,1.0,0.0,0.0,0.0,0.0,0.0,0.0,0.0,1.0,0.0
104512,0,0.0,1.0,1.0,0.0,0.0,112500.0,480469.5,46935.0,432000.0,0.018029,60.30684931506849,,-11709.0,-3470.0,16.0,2.0,3.0,3.0,9.0,,0.5560578389927922,0.4101025731788671,1.0,0.9169,0.9831,0.7688,0.4291,1.0,1.0,0.3333,0.375,0.6259,0.9901,1.0,0.027,0.0157,1.0,0.9515,0.9831,0.7779,0.433,1.0,1.0,0.3333,0.375,0.6402,1.0,1.0,0.0272,0.0167,1.0,0.9169,0.9831,0.7719,0.4318,1.0,1.0,0.3333,0.375,0.6368,1.0,1.0,0.0272,0.0161,1.0,1.0,3.0,0.0,3.0,0.0,-1526.0,0.0,0.0,0.0,0.0,1.0,3.0,1.0,0.0,0.0,1.0,0.0,0.0,0.0,0.0,0.0,1.0,0.0,0.0,0.0,1.0,0.0,0.0,0.0,0.0,0.0,0.0,0.0,0.0,0.0,0.0,0.0,0.0,0.0,0.0,0.0,0.0,0.0,0.0,1.0,,,67500.0,0.0,0.0,0.0,0.0,0.0,-160.0,126.0,-113.0,,6.0,-2.5,2.0,23460.48,340596.0,372676.5,9621.0,340596.0,21.0,-1262.5,365243.0,-1232.0,181949.0,-632.0,181951.5,11.0,0.5,0.104285039575258,689.5,39.0,36.0,16.0,-20.0,0.0,0.0,40.0,29576.745,29576.745,-568.0,-564.0,14.5,1.0,0.0,,,,,,,,,,,,,,,,,,,,,8354142427.5,184528613803.5,165700795536.0,52015460905.935,1863.0,1706.0,71125.0,70920.0,9141.0,506505.0,17825.2677000023,17887.521199999115,17338.590799998008,11306.177100000095,11243.972300000096,11191.353400000056,128527.0,663390.0,4141.813200000115,4139.508600000013,3950.078300000093,13539010.487670828,,-922673525.0,-296760359.0,-1536547716.0416667,44059.0,30732.0,11359.57399999919,11235.519999998984,10719.557599997288,22910.16480000977,22831.925400009743,22216.828000008307,,158171.81964301885,126214.35136331937,35033.291700027985,34973.40950002844,34418.843600028835,22973.198399995897,22946.233599995478,22592.997699995707,3717290.0,8303.360800000164,8408.004500000074,8131.467000000232,9826.38030000072,9941.397700002157,10301.49189999964,16483.006399999726,16668.401199999695,16265.0781999997,829.0764000001767,814.2530000000462,760.1720000000133,3916.9920000001234,3900.2117000001617,3732.86660000016,436836.0,431629.0,1264240.0,6430.350071002897,632497.0,626045.0,,16347.299099999802,154322.07499999073,154324.8160999903,154216.53999998723,77677.11599999637,78015.1914000066,78416.97640000659,6.0,,,7467953106.104992,2485550660.175001,86326101.80999996,784146.5999999999,136.0,16969.0,-24328766.0,11031572.0,-12603973.0,,-2.5,,,67500.0,0.0,0.0,0.0,0.0,0.0,-160.0,126.0,-113.0,,264120177.8024999,3760375971.510002,4231729429.6050014,61008394.13999996,3760375971.510002,272451.0,-18705410.0,4347301614.5,191845893.5,978398014.5,419608750.5,1022908338.0,269884.5,4252.0,757.3899816687422,6260280.5,2226587.0,1372635.0,-4494632.0,1458334.0,102768.0,2968690214.7676177,3000881094.682578,-179481162.0,-177997325.5,3130678.5,148901.5,,,,,,,,,,,,,,,,,,,,,1468719.0,14830621.0,3235249.0,8563119.0,11617717.0,1417111.0,,,72170956403.16716,21696214748.35512,583159188.8069987,5792665.7475,689.5,94245.0,-277171022.0,22011425.5,-123888702.0,,-2023156.5,,,,,,,,,,,,,,,,,,,,,4276969.5,2481631.5,-9011424.5,921269.0,37582.5,3737122309.05746,3661805148.164961,-260853725.5,-257539068.5,2528555.0,269452.5,3929763485.182454,33282309005.05592,36713628634.74764,1731363616.6200497,48129026393.093216,3991770.5,-247790777.0,103178068852.5,1055768708.5,17287933330.5,3506677535.0,18901408069.0,3675233.5,72001.5,20887.518689078348,89845844.5,,4.27084,2.3969319271332696,144.55141254810283,10.23691275167785,617.3559547669394,56250.0,-0.2225209339563143,0.9749279121818236,0.0,0.0,0.0,0.0,0.0,0.0,1.0,0.0,0.0,1.0,0.0,0.0,0.0,0.0,0.0,0.0,0.0,0.0,1.0,0.0,1.0,0.0,0.0,0.0,0.0,1.0,0.0,0.0,0.0,0.0,0.0,0.0,0.0,0.0,0.0,0.0,0.0,0.0,0.0,0.0,0.0,0.0,0.0,0.0,0.0,0.0,0.0,0.0,0.0,0.0,0.0,0.0,0.0,0.0,0.0,0.0,0.0,0.0,0.0,0.0,0.0,0.0,0.0,0.0,0.0,0.0,0.0,0.0,0.0,0.0,0.0,0.0,0.0,0.0,0.0,0.0,0.0,0.0,0.0,0.0,0.0,0.0,0.0,0.0,0.0,0.0,0.0,0.0,0.0,0.0,0.0,0.0,0.0,0.0,0.0,0.0,0.0,0.0,0.0,0.0,0.0,0.0,0.0,0.0,0.0,1.0,0.0,0.0,1.0,0.0,1.0,0.0,0.0,0.0,0.0,0.0,0.0,1.0,0.0,0.0
104520,0,0.0,1.0,1.0,0.0,0.0,193500.0,550980.0,43659.0,450000.0,0.035792,41.42191780821918,-626.0,-6764.0,-4645.0,7.0,2.0,2.0,2.0,10.0,,0.1870494606314635,0.5424451438613613,,,,,,,,,,,,,,,,,,,,,,,,,,,,,,,,,,,,,,,,,,,,,0.0,0.0,0.0,0.0,-2194.0,0.0,0.0,0.0,0.0,0.0,2.0,1.0,1.0,0.0,1.0,0.0,0.0,0.0,0.0,0.0,0.0,1.0,1.0,0.0,1.0,0.0,0.0,0.0,0.0,0.0,0.0,0.0,0.0,0.0,0.0,0.0,0.0,0.0,0.0,0.0,0.0,0.0,0.0,5.0,0.0,0.0,88560.0,31.5,0.0,0.0,0.0,0.0,-682.0,-113.0,-25.0,-1451.0,191.0,-23.0,7.0,4051.1925,19935.0,19422.0,2054.25,26500.5,10.0,-328.0,365243.0,-2499.0,-2304.0,-2289.0,-2297.5,11.0,0.5,0.1013905319984709,50.0,36.0,10.0,5.0,-86.5,0.0,0.0,32.0,2748.195,2748.195,-2628.0,-2620.0,4.5,1.0,0.0,,,,,,,,,,,,,,,,,,,,,8354186086.5,184529164783.5,165701245536.0,52015654405.935,1863.0,1706.0,71125.0,70920.0,9141.0,506507.0,,,,,,,128527.0,663392.0,,,,13539051.909588637,-602465629.0,-922678170.0,-296762553.0,-1536554480.0416667,44059.0,30732.0,,,,,,,,158172.00669247948,126214.8938084632,,,,,,,3717300.0,,,,,,,,,,,,,,,,436836.0,431629.0,1264247.0,6430.385863002895,632499.0,626047.0,,,,,,,,,23.0,74574314.64,26387085.91499999,7472793846.194992,2487226433.175001,86326101.80999996,784146.5999999999,137.0,16969.0,-24361557.0,11046391.0,-12622047.0,-13755288.0,-11.0,0.0,0.0,88560.0,0.0,0.0,0.0,0.0,0.0,-1707.0,-378.0,-588.0,-2312.0,264473814.1949998,3764981727.5400033,4236802927.6050014,61033060.16999996,3764997655.2900033,272931.0,-18751522.0,4354238995.5,191817076.5,980200028.5,419955910.5,1025441743.5,270309.0,4262.0,758.0678741499028,6263827.0,2231038.5,1375435.0,-4505271.5,1458335.0,102769.0,2972923086.0150986,3004945349.2200646,-179886743.5,-178399765.0,3135429.0,149210.5,,,,,,,,,,,,,,,,,,,,,1468724.0,14830812.0,3235249.0,8563155.0,11617749.0,1417118.0,1060606580.0445012,802083642.9074951,72171044963.16716,21696214779.85512,583159188.8069987,5792665.7475,689.5,94245.0,-277171704.0,22011312.5,-123888727.0,-218893832.5,-2023179.5,,,,,,,,,,,,,,,,,,,,,4276979.5,2481636.5,-9011511.0,921269.0,37582.5,3737125057.252461,3661807896.359961,-260856353.5,-257541688.5,2528559.5,269453.5,3929767536.3749537,33282328940.05592,36713648056.74764,1731365670.8700497,48129052893.593216,3991780.5,-247791105.0,103178434095.5,1055766209.5,17287931026.5,3506675246.0,18901405771.5,3675244.5,72002.0,20887.620079610348,89845894.5,-15.112772008730731,2.8474418604651164,4.43207586064729,183.5850820195243,12.620078334364049,522.7478474993152,96750.0,-0.9009688679024191,-0.433883739117558,0.0,1.0,0.0,0.0,0.0,0.0,0.0,0.0,0.0,0.0,0.0,0.0,0.0,1.0,0.0,0.0,0.0,0.0,1.0,0.0,1.0,0.0,0.0,0.0,0.0,1.0,0.0,0.0,0.0,0.0,0.0,0.0,0.0,0.0,0.0,0.0,0.0,0.0,1.0,0.0,0.0,0.0,0.0,0.0,0.0,0.0,0.0,0.0,0.0,0.0,0.0,0.0,0.0,1.0,0.0,0.0,0.0,0.0,0.0,0.0,0.0,0.0,0.0,0.0,0.0,0.0,0.0,0.0,0.0,0.0,0.0,0.0,0.0,0.0,0.0,0.0,0.0,0.0,0.0,0.0,0.0,0.0,0.0,0.0,0.0,0.0,0.0,0.0,0.0,0.0,0.0,0.0,0.0,0.0,0.0,0.0,0.0,0.0,0.0,0.0,0.0,0.0,0.0,0.0,0.0,0.0,0.0,0.0,0.0,0.0,0.0,0.0,0.0,0.0,0.0,0.0,0.0,0.0,0.0,0.0
104528,0,0.0,0.0,0.0,1.0,1.0,180000.0,479700.0,57060.0,450000.0,0.018029,33.884931506849306,-1138.0,-3702.0,-4274.0,,2.0,3.0,3.0,5.0,0.4552600707284989,0.5259245013688992,0.656158373001177,,,,,,,,,,,,,,,,,,,,,,,,,,,,,,,,,,,,,,,,,,,,,0.0,0.0,0.0,0.0,-384.0,0.0,0.0,0.0,0.0,1.0,0.0,1.0,1.0,0.0,1.0,1.0,1.0,0.0,0.0,0.0,0.0,0.0,0.0,0.0,1.0,0.0,0.0,0.0,0.0,0.0,0.0,0.0,0.0,0.0,0.0,0.0,0.0,0.0,0.0,0.0,0.0,0.0,0.0,4.0,6511.5,,226584.0,49421.6325,,0.0,0.0,0.0,-1074.5,-161.0,-168.5,-875.5,166.0,-25.5,1.0,7365.06,91219.635,72972.135,18247.5,91219.635,12.0,-384.0,365243.0,-341.0,-251.0,-11.0,-242.0,8.0,0.0,0.2178608406362989,18.0,6.0,12.0,10.0,-10.5,0.0,0.0,6.0,9562.5,19125.0,-325.0,-311.0,2.0,3.5,0.0,,,,,,,,,,,,,,,,,,,,,8354243146.5,184529644483.5,165701695536.0,52015834405.935,1863.0,1706.0,71125.0,70921.0,9141.0,506507.0,,,,,,,128528.0,663394.0,,,,13539085.794520143,-602466767.0,-922682444.0,-296762937.0,-1536558182.0416667,44059.0,30732.0,,,,,,,67537.86022209353,158172.53261698087,126215.54996683625,,,,,,,3717305.0,,,,,,,,,,,,,,,,436836.0,431629.0,,6430.403892002895,632502.0,626050.0,,,,,,,,,35.5,74610656.64,,7482588083.279992,2489216707.440001,,784524.5999999999,138.0,17087.0,-24425995.0,11067141.0,-12657330.5,-13783776.5,-17.25,7843.5,,309015.0,0.0,,0.0,0.0,0.0,-2649.0,-822.0,-1420.0,-1422.0,264828593.2949999,3768882148.215003,4240880202.240002,61233585.20999996,3768882148.215003,273283.0,-18789542.0,4362818677.0,192880162.0,982366211.0,421393467.0,1027975521.0,270859.0,4265.0,760.2866049771858,6279246.0,2232681.0,1376354.0,-4513483.5,1458342.0,102776.0,2975246489.3176107,3007263998.2725787,-180215041.5,-178726197.5,3140269.5,149379.5,,,,,,,,,,,,,,,,,,,,,1468728.0,14830978.0,3235249.0,8563161.0,11617755.0,1417119.0,1060613091.5445012,,72171271547.16716,21696264201.487617,,5792665.7475,689.5,94245.0,-277172778.5,22011151.5,-123888895.5,-218894708.0,-2023205.0,,,,,,,,,,,,,,,,,,,,,4276991.5,2481646.5,-9011521.5,921269.0,37582.5,3737134619.752461,3661827021.359961,-260856678.5,-257541999.5,2528561.5,269457.0,3929774901.4349537,33282420159.69092,36713721028.88265,1731383918.3700497,48129144113.22821,3991792.5,-247791489.0,103178799338.5,1055765868.5,17287930775.5,3506675235.0,18901405529.5,3675252.5,72002.0,20887.83794045099,89845912.5,-33.58424967658474,2.665,3.154574132492113,106.89252841277386,8.406940063091483,284.8685882200424,90000.0,-0.9009688679024191,0.4338837391175582,0.0,0.0,0.0,0.0,0.0,0.0,1.0,0.0,0.0,0.0,0.0,0.0,0.0,1.0,0.0,0.0,0.0,0.0,1.0,0.0,0.0,0.0,1.0,0.0,0.0,1.0,0.0,0.0,0.0,0.0,0.0,0.0,0.0,0.0,0.0,0.0,0.0,0.0,0.0,0.0,0.0,0.0,0.0,0.0,1.0,0.0,0.0,0.0,0.0,0.0,0.0,0.0,0.0,0.0,0.0,0.0,0.0,0.0,0.0,0.0,0.0,0.0,0.0,0.0,0.0,0.0,0.0,0.0,0.0,0.0,0.0,0.0,0.0,0.0,0.0,0.0,0.0,0.0,0.0,0.0,0.0,0.0,0.0,0.0,0.0,0.0,0.0,0.0,0.0,0.0,1.0,0.0,0.0,0.0,0.0,0.0,0.0,0.0,0.0,0.0,0.0,0.0,0.0,0.0,0.0,0.0,0.0,0.0,0.0,0.0,0.0,0.0,0.0,0.0,0.0,0.0,0.0,0.0,0.0,0.0
104529,0,0.0,0.0,0.0,0.0,1.0,90000.0,504000.0,16258.5,504000.0,0.003069,41.586301369863016,-1999.0,-2771.0,-5093.0,,3.0,3.0,3.0,17.0,0.6716268001130552,0.7565391152050331,0.6058362647264226,,,,,,,,,,,,,,,,,,,,,,,,,,,,,,,,,,,,,,,,,,,,,5.0,0.0,5.0,0.0,-1988.0,0.0,0.0,0.0,0.0,0.0,3.0,1.0,1.0,0.0,1.0,0.0,0.0,0.0,0.0,0.0,0.0,0.0,0.0,0.0,1.0,0.0,0.0,0.0,0.0,0.0,0.0,0.0,0.0,0.0,0.0,0.0,0.0,0.0,0.0,0.0,0.0,0.0,0.0,12.0,5661.0,0.0,73235.38500000001,0.0,0.0,0.0,0.0,0.0,-681.5,-630.0,-494.5,-700.5,325.0,-14.0,6.0,12464.73,48285.0,92184.75,14071.5,58410.0,12.0,-2027.0,365243.0,-1930.0,-1499.0,-1499.0,-1496.5,13.0,0.0,0.0999996262839814,276.5,52.0,12.0,6.0,-63.5,0.0,0.0,115.0,2856.375,2856.375,-1352.0,-1338.0,12.0,0.0,65.0,0.0,225000.0,0.0,0.0,0.0,0.0,0.0,398.565,398.565,0.0,0.0,0.0,0.0,0.0,0.0,0.0,20.0,-33.0,0.0,0.0,8354259405.0,184530148483.5,165702199536.0,52015924405.935,1863.0,1706.0,71125.0,70921.0,9141.0,506510.0,,,,,,,128529.0,663397.0,,,,13539127.380821511,-602468766.0,-922687537.0,-296764925.0,-1536560953.0416667,44059.0,30732.0,,,,,,,67538.53184889365,158173.28915609606,126216.15580310096,,,,,,,3717322.0,,,,,,,,,,,,,,,,436841.0,431634.0,,6430.406961002896,632505.0,626053.0,,,,,,,,,23.0,74628490.14,26412998.62499999,7483810619.519992,2489982485.940001,86326101.80999996,784524.5999999999,138.0,17087.0,-24432960.0,11065641.0,-12661484.0,-13788314.5,-11.0,0.0,0.0,81355.77,0.0,0.0,0.0,0.0,0.0,-1106.0,-771.0,-765.0,-771.0,264871903.8149999,3769096393.215003,4241319010.740002,61265796.20999996,3769125598.215003,273307.0,-18794428.0,4363729916.5,192875517.5,982724237.5,421754653.5,1028700050.0,270913.5,4265.0,760.6916037816471,6280006.5,2232981.0,1376543.0,-4514769.0,1458342.0,102776.0,2975672664.1351137,3007707063.615081,-180275542.0,-178786313.0,3141909.0,149395.0,2728394438.579973,7411783500.0,227186537.085,353002937.3099998,11893964.535000002,113564997.89999996,154590211.7549992,388609890.344999,358661415.96000016,2619397458.044998,2718296662.049968,2718428509.664967,11731.0,30906.0,161.0,19014.0,895071.0,-1587645.0,681006.0,1516.0,1468740.0,14831303.0,3235314.0,8563213.0,11617870.0,1417125.0,1060618752.5445012,802083642.9074951,72171344782.55215,21696264201.487617,583159188.8069987,5792665.7475,689.5,94245.0,-277173460.0,22010521.5,-123889390.0,-218895408.5,-2023219.0,5926407394.72496,18739422000.0,198873957.825,448266420.5624977,1948107.735,256965072.2775008,309287785.43249863,636936070.0724981,459413720.3249993,5711441154.660034,5889661510.297498,5889904693.0425,13392.5,80929.0,44.0,70430.5,972126.0,-1699932.5,177364.0,6755.0,4277003.5,2481652.5,-9011585.0,921269.0,37582.5,3737137476.127461,3661829877.734961,-260858030.5,-257543337.5,2528573.5,269457.0,3929787366.1649537,33282468444.69092,36713813213.63265,1731397989.8700497,48129202523.22821,3991804.5,-247793516.0,103179164581.5,1055763938.5,17287929276.5,3506673736.0,18901404033.0,3675265.5,72002.0,20887.937940077267,89846189.0,-48.06871335397589,5.6,5.535566011624688,230.2037164121949,30.99916966509825,1289.1408119082914,30000.0,0.6234898018587336,0.7818314824680298,0.0,1.0,0.0,0.0,0.0,0.0,0.0,0.0,0.0,0.0,0.0,0.0,0.0,1.0,0.0,0.0,0.0,0.0,1.0,0.0,1.0,0.0,0.0,0.0,0.0,1.0,0.0,0.0,0.0,0.0,0.0,0.0,0.0,0.0,0.0,0.0,0.0,0.0,1.0,0.0,0.0,0.0,0.0,0.0,0.0,0.0,0.0,0.0,0.0,0.0,0.0,0.0,0.0,1.0,0.0,0.0,0.0,0.0,0.0,0.0,0.0,0.0,0.0,0.0,0.0,0.0,0.0,0.0,0.0,0.0,0.0,0.0,0.0,0.0,0.0,0.0,0.0,0.0,0.0,0.0,0.0,0.0,0.0,0.0,0.0,0.0,0.0,0.0,0.0,0.0,0.0,0.0,0.0,0.0,0.0,0.0,0.0,0.0,0.0,0.0,0.0,0.0,0.0,0.0,0.0,0.0,0.0,0.0,0.0,0.0,0.0,0.0,0.0,0.0,0.0,0.0,0.0,0.0,0.0,0.0
104541,0,0.0,1.0,0.0,0.0,2.0,112500.0,451102.5,23161.5,337500.0,0.00496,42.649315068493145,-2530.0,-6734.0,-5245.0,,4.0,2.0,2.0,10.0,,0.6118911894024135,0.6006575372857061,0.0438,,0.9796,,,0.0,0.1034,0.1667,,,,0.0271,,,0.0263,,0.9786,,,0.0,0.069,0.1667,,,,0.0197,,,0.0442,,0.9796,,,0.0,0.1034,0.1667,,,,0.0275,,,0.0215,1.0,0.0,0.0,0.0,0.0,0.0,0.0,0.0,0.0,0.0,1.0,2.0,1.0,1.0,0.0,1.0,0.0,0.0,0.0,0.0,0.0,0.0,0.0,0.0,0.0,1.0,0.0,0.0,0.0,0.0,0.0,0.0,0.0,0.0,0.0,0.0,0.0,0.0,0.0,0.0,0.0,0.0,0.0,0.0,6.0,21573.0,2626.605,747000.0,0.0,0.0,0.0,0.0,0.0,-853.0,425.0,-269.5,-331.0,156.0,-16.0,4.0,19384.335,94902.75,87558.75,0.0,158350.5,12.0,-216.5,365243.0,-259.0,-109.0,71.0,-103.0,15.0,0.0,0.0,97.0,21.0,8.0,7.0,-10.0,0.0,0.0,22.0,11033.5275,2682.72,-948.0,-948.5,4.0,1.0,0.0,,,,,,,,,,,,,,,,,,,,,8354282566.5,184530599586.0,165702537036.0,52016036905.935,1863.0,1706.0,71125.0,70922.0,9141.0,506512.0,17825.3115000023,17887.565399999115,17338.61709999801,,,,128531.0,663401.0,,,,13539170.03013658,-602471296.0,-922692782.0,-296764925.0,-1536567687.0416667,44059.0,30732.0,11359.57399999919,11235.519999998984,10719.557599997288,22910.26820000977,22832.028800009743,22216.897000008303,,158173.90104728547,126216.75646063824,35033.458400028,34973.57620002843,34419.01030002884,,,,3717332.0,,,,,,,16483.033499999725,16668.428699999695,16265.0978999997,,,,,,,436841.0,431634.0,,6430.411921002897,632507.0,626055.0,,16347.320599999804,154323.05459999072,154325.7956999903,154217.51859998723,,,,28.0,74825466.84,26437799.56499999,7504362954.359994,2497770449.235001,86418451.93499996,784524.5999999999,138.0,17087.0,-24500770.5,11058602.5,-12702548.5,-13826430.0,-14.0,0.0,2626.605,594000.0,0.0,0.0,0.0,0.0,0.0,-1171.0,-331.0,-331.0,-331.0,265349902.49999985,3776103148.320003,4249556125.740002,61384792.81499996,3775908298.320003,273772.0,-18851090.0,4375599112.0,193192742.0,984513647.0,422450997.0,1030489679.0,271531.0,4275.0,763.2749700724949,6285861.5,2236322.0,1378619.0,-4529326.0,1458349.0,102783.0,2982252221.7075963,3014882368.0875635,-180873799.5,-179378989.0,3151993.0,149687.5,,,,,,,,,,,,,,,,,,,,,1468746.0,14831459.0,3235314.0,8563234.0,11617892.0,1417129.0,1060640325.5445012,802086269.5124952,72172091782.55215,21696264201.487617,583159188.8069987,5792665.7475,689.5,94245.0,-277174313.0,22010946.5,-123889659.5,-218895739.5,-2023235.0,,,,,,,,,,,,,,,,,,,,,4277011.5,2481659.5,-9011595.0,921269.0,37582.5,3737148509.654961,3661832560.454961,-260858978.5,-257544286.0,2528577.5,269458.0,3929806750.4999537,33282563347.44092,36713900772.38265,1731397989.8700497,48129360873.72821,3991816.5,-247793732.5,103179529824.5,1055763679.5,17287929167.5,3506673807.0,18901403930.0,3675280.5,72002.0,20887.937940077267,89846286.0,-59.32099955033082,4.0098,4.857198367981347,207.15618354620725,19.476394015931607,830.654864783582,28125.0,-0.9009688679024191,-0.433883739117558,0.0,0.0,0.0,0.0,0.0,0.0,1.0,0.0,0.0,0.0,0.0,0.0,0.0,1.0,0.0,1.0,0.0,0.0,0.0,0.0,1.0,0.0,0.0,0.0,0.0,0.0,1.0,0.0,0.0,0.0,0.0,0.0,0.0,0.0,0.0,0.0,0.0,0.0,1.0,0.0,0.0,0.0,0.0,0.0,0.0,0.0,0.0,0.0,0.0,0.0,0.0,0.0,0.0,1.0,0.0,0.0,0.0,0.0,0.0,0.0,0.0,0.0,0.0,0.0,0.0,0.0,0.0,0.0,0.0,0.0,0.0,0.0,0.0,0.0,0.0,0.0,0.0,0.0,0.0,0.0,0.0,0.0,0.0,0.0,0.0,0.0,0.0,0.0,0.0,0.0,0.0,0.0,0.0,0.0,0.0,0.0,0.0,0.0,0.0,0.0,0.0,0.0,0.0,0.0,0.0,0.0,0.0,0.0,0.0,0.0,1.0,0.0,0.0,0.0,0.0,0.0,0.0,0.0,1.0,0.0
104578,0,0.0,0.0,0.0,1.0,0.0,157500.0,781920.0,33259.5,675000.0,0.002042,62.75616438356165,,-2144.0,-5004.0,,2.0,3.0,3.0,12.0,,0.4693437661485284,0.8050196619153701,0.0773,0.0018,0.9752,0.66,0.0121,0.0,0.1379,0.1667,0.2083,0.0806,0.0538,0.0342,0.0425,0.0663,0.0788,0.0019,0.9752,0.6733,0.0122,0.0,0.1379,0.1667,0.2083,0.0825,0.0588,0.0357,0.0428,0.0702,0.0781,0.0018,0.9752,0.6645,0.0121,0.0,0.1379,0.1667,0.2083,0.0821,0.0547,0.0348,0.0427,0.0677,0.0413,1.0,0.0,0.0,0.0,0.0,-971.0,0.0,0.0,0.0,0.0,0.0,2.0,1.0,0.0,0.0,1.0,0.0,0.0,0.0,0.0,0.0,0.0,0.0,0.0,0.0,1.0,0.0,0.0,0.0,0.0,0.0,0.0,0.0,0.0,0.0,0.0,0.0,0.0,0.0,0.0,0.0,0.0,0.0,0.0,13.0,0.0,0.0,112401.0,0.0,0.0,0.0,0.0,0.0,-2030.0,-1649.5,-1026.0,-1722.0,801.0,-30.0,1.0,14842.71,147150.0,132435.0,14715.0,147150.0,10.0,-971.0,365243.0,-940.0,-670.0,-670.0,-662.0,15.0,0.0,0.1089090909090909,1044.0,11.0,10.0,5.0,-27.0,0.0,0.0,10.0,14842.71,14842.71,-833.5,-805.0,5.5,1.0,0.0,,,,,,,,,,,,,,,,,,,,,8354315826.0,184531381506.0,165703212036.0,52016194405.935,1863.0,1706.0,71125.0,70922.0,9141.0,506514.0,17825.3888000023,17887.643499999114,17338.69589999801,11306.178900000095,11243.974100000096,11191.355300000056,128531.0,663403.0,4141.825300000115,4139.520700000013,3950.0905000000935,13539232.786300965,,-922697786.0,-296765896.0,-1536569831.0416667,44059.0,30732.0,11359.57399999919,11235.519999998984,10719.557599997288,22910.40610000978,22832.16670000974,22217.034900008304,,158174.37039105163,126217.56148030017,35033.625100027995,34973.74290002843,34419.177000028845,22973.4066999959,22946.441899995472,22593.205999995705,3717344.0,8303.441400000163,8408.086600000073,8131.549500000232,9826.43410000072,9941.452400002156,10301.55069999964,16483.067699999723,16668.463499999696,16265.1335999997,829.1189000001767,814.2957000000463,760.2148000000134,3917.0583000001234,3900.279400000162,3732.93680000016,436841.0,431634.0,,6430.413963002897,632510.0,626058.0,,16347.361899999803,154324.0297999907,154326.77089999028,154218.49379998722,77677.77599999636,78015.8559000066,78417.64970000659,67.0,75091861.575,26530193.29499999,7549093549.2149935,2515593670.470001,86804610.07499996,784524.5999999999,140.0,17087.0,-24719178.0,11105076.5,-12820108.0,-13959774.0,-33.0,0.0,0.0,112401.0,0.0,0.0,0.0,0.0,0.0,-2031.0,-1725.0,-1026.0,-1725.0,267326739.31499985,3800568340.530003,4278057687.2700014,61801582.99499996,3800568340.530003,275612.0,-18994112.0,4407372174.0,195295382.0,993581105.0,426782355.0,1039557661.0,273674.0,4297.0,768.770643314551,6340642.0,2252546.0,1388870.0,-4559832.0,1458454.0,102837.0,3005096400.630105,3037135562.100075,-181847191.5,-180341073.0,3163766.5,150782.5,,,,,,,,,,,,,,,,,,,,,1468759.0,14832260.0,3235314.0,8563245.0,11617902.0,1417130.0,1060640325.5445012,802086269.5124952,72172204183.55215,21696264201.487617,583159188.8069987,5792665.7475,689.5,94245.0,-277176343.0,22009297.0,-123890685.5,-218897461.5,-2023265.0,,,,,,,,,,,,,,,,,,,,,4277021.5,2481664.5,-9011622.0,921269.0,37582.5,3737163352.364961,3661847403.164961,-260859812.0,-257545091.0,2528583.0,269459.0,3929821593.209953,33282710497.44092,36714033207.38265,1731412704.8700497,48129508023.72821,3991826.5,-247794703.5,103179895067.5,1055762739.5,17287928497.5,3506673137.0,18901403268.0,3675295.5,72002.0,20888.046849168182,89847330.0,,4.964571428571428,4.7354891083750505,297.1811329217504,23.50967392774996,1475.3769616138102,78750.0,-0.9009688679024191,0.4338837391175582,0.0,0.0,0.0,0.0,0.0,0.0,1.0,0.0,0.0,1.0,0.0,0.0,0.0,0.0,0.0,0.0,0.0,0.0,1.0,0.0,1.0,0.0,0.0,0.0,0.0,1.0,0.0,0.0,0.0,0.0,0.0,0.0,0.0,0.0,0.0,0.0,0.0,0.0,0.0,0.0,0.0,0.0,0.0,0.0,0.0,0.0,0.0,0.0,0.0,0.0,0.0,0.0,0.0,0.0,0.0,0.0,0.0,0.0,0.0,0.0,0.0,0.0,0.0,0.0,0.0,0.0,0.0,0.0,0.0,0.0,0.0,0.0,0.0,0.0,0.0,0.0,0.0,0.0,0.0,0.0,0.0,0.0,0.0,0.0,0.0,0.0,0.0,0.0,0.0,0.0,0.0,0.0,0.0,0.0,0.0,0.0,0.0,0.0,0.0,0.0,0.0,0.0,0.0,0.0,0.0,1.0,0.0,0.0,1.0,0.0,1.0,0.0,0.0,0.0,0.0,0.0,0.0,0.0,1.0,0.0
104584,0,0.0,1.0,1.0,1.0,2.0,202500.0,260640.0,31059.0,225000.0,0.014464,28.21095890410959,-3308.0,-755.0,-2478.0,17.0,4.0,2.0,2.0,9.0,0.5200224398598394,0.6924039880649022,0.1437580534911652,0.0619,0.0605,0.9861,,,0.0,0.1379,0.1667,,0.0458,,0.0329,,0.0926,0.063,0.0627,0.9861,,,0.0,0.1379,0.1667,,0.0468,,0.0342,,0.0981,0.0625,0.0605,0.9861,,,0.0,0.1379,0.1667,,0.0466,,0.0334,,0.0946,0.046,1.0,6.0,1.0,6.0,0.0,-1277.0,0.0,0.0,0.0,0.0,0.0,4.0,1.0,1.0,0.0,1.0,0.0,1.0,0.0,0.0,0.0,0.0,0.0,0.0,0.0,0.0,0.0,0.0,0.0,0.0,1.0,0.0,0.0,0.0,0.0,0.0,0.0,0.0,0.0,0.0,0.0,0.0,0.0,0.0,7.0,19863.0,19863.0,900000.0,105603.75,0.0,0.0,0.0,0.0,-823.0,602.0,-53.0,-707.5,190.0,-15.0,8.0,13771.575,61555.5,63618.75,0.0,91660.5,8.0,-495.0,365243.0,-625.0,-475.0,-475.0,-470.0,8.0,0.0,0.0,2.0,21.0,10.0,4.0,-16.0,0.0,0.0,19.0,19157.49,19145.655,-486.0,-475.0,4.0,1.0,0.0,,,,,,,,,,,,,,,,,,,,,8354346885.0,184531642146.0,165703437036.0,52016396905.935,1863.0,1706.0,71125.0,70922.0,9141.0,506518.0,17825.4507000023,17887.705999999114,17338.758899998007,11306.239400000091,11244.034600000095,11191.418000000056,128533.0,663407.0,,,,13539260.997259865,-602474604.0,-922700264.0,-296767173.0,-1536570586.0416667,44060.0,30732.0,11359.57399999919,11235.519999998984,10719.557599997288,22910.54400000978,22832.304600009746,22217.172800008306,67539.05187133349,158175.0627950397,126217.70523835364,35033.791800028,34973.90960002843,34419.34370002885,,,,3717353.0,8303.487200000163,8408.133200000073,8131.596300000232,,,,16483.100599999718,16668.496899999696,16265.1677999997,,,,3917.1509000001233,3900.3740000001617,3733.03490000016,436847.0,431640.0,1264264.0,6430.428427002897,632512.0,626060.0,,16347.407899999806,154325.0158999907,154327.7569999903,154219.47989998726,,,,28.0,75259072.575,26579876.66999999,7577646103.169993,2528361547.200001,86830349.84999996,784524.5999999999,140.0,17087.0,-24755844.0,11099767.0,-12839678.0,-13983967.5,-13.5,0.0,19863.0,790650.0,0.0,0.0,0.0,0.0,0.0,-835.0,602.0,-191.0,-1224.0,267558038.86499977,3803280781.7250032,4280737979.5200014,61899391.43999996,3803121513.2250032,275748.0,-19009221.5,4411754530.0,195285283.0,993573167.0,427141375.0,1039549838.0,273969.0,4298.0,769.6080921665565,6353956.0,2253786.0,1389638.0,-4562472.0,1458454.0,102837.0,3007081619.8651056,3039167964.510073,-181922457.0,-180414416.0,3164355.0,151008.0,,,,,,,,,,,,,,,,,,,,,1468766.0,14832450.0,3235314.0,8563266.0,11617921.0,1417138.0,1060660188.5445012,802106132.5124952,72173104183.55215,21696369805.237617,583159188.8069987,5792665.7475,689.5,94245.0,-277177166.0,22009899.0,-123890738.5,-218898169.0,-2023280.0,,,,,,,,,,,,,,,,,,,,,4277031.5,2481668.5,-9011638.0,921269.0,37582.5,3737182509.85496,3661866548.819961,-260860298.0,-257545566.0,2528587.0,269460.0,3929835364.784954,33282772052.94092,36714096826.13265,1731412704.8700497,48129599684.22821,3991834.5,-247795198.5,103180260310.5,1055762114.5,17287928022.5,3506672662.0,18901402798.0,3675303.5,72002.0,20888.046849168182,89847332.0,-117.2593959405652,1.2871111111111109,6.519849319037959,183.9312012003668,8.39177050130397,236.73989274500545,50625.0,1.0,0.0,0.0,0.0,0.0,0.0,0.0,0.0,1.0,0.0,0.0,0.0,1.0,0.0,0.0,0.0,0.0,0.0,0.0,0.0,1.0,0.0,1.0,0.0,0.0,0.0,0.0,1.0,0.0,0.0,0.0,0.0,0.0,0.0,0.0,0.0,0.0,0.0,0.0,0.0,1.0,0.0,0.0,0.0,0.0,0.0,0.0,0.0,0.0,0.0,0.0,0.0,0.0,0.0,0.0,0.0,0.0,0.0,0.0,0.0,0.0,0.0,0.0,0.0,0.0,0.0,0.0,0.0,0.0,0.0,0.0,0.0,0.0,0.0,0.0,0.0,0.0,0.0,0.0,0.0,0.0,1.0,0.0,0.0,0.0,0.0,0.0,0.0,0.0,0.0,0.0,0.0,0.0,0.0,0.0,0.0,0.0,0.0,0.0,0.0,0.0,0.0,0.0,0.0,0.0,0.0,0.0,0.0,0.0,0.0,0.0,0.0,1.0,0.0,0.0,0.0,0.0,0.0,0.0,1.0,0.0,0.0
104588,0,0.0,0.0,0.0,0.0,1.0,135000.0,144000.0,7362.0,144000.0,0.014464,33.03013698630137,-2521.0,-904.0,-3929.0,,2.0,2.0,2.0,7.0,0.2884184963854029,0.4229417031572816,0.4083588531230431,0.1124,0.0,0.9762,0.6736,0.0473,0.0,0.0345,0.1667,0.2083,0.0411,0.0908,0.0537,0.0039,0.0554,0.1145,0.0,0.9762,0.6864,0.0477,0.0,0.0345,0.1667,0.2083,0.0421,0.0992,0.0559,0.0039,0.0587,0.1135,0.0,0.9762,0.6779999999999999,0.0476,0.0,0.0345,0.1667,0.2083,0.0419,0.0923,0.0547,0.0039,0.0566,0.0543,1.0,0.0,0.0,0.0,0.0,-267.0,0.0,0.0,0.0,0.0,1.0,0.0,1.0,1.0,0.0,1.0,0.0,1.0,0.0,0.0,0.0,0.0,0.0,0.0,0.0,1.0,0.0,0.0,0.0,0.0,0.0,0.0,0.0,0.0,0.0,0.0,0.0,0.0,0.0,0.0,0.0,0.0,0.0,0.0,7.0,14508.0,0.0,456898.5,0.0,0.0,0.0,0.0,0.0,-1682.0,-757.0,-428.0,-1367.0,401.0,-28.0,3.0,4549.9275,45000.0,45000.0,0.0,51774.75,5.0,-411.0,182416.5,-374.5,182566.0,182566.0,182567.5,4.0,0.5,0.0,500.0,11.0,10.0,5.0,-8.0,0.0,0.0,47.0,2250.0,2250.0,-201.0,-188.0,13.0,0.0,13.0,124913.52,135000.0,0.0,3588.75,0.0,3588.75,4460.94,6794.1675,5383.575,122055.3,124913.52,124913.52,0.0,1.0,0.0,1.0,6.0,-7.0,0.0,0.0,8354354247.0,184531786146.0,165703581036.0,52016531905.935,1863.0,1706.0,71125.0,70923.0,9141.0,506518.0,17825.563100002302,17887.819499999114,17338.873399998007,11306.239400000091,11244.034600000095,11191.418000000056,128534.0,663409.0,4141.872600000115,4139.568300000013,3950.1382000000935,13539294.027396852,-602477125.0,-922704193.0,-296767440.0,-1536571490.0416667,44060.0,30732.0,11359.57399999919,11235.519999998984,10719.557599997288,22910.578500009786,22832.339100009747,22217.207300008307,67539.3402898299,158175.48573674285,126218.11359720676,35033.958500028,34974.076300028435,34419.51040002885,22973.61499999589,22946.650199995467,22593.414299995704,3717360.0,8303.528300000164,8408.175100000073,8131.638400000232,9826.52490000072,9941.544700002158,10301.649899999642,16483.154299999722,16668.551599999693,16265.2236999997,829.1228000001769,814.2996000000462,760.2187000000134,3917.206300000123,3900.4306000001616,3733.09360000016,436847.0,431640.0,,6430.442891002896,632514.0,626062.0,,16347.462199999803,154325.99209999072,154328.7331999903,154220.45609998723,77678.44959999635,78016.5339000066,78418.33610000659,56.0,75325834.575,26602462.16999999,7581199582.169993,2529555264.450001,86903223.56999996,784524.5999999999,140.0,17087.0,-24776288.0,11120059.0,-12849799.0,-13994720.0,-27.5,8532.0,0.0,225000.0,0.0,0.0,0.0,0.0,0.0,-1853.0,-839.0,-830.0,-1899.0,267725836.57499972,3805436711.4750032,4283062798.7700014,61909552.43999996,3805459211.4750032,275968.0,-19019327.0,4415406755.0,195645527.0,995580217.5,427690274.5,1041556912.5,274278.0,4303.0,769.7075529258176,6355088.0,2256419.0,1391510.0,-4563973.0,1458454.0,102837.0,3008607747.300096,3040629038.235064,-181970534.0,-180460821.0,3165434.0,151125.0,2769553538.8649697,7533544500.0,232435337.085,360149630.53499985,11893964.535000002,115461127.70999996,156733044.70499933,394986012.9525008,364555013.03999984,2659236098.6699967,2759272219.9799647,2759408792.594964,11930.0,31404.0,161.0,19313.0,899566.0,-1597585.0,681026.0,1528.0,1468773.0,14832851.0,3235327.0,8563277.0,11617968.0,1417141.0,1060674696.5445012,802106132.5124952,72173561082.05215,21696369805.237617,583159188.8069987,5792665.7475,689.5,94245.0,-277178848.0,22009142.0,-123891166.5,-218899536.0,-2023308.0,5926532308.244961,18739557000.0,198873957.825,448270009.3124977,1948107.735,256968661.0275008,309292246.37249863,636942864.2399981,459419103.89999926,5711563209.960034,5889786423.817497,5890029606.562499,13392.5,80930.0,44.0,70431.5,972132.0,-1699939.5,177364.0,6755.0,4277041.5,2481673.5,-9011646.0,921269.0,37582.5,3737184759.85496,3661868798.819961,-260860499.0,-257545754.0,2528600.0,269460.0,3929839914.712454,33282817052.94092,36714141826.13265,1731412704.8700497,48129651458.97821,3991839.5,-247795609.5,103180442727.0,1055761740.0,17288110588.5,3506855228.0,18901585365.5,3675307.5,72002.5,20888.046849168182,89847832.0,-76.32423689449236,1.0666666666666669,18.337408312958438,605.6871085507586,19.559902200489,646.0662491208093,67500.0,-0.2225209339563143,0.9749279121818236,0.0,0.0,0.0,0.0,0.0,0.0,1.0,0.0,1.0,0.0,0.0,0.0,0.0,0.0,0.0,0.0,0.0,0.0,1.0,0.0,0.0,0.0,1.0,0.0,0.0,1.0,0.0,0.0,0.0,0.0,0.0,0.0,0.0,0.0,0.0,0.0,0.0,0.0,0.0,0.0,0.0,0.0,0.0,0.0,1.0,0.0,0.0,0.0,0.0,0.0,0.0,0.0,0.0,0.0,0.0,0.0,0.0,0.0,0.0,0.0,0.0,0.0,0.0,0.0,0.0,0.0,0.0,0.0,0.0,0.0,0.0,0.0,0.0,0.0,0.0,0.0,0.0,0.0,0.0,0.0,0.0,0.0,0.0,0.0,0.0,0.0,0.0,0.0,0.0,0.0,1.0,0.0,0.0,0.0,0.0,0.0,0.0,0.0,0.0,0.0,0.0,0.0,0.0,0.0,0.0,0.0,0.0,0.0,1.0,0.0,1.0,0.0,0.0,0.0,0.0,0.0,0.0,0.0,1.0,0.0
104602,0,0.0,0.0,0.0,1.0,0.0,135000.0,285723.0,26334.0,238500.0,0.014464,53.73972602739726,-705.0,-2400.0,-3121.0,,2.0,2.0,2.0,6.0,,0.1071774952399272,,0.1062,0.0819999999999999,0.9752,0.66,0.0,0.0,0.2069,0.1667,0.2083,0.0952,0.0832,0.0855,0.0154,0.0131,0.1082,0.0851,0.9752,0.6733,0.0,0.0,0.2069,0.1667,0.2083,0.0974,0.0909,0.0891,0.0156,0.0138,0.1072,0.0819999999999999,0.9752,0.6645,0.0,0.0,0.2069,0.1667,0.2083,0.0969,0.0847,0.0871,0.0155,0.0133,0.0908,1.0,0.0,0.0,0.0,0.0,0.0,,,,,,,1.0,1.0,0.0,1.0,1.0,0.0,0.0,0.0,0.0,0.0,0.0,0.0,0.0,1.0,0.0,0.0,0.0,0.0,0.0,0.0,0.0,0.0,0.0,0.0,0.0,0.0,0.0,0.0,0.0,0.0,0.0,0.0,0.0,,,,,,,,,,,,,0.0,,12.0,16492.455,67500.0,67500.0,0.0,172012.5,6.0,-493.0,365243.0,-463.0,-358.0,47.0,-214.0,6.0,0.0,0.0,-1.0,23.0,12.0,10.0,-17.0,0.0,0.0,33.0,16415.1,16415.1,-414.0,-403.0,6.0,1.0,16.0,0.0,0.0,0.0,0.0,0.0,0.0,0.0,3.105,1.5525,0.0,0.0,0.0,0.0,0.0,0.0,0.0,3.0,-9.5,0.0,0.0,8354380581.0,184532071869.0,165703819536.0,52016666905.935,,,,,,,17825.6693000023,17887.926699999112,17338.981599998006,11306.321400000092,11244.116600000096,11191.503100000056,128534.0,663411.0,4141.872600000115,4139.568300000013,3950.1382000000935,13539347.76712288,-602477830.0,-922707314.0,-296767440.0,-1536573890.0416667,44060.0,30732.0,11359.57399999919,11235.519999998984,10719.557599997288,22910.785400009787,22832.546000009745,22217.414200008312,,158175.59291423808,,35034.125200028,34974.24300002844,34419.67710002885,22973.823299995893,22946.85849999547,22593.622599995702,3717366.0,8303.623500000163,8408.272000000074,8131.7358000002305,9826.608100000718,9941.629400002155,10301.74079999964,16483.239799999723,16668.638699999698,16265.3127999997,829.1382000001769,814.3151000000462,760.2343000000134,3917.219400000123,3900.4439000001616,3733.10740000016,436847.0,431640.0,,6430.457355002895,632516.0,626064.0,,16347.552999999803,154326.9672999907,154329.70839999028,154221.43129998722,77679.10959999637,78017.1984000066,78419.00940000659,,,,,,,,,,,,,,,,,,,,,,,,,,,268340643.85499972,3812904267.9750032,4291435791.2700014,62110549.43999996,3812986280.4750032,276588.0,-19077925.5,4428550075.0,196694107.0,997917935.0,429672766.0,1044993031.0,274921.0,4323.0,772.1653627814917,6371583.5,2263347.0,1396062.0,-4577288.0,1458454.0,102837.0,3018427634.295094,3050085638.2950697,-182562995.0,-181047787.0,3175409.0,151514.0,2785627791.94497,7565472000.0,234119687.085,362138309.0549998,11893964.535000002,115765456.22999994,157911024.32999924,397865819.2050013,367362961.2000001,2674626647.3099995,2775316961.294964,2775453533.909964,12026.0,31548.0,161.0,19361.0,903582.5,-1603079.0,681042.0,1544.0,1468773.0,14832851.0,3235343.0,8563300.0,11618001.0,1417153.0,,,,,,,,,,,,,,5926532308.244961,18739557000.0,198873957.825,448270009.3124977,1948107.735,256968661.0275008,309292246.37249863,636942867.344998,459419105.4524993,5711563209.960034,5889786423.817497,5890029606.562499,13392.5,80930.0,44.0,70431.5,972135.0,-1699949.0,177364.0,6755.0,4277053.5,2481683.5,-9011663.0,921269.0,37582.5,3737201174.95496,3661885213.919961,-260860913.0,-257546157.0,2528606.0,269461.0,3929856407.167454,33282884552.94092,36714209326.13265,1731412704.8700497,48129823471.47821,3991845.5,-247796102.5,103180807970.0,1055761277.0,17288110230.5,3506855275.0,18901585151.5,3675313.5,72002.5,20888.046849168182,89847831.0,-13.118786642875351,2.1164666666666667,5.126452494873548,275.49415256697165,10.849965823650033,583.0741907695765,67500.0,-0.9009688679024191,0.4338837391175582,0.0,0.0,0.0,0.0,0.0,0.0,1.0,0.0,1.0,0.0,0.0,0.0,0.0,0.0,0.0,0.0,0.0,0.0,1.0,0.0,1.0,0.0,0.0,0.0,0.0,1.0,0.0,0.0,0.0,0.0,1.0,0.0,0.0,0.0,0.0,0.0,0.0,0.0,0.0,0.0,0.0,0.0,0.0,0.0,0.0,0.0,0.0,0.0,0.0,0.0,0.0,0.0,0.0,1.0,0.0,0.0,0.0,0.0,0.0,0.0,0.0,0.0,0.0,0.0,0.0,0.0,0.0,0.0,0.0,0.0,0.0,0.0,0.0,0.0,0.0,0.0,0.0,0.0,0.0,0.0,0.0,0.0,0.0,0.0,0.0,0.0,0.0,0.0,0.0,0.0,0.0,0.0,0.0,0.0,0.0,0.0,0.0,0.0,0.0,0.0,0.0,0.0,0.0,0.0,0.0,0.0,0.0,0.0,1.0,0.0,1.0,0.0,0.0,0.0,0.0,0.0,0.0,1.0,0.0,0.0
104610,0,0.0,0.0,0.0,1.0,0.0,103500.0,225000.0,26833.5,225000.0,0.028663,65.83561643835617,,-1921.0,-4278.0,,2.0,2.0,2.0,12.0,,0.6202287524920336,0.7136313997323308,0.0412,0.0849,0.9707,0.5988,0.1367,0.0,0.1034,0.125,0.1667,0.0256,0.0286,0.024,0.0232,0.0425,0.042,0.0881,0.9707,0.6145,0.1379,0.0,0.1034,0.125,0.1667,0.0262,0.0312,0.025,0.0233,0.045,0.0416,0.0849,0.9707,0.6042,0.1376,0.0,0.1034,0.125,0.1667,0.0261,0.0291,0.0245,0.0233,0.0434,0.0604,1.0,3.0,0.0,3.0,0.0,0.0,0.0,0.0,0.0,0.0,0.0,1.0,1.0,0.0,0.0,1.0,0.0,0.0,0.0,0.0,0.0,0.0,0.0,0.0,0.0,1.0,0.0,0.0,0.0,0.0,0.0,0.0,0.0,0.0,0.0,0.0,0.0,0.0,0.0,0.0,0.0,0.0,0.0,0.0,5.0,0.0,0.0,99000.0,0.0,0.0,0.0,0.0,0.0,-726.0,-361.0,-329.0,-362.0,172.0,-18.0,1.0,3043.71,28121.4,27396.0,2813.4,28121.4,10.0,-2893.0,365243.0,-2862.0,-2592.0,-2592.0,-2584.0,9.0,1.0,0.1014269850985574,550.0,11.0,10.0,5.0,-90.0,0.0,0.0,10.0,3043.71,3043.71,-2727.0,-2727.0,5.5,1.0,0.0,,,,,,,,,,,,,,,,,,,,,8354407414.5,184532296869.0,165704044536.0,52016770405.935,1863.0,1706.0,71125.0,70923.0,9141.0,506519.0,17825.7105000023,17887.968299999113,17339.023599998007,11306.406300000092,11244.201500000096,11191.591200000055,128534.0,663413.0,4142.009300000114,4139.705900000013,3950.276100000093,13539413.602739315,,-922711592.0,-296767440.0,-1536575811.0416667,44060.0,30732.0,11359.57399999919,11235.519999998984,10719.557599997288,22910.888800009787,22832.649400009745,22217.517600008312,,158176.21314299054,126218.82722860647,35034.250200028,34974.36800002844,34419.80210002885,22973.98999999589,22947.025199995467,22593.789299995704,3717378.0,8303.649100000164,8408.298100000073,8131.762000000232,9826.636700000718,9941.658500002157,10301.77199999964,16483.263799999724,16668.663199999693,16265.3377999997,829.1614000001769,814.3384000000461,760.2576000000133,3917.261900000123,3900.4873000001617,3733.152400000161,436850.0,431643.0,,6430.486018002895,632518.0,626066.0,,16347.613399999806,154327.9379999907,154330.6790999903,154222.40199998725,77679.70839999638,78017.8026000066,78419.62390000657,24.0,75656945.16000001,26683085.78999999,7610160873.419993,2538576879.075001,87238890.26999997,784524.5999999999,140.0,17087.0,-24832637.0,11169688.0,-12872494.0,-14022518.0,-11.5,0.0,0.0,90000.0,0.0,0.0,0.0,0.0,0.0,-1064.0,-699.0,-692.0,-699.0,268880378.26499987,3821399814.3750033,4300582081.770002,62169603.83999996,3821399814.3750033,277198.0,-19119546.0,4438410664.0,196662859.0,1000087616.0,430022901.0,1047162832.0,275509.0,4333.0,772.8456790637455,6377049.0,2270249.0,1400672.0,-4587158.0,1458455.0,102838.0,3027424637.8350787,3059001359.595053,-182880377.0,-181360170.0,3180041.5,151904.5,,,,,,,,,,,,,,,,,,,,,1468778.0,14833023.0,3235343.0,8563311.0,11618011.0,1417154.0,1060674696.5445012,802106132.5124952,72173660082.05215,21696369805.237617,583159188.8069987,5792665.7475,689.5,94245.0,-277179574.0,22008781.0,-123891495.5,-218899898.0,-2023326.0,,,,,,,,,,,,,,,,,,,,,4277063.5,2481688.5,-9011753.0,921269.0,37582.5,3737204218.66496,3661888257.629961,-260863640.0,-257548884.0,2528611.5,269462.0,3929859450.877454,33282912674.34092,36714236722.13265,1731415518.270049,48129851592.87821,3991855.5,-247798995.5,103181173213.0,1055758415.0,17288107638.5,3506852683.0,18901582567.5,3675322.5,72003.5,20888.14827615328,89848381.0,,2.1739130434782608,3.8571188998826096,253.93580044980573,8.385041086701325,552.0343488039256,51750.0,1.0,0.0,0.0,0.0,0.0,0.0,0.0,1.0,0.0,0.0,0.0,1.0,0.0,0.0,0.0,0.0,0.0,0.0,0.0,0.0,1.0,0.0,1.0,0.0,0.0,0.0,0.0,1.0,0.0,0.0,0.0,0.0,0.0,0.0,0.0,0.0,0.0,0.0,0.0,0.0,0.0,0.0,0.0,0.0,0.0,0.0,0.0,0.0,0.0,0.0,0.0,0.0,0.0,0.0,0.0,0.0,0.0,0.0,0.0,0.0,0.0,0.0,0.0,0.0,0.0,0.0,0.0,0.0,0.0,0.0,0.0,0.0,0.0,0.0,0.0,0.0,0.0,0.0,0.0,0.0,0.0,0.0,0.0,0.0,0.0,0.0,0.0,0.0,0.0,0.0,0.0,0.0,0.0,0.0,0.0,0.0,0.0,0.0,0.0,0.0,0.0,0.0,0.0,0.0,0.0,0.0,0.0,1.0,0.0,0.0,1.0,0.0,1.0,0.0,0.0,0.0,0.0,0.0,0.0,0.0,1.0,0.0
104611,0,0.0,0.0,0.0,0.0,0.0,180000.0,601470.0,32760.0,450000.0,0.035792,28.517808219178075,-1833.0,-4542.0,-2170.0,,2.0,2.0,2.0,13.0,,0.3592074935217264,0.4083588531230431,0.0351,0.0344,0.9871,0.8096,0.0079,0.04,0.0345,0.3333,0.0417,0.0131,0.0277,0.0367,0.0039,0.0234,0.0357,0.0472,0.9876,0.8171,0.008,0.0403,0.0345,0.3333,0.0417,0.0,0.0303,0.0381,0.0039,0.0352,0.0354,0.0455,0.9876,0.8121,0.0079,0.04,0.0345,0.3333,0.0417,0.0,0.0282,0.0372,0.0039,0.0339,0.0299,1.0,2.0,0.0,2.0,0.0,-1779.0,0.0,0.0,0.0,0.0,3.0,3.0,1.0,1.0,0.0,1.0,0.0,0.0,0.0,0.0,0.0,0.0,0.0,0.0,0.0,1.0,0.0,0.0,0.0,0.0,0.0,0.0,0.0,0.0,0.0,0.0,0.0,0.0,0.0,0.0,0.0,0.0,0.0,0.0,1.0,9495.0,,208921.5,73350.0,0.0,0.0,0.0,0.0,-520.0,210.0,-26.0,,18.0,-8.5,6.0,15811.2,9177.75,111550.5,900.0,171868.5,15.0,-903.5,365243.0,-1378.0,-742.5,-637.5,-736.5,15.5,0.0,0.0433124243026808,-1.0,50.0,18.0,10.0,-47.5,0.0,0.0,129.0,16109.235,9122.4,-597.0,-581.0,14.0,0.0,35.0,454200.03,450000.0,3150.0,6576.03,0.0,2443.5,22855.275,22950.0,22500.0,438704.415,454690.89,454690.89,1.0,3.0,0.0,1.0,17.0,-18.0,0.0,0.0,8354440174.5,184532898339.0,165704494536.0,52016950405.935,1863.0,1706.0,71125.0,70926.0,9141.0,506522.0,17825.7456000023,17888.00369999911,17339.059299998007,11306.440700000096,11244.247000000096,11191.638400000058,128534.0,663415.0,4142.017200000115,4139.713800000012,3950.2841000000935,13539442.120547537,-602479663.0,-922713762.0,-296769219.0,-1536580353.0416667,44060.0,30732.0,11359.61399999919,11235.559999998984,10719.597899997289,22910.923300009785,22832.683900009743,22217.55210000831,,158176.57235048412,126219.2355874596,35034.583500028,34974.701300028435,34420.13540002885,22974.0316999959,22947.066899995472,22593.830999995705,3717391.0,8303.662200000164,8408.298100000073,8131.762000000232,9826.664400000718,9941.686700002158,10301.80229999964,16483.300499999725,16668.700399999696,16265.3758999997,829.1653000001769,814.3423000000462,760.2615000000135,3917.2853000001232,3900.5212000001616,3733.18760000016,436852.0,431645.0,,6430.521810002895,632520.0,626068.0,,16347.643299999803,154328.9250999907,154331.66669999028,154223.38959998722,77680.51799999637,78018.6147000066,78420.44100000657,18.0,75666440.16000001,,7610507652.419993,2538650229.075001,87238890.26999997,784524.5999999999,140.0,17087.0,-24835974.0,11167627.0,-12874797.0,,-8.5,9495.0,,208921.5,73350.0,0.0,0.0,0.0,0.0,-520.0,210.0,-26.0,,268920552.50999993,3821733169.8750033,4300943485.770002,62171403.83999996,3821733169.8750033,277228.0,-19122469.5,4439140625.5,196659629.0,1000268552.0,430203942.0,1047343781.0,275554.5,4334.0,772.9323039123508,6377084.5,2270719.0,1400892.5,-4588294.0,1458455.0,102838.0,3028534429.3200865,3059679182.220056,-182941299.0,-181420755.0,3181070.0,151954.0,2796026608.6199718,7582077000.0,234442787.085,362880980.32499975,11893964.535000002,116185027.49999994,158475022.8749992,398658872.61000127,368083360.57500017,2684578797.989999,2785666676.7599635,2785803249.374963,12063.0,31717.0,161.0,19493.0,904394.0,-1605303.0,681042.0,1544.0,1468779.0,14833041.0,3235378.0,8563361.0,11618140.0,1417160.0,1060684191.5445012,,72173869003.55215,21696443155.237617,583159188.8069987,5792665.7475,689.5,94245.0,-277180094.0,22008991.0,-123891521.5,,-2023334.5,5926986508.2749605,18740007000.0,198877107.825,448276585.3424977,1948107.735,256971104.5275008,309315101.6474986,636965817.344998,459441605.4524993,5712001914.375034,5890241114.7075,5890484297.452499,13393.5,80933.0,44.0,70432.5,972152.0,-1699967.0,177364.0,6755.0,4277081.5,2481698.5,-9011800.5,921269.0,37582.5,3737220327.899961,3661897380.029961,-260864237.0,-257549465.0,2528625.5,269462.0,3929875262.077453,33282921852.09092,36714348272.63265,1731416418.270049,48130023461.37821,3991870.5,-247799899.0,103181538456.0,1055757037.0,17288106896.0,3506852045.5,18901581831.0,3675338.0,72003.5,20888.19158857758,89848380.0,-64.27562686136997,3.3415,5.494505494505495,156.6912539515279,18.35989010989011,523.5838250790306,90000.0,-0.9009688679024191,-0.433883739117558,0.0,1.0,0.0,0.0,0.0,0.0,0.0,0.0,0.0,0.0,0.0,0.0,0.0,1.0,0.0,0.0,0.0,0.0,1.0,0.0,1.0,0.0,0.0,0.0,0.0,1.0,0.0,0.0,0.0,0.0,0.0,0.0,0.0,0.0,0.0,0.0,0.0,0.0,0.0,0.0,0.0,0.0,0.0,0.0,1.0,0.0,0.0,0.0,0.0,0.0,0.0,0.0,0.0,0.0,0.0,0.0,0.0,0.0,0.0,0.0,0.0,0.0,0.0,0.0,0.0,0.0,0.0,0.0,0.0,0.0,0.0,0.0,0.0,0.0,0.0,0.0,0.0,0.0,1.0,0.0,0.0,0.0,0.0,0.0,0.0,0.0,0.0,0.0,0.0,0.0,0.0,0.0,0.0,0.0,0.0,0.0,0.0,0.0,0.0,0.0,0.0,0.0,0.0,0.0,0.0,0.0,0.0,0.0,1.0,0.0,1.0,0.0,0.0,0.0,0.0,0.0,0.0,1.0,0.0,0.0
104618,0,0.0,1.0,1.0,1.0,1.0,135000.0,522396.0,38142.0,472500.0,0.031329,30.6054794520548,-2926.0,-1089.0,-3330.0,15.0,3.0,2.0,2.0,13.0,0.3689685457630317,0.6387397769371929,0.324891229465852,,,,,,,,,,,,,,,,,,,,,,,,,,,,,,,,,,,,,,,,,,,,,2.0,0.0,2.0,0.0,-2686.0,0.0,0.0,0.0,0.0,1.0,2.0,1.0,1.0,0.0,1.0,0.0,0.0,0.0,0.0,0.0,0.0,0.0,0.0,0.0,1.0,0.0,0.0,0.0,0.0,0.0,0.0,0.0,0.0,0.0,0.0,0.0,0.0,0.0,0.0,0.0,0.0,0.0,0.0,9.0,13896.0,0.0,193725.0,0.0,0.0,0.0,0.0,0.0,-443.0,148.0,-299.0,-365.0,200.0,-11.5,5.0,16541.2125,74160.0,86926.5,13928.0625,132390.0,9.0,-350.0,365243.0,-617.0,-587.0,-467.0,-576.0,13.0,0.0,0.1089090909090909,125.0,14.0,6.0,2.5,-25.5,0.0,0.0,10.0,3907.935,3907.935,-1037.0,-888.0,2.5,1.0,0.0,,,,,,,,,,,,,,,,,,,,,8354478316.5,184533420735.0,165704967036.0,52017085405.935,1863.0,1706.0,71125.0,70927.0,9141.0,506524.0,,,,,,,128535.0,663418.0,,,,13539472.72602699,-602482589.0,-922717092.0,-296771905.0,-1536581442.0416667,44060.0,30732.0,,,,,,,67539.70925837566,158177.21109026106,126219.56047868908,,,,,,,3717404.0,,,,,,,,,,,,,,,,436854.0,431647.0,1264279.0,6430.553139002896,632522.0,626070.0,,,,,,,,,15.0,75702116.16000001,26683085.78999999,7619488272.404994,2542594857.075001,87269629.76999997,784524.5999999999,140.0,17087.0,-24866807.0,11160770.0,-12885682.0,-14038402.0,-7.0,0.0,0.0,99000.0,0.0,0.0,0.0,0.0,0.0,-781.0,-596.0,-590.0,-594.0,269637496.6274998,3834778836.3750033,4314797905.770002,62361375.83999996,3834815916.3750033,277721.0,-19143770.0,4444253503.0,196647609.0,1000807938.0,430379482.0,1047883244.0,275934.0,4337.0,773.9169344885025,6382755.0,2272933.0,1402151.0,-4592509.5,1458455.0,102838.0,3033052081.110099,3064270941.562568,-183243374.5,-181721251.5,3191128.0,152134.5,,,,,,,,,,,,,,,,,,,,,1468788.0,14833241.0,3235378.0,8563375.0,11618150.0,1417165.0,1060698087.5445012,802106132.5124952,72174062728.55215,21696443155.237617,583159188.8069987,5792665.7475,689.5,94245.0,-277180537.0,22009139.0,-123891820.5,-218900263.0,-2023346.0,,,,,,,,,,,,,,,,,,,,,4277087.5,2481701.0,-9011826.0,921269.0,37582.5,3737224235.834961,3661901287.964961,-260865274.0,-257550353.0,2528628.0,269463.0,3929891803.289953,33282996012.09092,36714435199.13265,1731430346.332549,48130155851.37821,3991879.5,-247800249.0,103181903699.0,1055756420.0,17288106309.0,3506851578.5,18901581255.0,3675351.0,72003.5,20888.30049766849,89848505.0,-95.60379554202844,3.8696,3.539405379896177,108.32519862690464,13.696083058046248,419.1751886066703,45000.0,0.6234898018587336,0.7818314824680298,0.0,0.0,0.0,0.0,0.0,1.0,0.0,0.0,0.0,0.0,0.0,0.0,0.0,1.0,0.0,0.0,0.0,0.0,1.0,0.0,1.0,0.0,0.0,0.0,0.0,1.0,0.0,0.0,0.0,0.0,0.0,0.0,0.0,0.0,0.0,0.0,0.0,0.0,1.0,0.0,0.0,0.0,0.0,0.0,0.0,0.0,0.0,0.0,0.0,0.0,0.0,0.0,0.0,0.0,0.0,0.0,0.0,0.0,0.0,0.0,0.0,0.0,0.0,0.0,0.0,0.0,0.0,0.0,0.0,0.0,0.0,0.0,0.0,0.0,0.0,0.0,0.0,0.0,0.0,0.0,0.0,1.0,0.0,0.0,0.0,0.0,0.0,0.0,0.0,0.0,0.0,0.0,0.0,0.0,0.0,0.0,0.0,0.0,0.0,0.0,0.0,0.0,0.0,0.0,0.0,0.0,0.0,0.0,0.0,0.0,0.0,0.0,0.0,0.0,0.0,0.0,0.0,0.0,0.0,0.0
104620,0,0.0,0.0,0.0,1.0,0.0,157500.0,432000.0,22185.0,432000.0,0.026392,40.0958904109589,-737.0,-4086.0,-3586.0,,1.0,2.0,2.0,10.0,,0.562213619756296,0.7016957740576931,0.1515,0.045,0.994,,,0.12,0.1034,0.375,,0.0827,,0.1259,,0.0013,0.1544,0.0467,0.994,,,0.1208,0.1034,0.375,,0.0846,,0.1312,,0.0013,0.153,0.045,0.994,,,0.12,0.1034,0.375,,0.0841,,0.1282,,0.0013,0.0993,1.0,0.0,0.0,0.0,0.0,-1648.0,0.0,0.0,0.0,0.0,0.0,6.0,1.0,1.0,0.0,1.0,0.0,0.0,0.0,0.0,0.0,0.0,0.0,0.0,0.0,1.0,0.0,0.0,0.0,0.0,0.0,0.0,0.0,0.0,0.0,0.0,0.0,0.0,0.0,0.0,0.0,0.0,0.0,0.0,13.0,0.0,0.0,26563.5,0.0,0.0,0.0,0.0,0.0,-1088.0,-585.0,-641.0,-846.0,528.0,-20.0,14.0,6116.2425,45000.0,54182.25,0.0,45000.0,12.0,-1510.5,365243.0,-1592.0,-1262.0,-1262.0,-1257.0,13.5,0.5,0.0,-1.0,82.0,12.0,6.5,-52.0,0.0,0.0,94.0,5700.645,5700.645,-1405.0,-1397.0,6.0,1.0,14.0,149.7375,22500.0,0.0,0.0,0.0,0.0,149.7375,451.305,225.6525,0.0,0.0,0.0,0.0,0.0,0.0,0.0,6.5,-8.5,0.0,0.0,8354500501.5,184533852735.0,165705399036.0,52017242905.935,1863.0,1706.0,71125.0,70927.0,9141.0,506530.0,17825.8971000023,17888.156699999112,17339.213699998007,11306.485700000096,11244.292000000096,11191.68510000006,128535.0,663419.0,,,,13539512.821917402,-602483326.0,-922720678.0,-296773553.0,-1536585528.0416667,44060.0,30732.0,11359.733999999193,11235.679999998983,10719.71869999729,22911.026700009785,22832.787300009742,22217.65550000831,,158177.7733038808,126220.26217446312,35034.958500028,34975.076300028435,34420.51040002885,,,,3717414.0,8303.744900000165,8408.382200000073,8131.846600000232,,,,16483.426399999724,16668.828599999695,16265.5070999997,,,,3917.286600000123,3900.522500000162,3733.18890000016,436854.0,431647.0,,6430.579531002895,632524.0,626072.0,,16347.742599999803,154329.91909999072,154332.6606999903,154224.38359998722,,,,36.0,75716012.16000001,26683085.78999999,7620783485.084993,2542804538.2650013,87269629.76999997,784524.5999999999,140.0,17087.0,-24880786.0,11151377.0,-12894600.0,-14048410.5,-17.5,0.0,0.0,22657.68,0.0,0.0,0.0,0.0,0.0,-1231.0,-865.0,-917.0,-1265.0,269695905.4349998,3835462477.5000033,4315463185.770002,62448172.96499996,3835439977.5000033,277794.0,-19155218.0,4446444734.5,196638922.0,1000802152.0,430556265.0,1047877491.0,276074.0,4340.0,774.9761073852266,6388521.5,2273490.0,1402439.5,-4595166.0,1458455.0,102838.0,3033441326.205101,3064653272.0250697,-183323042.5,-181799976.5,3191448.5,152210.0,2803085503.3799706,7591999500.0,234652037.085,363173769.6299997,11893964.535000002,116268566.80499992,158835044.15999922,399082944.95999926,368382477.96000016,2691272610.854999,2792682015.6149626,2792818588.229962,12096.0,31786.0,161.0,19529.0,906523.5,-1610357.0,681043.0,1545.0,1468801.0,14833769.0,3235392.0,8563457.0,11618244.0,1417179.0,1060698087.5445012,802106132.5124952,72174089292.05215,21696443155.237617,583159188.8069987,5792665.7475,689.5,94245.0,-277181625.0,22008554.0,-123892461.5,-218901109.0,-2023366.0,5926986658.012461,18740029500.0,198877107.825,448276585.3424977,1948107.735,256971104.5275008,309315251.3849986,636966268.6499981,459441831.1049992,5712001914.375034,5890241114.7075,5890484297.452499,13393.5,80933.0,44.0,70432.5,972158.5,-1699975.5,177364.0,6755.0,4277099.5,2481707.5,-9011878.0,921269.0,37582.5,3737229936.47996,3661906988.609961,-260866679.0,-257551750.0,2528634.0,269464.0,3929897919.532453,33283041012.09092,36714489381.38265,1731430346.332549,48130200851.37821,3991891.5,-247801759.5,103182268942.0,1055754828.0,17288105047.0,3506850316.5,18901579998.0,3675364.5,72004.0,20888.30049766849,89848504.0,-18.38093611206013,2.7428571428571438,7.099391480730223,284.65642279585427,19.47261663286004,780.7719025257718,157500.0,1.0,0.0,0.0,0.0,0.0,0.0,0.0,0.0,1.0,0.0,0.0,0.0,0.0,0.0,0.0,1.0,0.0,0.0,0.0,0.0,1.0,0.0,0.0,1.0,0.0,0.0,0.0,1.0,0.0,0.0,0.0,0.0,0.0,0.0,0.0,0.0,0.0,0.0,0.0,0.0,1.0,0.0,0.0,0.0,0.0,0.0,0.0,0.0,0.0,0.0,0.0,0.0,0.0,0.0,1.0,0.0,0.0,0.0,0.0,0.0,0.0,0.0,0.0,0.0,0.0,0.0,0.0,0.0,0.0,0.0,0.0,0.0,0.0,0.0,0.0,0.0,0.0,0.0,0.0,0.0,0.0,0.0,0.0,0.0,0.0,0.0,0.0,0.0,0.0,0.0,0.0,0.0,0.0,0.0,0.0,0.0,0.0,0.0,0.0,0.0,0.0,0.0,0.0,0.0,0.0,0.0,0.0,0.0,0.0,0.0,0.0,0.0,1.0,0.0,0.0,0.0,0.0,0.0,0.0,1.0,0.0,0.0
104622,0,0.0,0.0,1.0,1.0,2.0,135000.0,220536.0,9400.5,135000.0,0.02461,28.797260273972608,-1397.0,-4636.0,-707.0,9.0,4.0,2.0,2.0,12.0,0.3714437560238264,0.7449895677414688,0.4776491548517548,0.0619,0.0623,0.9737,0.6396,0.0444,0.0,0.1034,0.1667,0.2083,0.0888,0.0504,0.0496,0.0,0.0,0.063,0.0647,0.9737,0.6537,0.0448,0.0,0.1034,0.1667,0.2083,0.0909,0.0551,0.0517,0.0,0.0,0.0625,0.0623,0.9737,0.6444,0.0447,0.0,0.1034,0.1667,0.2083,0.0904,0.0513,0.0505,0.0,0.0,0.0649,1.0,6.0,0.0,6.0,0.0,-2344.0,0.0,0.0,0.0,0.0,1.0,1.0,1.0,1.0,1.0,1.0,1.0,0.0,0.0,0.0,0.0,0.0,0.0,0.0,0.0,1.0,0.0,0.0,0.0,0.0,0.0,0.0,0.0,0.0,0.0,0.0,0.0,0.0,0.0,0.0,0.0,0.0,0.0,0.0,5.0,8055.0,,313708.5,0.0,0.0,0.0,0.0,0.0,-395.0,1431.0,-48.0,-143.0,87.0,-9.0,4.0,15101.6175,105900.75,119558.25,2180.25,105900.75,8.0,-1014.0,365243.0,-1256.0,-1196.0,-1106.0,-1188.0,17.0,0.0,0.050693106490013,27.0,14.0,9.0,5.0,-70.5,0.0,0.0,12.0,5866.47,5866.47,-2162.0,-2129.0,3.5,1.0,22.0,0.0,765000.0,,0.0,,,0.0,,0.0,0.0,0.0,0.0,,0.0,,,0.0,-13.5,0.0,0.0,8354509902.0,184534073271.0,165705534036.0,52017377905.935,1863.0,1706.0,71125.0,70928.0,9141.0,506531.0,17825.959000002298,17888.219199999112,17339.276699998,11306.548000000092,11244.354300000095,11191.749800000058,128537.0,663423.0,4142.061600000115,4139.758500000013,3950.328900000093,13539541.619177671,-602484723.0,-922721385.0,-296775897.0,-1536590164.0416667,44060.0,30732.0,11359.733999999193,11235.679999998983,10719.71869999729,22911.130100009785,22832.890700009742,22217.75890000831,67540.08070213169,158178.51829344852,126220.739823618,35035.125200028,34975.24300002844,34420.67710002885,22974.23999999589,22947.275199995467,22594.039299995704,3717426.0,8303.833700000165,8408.472600000072,8131.937500000232,9826.714800000718,9941.738000002157,10301.85739999964,16483.475999999722,16668.879099999696,16265.5587999997,829.1653000001769,814.3423000000462,760.2615000000135,3917.286600000123,3900.522500000162,3733.18890000016,436860.0,431653.0,1264288.0,6430.6041410028965,632526.0,626074.0,,16347.807499999804,154330.89279999072,154333.6343999903,154225.35729998726,77681.15759999635,78019.2591000066,78421.09470000658,14.0,75724067.16000001,,7626928175.504993,2544752088.7650013,87269629.76999997,784524.5999999999,140.0,17087.0,-24897272.0,11153979.0,-12903035.0,-14054736.5,-6.5,8055.0,,450000.0,271696.5,0.0,0.0,0.0,0.0,-433.0,916.0,-26.0,-217.0,269803486.9349998,3837147691.5000033,4317196068.270002,62465626.21499996,3837147691.5000033,277907.0,-19169662.0,4449001209.0,196995858.0,1001524474.0,431098004.0,1048599863.0,276234.5,4341.0,775.3864473864058,6388772.0,2274572.5,1403201.0,-4598219.5,1458455.0,102838.0,3034527548.7600994,3066366513.105068,-183403520.0,-181879139.0,3191861.0,152326.5,2803296831.83997,7601877000.0,,363218769.6299997,,,158846533.60499918,,368420727.96000016,2691477926.3699994,2792891773.5749626,2793028346.189962,,31787.0,,,906542.0,-1610569.0,681043.0,1545.0,1468806.0,14833856.0,3235414.0,8563471.0,11618256.0,1417183.0,1060706142.5445012,,72174403000.55215,21696443155.237617,583159188.8069987,5792665.7475,689.5,94245.0,-277182020.0,22009985.0,-123892509.5,-218901252.0,-2023375.0,5926986658.012461,18740794500.0,,448276585.3424977,,,309315251.3849986,,459441831.1049992,5712001914.375034,5890241114.7075,5890484297.452499,,80933.0,,,972158.5,-1699989.0,177364.0,6755.0,4277108.5,2481712.5,-9011948.5,921269.0,37582.5,3737235802.94996,3661912855.079961,-260868841.0,-257553879.0,2528637.5,269465.0,3929913021.149953,33283146912.84092,36714608939.63265,1731432526.582549,48130306752.12821,3991899.5,-247802773.5,103182634185.0,1055753572.0,17288103851.0,3506849210.5,18901578810.0,3675381.5,72004.0,20888.35119077497,89848531.0,-48.511559318808864,1.6336,14.360938247965532,413.5556765051116,23.460028721876498,675.5845531387504,33750.0,-0.9009688679024191,-0.433883739117558,0.0,0.0,0.0,0.0,0.0,0.0,1.0,0.0,1.0,0.0,0.0,0.0,0.0,0.0,0.0,1.0,0.0,0.0,0.0,0.0,1.0,0.0,0.0,0.0,0.0,1.0,0.0,0.0,0.0,0.0,0.0,0.0,0.0,0.0,0.0,0.0,0.0,0.0,0.0,0.0,0.0,0.0,0.0,0.0,0.0,0.0,0.0,0.0,0.0,0.0,1.0,0.0,0.0,0.0,0.0,0.0,0.0,0.0,0.0,0.0,0.0,0.0,0.0,0.0,0.0,0.0,0.0,0.0,0.0,0.0,0.0,0.0,0.0,0.0,0.0,0.0,0.0,0.0,0.0,0.0,0.0,0.0,0.0,0.0,0.0,0.0,0.0,0.0,0.0,0.0,0.0,0.0,0.0,0.0,0.0,0.0,0.0,0.0,0.0,0.0,0.0,0.0,0.0,0.0,0.0,0.0,0.0,0.0,1.0,0.0,1.0,0.0,0.0,0.0,0.0,0.0,0.0,0.0,1.0,0.0
104624,0,0.0,1.0,0.0,1.0,0.0,171000.0,686749.5,26019.0,567000.0,0.025164,64.3917808219178,,-10636.0,-4666.0,,2.0,2.0,2.0,15.0,0.6696039494069218,0.4550652915760574,0.6430255641096323,,,,,,,,,,,,,,,,,,,,,,,,,,,,,,,,,,,,,,,,,,,,,8.0,3.0,8.0,3.0,-2223.0,0.0,0.0,0.0,0.0,1.0,1.0,1.0,0.0,0.0,1.0,0.0,1.0,0.0,0.0,0.0,0.0,0.0,0.0,0.0,0.0,0.0,0.0,1.0,0.0,0.0,0.0,0.0,0.0,0.0,0.0,0.0,0.0,0.0,0.0,0.0,0.0,0.0,0.0,12.0,0.0,0.0,66888.0,0.0,0.0,0.0,0.0,0.0,-237.5,-317.0,-130.0,-168.0,200.0,-14.0,5.0,11154.105,77836.5,94729.5,0.0,86283.0,9.0,-2223.0,365243.0,-1542.5,-1037.5,-337.0,-589.0,10.0,0.0,0.0,911.0,26.0,24.0,12.0,-24.5,0.0,0.0,171.0,5625.0,5625.0,-1621.0,-1606.0,62.0,0.0,93.0,353.97,112500.0,0.0,0.0,0.0,0.0,1864.485,298.575,0.0,0.0,0.0,0.0,0.0,0.0,0.0,0.0,44.5,-47.0,0.0,0.0,8354535921.0,184534760020.5,165706101036.0,52017548905.935,1863.0,1706.0,71125.0,70929.0,9141.0,506532.0,,,,,,,128537.0,663425.0,,,,13539606.010958496,,-922726051.0,-296778120.0,-1536600800.0416667,44063.0,30735.0,,,,,,,67540.7503060811,158178.9733587401,126221.38284918208,,,,,,,3717441.0,,,,,,,,,,,,,,,,436868.0,431661.0,,6430.629305002895,632528.0,626076.0,,,,,,,,,8.5,75753834.66000001,26741950.28999999,7632054386.504993,2547666095.625001,87269629.76999997,784524.5999999999,140.0,17087.0,-24903428.5,11155365.5,-12906203.5,-14057965.0,-4.0,11250.0,0.0,135000.0,77008.5,0.0,0.0,0.0,0.0,-901.0,-2338.0,-671.0,-671.0,269886159.15749985,3838242015.0000033,4318411644.270002,62485806.46499996,3838280933.2500033,277945.0,-19178948.0,4450276444.5,196987812.0,1001883962.0,431824292.0,1049325885.0,276330.0,4341.0,775.8732129289682,6391790.0,2274825.0,1403351.0,-4599396.5,1458455.0,102838.0,3035243193.0751014,3067076532.42007,-183563297.0,-182038201.0,3198328.0,152338.0,2809507032.67497,7620439500.0,235450337.085,364422251.3399997,11893964.535000002,116718748.51499993,159164219.74499923,399655334.8799992,368935660.98000014,2697454758.8250003,2799082785.1499624,2799219357.764961,12125.0,31896.0,161.0,19610.0,908097.5,-1613151.0,681044.0,1546.0,1468818.0,14834056.0,3235507.0,8563497.0,11618427.0,1417188.0,1060706142.5445012,802106132.5124952,72174469888.55215,21696443155.237617,583159188.8069987,5792665.7475,689.5,94245.0,-277182257.5,22009668.0,-123892639.5,-218901420.0,-2023389.0,5926987011.982461,18740907000.0,198877107.825,448276585.3424977,1948107.735,256971104.5275008,309317115.86999863,636966567.224998,459441831.1049992,5712001914.375034,5890241114.7075,5890484297.452499,13393.5,80933.0,44.0,70432.5,972203.0,-1700036.0,177364.0,6755.0,4277132.5,2481724.5,-9011973.0,921269.0,37582.5,3737241427.94996,3661918480.079961,-260870462.0,-257555485.0,2528699.5,269465.0,3929924175.254953,33283224749.34092,36714703669.13265,1731432526.582549,48130393035.12821,3991908.5,-247804996.5,103182999428.0,1055752029.5,17288102813.5,3506848873.5,18901578221.0,3675391.5,72004.0,20888.35119077497,89849442.0,,4.016078947368421,6.572120373573158,423.19053463038335,26.394154271878246,1699.5665968546691,85500.0,1.0,0.0,0.0,0.0,0.0,0.0,0.0,0.0,1.0,0.0,0.0,1.0,0.0,0.0,0.0,0.0,0.0,1.0,0.0,0.0,0.0,0.0,1.0,0.0,0.0,0.0,0.0,1.0,0.0,0.0,0.0,0.0,0.0,0.0,0.0,0.0,0.0,0.0,0.0,0.0,0.0,0.0,0.0,0.0,0.0,0.0,0.0,0.0,0.0,0.0,0.0,0.0,0.0,0.0,0.0,0.0,0.0,0.0,0.0,0.0,0.0,0.0,0.0,0.0,0.0,0.0,0.0,0.0,0.0,0.0,0.0,0.0,0.0,0.0,0.0,0.0,0.0,0.0,0.0,0.0,0.0,0.0,0.0,0.0,0.0,0.0,0.0,0.0,0.0,0.0,0.0,0.0,0.0,0.0,0.0,0.0,0.0,0.0,0.0,0.0,0.0,0.0,0.0,0.0,0.0,0.0,0.0,1.0,0.0,0.0,0.0,0.0,0.0,0.0,0.0,0.0,0.0,0.0,0.0,0.0,0.0,0.0
104625,0,0.0,0.0,0.0,1.0,0.0,157500.0,296280.0,23409.0,225000.0,0.028663,27.378082191780823,-430.0,-4705.0,-2651.0,,1.0,2.0,2.0,13.0,,0.617035258449172,0.2721336844147212,,,,,,,,,,,,,,,,,,,,,,,,,,,,,,,,,,,,,,,,,,,,,1.0,0.0,1.0,0.0,-335.0,0.0,0.0,0.0,0.0,0.0,1.0,1.0,1.0,1.0,1.0,0.0,0.0,1.0,1.0,0.0,1.0,1.0,0.0,0.0,1.0,0.0,0.0,0.0,0.0,0.0,0.0,0.0,0.0,0.0,0.0,0.0,0.0,0.0,0.0,0.0,0.0,0.0,0.0,5.0,0.0,0.0,63643.05,0.0,0.0,0.0,0.0,0.0,-805.0,-551.0,-551.0,-551.0,169.0,-16.0,6.0,5924.655000000002,24626.25,23679.0,2250.0,30663.0,5.0,-648.5,365243.0,-1169.0,-1049.0,-1049.0,-1045.0,14.0,0.0,0.0944948381858253,14.5,25.0,6.0,4.0,-48.0,0.0,0.0,38.0,4002.57,4002.57,-858.5,-856.0,5.5,1.0,8.0,91776.1275,180000.0,0.0,372.105,0.0,32.175,5307.0075,9900.0,5001.12,87894.0,88231.2975,88231.2975,0.0,0.5,0.0,0.5,3.5,-7.5,0.0,0.0,8354559330.0,184535056300.5,165706326036.0,52017706405.935,1863.0,1706.0,71125.0,70929.0,9141.0,506533.0,,,,,,,128537.0,663426.0,,,,13539633.389040684,-602485153.0,-922728702.0,-296778455.0,-1536605505.0416667,44063.0,30735.0,,,,,,,,158179.59039399854,126221.6549828665,,,,,,,3717454.0,,,,,,,,,,,,,,,,436869.0,431662.0,,6430.657968002895,632530.0,626078.0,,,,,,,,,27.0,75753834.66000001,26741950.28999999,7632933588.854994,2547666095.625001,87404629.76999997,784524.5999999999,140.0,17087.0,-24909091.0,11151574.0,-12909823.0,-14062019.0,-13.0,0.0,0.0,28083.78,0.0,0.0,0.0,0.0,0.0,-1011.0,-561.0,-555.0,-561.0,269921290.1849999,3838724347.5000033,4318903847.520002,62509422.46499996,3838724347.5000033,277987.0,-19185526.0,4451371839.5,196982812.5,1001879969.5,432186000.5,1049321932.5,276400.0,4342.0,776.2915251510581,6393535.5,2275275.0,1403643.0,-4600545.0,1458455.0,102838.0,3036248196.075104,3068072071.245073,-183698919.5,-182171816.0,3203164.5,152368.5,2811063755.384971,7625299500.0,235523237.085,364496682.82499975,11893964.535000002,116719600.13999993,159292062.92249924,400001609.339999,369375719.76000017,2698926852.51,2800637027.819963,2800773600.4349623,12133.5,31905.5,161.0,19611.0,909864.0,-1615172.5,681045.0,1547.0,1468823.0,14834225.0,3235515.0,8563522.0,11618465.0,1417194.0,1060706142.5445012,802106132.5124952,72174533531.60216,21696443155.237617,583159188.8069987,5792665.7475,689.5,94245.0,-277183062.5,22009117.0,-123893190.5,-218901971.0,-2023405.0,5927078788.109961,18741087000.0,198877107.825,448276957.44749767,1948107.735,256971136.7025008,309322422.8774986,636976467.224998,459446832.2249993,5712089808.375034,5890329346.004997,5890572528.749999,13393.5,80933.5,44.0,70433.0,972206.5,-1700043.5,177364.0,6755.0,4277138.5,2481728.5,-9012021.0,921269.0,37582.5,3737245430.51996,3661922482.649961,-260871320.5,-257556341.0,2528705.0,269466.0,3929930099.909953,33283249375.59092,36714727348.13265,1731434776.582549,48130423698.12821,3991913.5,-247805645.0,103183364671.0,1055750860.5,17288101764.5,3506847824.5,18901577176.0,3675405.5,72004.0,20888.44568561317,89849456.5,-15.705994195937157,1.8811428571428568,6.728181468665898,184.2047052503516,12.656670511341794,346.5153655338042,157500.0,0.6234898018587336,0.7818314824680298,0.0,0.0,0.0,0.0,0.0,0.0,1.0,0.0,1.0,0.0,0.0,0.0,0.0,0.0,0.0,1.0,0.0,0.0,0.0,0.0,0.0,0.0,1.0,0.0,0.0,1.0,0.0,0.0,0.0,0.0,0.0,0.0,0.0,1.0,0.0,0.0,0.0,0.0,0.0,0.0,0.0,0.0,0.0,0.0,0.0,0.0,0.0,0.0,0.0,0.0,0.0,0.0,0.0,0.0,0.0,0.0,0.0,0.0,0.0,0.0,0.0,0.0,0.0,0.0,0.0,0.0,0.0,0.0,0.0,0.0,0.0,0.0,0.0,0.0,0.0,0.0,0.0,0.0,0.0,0.0,0.0,0.0,0.0,0.0,0.0,0.0,0.0,0.0,0.0,0.0,0.0,0.0,0.0,0.0,0.0,1.0,0.0,0.0,0.0,0.0,0.0,0.0,0.0,0.0,0.0,0.0,0.0,0.0,0.0,0.0,0.0,0.0,0.0,0.0,0.0,0.0,0.0,0.0,0.0,0.0
104634,0,0.0,1.0,1.0,1.0,0.0,225000.0,278460.0,21676.5,225000.0,0.006305,24.416438356164388,-1063.0,-2874.0,-1175.0,14.0,2.0,3.0,3.0,8.0,0.1826654718633689,0.4866712837392048,0.4902575124990026,,,,,,,,,,,,,,,,,,,,,,,,,,,,,,,,,,,,,,,,,,,,,1.0,0.0,1.0,0.0,-1055.0,0.0,0.0,0.0,0.0,0.0,2.0,1.0,1.0,0.0,1.0,0.0,0.0,0.0,0.0,0.0,1.0,1.0,1.0,0.0,1.0,0.0,0.0,0.0,0.0,0.0,0.0,0.0,0.0,0.0,0.0,0.0,0.0,0.0,0.0,0.0,0.0,0.0,0.0,5.0,40216.5,0.0,97245.0,0.0,0.0,0.0,0.0,0.0,-363.0,146.0,-92.0,-228.0,68.0,-7.5,2.0,7156.7325,92565.0,95618.25,0.0,92565.0,15.0,-988.5,365243.0,-955.5,-580.5,-535.5,-572.5,7.0,0.0,0.0,140.0,29.0,18.0,8.0,-25.0,0.0,0.0,29.0,8346.105,8346.105,-804.0,-782.0,7.0,1.0,0.0,,,,,,,,,,,,,,,,,,,,,8354581006.5,184535334760.5,165706551036.0,52017931405.935,1863.0,1706.0,71125.0,70929.0,9141.0,506535.0,,,,,,,128537.0,663428.0,,,,13539657.805479042,-602486216.0,-922729877.0,-296779510.0,-1536608379.0416667,44063.0,30735.0,,,,,,,67540.93297155296,158180.07706528227,126222.145240379,,,,,,,3717462.0,,,,,,,,,,,,,,,,436870.0,431663.0,1264302.0,6430.664273002895,632533.0,626081.0,,,,,,,,,12.0,76975871.85000001,26804160.40499999,7652474698.724996,2555436295.170001,88099746.11999996,784524.5999999999,141.0,17087.0,-24984125.0,11136258.0,-12948611.0,-14097597.0,-5.5,722353.5,0.0,792000.0,0.0,0.0,0.0,0.0,0.0,-596.0,1105.0,-225.0,-228.0,270950900.4224997,3865489551.0000033,4347933831.270002,62648985.46499996,3865489551.0000033,279697.0,-19247333.5,4463421625.5,197305412.0,1003308481.0,433256268.0,1050751074.0,277444.0,4351.0,778.8411252473419,6400541.0,2280655.0,1407177.0,-4613532.0,1458491.0,102865.0,3044247586.4251127,3076203693.51008,-184235030.0,-182703545.0,3211503.0,152746.0,,,,,,,,,,,,,,,,,,,,,1468828.0,14834293.0,3235515.0,8563551.0,11618494.0,1417196.0,1060746359.0445012,802106132.5124952,72174630776.60216,21696443155.237617,583159188.8069987,5792665.7475,689.5,94245.0,-277183425.5,22009263.0,-123893282.5,-218902199.0,-2023412.5,,,,,,,,,,,,,,,,,,,,,4277156.5,2481736.5,-9012046.0,921269.0,37582.5,3737253776.62496,3661930828.754961,-260872124.5,-257557123.0,2528712.0,269467.0,3929937256.642453,33283341940.59092,36714822966.38265,1731434776.582549,48130516263.12821,3991928.5,-247806633.5,103183729914.0,1055749905.0,17288101184.0,3506847289.0,18901576603.5,3675412.5,72004.0,20888.44568561317,89849596.5,-43.53624326750449,1.2376,10.379904504878557,253.44029848624024,12.8461698152377,313.6577134065709,112500.0,0.6234898018587336,0.7818314824680298,0.0,0.0,0.0,0.0,0.0,0.0,1.0,0.0,0.0,0.0,1.0,0.0,0.0,0.0,0.0,0.0,0.0,0.0,1.0,1.0,0.0,0.0,0.0,0.0,0.0,1.0,0.0,0.0,0.0,0.0,0.0,0.0,0.0,1.0,0.0,0.0,0.0,0.0,0.0,0.0,0.0,0.0,0.0,0.0,0.0,0.0,0.0,0.0,0.0,0.0,0.0,0.0,0.0,0.0,0.0,0.0,0.0,0.0,0.0,0.0,0.0,0.0,0.0,0.0,0.0,0.0,0.0,0.0,0.0,0.0,0.0,0.0,0.0,0.0,0.0,0.0,0.0,0.0,0.0,1.0,0.0,0.0,0.0,0.0,0.0,0.0,0.0,0.0,0.0,0.0,0.0,0.0,0.0,0.0,0.0,0.0,0.0,0.0,0.0,0.0,0.0,0.0,0.0,0.0,0.0,0.0,0.0,0.0,0.0,0.0,0.0,0.0,0.0,0.0,0.0,0.0,0.0,0.0,0.0,0.0
104639,0,0.0,0.0,0.0,0.0,1.0,117000.0,550980.0,43659.0,450000.0,0.00496,25.69041095890411,-1181.0,-1171.0,-1285.0,,3.0,2.0,2.0,16.0,0.6076749527038211,0.5332189373386672,0.5406544504453575,,,,,,,,,,,,,,,,,,,,,,,,,,,,,,,,,,,,,,,,,,,,,0.0,0.0,0.0,0.0,0.0,0.0,0.0,0.0,0.0,0.0,3.0,1.0,1.0,1.0,1.0,0.0,0.0,0.0,0.0,0.0,0.0,0.0,0.0,0.0,1.0,0.0,0.0,0.0,0.0,0.0,0.0,0.0,0.0,0.0,0.0,0.0,0.0,0.0,0.0,0.0,0.0,0.0,0.0,3.0,9141.75,0.0,76500.0,0.0,0.0,0.0,0.0,0.0,-430.0,-247.0,-245.0,-512.5,54.0,-10.0,1.0,5091.345,50418.0,50166.0,5044.5,50418.0,12.0,-813.0,365243.0,-781.0,-691.0,-451.0,-684.0,18.0,0.0,0.0995085914981586,90.0,5.0,12.0,10.0,-24.0,0.0,0.0,4.0,5091.345,5091.345,-779.0,-736.0,2.5,1.0,0.0,,,,,,,,,,,,,,,,,,,,,8354624665.5,184535885740.5,165707001036.0,52018048405.935,1863.0,1706.0,71125.0,70929.0,9141.0,506538.0,,,,,,,128538.0,663431.0,,,,13539683.49589,-602487397.0,-922731162.0,-296779510.0,-1536609550.0416667,44063.0,30735.0,,,,,,,67541.54064650566,158180.6102842196,126222.68589482944,,,,,,,3717478.0,,,,,,,,,,,,,,,,436870.0,431663.0,,6430.669233002895,632535.0,626083.0,,,,,,,,,15.0,77070761.10000001,26806163.66999999,7661972294.909994,2557158704.865001,88099746.11999996,784524.5999999999,141.0,17087.0,-25015180.0,11125315.0,-12964891.0,-14114629.5,-7.0,0.0,0.0,65205.0,0.0,0.0,0.0,0.0,0.0,-995.0,-722.0,-779.0,-780.0,271075416.8849997,3866634063.0000033,4349094376.770002,62712124.96499996,3866634063.0000033,279852.0,-19269706.0,4468352406.0,197652970.0,1004023966.0,433242132.0,1051466620.0,277666.0,4355.0,780.1111435428352,6401486.0,2281906.0,1407852.0,-4618564.0,1458491.0,102865.0,3045301052.917616,3077240666.2425823,-184373036.5,-182840346.5,3212097.5,152867.5,,,,,,,,,,,,,,,,,,,,,1468831.0,14834347.0,3235515.0,8563556.0,11618498.0,1417197.0,1060755500.7945012,802106132.5124952,72174707276.60216,21696443155.237617,583159188.8069987,5792665.7475,689.5,94245.0,-277183855.5,22009016.0,-123893527.5,-218902711.5,-2023422.5,,,,,,,,,,,,,,,,,,,,,4277168.5,2481746.5,-9012070.0,921269.0,37582.5,3737258867.96996,3661935920.099961,-260872903.5,-257557859.0,2528714.5,269468.0,3929942347.987453,33283392358.59092,36714873132.38265,1731439821.082549,48130566681.12821,3991940.5,-247807446.5,103184095157.0,1055749124.0,17288100493.0,3506846838.0,18901575919.5,3675430.5,72004.0,20888.545194204664,89849686.5,-45.97045963527781,4.7092307692307696,2.6798598227169657,68.84670015785476,12.620078334364049,324.2149987433745,39000.0,-0.9009688679024191,-0.433883739117558,0.0,0.0,0.0,0.0,0.0,0.0,1.0,0.0,0.0,0.0,0.0,0.0,0.0,1.0,0.0,0.0,1.0,0.0,0.0,0.0,1.0,0.0,0.0,0.0,0.0,1.0,0.0,0.0,0.0,0.0,0.0,0.0,0.0,0.0,0.0,0.0,0.0,0.0,1.0,0.0,0.0,0.0,0.0,0.0,0.0,0.0,0.0,0.0,0.0,0.0,0.0,0.0,0.0,0.0,0.0,0.0,0.0,0.0,0.0,0.0,0.0,0.0,0.0,0.0,0.0,0.0,0.0,0.0,1.0,0.0,0.0,0.0,0.0,0.0,0.0,0.0,0.0,0.0,0.0,0.0,0.0,0.0,0.0,0.0,0.0,0.0,0.0,0.0,0.0,0.0,0.0,0.0,0.0,0.0,0.0,0.0,0.0,0.0,0.0,0.0,0.0,0.0,0.0,0.0,0.0,0.0,0.0,0.0,0.0,0.0,0.0,0.0,0.0,0.0,0.0,0.0,0.0,0.0,0.0,0.0
104646,0,0.0,0.0,1.0,1.0,0.0,450000.0,761872.5,59089.5,675000.0,0.0038179999999999,37.227397260273975,-2023.0,-3912.0,-4756.0,17.0,2.0,2.0,2.0,3.0,0.4570055916366969,0.5974125393013211,0.5832379256761245,,,,,,,,,,,,,,,,,,,,,,,,,,,,,,,,,,,,,,,,,,,,,0.0,0.0,0.0,0.0,-1781.0,0.0,0.0,0.0,0.0,0.0,3.0,1.0,1.0,0.0,1.0,0.0,0.0,0.0,0.0,0.0,0.0,0.0,0.0,0.0,1.0,0.0,0.0,0.0,0.0,0.0,0.0,0.0,0.0,0.0,0.0,0.0,0.0,0.0,0.0,0.0,0.0,0.0,0.0,16.0,0.0,0.0,283142.25,0.0,0.0,0.0,0.0,0.0,-1194.5,-756.0,-938.5,-1284.5,825.0,-28.0,9.0,9256.23,48060.0,45396.0,2403.0,91505.25,6.0,-833.0,365243.0,-895.0,-685.0,-565.0,-681.0,9.0,0.0,0.0521310994491346,29.0,66.0,12.0,5.5,-22.0,0.0,0.0,59.0,33571.89,33571.89,-622.0,-623.0,6.0,1.0,13.0,0.0,225000.0,,0.0,,,0.0,,0.0,0.0,0.0,0.0,,0.0,,,0.0,-7.0,0.0,0.0,8354683755.0,184536647613.0,165707676036.0,52018498405.935,1863.0,1706.0,71125.0,70929.0,9141.0,506541.0,,,,,,,128538.0,663433.0,,,,13539720.723287262,-602489420.0,-922735918.0,-296781291.0,-1536613462.0416667,44063.0,30735.0,,,,,,,67541.9976520973,158181.2076967589,126223.26913275511,,,,,,,3717481.0,,,,,,,,,,,,,,,,436870.0,431663.0,1264319.0,6430.6730510028965,632537.0,626085.0,,,,,,,,,39.5,77120353.35000001,26806163.66999999,7670184819.2999935,2557848014.865001,88099746.11999996,784524.5999999999,141.0,17087.0,-25054786.5,11144165.0,-12986351.5,-14137613.5,-19.25,0.0,0.0,280084.5,0.0,0.0,0.0,0.0,0.0,-2448.0,-1370.0,-1366.0,-1502.0,271260329.3099998,3869221648.050003,4351753980.270002,62748234.76499996,3869239339.800003,279977.0,-19285522.0,4472369776.0,197640918.0,1004379677.0,433598203.0,1051822385.0,277877.0,4358.0,780.839901652512,6407810.0,2283615.0,1408744.5,-4622343.5,1458505.0,102877.0,3048125410.9351177,3079938406.8150816,-184487317.0,-182952940.0,3213319.0,152987.0,2824902017.459969,7659229500.0,,366294016.3049997,,,160094988.5849992,,371286208.53000015,2712139638.345,2814436477.1699605,2814573049.7849603,,32068.0,,,913221.0,-1619766.0,681045.0,1547.0,1468847.0,14835172.0,3235528.0,8563622.0,11618557.0,1417206.0,1060755500.7945012,802106132.5124952,72174990418.85216,21696443155.237617,583159188.8069987,5792665.7475,689.5,94245.0,-277185050.0,22008260.0,-123894466.0,-218903996.0,-2023450.5,5927078788.109961,18741312000.0,,448276957.44749767,,,309322422.8774986,,459446832.2249993,5712089808.375034,5890329346.004997,5890572528.749999,,80933.5,,,972206.5,-1700050.5,177364.0,6755.0,4277180.5,2481752.0,-9012092.0,921269.0,37582.5,3737292439.85996,3661969491.989961,-260873525.5,-257558482.0,2528720.5,269469.0,3929951604.217453,33283440418.59092,36714918528.38265,1731442224.082549,48130658186.37821,3991946.5,-247808279.5,103184460400.0,1055748229.0,17288099808.0,3506846273.0,18901575238.5,3675439.5,72004.0,20888.597325304112,89849715.5,-54.34169855755079,1.69305,7.61556621734826,283.5077089351456,12.893534384281471,479.9927266126483,225000.0,0.6234898018587336,0.7818314824680298,0.0,0.0,0.0,0.0,0.0,0.0,1.0,0.0,0.0,0.0,0.0,0.0,0.0,1.0,0.0,1.0,0.0,0.0,0.0,0.0,1.0,0.0,0.0,0.0,0.0,1.0,0.0,0.0,0.0,0.0,0.0,0.0,0.0,0.0,0.0,0.0,0.0,0.0,0.0,0.0,0.0,0.0,0.0,0.0,0.0,0.0,0.0,0.0,0.0,0.0,0.0,0.0,0.0,0.0,0.0,0.0,0.0,0.0,0.0,0.0,0.0,0.0,0.0,0.0,0.0,0.0,0.0,0.0,0.0,0.0,0.0,0.0,0.0,0.0,0.0,0.0,0.0,0.0,0.0,0.0,0.0,0.0,0.0,0.0,0.0,0.0,0.0,0.0,0.0,0.0,1.0,0.0,0.0,0.0,0.0,0.0,0.0,0.0,0.0,0.0,0.0,0.0,0.0,0.0,0.0,0.0,0.0,0.0,0.0,0.0,0.0,0.0,0.0,0.0,0.0,0.0,0.0,0.0,0.0,0.0
104647,0,0.0,0.0,0.0,1.0,1.0,112500.0,523152.0,42075.0,463500.0,0.0031219999999999,26.94794520547945,-2209.0,-4702.0,-1413.0,,3.0,3.0,3.0,18.0,0.4003562577571286,0.6703344370301499,,0.0515,0.0368,0.9786,,,0.04,0.0345,0.3333,,0.0302,,0.0435,,0.0137,0.0525,0.0382,0.9786,,,0.0403,0.0345,0.3333,,0.0309,,0.0453,,0.0145,0.052,0.0368,0.9786,,,0.04,0.0345,0.3333,,0.0307,,0.0443,,0.0139,0.0391,1.0,0.0,0.0,0.0,0.0,-704.0,,,,,,,1.0,1.0,0.0,1.0,0.0,0.0,0.0,0.0,0.0,0.0,0.0,0.0,0.0,1.0,0.0,0.0,0.0,0.0,0.0,0.0,0.0,0.0,0.0,0.0,0.0,0.0,0.0,0.0,0.0,0.0,0.0,0.0,0.0,,,,,,,,,,,,,0.0,,1.0,3685.905,36405.0,40248.0,0.0,36405.0,12.0,-704.0,365243.0,-673.0,-373.0,-343.0,-366.0,18.0,0.0,0.0,253.0,12.0,12.0,6.5,-17.5,0.0,0.0,11.0,3685.905,3685.905,-532.0,-523.0,6.0,1.0,0.0,,,,,,,,,,,,,,,,,,,,,8354725830.0,184537170765.0,165708139536.0,52018610905.935,,,,,,,17826.010500002303,17888.271199999108,17339.329199998007,11306.584800000091,11244.391100000095,11191.78800000006,128539.0,663436.0,,,,13539747.671232468,-602491629.0,-922737331.0,-296781995.0,-1536618164.0416667,44063.0,30735.0,11359.773999999192,11235.719999998986,10719.75899999729,22911.164600009783,22832.925200009748,22217.79340000831,67542.39800835506,158181.87803119593,,35035.458500028,34975.576300028435,34421.01040002885,,,,3717499.0,8303.863900000164,8408.503300000071,8131.968400000232,,,,16483.519499999722,16668.923399999698,16265.6040999997,,,,3917.300300000123,3900.536400000162,3733.20340000016,436870.0,431663.0,,6430.676173002897,632540.0,626088.0,,16347.846599999802,154331.87139999072,154334.6129999903,154226.33589998726,,,,,,,,,,,,,,,,,,,,,,,,,,,,,,271309093.3349998,3869731106.550003,4352258704.770002,62756580.01499996,3869731106.550003,280007.0,-19290427.0,4473830748.0,198000967.0,1004741316.0,433959872.0,1052184062.0,277929.0,4358.0,781.0496267915729,6408250.0,2284059.0,1408971.5,-4623392.0,1458505.0,102877.0,3049108893.0451174,3080921888.925081,-184512739.0,-182978033.0,3213575.0,153023.0,,,,,,,,,,,,,,,,,,,,,1468847.0,14835172.0,3235528.0,8563634.0,11618568.0,1417207.0,,,,,,,,,,,,,,,,,,,,,,,,,,,,,,,,,,4277192.5,2481758.5,-9012109.5,921269.0,37582.5,3737296125.76496,3661973177.894961,-260874057.5,-257559005.0,2528726.5,269470.0,3929955290.122453,33283476823.59092,36714958776.38265,1731442224.082549,48130694591.37821,3991958.5,-247808983.5,103184825643.0,1055747556.0,17288099435.0,3506845930.0,18901574872.5,3675457.5,72004.0,20888.597325304112,89849968.5,-81.97285481903212,4.65024,2.6737967914438503,72.05332942641564,12.433796791443848,335.06527463189514,37500.0,0.6234898018587336,0.7818314824680298,0.0,0.0,0.0,0.0,0.0,0.0,1.0,0.0,0.0,0.0,0.0,0.0,0.0,1.0,0.0,1.0,0.0,0.0,0.0,0.0,1.0,0.0,0.0,0.0,0.0,1.0,0.0,0.0,0.0,0.0,0.0,0.0,0.0,1.0,0.0,0.0,0.0,0.0,0.0,0.0,0.0,0.0,0.0,0.0,0.0,0.0,0.0,0.0,0.0,0.0,0.0,0.0,0.0,0.0,0.0,0.0,0.0,0.0,0.0,0.0,0.0,0.0,0.0,0.0,0.0,0.0,0.0,0.0,0.0,0.0,0.0,0.0,0.0,0.0,0.0,0.0,0.0,0.0,0.0,0.0,0.0,1.0,0.0,0.0,0.0,0.0,0.0,0.0,0.0,0.0,0.0,0.0,0.0,0.0,0.0,0.0,0.0,0.0,0.0,0.0,0.0,0.0,0.0,0.0,0.0,0.0,0.0,0.0,0.0,0.0,1.0,0.0,0.0,0.0,0.0,0.0,0.0,0.0,1.0,0.0
104652,0,0.0,0.0,1.0,1.0,0.0,225000.0,1723500.0,53626.5,1723500.0,0.028663,37.33150684931507,-5745.0,-748.0,-3291.0,4.0,2.0,2.0,2.0,13.0,0.3750935915961677,0.4534335347007456,0.5656079814115492,0.0835,0.1382,0.9901,,,0.12,0.069,0.5,0.4167,0.1085,0.0639,0.1265,0.0193,0.0721,0.0851,0.1434,0.9901,,,0.1208,0.069,0.5,0.4167,0.111,0.0698,0.1318,0.0195,0.0764,0.0843,0.1382,0.9901,,,0.12,0.069,0.5,0.4167,0.1104,0.065,0.1287,0.0194,0.0736,0.1322,1.0,1.0,0.0,1.0,0.0,-193.0,0.0,0.0,0.0,0.0,0.0,1.0,1.0,1.0,0.0,1.0,0.0,0.0,0.0,0.0,0.0,0.0,0.0,0.0,0.0,1.0,0.0,0.0,0.0,0.0,0.0,0.0,0.0,0.0,0.0,0.0,0.0,0.0,0.0,0.0,0.0,0.0,0.0,0.0,10.0,0.0,48271.14,223143.75,0.0,0.0,0.0,0.0,0.0,-1137.5,-744.0,-268.0,-988.0,412.0,-22.0,8.0,11958.435,81209.25,70690.5,12291.75,96610.5,10.0,-1356.5,365243.0,-2271.0,-2091.0,-2001.0,-2082.0,13.0,0.0,0.1942104914511944,23.5,36.0,7.0,4.0,-74.0,0.0,0.0,31.0,10356.57,10356.57,-2301.0,-2228.0,4.0,1.0,0.0,,,,,,,,,,,,,,,,,,,,,8354779456.5,184538894265.0,165709863036.0,52018835905.935,1863.0,1706.0,71125.0,70929.0,9141.0,506542.0,17826.094000002304,17888.35549999911,17339.414299998007,11306.723000000093,11244.529300000091,11191.93140000006,128539.0,663438.0,,,,13539785.002739318,-602497374.0,-922740622.0,-296782188.0,-1536618912.0416667,44063.0,30735.0,11359.893999999193,11235.839999998989,10719.87979999729,22911.233600009786,22832.994200009747,22217.86240000831,67542.77310194666,158182.33146473064,126223.83474073654,35035.958500028,34976.076300028435,34421.51040002885,22974.6566999959,22947.691899995472,22594.455999995705,3717512.0,8303.972400000164,8408.61370000007,8132.07940000023,9826.778700000716,9941.803000002155,10301.927199999638,16483.64599999972,16669.0520999997,16265.735899999698,829.1846000001768,814.3617000000462,760.2810000000135,3917.372400000123,3900.6100000001616,3733.27980000016,436871.0,431664.0,1264323.0,6430.704836002897,632542.0,626090.0,,16347.978799999804,154332.86149999071,154335.6030999903,154227.32599998722,,,,38.0,77305400.37,26854434.80999999,7682141264.489994,2558891101.365001,88099746.11999996,784524.5999999999,141.0,17087.0,-25102494.5,11153391.0,-13008983.0,-14166981.0,-18.5,0.0,48271.14,221287.5,0.0,0.0,0.0,0.0,0.0,-1476.0,-1325.0,-572.0,-1325.0,271490845.2299998,3871561491.900003,4354043978.520002,62819117.86499996,3871498176.900003,280181.0,-19311074.0,4478944150.0,197985910.0,1006189033.0,433949255.0,1053631847.0,278170.0,4360.0,782.0860672250245,6484097.5,2286151.0,1410107.0,-4628916.0,1458505.0,102877.0,3050967388.680123,3082768826.3100863,-184665971.0,-183128894.0,3214568.0,153178.0,,,,,,,,,,,,,,,,,,,,,1468857.0,14835584.0,3235528.0,8563670.0,11618599.0,1417215.0,1060755500.7945012,802154403.6524951,72175213562.60216,21696443155.237617,583159188.8069987,5792665.7475,689.5,94245.0,-277186187.5,22007516.0,-123894734.0,-218904984.0,-2023472.5,,,,,,,,,,,,,,,,,,,,,4277199.5,2481762.5,-9012183.5,921269.0,37582.5,3737306482.334961,3661983534.464961,-260876358.5,-257561233.0,2528730.5,269471.0,3929967248.557453,33283558032.84092,36715029466.88265,1731454515.832549,48130791201.87821,3991968.5,-247810340.0,103185190886.0,1055745285.0,17288097344.0,3506843929.0,18901572790.5,3675470.5,72004.0,20888.791535795564,89849992.0,-153.8914575077059,7.66,4.195686833934714,156.63131177861487,32.13896114793992,1199.79584822419,112500.0,-0.2225209339563143,0.9749279121818236,0.0,0.0,0.0,0.0,0.0,0.0,1.0,0.0,1.0,0.0,0.0,0.0,0.0,0.0,0.0,1.0,0.0,0.0,0.0,0.0,1.0,0.0,0.0,0.0,0.0,1.0,0.0,0.0,0.0,0.0,1.0,0.0,0.0,0.0,0.0,0.0,0.0,0.0,0.0,0.0,0.0,0.0,0.0,0.0,0.0,0.0,0.0,0.0,0.0,0.0,0.0,0.0,0.0,0.0,0.0,0.0,0.0,0.0,0.0,0.0,0.0,0.0,0.0,0.0,0.0,0.0,0.0,0.0,0.0,0.0,0.0,0.0,0.0,0.0,0.0,0.0,0.0,0.0,0.0,0.0,0.0,0.0,0.0,0.0,0.0,0.0,0.0,0.0,0.0,0.0,1.0,0.0,0.0,0.0,0.0,0.0,0.0,0.0,0.0,0.0,0.0,0.0,0.0,0.0,0.0,0.0,0.0,0.0,1.0,0.0,1.0,0.0,0.0,0.0,0.0,0.0,0.0,0.0,1.0,0.0
104670,0,0.0,0.0,0.0,0.0,0.0,157500.0,320382.0,15543.0,229500.0,0.018029,55.7945205479452,,-2388.0,-3898.0,,2.0,3.0,3.0,6.0,0.5336569037647515,0.1545195130063744,,,,,,,,,,,,,,,,,,,,,,,,,,,,,,,,,,,,,,,,,,,,,,2.0,1.0,2.0,1.0,-2036.0,,,,,,,1.0,0.0,0.0,1.0,0.0,0.0,0.0,0.0,0.0,0.0,0.0,0.0,0.0,0.0,0.0,0.0,1.0,0.0,0.0,0.0,0.0,0.0,0.0,0.0,0.0,0.0,0.0,0.0,0.0,0.0,0.0,0.0,0.0,,,,,,,,,,,,,0.0,,4.0,14836.1625,95535.0,204412.5,16875.0,112500.0,8.0,-1609.0,365243.0,-1540.0,-1033.5,-928.5,-1021.0,8.0,0.0,0.2013095432238644,110.5,38.0,14.0,8.0,-42.5,0.0,0.0,117.0,6750.0,6750.0,-881.0,-864.0,25.0,0.0,47.0,38873.88,450000.0,0.0,0.0,0.0,368.1,2250.0,9000.0,3891.555,38505.825,39179.79,39179.79,0.0,0.0,0.0,0.5,20.5,-24.0,0.0,0.0,8354794999.5,184539214647.0,165710092536.0,52018993405.935,,,,,,,,,,,,,128539.0,663440.0,,,,13539840.797259863,,-922744520.0,-296784224.0,-1536621300.0416667,44064.0,30736.0,,,,,,,67543.30675885043,158182.48598424366,,,,,,,,3717518.0,,,,,,,,,,,,,,,,436873.0,431666.0,,6430.7228650028965,632545.0,626093.0,,,,,,,,,,,,,,,,,,,,,,,,,,,,,,,,,,,272668357.0124997,3888568115.4150033,4373039851.020002,63393982.37999996,3888607400.4150033,281757.0,-19403571.0,4500304065.5,199005881.5,1010884809.5,436094882.5,1057963693.5,279278.5,4380.0,786.6066437724896,6502011.0,2298240.0,1417025.5,-4655554.0,1458662.0,102881.0,3062412819.720122,3093853461.3900857,-185670881.0,-184125326.0,3228739.0,153854.0,2836426932.359968,7690230000.0,237502337.085,367327112.8949997,11893964.535000002,117570930.2099999,160870362.5249992,403380675.5399993,372408133.50000006,2723136812.145,2825966876.039961,2826105769.3499603,12225.0,32134.0,161.0,19748.0,918469.5,-1627713.0,681083.0,1585.0,1468857.0,14835584.0,3235575.0,8563708.0,11618716.0,1417219.0,,,,,,,,,,,,,,5927117661.989961,18741762000.0,198877107.825,448276957.44749767,1948107.735,256971504.8025008,309324672.8774986,636985467.224998,459450723.77999926,5712128314.200034,5890368525.794997,5890611708.539999,13393.5,80933.5,44.0,70433.5,972227.0,-1700074.5,177364.0,6755.0,4277213.5,2481770.5,-9012226.0,921269.0,37582.5,3737313232.334961,3661990284.464961,-260877239.5,-257562097.0,2528755.5,269471.0,3929982084.719953,33283653567.84092,36715233879.38265,1731471390.832549,48130903701.87821,3991976.5,-247811949.0,103185556129.0,1055743745.0,17288096310.5,3506843000.5,18901571769.5,3675478.5,72004.0,20888.992845338787,89850102.5,,2.0341714285714287,10.13317892298784,565.3758596346503,20.612623045744066,1150.0714200728164,78750.0,-0.2225209339563143,0.9749279121818236,0.0,0.0,0.0,0.0,0.0,0.0,1.0,0.0,0.0,1.0,0.0,0.0,0.0,0.0,0.0,0.0,0.0,0.0,1.0,0.0,1.0,0.0,0.0,0.0,0.0,1.0,0.0,0.0,0.0,0.0,0.0,0.0,0.0,0.0,0.0,0.0,0.0,0.0,0.0,0.0,0.0,0.0,0.0,0.0,0.0,0.0,0.0,0.0,0.0,0.0,0.0,0.0,0.0,0.0,0.0,0.0,0.0,0.0,0.0,0.0,0.0,0.0,0.0,0.0,0.0,0.0,0.0,0.0,0.0,0.0,0.0,0.0,0.0,0.0,0.0,0.0,0.0,0.0,0.0,0.0,0.0,0.0,0.0,0.0,0.0,0.0,0.0,0.0,0.0,0.0,0.0,0.0,0.0,0.0,0.0,0.0,0.0,0.0,0.0,0.0,0.0,0.0,0.0,0.0,0.0,1.0,0.0,0.0,0.0,0.0,0.0,0.0,0.0,0.0,0.0,0.0,0.0,0.0,0.0,0.0
104677,0,0.0,0.0,0.0,0.0,0.0,81000.0,135000.0,13351.5,135000.0,0.018634,62.55068493150685,,-8635.0,-4818.0,,2.0,2.0,2.0,16.0,0.8301692670640529,0.3278688966736389,0.501075160239048,,,,,,,,,,,,,,,,,,,,,,,,,,,,,,,,,,,,,,,,,,,,,0.0,0.0,0.0,0.0,-967.0,0.0,0.0,0.0,0.0,0.0,3.0,1.0,0.0,0.0,1.0,1.0,0.0,0.0,0.0,0.0,0.0,0.0,0.0,0.0,1.0,0.0,0.0,0.0,0.0,0.0,0.0,0.0,0.0,0.0,0.0,0.0,0.0,0.0,0.0,0.0,0.0,0.0,0.0,6.0,5067.0,0.0,67387.5,0.0,0.0,0.0,0.0,0.0,-1054.0,-780.0,-169.5,-1108.0,251.0,-25.0,4.0,8422.1775,22500.0,23242.5,,58500.0,9.0,-495.5,365243.0,-708.5,-468.5,-468.5,-461.5,13.5,1.0,,-1.0,20.0,12.0,4.5,-14.5,0.0,0.0,18.0,7287.615,7287.615,-408.0,-405.0,5.0,1.0,0.0,,,,,,,,,,,,,,,,,,,,,8354808351.0,184539349647.0,165710227536.0,52019074405.935,1863.0,1706.0,71125.0,70929.0,9141.0,506545.0,,,,,,,128539.0,663442.0,,,,13539903.347944794,,-922749338.0,-296785191.0,-1536629935.0416667,44064.0,30736.0,,,,,,,67544.13692811747,158182.81385314034,126224.33581589676,,,,,,,3717534.0,,,,,,,,,,,,,,,,436873.0,431666.0,,6430.7414990028965,632547.0,626095.0,,,,,,,,,35.0,77467562.37,26867357.45999999,7716190138.019994,2568001640.8050013,88637259.37499996,784666.8449999999,142.0,17125.0,-25252196.5,11318280.0,-13086796.5,-14249213.0,-17.0,5067.0,0.0,67500.0,0.0,0.0,0.0,0.0,0.0,-1707.0,-1342.0,-128.0,-1342.0,273091676.2649997,3894950298.9150033,4380263716.770002,,3894950298.9150033,282273.0,-19434136.5,4507606968.5,198982780.5,1011964926.5,436814684.5,1059410146.0,279680.0,4388.5,,6506956.5,2304033.0,1420340.5,-4665803.0,1482506.0,102897.0,3069154574.5276217,3099937219.627593,-185995501.0,-184446500.0,3234934.5,154172.5,,,,,,,,,,,,,,,,,,,,,1468863.0,14835835.0,3235575.0,8563728.0,11618734.0,1417223.0,1060760567.7945012,802154403.6524951,72175280950.10216,21696443155.237617,583159188.8069987,5792665.7475,689.5,94245.0,-277187241.5,22006736.0,-123894903.5,-218906092.0,-2023497.5,,,,,,,,,,,,,,,,,,,,,4277225.5,2481775.0,-9012240.5,921269.0,37582.5,3737320519.94996,3661997572.079961,-260877647.5,-257562502.0,2528760.5,269472.0,3929990506.897453,33283676067.84092,36715257121.88265,,48130962201.87821,3991985.5,-247812444.5,103185921372.0,1055743036.5,17288095842.0,3506842532.0,18901571308.0,3675492.0,72005.0,,89850101.5,,1.6666666666666667,6.066734074823054,379.4783716774936,10.111223458038422,632.4639527958225,40500.0,1.0,0.0,0.0,0.0,0.0,0.0,0.0,0.0,1.0,0.0,0.0,1.0,0.0,0.0,0.0,0.0,0.0,0.0,0.0,0.0,1.0,0.0,1.0,0.0,0.0,0.0,0.0,1.0,0.0,0.0,0.0,0.0,0.0,0.0,0.0,0.0,0.0,0.0,0.0,0.0,0.0,0.0,0.0,0.0,0.0,0.0,0.0,0.0,0.0,0.0,0.0,0.0,0.0,0.0,0.0,0.0,0.0,0.0,0.0,0.0,0.0,0.0,0.0,0.0,0.0,0.0,0.0,0.0,0.0,0.0,0.0,0.0,0.0,0.0,0.0,0.0,0.0,0.0,0.0,0.0,0.0,0.0,0.0,0.0,0.0,0.0,0.0,0.0,0.0,0.0,0.0,0.0,0.0,0.0,0.0,0.0,0.0,0.0,0.0,0.0,0.0,0.0,0.0,0.0,0.0,0.0,0.0,1.0,0.0,0.0,0.0,0.0,0.0,0.0,0.0,0.0,0.0,0.0,0.0,0.0,0.0,0.0
104685,0,0.0,0.0,0.0,1.0,1.0,171000.0,1091677.5,39343.5,846000.0,0.018029,43.93150684931507,-4509.0,-5468.0,-5890.0,,3.0,3.0,3.0,7.0,0.2554546742810104,0.2448518856584354,0.4382813743111921,,,,,,,,,,,,,,,,,,,,,,,,,,,,,,,,,,,,,,,,,,,,,0.0,0.0,0.0,0.0,-261.0,0.0,0.0,0.0,0.0,1.0,5.0,1.0,1.0,0.0,1.0,0.0,0.0,0.0,0.0,0.0,0.0,0.0,0.0,0.0,1.0,0.0,0.0,0.0,0.0,0.0,0.0,0.0,0.0,0.0,0.0,0.0,0.0,0.0,0.0,0.0,0.0,0.0,0.0,7.0,0.0,0.0,69489.0,0.0,0.0,0.0,0.0,0.0,-656.0,-562.0,-290.0,-944.5,215.0,-19.0,8.0,11602.53,67500.0,82890.0,10372.5,90720.0,6.0,-261.0,365243.0,-801.0,-651.0,-651.0,-648.0,7.0,0.0,0.1039699542536568,-1.0,26.0,10.0,5.0,-26.5,0.0,0.0,24.0,17472.24,17472.24,-779.5,-756.0,4.5,1.0,0.0,,,,,,,,,,,,,,,,,,,,,8354847694.5,184540441324.5,165711073536.0,52019245405.935,1863.0,1706.0,71125.0,70930.0,9141.0,506550.0,,,,,,,128540.0,663445.0,,,,13539947.279451646,-602501883.0,-922755228.0,-296785452.0,-1536635403.0416667,44064.0,30736.0,,,,,,,67544.39238279176,158183.058705026,126224.77409727107,,,,,,,3717541.0,,,,,,,,,,,,,,,,436873.0,431666.0,,6430.759528002895,632550.0,626098.0,,,,,,,,,22.0,77586455.88000001,26867357.45999999,7719511258.304994,2568768463.3050013,88637259.37499996,784666.8449999999,142.0,17125.0,-25286761.0,11298531.0,-13108486.0,-14267382.5,-10.5,0.0,0.0,41545.575,0.0,0.0,0.0,0.0,0.0,-1385.0,-1170.0,-828.0,-1055.0,273575425.7249996,3903329825.4150033,4389422161.770002,63589381.37999996,3903329825.4150033,282957.0,-19470988.5,4517650898.0,199317441.0,1014499306.0,437165353.0,1061944726.0,280149.0,4404.0,789.0306696071382,6509778.5,2311025.0,1425232.5,-4674907.5,1482506.0,102897.0,3076016364.855122,3106797874.155093,-186241684.5,-184689898.5,3237059.0,154503.5,,,,,,,,,,,,,,,,,,,,,1468870.0,14836050.0,3235575.0,8563754.0,11618758.0,1417231.0,1060760567.7945012,802154403.6524951,72175350439.10216,21696443155.237617,583159188.8069987,5792665.7475,689.5,94245.0,-277187897.5,22006174.0,-123895193.5,-218907036.5,-2023516.5,,,,,,,,,,,,,,,,,,,,,4277235.5,2481780.0,-9012267.0,921269.0,37582.5,3737337992.18996,3662015044.319961,-260878427.0,-257563258.0,2528765.0,269473.0,3930002109.427453,33283743567.84092,36715340011.88265,1731481763.332549,48131052921.87821,3991991.5,-247812705.5,103186286615.0,1055742235.5,17288095191.0,3506841881.0,18901570660.0,3675499.0,72005.0,20889.09681529304,89850100.5,-102.63704396632366,6.384078947368421,4.346334210225323,190.94101112592617,27.74734072972664,1218.9824893182647,57000.0,-0.9009688679024191,0.4338837391175582,0.0,0.0,0.0,0.0,0.0,1.0,0.0,0.0,0.0,0.0,1.0,0.0,0.0,0.0,0.0,0.0,0.0,0.0,1.0,1.0,0.0,0.0,0.0,0.0,0.0,1.0,0.0,0.0,0.0,0.0,0.0,0.0,0.0,0.0,0.0,0.0,0.0,0.0,0.0,0.0,0.0,1.0,0.0,0.0,0.0,0.0,0.0,0.0,0.0,0.0,0.0,0.0,0.0,0.0,0.0,0.0,0.0,0.0,0.0,0.0,0.0,0.0,0.0,0.0,0.0,0.0,0.0,0.0,0.0,0.0,0.0,0.0,0.0,0.0,0.0,0.0,1.0,0.0,0.0,0.0,0.0,0.0,0.0,0.0,0.0,0.0,0.0,0.0,0.0,0.0,0.0,0.0,0.0,0.0,0.0,0.0,0.0,0.0,0.0,0.0,0.0,0.0,0.0,0.0,0.0,0.0,0.0,0.0,0.0,0.0,0.0,0.0,0.0,0.0,0.0,0.0,0.0,0.0,0.0,0.0
104691,0,0.0,0.0,0.0,1.0,1.0,99000.0,250614.0,18868.5,202500.0,0.00702,39.96986301369864,-3016.0,-3459.0,-4487.0,,3.0,2.0,2.0,10.0,0.3790239487242209,0.7224590791109837,0.4812493411434029,,,,,,,,,,,,,,,,,,,,,,,,,,,,,,,,,,,,,,,,,,,,,4.0,1.0,4.0,0.0,-2606.0,0.0,0.0,0.0,0.0,0.0,0.0,1.0,1.0,0.0,1.0,0.0,0.0,0.0,0.0,0.0,0.0,0.0,0.0,0.0,1.0,0.0,0.0,0.0,0.0,0.0,0.0,0.0,0.0,0.0,0.0,0.0,0.0,0.0,0.0,0.0,0.0,0.0,0.0,7.0,0.0,0.0,44820.0,0.0,0.0,0.0,0.0,0.0,-2209.0,-1673.0,-1580.0,-1766.0,477.0,-34.0,3.0,7353.045,135369.0,135369.0,0.0,135369.0,24.0,-936.0,365243.0,-902.0,-212.0,-212.0,-206.0,15.0,0.0,0.0,50.0,78.0,24.0,11.0,-41.0,0.0,0.0,77.0,10160.685,7353.045,-1626.0,-1616.0,12.0,1.0,0.0,,,,,,,,,,,,,,,,,,,,,8354866563.0,184540691938.5,165711276036.0,52019344405.935,1863.0,1706.0,71125.0,70930.0,9141.0,506550.0,,,,,,,128541.0,663448.0,,,,13539987.24931466,-602504899.0,-922759715.0,-296788058.0,-1536638862.0416667,44065.0,30736.0,,,,,,,67544.77140674049,158183.7811641051,126225.25534661223,,,,,,,3717551.0,,,,,,,,,,,,,,,,436877.0,431670.0,,6430.766548002895,632552.0,626100.0,,,,,,,,,73.0,77602344.885,26875480.27499999,7725199186.304994,2571492092.8050013,89163047.38499996,784675.8449999999,142.0,17162.0,-25320040.0,11352298.5,-13121307.0,-14283752.0,-36.0,0.0,0.0,44820.0,0.0,0.0,0.0,0.0,0.0,-2420.0,-1766.0,-1737.0,-1766.0,273901958.4599996,3907483892.4150033,4393939747.770002,63731675.87999996,3907483892.4150033,283303.0,-19515521.0,4524953290.0,200017744.0,1016302191.0,438241151.0,1063749105.0,280488.0,4413.0,790.717781605327,6527397.0,2315846.0,1427969.0,-4686332.5,1482603.0,102916.0,3081396551.175145,3111621864.0301075,-186895669.0,-185340665.0,3249732.0,154777.0,,,,,,,,,,,,,,,,,,,,,1468877.0,14836527.0,3235575.0,8563832.0,11618835.0,1417234.0,1060760567.7945012,802154403.6524951,72175395259.10216,21696443155.237617,583159188.8069987,5792665.7475,689.5,94245.0,-277190106.5,22004501.0,-123896773.5,-218908802.5,-2023550.5,,,,,,,,,,,,,,,,,,,,,4277259.5,2481791.0,-9012308.0,921269.0,37582.5,3737348152.87496,3662022397.364961,-260880053.0,-257564874.0,2528777.0,269474.0,3930009462.472453,33283878936.84092,36715475380.88265,1731481763.332549,48131188290.87821,3992015.5,-247813641.5,103186651858.0,1055741333.5,17288094979.0,3506841669.0,18901570454.0,3675514.0,72005.0,20889.09681529304,89850150.5,-75.45685105216259,2.5314545454545456,5.246839971380873,209.71547491089197,13.282136894824708,530.885192215336,33000.0,-0.2225209339563143,0.9749279121818236,0.0,0.0,0.0,0.0,0.0,0.0,1.0,0.0,0.0,0.0,0.0,0.0,0.0,1.0,0.0,0.0,0.0,0.0,1.0,0.0,1.0,0.0,0.0,0.0,0.0,1.0,0.0,0.0,0.0,0.0,0.0,0.0,0.0,0.0,0.0,0.0,0.0,0.0,0.0,0.0,0.0,0.0,0.0,0.0,1.0,0.0,0.0,0.0,0.0,0.0,0.0,0.0,0.0,0.0,0.0,0.0,0.0,0.0,0.0,0.0,0.0,0.0,0.0,0.0,0.0,0.0,0.0,0.0,0.0,0.0,0.0,0.0,0.0,0.0,0.0,0.0,0.0,0.0,0.0,0.0,0.0,0.0,0.0,0.0,0.0,0.0,0.0,0.0,0.0,0.0,0.0,0.0,0.0,0.0,0.0,0.0,0.0,0.0,0.0,1.0,0.0,0.0,0.0,0.0,0.0,0.0,0.0,0.0,0.0,0.0,0.0,0.0,0.0,0.0,0.0,0.0,0.0,0.0,0.0,0.0
104696,0,0.0,1.0,0.0,1.0,0.0,90000.0,599778.0,30753.0,477000.0,0.0196889999999999,61.18082191780822,,-8113.0,-4659.0,,2.0,2.0,2.0,12.0,,0.5872374337205918,,0.0124,0.0,0.9752,0.66,0.0018,0.0,0.069,0.0417,0.0833,0.0055,0.0101,0.0057,0.0,0.0126,0.0126,0.0,0.9752,0.6733,0.0018,0.0,0.069,0.0417,0.0833,0.0056,0.011,0.0059,0.0,0.0134,0.0125,0.0,0.9752,0.6645,0.0018,0.0,0.069,0.0417,0.0833,0.0056,0.0103,0.0058,0.0,0.0129,0.0072,1.0,0.0,0.0,0.0,0.0,0.0,,,,,,,1.0,0.0,0.0,1.0,0.0,0.0,0.0,0.0,0.0,0.0,0.0,0.0,0.0,0.0,0.0,0.0,1.0,0.0,0.0,0.0,0.0,0.0,0.0,0.0,0.0,0.0,0.0,0.0,0.0,0.0,0.0,0.0,0.0,,,,,,,,,,,,,0.0,,1.0,13872.735,127710.0,128214.0,12771.0,127710.0,14.0,-2347.0,365243.0,-2316.0,-1926.0,-1926.0,-1923.0,10.0,0.0,0.0986543249281838,3500.0,15.0,14.0,7.0,-70.0,0.0,0.0,15.0,13872.735,13872.735,-2143.0,-2106.0,8.0,1.0,0.0,,,,,,,,,,,,,,,,,,,,,8354897316.0,184541291716.5,165711753036.0,52019434405.935,,,,,,,17826.106400002303,17888.367999999107,17339.426899998,11306.723000000093,11244.529300000091,11191.93140000006,128541.0,663450.0,4142.063400000115,4139.760300000013,3950.330700000093,13540048.430136578,,-922764374.0,-296788058.0,-1536646975.0416667,44065.0,30736.0,11359.893999999193,11235.839999998989,10719.87979999729,22911.302600009785,22833.063200009747,22217.93140000831,,158184.36840153884,,35036.000200028,34976.11800002844,34421.55210002885,22974.73999999589,22947.775199995467,22594.539299995704,3717563.0,8303.977900000164,8408.619300000071,8132.085000000232,9826.788800000715,9941.813300002155,10301.93819999964,16483.651699999722,16669.057899999698,16265.741799999698,829.1846000001768,814.3617000000462,760.2810000000135,3917.385000000124,3900.6229000001617,3733.29320000016,436877.0,431670.0,,6430.786237002895,632554.0,626102.0,,16347.985999999804,154333.8366999907,154336.57829999027,154228.3011999872,77681.81759999637,78019.9236000066,78421.76800000657,,,,,,,,,,,,,,,,,,,,,,,,,,,273976223.35499966,3908184730.785002,4394897086.770002,63760835.24999996,3908184730.785002,283427.0,-19529930.0,4528236577.0,200368950.0,1017388852.0,438964907.0,1065202675.0,280630.0,4414.0,791.3404377068273,6535027.0,2317609.0,1428854.0,-4690388.0,1482616.0,102916.0,3083629370.445152,3113852269.8601136,-187209224.0,-185650864.0,3259365.0,154888.0,,,,,,,,,,,,,,,,,,,,,1468877.0,14836527.0,3235575.0,8563847.0,11618850.0,1417235.0,,,,,,,,,,,,,,,,,,,,,,,,,,,,,,,,,,4277273.5,2481798.0,-9012378.0,921269.0,37582.5,3737362025.60996,3662036270.099961,-260882196.0,-257566980.0,2528785.0,269475.0,3930023335.207453,33284006646.84092,36715603594.88265,1731494534.332549,48131316000.87821,3992029.5,-247815988.5,103187017101.0,1055739017.5,17288093053.0,3506839743.0,18901568531.0,3675524.0,72005.0,20889.195469617967,89853650.5,,6.6642,2.9265437518290898,179.04835211532986,19.503072870939423,1193.2140281669813,45000.0,-0.9009688679024191,-0.433883739117558,0.0,0.0,0.0,0.0,0.0,1.0,0.0,0.0,0.0,1.0,0.0,0.0,0.0,0.0,0.0,0.0,0.0,0.0,1.0,0.0,1.0,0.0,0.0,0.0,0.0,1.0,0.0,0.0,0.0,0.0,0.0,0.0,0.0,0.0,0.0,0.0,0.0,0.0,0.0,0.0,0.0,0.0,0.0,0.0,0.0,0.0,0.0,0.0,0.0,0.0,0.0,0.0,0.0,0.0,0.0,0.0,0.0,0.0,0.0,0.0,0.0,0.0,0.0,0.0,0.0,0.0,0.0,0.0,0.0,0.0,0.0,0.0,0.0,0.0,0.0,0.0,0.0,0.0,0.0,0.0,0.0,0.0,0.0,0.0,0.0,0.0,0.0,0.0,0.0,0.0,0.0,0.0,0.0,0.0,0.0,0.0,0.0,0.0,0.0,0.0,0.0,0.0,0.0,0.0,0.0,1.0,0.0,0.0,1.0,0.0,1.0,0.0,0.0,0.0,0.0,0.0,0.0,0.0,1.0,0.0
104699,0,0.0,0.0,0.0,1.0,0.0,117000.0,260640.0,26838.0,225000.0,0.0196889999999999,67.33698630136986,,-8565.0,-4794.0,,2.0,2.0,2.0,10.0,,0.7606596987136782,0.5867400085415683,0.0361,0.0041,0.9737,0.6396,0.0535,0.0,0.069,0.1667,0.2083,0.0289,0.0261,0.0274,0.0154,0.0301,0.0368,0.0042,0.9737,0.6537,0.054,0.0,0.069,0.1667,0.2083,0.0296,0.0285,0.0285,0.0156,0.0318,0.0364,0.0041,0.9737,0.6444,0.0539,0.0,0.069,0.1667,0.2083,0.0295,0.0265,0.0279,0.0155,0.0307,0.0293,1.0,0.0,0.0,0.0,0.0,-1968.0,0.0,0.0,0.0,0.0,0.0,6.0,1.0,0.0,0.0,1.0,0.0,0.0,0.0,0.0,0.0,0.0,0.0,0.0,0.0,1.0,0.0,0.0,0.0,0.0,0.0,0.0,0.0,0.0,0.0,0.0,0.0,0.0,0.0,0.0,0.0,0.0,0.0,0.0,2.0,6835.5,,115110.0,19496.25,0.0,0.0,0.0,0.0,-280.5,23.0,-21.0,,20.0,-4.5,6.0,12542.85,110250.0,136705.5,0.0,110250.0,15.0,-1580.0,365243.0,-1550.0,-1070.0,-1040.0,-1052.0,10.0,1.0,0.0,0.0,140.0,24.0,9.0,-45.0,0.0,0.0,145.0,13000.5,11954.7,-1329.0,-1321.0,10.0,1.0,0.0,,,,,,,,,,,,,,,,,,,,,8354924154.0,184541552356.5,165711978036.0,52019551405.935,1863.0,1706.0,71125.0,70930.0,9141.0,506556.0,17826.142500002305,17888.404399999108,17339.463699998007,11306.727100000093,11244.533400000091,11191.93560000006,128541.0,663452.0,4142.116900000115,4139.8142000000125,3950.384700000093,13540115.76712288,,-922769168.0,-296790026.0,-1536655540.0416667,44065.0,30736.0,11359.893999999193,11235.839999998989,10719.87979999729,22911.371600009785,22833.132200009743,22218.00040000831,,158185.12906123756,126225.84208662076,35036.166900027994,34976.28470002844,34421.718800028844,22974.948299995893,22947.98349999547,22594.747599995702,3717573.0,8304.006800000163,8408.648800000072,8132.114600000232,9826.814900000716,9941.839800002155,10301.96669999964,16483.679099999717,16669.0857999997,16265.770299999696,829.2000000001768,814.3772000000463,760.2966000000133,3917.4151000001234,3900.6536000001615,3733.32500000016,436877.0,431670.0,,6430.805926002896,632556.0,626104.0,,16348.015299999804,154334.8103999907,154337.55199999028,154229.2748999872,77682.45719999635,78020.5680000066,78422.42170000657,10.0,77674688.37,,7730293966.604994,2572562872.3050013,89167097.38499996,784675.8449999999,143.0,17162.0,-25364234.0,11345285.5,-13144660.5,,-4.5,6835.5,,115110.0,19496.25,0.0,0.0,0.0,0.0,-280.5,23.0,-21.0,,274071342.50999963,3909523345.785002,4396295164.770002,63760835.24999996,3909523345.785002,283527.0,-19538546.5,4530610156.5,200361718.5,1018845294.5,439691377.5,1066659136.0,280790.5,4417.5,791.3404377068273,6536354.0,2319356.0,1429786.5,-4694695.5,1482625.0,102925.0,3085687389.735146,3115777441.8601108,-187338721.0,-185778405.0,3260781.0,155022.0,,,,,,,,,,,,,,,,,,,,,1468879.0,14836547.0,3235575.0,8563987.0,11618995.0,1417241.0,1060767403.2945012,,72175510369.10216,21696462651.487617,583159188.8069987,5792665.7475,689.5,94245.0,-277190387.0,22004524.0,-123896794.5,,-2023555.0,,,,,,,,,,,,,,,,,,,,,4277297.5,2481807.0,-9012423.0,921269.0,37582.5,3737375026.10996,3662048224.799961,-260883525.0,-257568301.0,2528795.0,269476.0,3930035878.057453,33284116896.84092,36715740300.38265,1731494534.332549,48131426250.87821,3992044.5,-247817568.5,103187382344.0,1055737467.5,17288091983.0,3506838703.0,18901567479.0,3675534.0,72006.0,20889.195469617967,89853650.5,,2.2276923076923083,4.359490274983233,293.55493692750105,9.711602951039572,653.9500748784948,58500.0,0.6234898018587336,0.7818314824680298,0.0,1.0,0.0,0.0,0.0,0.0,0.0,0.0,0.0,1.0,0.0,0.0,0.0,0.0,0.0,0.0,0.0,0.0,1.0,0.0,1.0,0.0,0.0,0.0,0.0,1.0,0.0,0.0,0.0,0.0,0.0,0.0,0.0,0.0,0.0,0.0,0.0,0.0,0.0,0.0,0.0,0.0,0.0,0.0,0.0,0.0,0.0,0.0,0.0,0.0,0.0,0.0,0.0,0.0,0.0,0.0,0.0,0.0,0.0,0.0,0.0,0.0,0.0,0.0,0.0,0.0,0.0,0.0,0.0,0.0,0.0,0.0,0.0,0.0,0.0,0.0,0.0,0.0,0.0,0.0,0.0,0.0,0.0,0.0,0.0,0.0,0.0,0.0,0.0,0.0,0.0,0.0,0.0,0.0,0.0,0.0,0.0,0.0,0.0,0.0,0.0,0.0,0.0,0.0,0.0,1.0,0.0,1.0,0.0,0.0,1.0,0.0,0.0,0.0,0.0,0.0,0.0,0.0,1.0,0.0
104712,0,0.0,0.0,0.0,1.0,1.0,112500.0,126000.0,13230.0,126000.0,0.015221,28.51232876712329,-970.0,-39.0,-3083.0,,2.0,2.0,2.0,16.0,0.2481492088149744,0.5147418271012032,0.3457848024695955,0.0093,,0.9801,,,,0.0345,0.3333,,0.0602,,0.0735,,0.0416,0.0095,,0.9801,,,,0.0345,0.3333,,0.0616,,0.0766,,0.044,0.0094,,0.9801,,,,0.0345,0.3333,,0.0613,,0.0748,,0.0424,0.0593,1.0,1.0,1.0,1.0,1.0,-1237.0,0.0,0.0,0.0,0.0,1.0,1.0,1.0,1.0,0.0,1.0,0.0,0.0,0.0,0.0,0.0,0.0,0.0,0.0,0.0,1.0,0.0,0.0,0.0,0.0,0.0,0.0,0.0,0.0,0.0,0.0,0.0,0.0,0.0,0.0,0.0,0.0,0.0,0.0,1.0,,,67500.0,60790.5,0.0,0.0,0.0,0.0,-288.0,855.0,-135.0,,10.0,-4.5,2.0,7381.934999999998,58365.0,69385.5,5355.0,58365.0,13.0,-942.0,365243.0,-909.0,-729.0,-549.0,-722.5,14.5,0.5,0.2065696815138958,12.0,16.0,18.0,10.5,-15.5,0.0,0.0,15.0,10760.22,10760.22,-465.0,-437.0,7.0,2.0,0.0,,,,,,,,,,,,,,,,,,,,,8354937384.0,184541678356.5,165712104036.0,52019663905.935,1863.0,1706.0,71125.0,70931.0,9141.0,506557.0,17826.151800002306,17888.413799999107,17339.473199998007,,,,128542.0,663454.0,,,,13540144.279451646,-602505869.0,-922772251.0,-296791263.0,-1536655579.0416667,44066.0,30737.0,,,,22911.406100009783,22833.166700009748,22218.03490000831,67545.0195559493,158185.64380306465,126226.18787142324,35036.500200028,34976.61800002844,34422.05210002885,,,,3717589.0,8304.067000000163,8408.710100000071,8132.176200000232,,,,16483.75259999972,16669.160599999694,16265.8468999997,,,,3917.4567000001234,3900.696000000162,3733.36900000016,436878.0,431671.0,,6430.821147002896,632558.0,626106.0,,16348.074599999803,154335.7904999907,154338.53209999026,154230.2549999872,,,,10.0,,,7738130834.864994,2575264001.355001,89167097.38499996,784675.8449999999,143.0,17162.0,-25406134.0,11325833.0,-13168370.0,,-4.5,,,67500.0,60790.5,0.0,0.0,0.0,0.0,-288.0,855.0,-135.0,,274587544.79999954,3916850389.4250026,4404739360.410003,63925593.74999996,3916850389.4250026,284135.0,-19573669.5,4542297659.5,201792442.5,1022842541.5,440407987.5,1070656541.0,281380.5,4427.5,793.3814680994369,6545606.5,2328351.0,1435270.0,-4707347.5,1482625.0,102925.0,3093340509.675137,3123688405.860105,-187855942.0,-186290979.0,3270638.0,155468.0,,,,,,,,,,,,,,,,,,,,,1468880.0,14836557.0,3235575.0,8564003.0,11619010.0,1417243.0,,,72175577869.10216,21696523441.987617,583159188.8069987,5792665.7475,689.5,94245.0,-277190675.0,22005379.0,-123896929.5,,-2023559.5,,,,,,,,,,,,,,,,,,,,,4277315.5,2481817.5,-9012438.5,921269.0,37582.5,3737385786.32996,3662058985.01996,-260883990.0,-257568738.0,2528802.0,269478.0,3930043259.992453,33284175261.84092,36715809685.88265,1731499889.332549,48131484615.87821,3992057.5,-247818510.5,103187747587.0,1055736558.5,17288091254.0,3506838154.0,18901566756.5,3675548.5,72006.5,20889.402039299486,89853662.5,-34.0203709041991,1.12,8.503401360544219,242.4517752306401,9.523809523809524,271.545988258317,56250.0,-0.9009688679024191,-0.433883739117558,0.0,0.0,0.0,0.0,0.0,0.0,1.0,0.0,0.0,0.0,0.0,0.0,0.0,1.0,0.0,0.0,0.0,0.0,1.0,0.0,0.0,0.0,1.0,0.0,0.0,0.0,0.0,0.0,0.0,1.0,0.0,0.0,0.0,0.0,0.0,0.0,0.0,0.0,0.0,0.0,0.0,0.0,0.0,0.0,1.0,0.0,0.0,0.0,0.0,0.0,0.0,0.0,0.0,1.0,0.0,0.0,0.0,0.0,0.0,0.0,0.0,0.0,0.0,0.0,0.0,0.0,0.0,0.0,0.0,0.0,0.0,0.0,0.0,0.0,0.0,0.0,0.0,0.0,0.0,0.0,0.0,0.0,0.0,0.0,0.0,0.0,0.0,0.0,0.0,0.0,0.0,0.0,0.0,0.0,0.0,0.0,0.0,0.0,0.0,0.0,0.0,0.0,0.0,0.0,0.0,0.0,0.0,0.0,0.0,0.0,1.0,0.0,0.0,0.0,0.0,0.0,0.0,0.0,1.0,0.0
104714,0,0.0,0.0,0.0,1.0,1.0,36000.0,104256.0,10813.5,90000.0,0.018801,48.909589041095884,-200.0,-2848.0,-1358.0,,3.0,2.0,2.0,12.0,0.4640725629697183,0.5501229373592715,0.5531646987710016,,,,,,,,,,,,,,,,,,,,,,,,,,,,,,,,,,,,,,,,,,,,,0.0,0.0,0.0,0.0,-2449.0,0.0,0.0,0.0,0.0,0.0,3.0,1.0,1.0,1.0,1.0,1.0,0.0,0.0,0.0,0.0,0.0,0.0,0.0,0.0,1.0,0.0,0.0,0.0,0.0,0.0,0.0,0.0,0.0,0.0,0.0,0.0,0.0,0.0,0.0,0.0,0.0,0.0,0.0,2.0,10224.0,0.0,73407.15,13835.25,0.0,0.0,0.0,0.0,-508.5,-172.5,-215.0,-413.0,34.0,-8.0,6.0,8743.3875,94738.5,107556.75,0.0,94738.5,11.0,-828.5,365243.0,-797.5,-497.5,-497.5,-493.0,10.5,0.5,0.0,185.0,71.0,12.0,7.0,-32.0,0.0,0.0,77.0,8246.79,8246.79,-1497.0,-1489.0,8.0,1.0,12.0,0.0,202500.0,,0.0,,,0.0,,0.0,0.0,0.0,0.0,,0.0,,,0.0,-7.5,0.0,0.0,8354948197.5,184541782612.5,165712194036.0,52019699905.935,1863.0,1706.0,71125.0,70931.0,9141.0,506560.0,,,,,,,128543.0,663457.0,,,,13540193.189040689,-602506069.0,-922773609.0,-296793712.0,-1536658427.0416667,44066.0,30737.0,,,,,,,67545.48362851227,158186.19392600204,126226.741036122,,,,,,,3717601.0,,,,,,,,,,,,,,,,436878.0,431671.0,,6430.839948002896,632560.0,626108.0,,,,,,,,,17.0,77713357.77000001,26916656.625,7738435716.074994,2575291671.855001,89167097.38499996,784675.8449999999,143.0,17162.0,-25409780.5,11323462.5,-13170328.5,-14334790.0,-8.0,10224.0,0.0,45915.3,0.0,0.0,0.0,0.0,0.0,-717.0,-413.0,-409.0,-413.0,274634531.6849996,3917257117.4250026,4405209407.910003,63927969.74999996,3917257117.4250026,284202.0,-19579999.0,4544123874.5,201789224.0,1022840058.0,440405609.0,1070654077.5,281439.0,4430.5,793.4903771903461,6546403.5,2329082.0,1435719.0,-4709194.0,1482626.0,102926.0,3093736973.490136,3124055221.6951056,-187912787.0,-186347153.0,3271040.0,155527.0,2873114636.759969,7769216250.0,,371526373.4849996,,,162924132.55499902,,377090979.61499935,2758523151.960001,2862568140.794961,2862707034.10496,,32486.0,,,932911.0,-1650234.5,681092.0,1594.0,1468882.0,14836591.0,3235587.0,8564074.0,11619087.0,1417249.0,1060777627.2945012,802154403.6524951,72175651276.25215,21696537277.237617,583159188.8069987,5792665.7475,689.5,94245.0,-277191183.5,22005206.5,-123897144.5,-218909215.5,-2023567.5,5927117661.989961,18741964500.0,,448276957.44749767,,,309324672.8774986,,459450723.77999926,5712128314.200034,5890368525.794997,5890611708.539999,,80933.5,,,972227.0,-1700082.0,177364.0,6755.0,4277327.5,2481824.5,-9012470.5,921269.0,37582.5,3737394033.11996,3662067231.80996,-260885487.0,-257570227.0,2528810.0,269479.0,3930052003.379953,33284270000.34092,36715917242.63265,1731499889.332549,48131579354.37821,3992068.5,-247819339.0,103188112830.0,1055735761.0,17288090756.5,3506837656.5,18901566263.5,3675559.0,72007.0,20889.402039299486,89853847.5,-4.089177683172752,2.8960000000000004,3.329171868497712,162.82842793540038,9.641281731169371,471.5511273009195,12000.0,-0.2225209339563143,0.9749279121818236,0.0,0.0,0.0,0.0,0.0,0.0,1.0,0.0,1.0,0.0,0.0,0.0,0.0,0.0,0.0,0.0,0.0,0.0,1.0,0.0,1.0,0.0,0.0,0.0,0.0,1.0,0.0,0.0,0.0,0.0,0.0,0.0,0.0,0.0,0.0,0.0,0.0,0.0,0.0,0.0,0.0,1.0,0.0,0.0,0.0,0.0,0.0,0.0,0.0,0.0,0.0,0.0,0.0,0.0,0.0,0.0,0.0,0.0,0.0,0.0,0.0,0.0,0.0,0.0,0.0,0.0,0.0,0.0,0.0,0.0,0.0,0.0,0.0,0.0,0.0,0.0,0.0,0.0,0.0,0.0,0.0,1.0,0.0,0.0,0.0,0.0,0.0,0.0,0.0,0.0,0.0,0.0,0.0,0.0,0.0,0.0,0.0,0.0,0.0,0.0,0.0,0.0,0.0,0.0,0.0,0.0,0.0,0.0,0.0,0.0,0.0,0.0,0.0,0.0,0.0,0.0,0.0,0.0,0.0,0.0
104717,0,0.0,1.0,1.0,0.0,0.0,45000.0,360000.0,18508.5,360000.0,0.018029,60.20821917808219,,-3926.0,-3220.0,16.0,2.0,3.0,3.0,14.0,,0.3996021445133182,0.656158373001177,,,,,,,,,,,,,,,,,,,,,,,,,,,,,,,,,,,,,,,,,,,,,1.0,1.0,1.0,1.0,-872.0,0.0,0.0,0.0,0.0,0.0,0.0,1.0,0.0,0.0,1.0,1.0,0.0,0.0,0.0,0.0,0.0,0.0,0.0,0.0,1.0,0.0,0.0,0.0,0.0,0.0,0.0,0.0,0.0,0.0,0.0,0.0,0.0,0.0,0.0,0.0,0.0,0.0,0.0,1.0,,0.0,99135.0,0.0,0.0,0.0,0.0,0.0,-753.0,-449.0,-446.0,-449.0,25.0,-12.0,2.0,12108.3075,83070.0,84838.5,0.0,83070.0,8.0,-812.5,365243.0,-841.0,-751.0,-691.0,-745.0,6.5,0.0,0.0,367.5,5.0,6.0,4.0,-26.0,0.0,0.0,4.0,12816.09,12816.09,-804.0,-796.0,2.5,1.0,0.0,,,,,,,,,,,,,,,,,,,,,8354966706.0,184542142612.5,165712554036.0,52019744905.935,1863.0,1706.0,71125.0,70931.0,9141.0,506560.0,,,,,,,128543.0,663459.0,,,,13540253.397259863,,-922776829.0,-296794584.0,-1536662353.0416667,44067.0,30738.0,,,,,,,,158186.59352814654,126227.39719449502,,,,,,,3717615.0,,,,,,,,,,,,,,,,436879.0,431672.0,1264339.0,6430.857977002896,632563.0,626111.0,,,,,,,,,25.0,,26916656.625,7739525308.724994,2576207034.855001,89167097.38499996,784675.8449999999,143.0,17162.0,-25411804.0,11381186.0,-13171007.0,-14335239.0,-12.0,,0.0,99135.0,0.0,0.0,0.0,0.0,0.0,-753.0,-449.0,-446.0,-449.0,274702892.1974995,3917883134.9250026,4405855616.910003,63945983.24999996,3917883134.9250026,284253.0,-19585669.5,4546132254.0,202147795.0,1023566246.0,441132097.0,1071380296.0,281542.0,4431.0,793.7008071400763,6547634.0,2329824.0,1436050.0,-4710830.0,1482634.0,102927.0,3095024268.465135,3125276450.5951056,-187982195.5,-186415713.5,3272514.0,155586.0,,,,,,,,,,,,,,,,,,,,,1468883.0,14836616.0,3235587.0,8564079.0,11619091.0,1417251.0,,802154403.6524951,72175750411.25215,21696537277.237617,583159188.8069987,5792665.7475,689.5,94245.0,-277191936.5,22004757.5,-123897590.5,-218909664.5,-2023579.5,,,,,,,,,,,,,,,,,,,,,4277333.5,2481828.5,-9012496.5,921269.0,37582.5,3737406849.20996,3662080047.899961,-260886291.0,-257571023.0,2528812.5,269480.0,3930064111.687453,33284353070.34092,36716002081.13265,1731499889.332549,48131662424.37821,3992076.5,-247820151.5,103188478073.0,1055734920.0,17288090005.5,3506836965.5,18901565518.5,3675565.5,72007.0,20889.402039299486,89854215.0,,8.0,2.431315341599805,146.38516697807486,19.450522732798444,1171.081335824599,22500.0,0.6234898018587336,0.7818314824680298,0.0,0.0,0.0,0.0,0.0,0.0,1.0,0.0,0.0,1.0,0.0,0.0,0.0,0.0,0.0,0.0,0.0,0.0,1.0,0.0,1.0,0.0,0.0,0.0,0.0,1.0,0.0,0.0,0.0,0.0,0.0,0.0,0.0,0.0,0.0,0.0,0.0,0.0,0.0,0.0,0.0,0.0,0.0,0.0,0.0,0.0,0.0,0.0,0.0,0.0,0.0,0.0,0.0,0.0,0.0,0.0,0.0,0.0,0.0,0.0,0.0,0.0,0.0,0.0,0.0,0.0,0.0,0.0,0.0,0.0,0.0,0.0,0.0,0.0,0.0,0.0,0.0,0.0,0.0,0.0,0.0,0.0,0.0,0.0,0.0,0.0,0.0,0.0,0.0,0.0,0.0,0.0,0.0,0.0,0.0,0.0,0.0,0.0,0.0,0.0,0.0,0.0,0.0,0.0,0.0,1.0,0.0,0.0,0.0,0.0,0.0,0.0,0.0,0.0,0.0,0.0,0.0,0.0,0.0,0.0
104718,0,0.0,1.0,1.0,1.0,0.0,279000.0,810000.0,41355.0,810000.0,0.030755,39.37808219178082,-3097.0,-3700.0,-4794.0,65.0,2.0,2.0,2.0,11.0,,0.7974985872630092,0.6690566947824041,,,,,,,,,,,,,,,,,,,,,,,,,,,,,,,,,,,,,,,,,,,,,1.0,1.0,1.0,0.0,-1947.0,0.0,0.0,0.0,0.0,0.0,2.0,1.0,1.0,0.0,1.0,0.0,0.0,0.0,0.0,0.0,1.0,1.0,0.0,0.0,1.0,0.0,0.0,0.0,0.0,0.0,0.0,0.0,0.0,0.0,0.0,0.0,0.0,0.0,0.0,0.0,0.0,0.0,0.0,8.0,0.0,,344151.0,0.0,0.0,0.0,0.0,0.0,-1645.5,-638.5,-86.0,-1363.0,367.0,-24.0,2.0,11837.34,100820.25,99911.25,3375.0,100820.25,10.0,-1283.5,365243.0,-1248.0,-993.0,-978.0,-987.5,20.5,0.0,0.0514174859510375,71.5,22.0,10.0,5.0,-53.5,0.0,0.0,23.0,8830.125,8830.125,-1669.0,-1671.0,6.0,1.0,0.0,,,,,,,,,,,,,,,,,,,,,8355008061.0,184542952612.5,165713364036.0,52020023905.935,1863.0,1706.0,71125.0,70931.0,9141.0,506562.0,,,,,,,128543.0,663461.0,,,,13540292.775342057,-602509166.0,-922781623.0,-296796531.0,-1536666053.0416667,44068.0,30738.0,,,,,,,,158187.39102673382,126228.0662511898,,,,,,,3717626.0,,,,,,,,,,,,,,,,436880.0,431673.0,1264404.0,6430.888732002895,632565.0,626113.0,,,,,,,,,54.5,77713357.77000001,,7740683885.474994,2576360520.1800013,89167097.38499996,784675.8449999999,143.0,17162.0,-25417936.0,11378200.0,-13172154.5,-14339910.0,-26.75,0.0,,238302.0,0.0,0.0,0.0,0.0,0.0,-1652.0,-921.0,-86.0,-1400.0,274724844.86249954,3918066800.1750026,4406037464.160003,63952733.24999996,3918066800.1750026,284273.0,-19588303.0,4546680118.5,202145591.5,1023564432.5,441130298.5,1071378491.0,281576.5,4431.0,793.8036421119783,6547779.5,2329949.0,1436108.0,-4711552.0,1482640.0,102933.0,3095161884.990135,3125378704.275105,-188004521.0,-186437882.0,3272595.0,155600.0,,,,,,,,,,,,,,,,,,,,,1468891.0,14836983.0,3235587.0,8564101.0,11619114.0,1417253.0,1060777627.2945012,,72176094562.25215,21696537277.237617,583159188.8069987,5792665.7475,689.5,94245.0,-277193582.0,22004119.0,-123897676.5,-218911027.5,-2023603.5,,,,,,,,,,,,,,,,,,,,,4277343.5,2481833.5,-9012550.0,921269.0,37582.5,3737415679.33496,3662088878.024961,-260887960.0,-257572694.0,2528818.5,269481.0,3930075949.027453,33284453890.59092,36716101992.38265,1731503264.332549,48131763244.62821,3992086.5,-247821435.0,103188843316.0,1055733672.0,17288089012.5,3506835987.5,18901564531.0,3675586.0,72007.0,20889.453456785435,89854286.5,-78.64781186947751,2.903225806451613,6.7464635473340575,265.6627960707737,19.586507072905327,771.2790853667625,139500.0,-0.9009688679024191,0.4338837391175582,0.0,0.0,0.0,0.0,0.0,0.0,1.0,0.0,1.0,0.0,0.0,0.0,0.0,0.0,0.0,1.0,0.0,0.0,0.0,0.0,1.0,0.0,0.0,0.0,0.0,1.0,0.0,0.0,0.0,0.0,0.0,0.0,0.0,0.0,0.0,0.0,0.0,0.0,0.0,0.0,1.0,0.0,0.0,0.0,0.0,0.0,0.0,0.0,0.0,0.0,0.0,0.0,0.0,1.0,0.0,0.0,0.0,0.0,0.0,0.0,0.0,0.0,0.0,0.0,0.0,0.0,0.0,0.0,0.0,0.0,0.0,0.0,0.0,0.0,0.0,0.0,0.0,0.0,0.0,0.0,0.0,0.0,0.0,0.0,0.0,0.0,0.0,0.0,0.0,0.0,0.0,0.0,0.0,0.0,0.0,0.0,0.0,0.0,0.0,0.0,0.0,0.0,0.0,0.0,0.0,0.0,0.0,0.0,0.0,0.0,0.0,0.0,0.0,0.0,0.0,0.0,0.0,0.0,0.0,0.0
104740,0,0.0,0.0,1.0,1.0,0.0,270000.0,450000.0,23107.5,450000.0,0.026392,31.20821917808219,-866.0,-938.0,-2429.0,4.0,2.0,2.0,2.0,12.0,0.505213522621875,0.6630164026933718,,0.1763,0.0482,0.9826,,,0.04,0.0345,0.3333,,0.0642,,0.0829,,0.0,0.1796,0.0501,0.9826,,,0.0403,0.0345,0.3333,,0.0657,,0.0864,,0.0,0.178,0.0482,0.9826,,,0.04,0.0345,0.3333,,0.0653,,0.0844,,0.0,0.0652,1.0,2.0,0.0,2.0,0.0,-764.0,,,,,,,1.0,1.0,0.0,1.0,0.0,0.0,0.0,0.0,0.0,0.0,0.0,0.0,0.0,1.0,0.0,0.0,0.0,0.0,0.0,0.0,0.0,0.0,0.0,0.0,0.0,0.0,0.0,0.0,0.0,0.0,0.0,0.0,0.0,,,,,,,,,,,,,0.0,,5.0,7414.155,142285.5,158373.0,0.0,142285.5,24.0,-675.0,365243.0,-501.0,182330.0,-201.0,182333.0,16.0,0.0,0.0,1000.0,16.0,10.0,7.5,-9.5,0.0,0.0,15.0,7414.155,7414.155,-266.0,-239.0,4.0,1.0,0.0,,,,,,,,,,,,,,,,,,,,,8355031168.5,184543402612.5,165713814036.0,52020293905.935,,,,,,,17826.328100002305,17888.59179999911,17339.652799998006,11306.775300000092,11244.581600000092,11191.98570000006,128543.0,663463.0,,,,13540323.983561236,-602510032.0,-922784052.0,-296797295.0,-1536666991.0416667,44068.0,30738.0,11359.933999999192,11235.879999998986,10719.92009999729,22911.44060000979,22833.20120000975,22218.06940000832,67545.9888420349,158188.05404313648,,35036.833500028,34976.951300028435,34422.38540002885,,,,3717638.0,8304.131200000164,8408.775400000071,8132.241900000232,,,,16483.83549999972,16669.244999999693,16265.9332999997,,,,3917.4567000001234,3900.696000000162,3733.36900000016,436882.0,431675.0,1264408.0,6430.915124002896,632567.0,626115.0,,16348.139799999804,154336.77309999068,154339.51469999025,154231.23759998722,,,,,,,,,,,,,,,,,,,,,,,,,,,,,,275588120.2049996,3930530362.200002,4419202684.410003,64158666.52499995,3930530362.200002,285293.0,-19653179.0,4566037680.5,202819815.5,1026077645.5,441827409.5,1073526465.5,282508.0,4449.0,797.4559233718549,6575704.0,2338862.0,1441807.5,-4728392.5,1482751.0,102984.0,3106881586.260145,3136757323.2751164,-188494771.0,-186921820.0,3276355.0,156204.0,,,,,,,,,,,,,,,,,,,,,1468891.0,14836983.0,3235587.0,8564117.0,11619129.0,1417258.0,,,,,,,,,,,,,,,,,,,,,,,,,,,,,,,,,,4277353.5,2481841.0,-9012559.5,921269.0,37582.5,3737423093.48996,3662096292.1799607,-260888226.0,-257572933.0,2528822.5,269482.0,3930083363.182453,33284596176.09092,36716260365.38265,1731503264.332549,48131905530.12821,3992110.5,-247822110.0,103189208559.0,1055733171.0,17288271342.5,3506835786.5,18901746864.0,3675602.0,72007.0,20889.453456785435,89855286.5,-27.749100166798357,1.6666666666666667,11.684518013631935,364.6529991596751,19.474196689386567,607.7549985994584,135000.0,-0.2225209339563143,0.9749279121818236,0.0,0.0,0.0,0.0,0.0,0.0,1.0,0.0,0.0,0.0,0.0,0.0,0.0,1.0,0.0,0.0,0.0,0.0,1.0,0.0,1.0,0.0,0.0,0.0,0.0,1.0,0.0,0.0,0.0,0.0,0.0,0.0,0.0,0.0,0.0,0.0,0.0,0.0,0.0,0.0,0.0,0.0,1.0,0.0,0.0,0.0,0.0,0.0,0.0,0.0,0.0,0.0,0.0,0.0,0.0,0.0,0.0,0.0,0.0,0.0,0.0,0.0,0.0,0.0,0.0,0.0,0.0,0.0,0.0,0.0,0.0,0.0,0.0,0.0,0.0,0.0,0.0,0.0,0.0,0.0,0.0,0.0,0.0,0.0,0.0,0.0,0.0,0.0,0.0,0.0,0.0,1.0,0.0,0.0,0.0,0.0,0.0,0.0,0.0,0.0,0.0,0.0,0.0,0.0,0.0,0.0,0.0,0.0,0.0,0.0,1.0,0.0,0.0,0.0,0.0,0.0,0.0,0.0,1.0,0.0
104741,0,0.0,0.0,0.0,0.0,1.0,171000.0,450000.0,47385.0,450000.0,0.028663,38.23835616438356,-1327.0,-7733.0,-4956.0,,2.0,2.0,2.0,11.0,0.6049890147120568,0.6150542255751398,0.5673792367572691,0.1485,,0.9836,0.7756,,0.08,0.069,0.3333,0.375,,,0.113,,0.0732,0.1513,,0.9836,0.7844,,0.0806,0.069,0.3333,0.375,,,0.1177,,0.0775,0.1499,,0.9836,0.7786,,0.08,0.069,0.3333,0.375,,,0.115,,0.0747,0.1048,1.0,2.0,0.0,2.0,0.0,0.0,0.0,0.0,0.0,0.0,1.0,1.0,1.0,1.0,0.0,1.0,0.0,0.0,0.0,0.0,0.0,0.0,0.0,0.0,0.0,1.0,0.0,0.0,0.0,0.0,0.0,0.0,0.0,0.0,0.0,0.0,0.0,0.0,0.0,0.0,0.0,0.0,0.0,0.0,3.0,0.0,7035.0075,101788.875,0.0,0.0,0.0,0.0,0.0,-973.0,-702.0,-687.0,-702.0,95.0,-15.0,7.0,11930.6925,71869.5,71869.5,0.0,71869.5,7.0,-1751.0,365243.0,-1300.5,-1180.5,-1180.5,-1175.5,13.0,0.0,0.0,30.0,51.0,8.0,4.0,-54.0,0.0,0.0,51.0,9889.74,9889.74,-1630.0,-1630.0,4.0,1.0,0.0,,,,,,,,,,,,,,,,,,,,,8355078553.5,184543852612.5,165714264036.0,52020464905.935,1863.0,1706.0,71125.0,70932.0,9141.0,506563.0,17826.476600002305,17888.741699999107,17339.804099998008,,,,128544.0,663465.0,,,,13540362.221917398,-602511359.0,-922789008.0,-296797295.0,-1536674724.0416667,44068.0,30738.0,11360.013999999192,11235.959999998986,10720.00069999729,22911.50960000979,22833.270200009752,22218.13840000832,67546.59383104961,158188.66909736206,126228.63363042654,35037.166800028,34977.28460002843,34422.71870002885,22975.323299995893,22948.35849999547,22595.122599995702,3717649.0,,,,,,,16483.948499999722,16669.3599999997,16266.0509999997,,,,3917.5299000001232,3900.770700000162,3733.44650000016,436884.0,431677.0,,6430.943787002895,632569.0,626117.0,,16348.244599999802,154337.75669999068,154340.49829999026,154232.2211999872,77683.23279999635,78021.34660000661,78423.20610000657,33.0,77864398.33500001,27010140.16499999,7764754543.019994,2582290160.820001,89187083.72999996,784675.8449999999,143.0,17162.0,-25526300.0,11339032.0,-13233666.0,-14408687.0,-16.0,0.0,8415.0,101788.875,0.0,0.0,0.0,0.0,0.0,-973.0,-702.0,-687.0,-702.0,275658139.82249963,3931104494.700002,4419813995.910003,64169016.52499995,3931104494.700002,285366.0,-19660223.0,4567498652.5,202814908.0,1026073458.0,441823312.0,1073522299.0,282596.0,4449.0,797.6664692208881,6579363.0,2339169.0,1441978.0,-4729757.0,1482774.0,102984.0,3107326161.4201465,3137149902.060117,-188536197.0,-186962778.0,3276505.0,156238.0,,,,,,,,,,,,,,,,,,,,,1468894.0,14837078.0,3235587.0,8564168.0,11619180.0,1417265.0,1060777627.2945012,802161438.6599952,72176196351.12715,21696537277.237617,583159188.8069987,5792665.7475,689.5,94245.0,-277194555.0,22003417.0,-123898363.5,-218911729.5,-2023618.5,,,,,,,,,,,,,,,,,,,,,4277361.5,2481845.0,-9012613.5,921269.0,37582.5,3737432983.22996,3662106181.919961,-260889856.0,-257574563.0,2528826.5,269483.0,3930095293.874953,33284668045.59092,36716332234.88265,1731503264.332549,48131977399.62821,3992117.5,-247823861.0,103189573802.0,1055731870.5,17288270162.0,3506834606.0,18901745688.5,3675615.0,72007.0,20889.453456785435,89855316.5,-34.7033746507129,2.631578947368421,3.608736942070276,137.9921684944516,9.49667616334283,363.1372855117147,85500.0,-0.2225209339563143,0.9749279121818236,0.0,0.0,0.0,0.0,0.0,0.0,1.0,0.0,0.0,0.0,0.0,0.0,0.0,1.0,0.0,0.0,0.0,0.0,1.0,0.0,0.0,0.0,0.0,1.0,0.0,0.0,0.0,0.0,0.0,1.0,0.0,0.0,0.0,0.0,0.0,0.0,0.0,0.0,0.0,0.0,0.0,0.0,0.0,0.0,1.0,0.0,0.0,0.0,0.0,0.0,0.0,0.0,0.0,1.0,0.0,0.0,0.0,0.0,0.0,0.0,0.0,0.0,0.0,0.0,0.0,0.0,0.0,0.0,0.0,0.0,0.0,0.0,0.0,0.0,0.0,0.0,0.0,0.0,0.0,0.0,0.0,0.0,0.0,0.0,0.0,0.0,0.0,0.0,0.0,0.0,0.0,0.0,0.0,0.0,0.0,0.0,0.0,0.0,0.0,0.0,0.0,0.0,0.0,0.0,0.0,0.0,0.0,0.0,0.0,0.0,1.0,0.0,0.0,0.0,0.0,0.0,0.0,0.0,0.0,0.0
104743,0,0.0,0.0,0.0,1.0,0.0,94500.0,78192.0,8140.5,67500.0,0.0196889999999999,65.53698630136986,,-8873.0,-2664.0,,2.0,2.0,2.0,10.0,0.7860198832868173,0.7090698780180215,0.7194907850918436,0.0856,0.0493,0.9886,0.8436,0.0099,0.08,0.0345,0.4583,0.5,0.0312,0.0698,0.0821,0.0,0.0003,0.0872,0.0511,0.9876,0.8367,0.0092,0.0806,0.0345,0.4583,0.5,0.0245,0.0762,0.0854,0.0,0.0,0.0864,0.0493,0.9886,0.8457,0.01,0.08,0.0345,0.4583,0.5,0.0318,0.071,0.0835,0.0,0.0003,0.0644,1.0,1.0,0.0,1.0,0.0,-3448.0,0.0,0.0,0.0,0.0,0.0,3.0,1.0,0.0,0.0,1.0,1.0,0.0,0.0,0.0,0.0,0.0,0.0,0.0,0.0,0.0,0.0,0.0,1.0,0.0,0.0,0.0,0.0,0.0,0.0,0.0,0.0,0.0,0.0,0.0,0.0,0.0,0.0,0.0,4.0,4464.9,4693.5,153000.0,0.0,9433.26,0.0,0.0,0.0,-1597.0,8780.0,-510.0,-2340.0,214.0,-28.5,4.0,10495.8,71955.0,82797.75,0.0,90000.0,12.0,-845.0,365243.0,-1169.0,-333.0,-303.0,-328.0,13.5,0.0,0.0,10.0,152.0,8.0,0.0,-34.0,0.0,0.0,53.0,9872.775,9872.775,-777.0,-749.0,11.0,1.0,0.0,,,,,,,,,,,,,,,,,,,,,8355086694.0,184543930804.5,165714331536.0,52020559405.935,1863.0,1706.0,71125.0,70932.0,9141.0,506566.0,17826.562200002303,17888.828099999108,17339.89129999801,11306.824600000093,11244.630900000093,11192.036800000062,128544.0,663467.0,4142.126800000115,4139.824200000013,3950.393900000093,13540427.7589037,,-922791672.0,-296800743.0,-1536683597.0416667,44068.0,30738.0,11360.093999999192,11236.039999998988,10720.08129999729,22911.54410000979,22833.30470000975,22218.172900008318,67547.3798509329,158189.37816724007,126229.35312121164,35037.625100027995,34977.74290002843,34423.177000028845,22975.823299995893,22948.85849999547,22595.622599995702,3717659.0,8304.162400000163,8408.807200000072,8132.266400000232,9826.884700000715,9941.910800002155,10302.042899999637,16484.030599999718,16669.4434999997,16266.1363999997,829.2000000001768,814.3772000000463,760.2966000000133,3917.5302000001234,3900.7710000001616,3733.44650000016,436885.0,431678.0,,6430.963476002896,632571.0,626119.0,,16348.3089999998,154338.7452999907,154341.48689999027,154233.20879998722,77684.07639999634,78022.19230000662,78424.04280000657,53.0,77869910.83500001,27020589.16499999,7767134084.519994,2582690066.820001,89196516.98999996,784675.8449999999,143.0,17162.0,-25540906.5,11377029.0,-13237562.5,-14414756.0,-26.0,0.0,9387.0,195750.0,0.0,9433.26,0.0,0.0,0.0,-2335.0,8780.0,-1000.0,-2340.0,275729434.7849996,3932105362.200002,4420928976.660003,64169016.52499995,3932132317.200002,285489.0,-19669125.5,4569872732.0,202807739.0,1026433193.0,441819638.0,1073882079.0,282691.0,4452.0,797.6664692208881,6583828.0,2340869.0,1442823.0,-4735510.5,1482774.0,102984.0,3108165890.7151484,3137975657.14512,-188612365.0,-187037914.0,3277030.0,156315.0,,,,,,,,,,,,,,,,,,,,,1468898.0,14837292.0,3235587.0,8564320.0,11619233.0,1417269.0,1060782092.1945012,802166132.1599952,72176349351.12715,21696537277.237617,583168622.0669987,5792665.7475,689.5,94245.0,-277196152.0,22012197.0,-123898873.5,-218914069.5,-2023647.0,,,,,,,,,,,,,,,,,,,,,4277369.5,2481845.0,-9012647.5,921269.0,37582.5,3737442856.00496,3662116054.694961,-260890633.0,-257575312.0,2528837.5,269484.0,3930105789.674954,33284740000.59092,36716415032.63265,1731503264.332549,48132067399.62821,3992129.5,-247824706.0,103189939045.0,1055730701.5,17288269829.0,3506834303.0,18901745360.5,3675628.5,72007.0,20889.453456785435,89855326.5,,0.8274285714285714,11.608623548922054,760.7942025034644,9.60530679933665,629.5028601285809,47250.0,-0.2225209339563146,-0.9749279121818236,0.0,0.0,0.0,0.0,0.0,0.0,1.0,0.0,0.0,1.0,0.0,0.0,0.0,0.0,0.0,0.0,0.0,0.0,1.0,0.0,1.0,0.0,0.0,0.0,0.0,1.0,0.0,0.0,0.0,0.0,0.0,0.0,0.0,0.0,0.0,0.0,0.0,0.0,0.0,0.0,0.0,0.0,0.0,0.0,0.0,0.0,0.0,0.0,0.0,0.0,0.0,0.0,0.0,0.0,0.0,0.0,0.0,0.0,0.0,0.0,0.0,0.0,0.0,0.0,0.0,0.0,0.0,0.0,0.0,0.0,0.0,0.0,0.0,0.0,0.0,0.0,0.0,0.0,0.0,0.0,0.0,0.0,0.0,0.0,0.0,0.0,0.0,0.0,0.0,0.0,0.0,0.0,0.0,0.0,0.0,0.0,0.0,0.0,0.0,0.0,0.0,0.0,0.0,0.0,0.0,1.0,0.0,1.0,0.0,0.0,1.0,0.0,0.0,0.0,0.0,0.0,0.0,0.0,1.0,0.0
104744,0,0.0,0.0,0.0,1.0,1.0,90000.0,225000.0,23053.5,225000.0,0.0196889999999999,48.221917808219175,-10319.0,-6299.0,-1123.0,,2.0,2.0,2.0,17.0,0.7345044890429512,0.5179747538061198,0.5602843280409464,0.0021,,0.9851,,,0.0,0.0345,0.0,,,,0.0016,,0.0,0.0021,,0.9851,,,0.0,0.0345,0.0,,,,0.0017,,0.0,0.0021,,0.9851,,,0.0,0.0345,0.0,,,,0.0016,,0.0,0.0013,1.0,2.0,1.0,2.0,1.0,-341.0,0.0,0.0,0.0,0.0,0.0,0.0,1.0,1.0,1.0,1.0,1.0,0.0,0.0,0.0,0.0,0.0,0.0,0.0,0.0,1.0,0.0,0.0,0.0,0.0,0.0,0.0,0.0,0.0,0.0,0.0,0.0,0.0,0.0,0.0,0.0,0.0,0.0,0.0,2.0,,0.0,45900.0,0.0,0.0,0.0,0.0,0.0,-751.5,-566.5,-580.5,-581.0,50.0,-12.0,6.0,13897.98,105750.0,91575.0,10350.0,105750.0,8.0,-1937.0,365243.0,-1741.0,-1591.0,-1591.0,-1583.0,14.0,0.0,0.1089090909090909,100.5,45.0,11.0,5.0,-56.0,0.0,0.0,46.0,13897.98,12148.0875,-1638.5,-1636.0,5.0,1.0,0.0,,,,,,,,,,,,,,,,,,,,,8355109747.5,184544155804.5,165714556536.0,52020649405.935,1863.0,1706.0,71125.0,70932.0,9141.0,506566.0,17826.564300002305,17888.830199999113,17339.89339999801,,,,128545.0,663469.0,,,,13540475.980821509,-602521678.0,-922792795.0,-296801084.0,-1536689896.0416667,44069.0,30739.0,11360.093999999192,11236.039999998988,10720.08129999729,22911.57860000979,22833.339200009752,22218.20740000832,67548.11435542196,158189.89614199387,126229.91340553969,35037.625100027995,34977.74290002843,34423.177000028845,,,,3717676.0,,,,,,,16484.032199999718,16669.4450999997,16266.1380999997,,,,3917.5302000001234,3900.7710000001616,3733.44650000016,436887.0,431680.0,,6430.983165002896,632573.0,626121.0,,16348.3102999998,154339.73039999072,154342.47199999026,154234.19389998718,,,,25.0,,27025282.66499999,7767346907.519994,2582790880.320001,89196516.98999996,784675.8449999999,143.0,17162.0,-25544490.0,11385141.0,-13239592.0,-14415438.5,-12.0,,0.0,46800.0,0.0,0.0,0.0,0.0,0.0,-1114.0,-930.0,-958.0,-959.0,275783410.3949996,3932936422.200002,4421743447.410003,64197362.02499995,3932936422.200002,285569.0,-19677209.0,4571333704.0,202800913.0,1026428197.0,441815092.0,1073877114.0,282755.5,4452.0,798.0931989131651,6584126.5,2342906.0,1443778.0,-4738860.0,1482774.0,102984.0,3109125500.302649,3138830629.267623,-188663213.5,-187088147.5,3277681.5,156365.5,,,,,,,,,,,,,,,,,,,,,1468900.0,14837342.0,3235587.0,8564365.0,11619279.0,1417275.0,,802166132.1599952,72176395251.12715,21696537277.237617,583168622.0669987,5792665.7475,689.5,94245.0,-277196903.5,22011630.5,-123899454.0,-218914650.5,-2023659.0,,,,,,,,,,,,,,,,,,,,,4277380.5,2481850.0,-9012703.5,921269.0,37582.5,3737456753.98496,3662128202.782461,-260892271.5,-257576948.0,2528842.5,269485.0,3930119687.654954,33284845750.59092,36716506607.63265,1731513614.332549,48132173149.62821,3992137.5,-247826643.0,103190304288.0,1055728960.5,17288268238.0,3506832712.0,18901743777.5,3675642.5,72007.0,20889.562365876347,89855427.0,-213.98983012328847,2.5,3.9039625219597887,188.256559860313,9.759906304899474,470.64139965078255,45000.0,1.0,0.0,0.0,0.0,0.0,0.0,0.0,0.0,1.0,0.0,0.0,0.0,0.0,0.0,0.0,1.0,0.0,0.0,0.0,0.0,1.0,0.0,0.0,0.0,1.0,0.0,0.0,1.0,0.0,0.0,0.0,0.0,0.0,0.0,0.0,0.0,0.0,0.0,0.0,0.0,0.0,0.0,0.0,0.0,0.0,0.0,0.0,0.0,0.0,0.0,0.0,0.0,0.0,0.0,0.0,0.0,0.0,0.0,0.0,0.0,0.0,0.0,0.0,0.0,0.0,0.0,0.0,0.0,0.0,0.0,0.0,0.0,0.0,0.0,0.0,0.0,0.0,0.0,0.0,0.0,0.0,0.0,0.0,0.0,0.0,0.0,0.0,0.0,0.0,0.0,0.0,0.0,1.0,0.0,0.0,0.0,0.0,0.0,0.0,0.0,0.0,0.0,0.0,0.0,0.0,0.0,0.0,0.0,0.0,0.0,0.0,0.0,0.0,0.0,1.0,0.0,0.0,0.0,0.0,0.0,0.0,1.0
104747,0,0.0,0.0,0.0,1.0,1.0,45000.0,157500.0,9634.5,157500.0,0.010643,38.12876712328767,-3839.0,-2906.0,-5160.0,,3.0,2.0,2.0,10.0,0.5094621769713473,0.3155209629503257,0.3185955240537633,,,,,,,,,,,,,,,,,,,,,,,,,,,,,,,,,,,,,,,,,,,,,2.0,0.0,2.0,0.0,0.0,0.0,0.0,0.0,0.0,0.0,5.0,1.0,1.0,0.0,1.0,0.0,0.0,0.0,0.0,0.0,0.0,0.0,0.0,0.0,1.0,0.0,0.0,0.0,0.0,0.0,0.0,0.0,0.0,0.0,0.0,0.0,0.0,0.0,0.0,0.0,0.0,0.0,0.0,9.0,6750.0,0.0,45000.0,21802.5,0.0,0.0,0.0,0.0,-675.0,-70.0,-118.0,-1080.5,271.0,-21.0,10.0,6237.6975,40995.0,43060.5,1809.0,49500.0,11.0,-681.5,365243.0,-733.0,-628.0,-463.0,-617.5,14.0,0.0,0.0440368683820705,7.0,62.0,12.0,7.0,-30.5,0.0,0.0,55.0,6576.795,11717.82,-1074.0,-1064.0,4.0,1.0,15.0,0.0,225000.0,,0.0,,,0.0,,0.0,0.0,0.0,0.0,,0.0,,,0.0,-9.0,0.0,0.0,8355119382.0,184544313304.5,165714714036.0,52020694405.935,1863.0,1706.0,71125.0,70932.0,9141.0,506571.0,,,,,,,128546.0,663472.0,,,,13540514.10958863,-602525517.0,-922797955.0,-296801084.0,-1536692802.0416667,44069.0,30739.0,,,,,,,67548.62381759891,158190.21166295686,126230.23200106372,,,,,,,3717686.0,,,,,,,,,,,,,,,,436889.0,431682.0,,6430.993808002894,632575.0,626123.0,,,,,,,,,22.0,77914070.86500001,27025282.66499999,7767827825.849994,2583363190.4550014,89196516.98999996,784675.8449999999,143.0,17162.0,-25555808.0,11379026.0,-13245970.0,-14423264.0,-11.5,0.0,0.0,45000.0,0.0,0.0,0.0,0.0,0.0,-2250.0,-1885.0,-1742.0,-1885.0,275913128.0699997,3934318547.700002,4423112385.660003,64299845.02499995,3934318547.700002,285704.0,-19696817.5,4575899241.5,203146982.0,1027143456.0,442166089.5,1074228620.5,282925.0,4457.0,799.22966416833,6586058.5,2344754.0,1444719.0,-4745437.5,1482777.0,102987.0,3110781084.210149,3140481041.730121,-188854250.0,-187278170.0,3278631.0,156508.0,2874931217.009969,7775140500.0,,372301182.8999996,,,163010202.74999905,,377647337.92499936,2760263295.12,2864349043.874961,2864487937.1849604,,32740.0,,,933039.0,-1650647.0,681092.0,1594.0,1468909.0,14837613.0,3235602.0,8564427.0,11619334.0,1417285.0,1060788842.1945012,802166132.1599952,72176440251.12715,21696559079.737617,583168622.0669987,5792665.7475,689.5,94245.0,-277197578.5,22011560.5,-123899572.0,-218915731.0,-2023680.0,5927117661.989961,18742189500.0,,448276957.44749767,,,309324672.8774986,,459450723.77999926,5712128314.200034,5890368525.794997,5890611708.539999,,80933.5,,,972227.0,-1700091.0,177364.0,6755.0,4277392.5,2481857.0,-9012734.0,921269.0,37582.5,3737463330.77996,3662139920.602461,-260893345.5,-257578012.0,2528846.5,269486.0,3930125925.3524537,33284886745.59092,36716549668.13265,1731515423.332549,48132222649.62821,3992148.5,-247827324.5,103190669531.0,1055728227.5,17288267610.0,3506832249.0,18901743160.0,3675656.5,72007.0,20889.606402744725,89855434.0,-100.6851332902206,3.5,4.670714619336757,178.08859002002652,16.347501167678654,623.3100650700927,15000.0,-0.9009688679024191,0.4338837391175582,0.0,0.0,0.0,0.0,0.0,0.0,1.0,0.0,0.0,0.0,1.0,0.0,0.0,0.0,0.0,0.0,0.0,0.0,1.0,0.0,1.0,0.0,0.0,0.0,0.0,1.0,0.0,0.0,0.0,0.0,0.0,0.0,0.0,0.0,0.0,0.0,0.0,0.0,1.0,0.0,0.0,0.0,0.0,0.0,0.0,0.0,0.0,0.0,0.0,0.0,0.0,0.0,0.0,0.0,0.0,0.0,0.0,0.0,0.0,0.0,0.0,0.0,0.0,0.0,0.0,0.0,0.0,0.0,0.0,0.0,0.0,0.0,0.0,0.0,0.0,0.0,0.0,0.0,0.0,0.0,0.0,0.0,0.0,0.0,0.0,0.0,0.0,1.0,0.0,0.0,0.0,0.0,0.0,0.0,0.0,0.0,0.0,0.0,0.0,0.0,0.0,0.0,0.0,0.0,0.0,0.0,0.0,0.0,0.0,0.0,0.0,0.0,0.0,0.0,0.0,0.0,0.0,0.0,0.0,0.0
104767,0,0.0,0.0,0.0,1.0,0.0,135000.0,799299.0,35338.5,702000.0,0.018801,60.85479452054796,-10480.0,-7326.0,-4805.0,,1.0,2.0,2.0,13.0,0.619292618451026,0.4196575412823183,0.3606125659189888,0.0619,0.0595,0.9851,0.7959999999999999,0.0274,0.0,0.1379,0.1667,0.2083,0.0169,0.0504,0.0507,0.0,0.0,0.063,0.0618,0.9851,0.804,0.0277,0.0,0.1379,0.1667,0.2083,0.0172,0.0551,0.0529,0.0,0.0,0.0625,0.0595,0.9851,0.7987,0.0276,0.0,0.1379,0.1667,0.2083,0.0172,0.0513,0.0517,0.0,0.0,0.0549,1.0,4.0,1.0,4.0,1.0,-1765.0,0.0,0.0,0.0,0.0,0.0,6.0,1.0,1.0,0.0,1.0,0.0,0.0,0.0,0.0,0.0,0.0,0.0,0.0,0.0,1.0,0.0,0.0,0.0,0.0,0.0,0.0,0.0,0.0,0.0,0.0,0.0,0.0,0.0,0.0,0.0,0.0,0.0,0.0,3.0,26077.5,,675000.0,138739.5,0.0,0.0,0.0,0.0,-1168.0,191.0,-16.0,,114.0,-18.5,7.0,15221.385,160935.48,164146.5,2612.25,160935.48,24.0,-1765.0,365243.0,-1735.0,-1435.0,-865.0,-1430.0,10.0,1.0,0.0254779510632632,-1.0,136.0,36.0,10.0,-33.0,0.0,0.0,141.0,16353.45,16353.45,-1018.0,-1016.0,10.0,1.0,0.0,,,,,,,,,,,,,,,,,,,,,8355154720.5,184545112603.5,165715416036.0,52020829405.935,1863.0,1706.0,71125.0,70932.0,9141.0,506577.0,17826.626200002305,17888.892699999113,17339.95639999801,11306.884100000092,11244.690400000092,11192.09860000006,128546.0,663473.0,4142.1542000001145,4139.851800000013,3950.421600000094,13540574.964383151,-602535997.0,-922802760.0,-296802849.0,-1536700128.0416667,44070.0,30740.0,11360.093999999192,11236.039999998988,10720.08129999729,22911.71650000979,22833.47710000976,22218.34530000832,67549.24311021736,158190.63132049813,126230.59261362963,35037.791800028,34977.90960002843,34423.34370002885,22976.031599995888,22949.066799995468,22595.830899995697,3717699.0,8304.179300000163,8408.824400000072,8132.2836000002335,9826.935100000715,9941.962100002156,10302.097999999638,16484.082899999717,16669.4967999997,16266.1909999997,829.2000000001768,814.3772000000463,760.2966000000133,3917.5302000001234,3900.7710000001616,3733.44650000016,436893.0,431686.0,,6431.012609002894,632577.0,626125.0,,16348.3651999998,154340.71549999068,154343.45709999025,154235.17899998714,77684.87239999634,78022.99100000662,78424.84680000658,39.0,78148860.39000002,,7798631502.554991,2598301563.1650014,89452296.85499997,784675.8449999999,143.0,17162.0,-25665620.0,11506641.0,-13303775.0,,-19.0,26077.5,,675000.0,138739.5,0.0,0.0,0.0,0.0,-1168.0,191.0,-16.0,,276826221.2699999,3945413488.3200026,4436077040.910003,64456678.39499995,3945413488.3200026,286758.0,-19776830.0,4595436733.0,203454228.0,1032214889.0,444688055.0,1079298784.0,284060.0,4484.0,802.1136139316434,6634784.0,2355043.0,1450782.5,-4764017.5,1482859.0,103045.0,3122135948.9251328,3151270953.090104,-189456902.0,-187872709.0,3287766.0,157182.0,,,,,,,,,,,,,,,,,,,,,1468912.0,14837727.0,3235602.0,8564563.0,11619475.0,1417292.0,1060814919.6945012,,72177115251.12715,21696697819.237617,583168622.0669987,5792665.7475,689.5,94245.0,-277198746.5,22011751.5,-123899588.0,,-2023698.5,,,,,,,,,,,,,,,,,,,,,4277428.5,2481867.0,-9012767.0,921269.0,37582.5,3737479684.22996,3662156274.052461,-260894363.5,-257579028.0,2528856.5,269487.0,3930141146.737455,33285047681.07092,36716713814.63265,1731518035.582549,48132383585.108215,3992172.5,-247829089.5,103191034774.0,1055726492.5,17288266175.0,3506831384.0,18901741730.0,3675666.5,72008.0,20889.631880695782,89855433.0,-172.21321808031695,5.920733333333334,3.820196103399976,232.4772489006034,22.618362409270343,1376.4357968074326,135000.0,0.6234898018587336,0.7818314824680298,0.0,0.0,0.0,0.0,0.0,0.0,1.0,0.0,0.0,0.0,0.0,0.0,0.0,1.0,0.0,0.0,0.0,0.0,1.0,0.0,0.0,0.0,1.0,0.0,0.0,1.0,0.0,0.0,0.0,0.0,0.0,0.0,0.0,0.0,0.0,0.0,0.0,0.0,0.0,0.0,1.0,0.0,0.0,0.0,0.0,0.0,0.0,0.0,0.0,0.0,0.0,0.0,0.0,0.0,0.0,0.0,0.0,0.0,0.0,1.0,0.0,0.0,0.0,0.0,0.0,0.0,0.0,0.0,0.0,0.0,0.0,0.0,0.0,0.0,0.0,0.0,0.0,0.0,0.0,0.0,0.0,0.0,0.0,0.0,0.0,0.0,0.0,0.0,0.0,0.0,0.0,0.0,0.0,0.0,0.0,0.0,0.0,0.0,0.0,0.0,0.0,0.0,0.0,0.0,0.0,0.0,0.0,0.0,1.0,0.0,1.0,0.0,0.0,0.0,0.0,0.0,0.0,1.0,0.0,0.0
104772,0,0.0,1.0,0.0,0.0,0.0,121500.0,315000.0,13239.0,315000.0,0.019101,23.950684931506853,-1146.0,-2760.0,-1268.0,,1.0,2.0,2.0,13.0,0.1420119379558359,0.1238764252373059,0.3425288720742255,,,,,,,,,,,,,,,,,,,,,,,,,,,,,,,,,,,,,,,,,,,,,0.0,0.0,0.0,0.0,-507.0,0.0,0.0,0.0,0.0,1.0,0.0,1.0,1.0,1.0,1.0,0.0,0.0,0.0,0.0,0.0,0.0,0.0,0.0,0.0,1.0,0.0,0.0,0.0,0.0,0.0,0.0,0.0,0.0,0.0,0.0,0.0,0.0,0.0,0.0,0.0,0.0,0.0,0.0,1.0,2835.0,0.0,67500.0,2835.0,64665.0,0.0,0.0,0.0,-266.0,770.0,-29.0,,9.0,-4.0,1.0,8910.9,99000.0,89100.0,9900.0,99000.0,12.0,-507.0,365243.0,-463.0,-133.0,-133.0,-131.0,14.0,0.0,0.1089090909090909,50.0,14.0,12.0,6.0,-10.5,0.0,0.0,13.0,8910.9,8910.9,-303.0,-283.0,7.0,1.0,0.0,,,,,,,,,,,,,,,,,,,,,8355167959.5,184545427603.5,165715731036.0,52020950905.935,1863.0,1706.0,71125.0,70933.0,9141.0,506577.0,,,,,,,128546.0,663474.0,,,,13540598.915068084,-602537143.0,-922804028.0,-296803356.0,-1536702888.0416667,44070.0,30740.0,,,,,,,67549.38512215532,158190.75519692336,126230.93514250172,,,,,,,3717712.0,,,,,,,,,,,,,,,,436893.0,431686.0,,6431.031710002894,632579.0,626127.0,,,,,,,,,9.0,78177772.89000002,27064546.42499999,7805098781.4599905,2600138128.635001,89534637.85499997,784675.8449999999,143.0,17162.0,-25691368.0,11561454.0,-13317122.0,,-4.0,2835.0,0.0,67500.0,2835.0,64665.0,0.0,0.0,0.0,-266.0,770.0,-29.0,,277049286.94500005,3949255849.3200026,4440193127.910003,64661372.14499995,3949255849.3200026,287112.0,-19798896.0,4600915378.0,203434751.0,1032932051.0,444677848.0,1080016012.0,284272.0,4491.0,803.4975248077739,6637719.0,2360395.0,1453870.0,-4771912.0,1482859.0,103045.0,3126480159.825135,3155684914.935105,-189706927.0,-188120207.0,3290282.0,157414.0,,,,,,,,,,,,,,,,,,,,,1468913.0,14837736.0,3235602.0,8564577.0,11619488.0,1417293.0,1060817754.6945012,802166132.1599952,72177182751.12715,21696700654.237617,583233287.0669987,5792665.7475,689.5,94245.0,-277199012.5,22012521.5,-123899617.0,,-2023702.5,,,,,,,,,,,,,,,,,,,,,4277440.5,2481873.0,-9012777.5,921269.0,37582.5,3737488595.12996,3662165184.952461,-260894666.5,-257579311.0,2528863.5,269488.0,3930150057.637455,33285146681.07092,36716802914.63265,1731527935.582549,48132482585.108215,3992184.5,-247829596.5,103191400017.0,1055726029.5,17288266042.0,3506831251.0,18901741599.0,3675680.5,72008.0,20889.74078978669,89855483.0,-47.84831846259437,2.592592592592593,9.177430319510538,219.80574206345509,23.79333786539769,569.8667386830317,121500.0,-0.9009688679024191,-0.433883739117558,0.0,0.0,0.0,0.0,0.0,0.0,1.0,0.0,0.0,0.0,0.0,0.0,0.0,1.0,0.0,0.0,0.0,0.0,1.0,0.0,0.0,0.0,1.0,0.0,0.0,0.0,0.0,0.0,0.0,1.0,0.0,0.0,0.0,0.0,1.0,0.0,0.0,0.0,0.0,0.0,0.0,0.0,0.0,0.0,0.0,0.0,0.0,0.0,0.0,0.0,0.0,0.0,0.0,0.0,0.0,0.0,0.0,0.0,0.0,0.0,0.0,0.0,0.0,0.0,0.0,0.0,0.0,0.0,0.0,0.0,0.0,0.0,0.0,0.0,0.0,0.0,0.0,0.0,0.0,0.0,0.0,0.0,0.0,0.0,0.0,0.0,0.0,0.0,0.0,0.0,1.0,0.0,0.0,0.0,0.0,0.0,0.0,0.0,0.0,0.0,0.0,0.0,0.0,0.0,0.0,0.0,0.0,0.0,0.0,0.0,0.0,0.0,0.0,0.0,0.0,0.0,0.0,0.0,0.0,0.0
104776,0,0.0,1.0,0.0,0.0,0.0,157500.0,319041.0,23215.5,270000.0,0.010006,35.46575342465753,-802.0,-7018.0,-1805.0,,2.0,2.0,2.0,16.0,,0.2687184978541121,0.4206109640437848,,,,,,,,,,,,,,,,,,,,,,,,,,,,,,,,,,,,,,,,,,,,,0.0,0.0,0.0,0.0,-640.0,0.0,0.0,0.0,0.0,1.0,3.0,1.0,1.0,1.0,1.0,1.0,0.0,0.0,0.0,0.0,0.0,0.0,0.0,0.0,1.0,0.0,0.0,0.0,0.0,0.0,0.0,0.0,0.0,0.0,0.0,0.0,0.0,0.0,0.0,0.0,0.0,0.0,0.0,10.0,0.0,,22500.0,0.0,0.0,0.0,0.0,0.0,-213.0,-173.0,-166.0,-205.5,97.0,-5.0,6.0,11955.3975,74250.0,81081.0,,90000.0,12.0,-387.0,365243.0,-357.0,365243.0,63.0,365243.0,11.0,1.0,,-1.0,31.0,12.0,9.0,-9.0,0.0,0.0,30.0,11516.67,11516.67,-272.0,-237.0,5.5,1.0,0.0,,,,,,,,,,,,,,,,,,,,,8355191175.0,184545746644.5,165716001036.0,52021108405.935,1863.0,1706.0,71125.0,70934.0,9141.0,506580.0,,,,,,,128546.0,663476.0,,,,13540634.380821507,-602537945.0,-922805833.0,-296803996.0,-1536709906.0416667,44070.0,30740.0,,,,,,,,158191.02391542122,126231.35575346574,,,,,,,3717728.0,,,,,,,,,,,,,,,,436893.0,431686.0,,6431.041716002896,632581.0,626129.0,,,,,,,,,7.5,78177772.89000002,,7816222857.82499,2601078754.635001,90029666.06999998,784675.8449999999,143.0,17162.0,-25731562.0,11542597.0,-13336126.0,-14523371.0,-3.25,0.0,,29826.0,0.0,0.0,0.0,0.0,0.0,-308.0,-222.0,-218.0,-228.0,277206944.0625,3951194327.8200026,4442680669.410003,,3951239327.8200026,287234.0,-19810315.5,4603835954.0,203425995.0,1034021220.0,445038836.0,1081471591.0,284467.0,4493.0,,6639713.5,2361908.0,1454675.0,-4774862.0,1482859.0,103045.0,3129371575.62763,3158576330.7376,-189826377.5,-188238188.5,3292369.0,157510.5,,,,,,,,,,,,,,,,,,,,,1468923.0,14837833.0,3235602.0,8564608.0,11619518.0,1417299.0,1060817754.6945012,,72177205251.12715,21696700654.237617,583233287.0669987,5792665.7475,689.5,94245.0,-277199225.5,22012348.5,-123899783.0,-218915936.5,-2023707.5,,,,,,,,,,,,,,,,,,,,,4277452.5,2481882.0,-9012786.5,921269.0,37582.5,3737500111.79996,3662176701.622461,-260894938.5,-257579548.0,2528869.0,269489.0,3930162013.0349545,33285220931.07092,36716883995.63265,,48132572585.108215,3992196.5,-247829983.5,103191765260.0,1055725672.5,17288631285.0,3506831314.0,18902106842.0,3675691.5,72009.0,,89855482.0,-22.61336423329471,2.025657142857143,6.784260515603799,240.60891061504435,13.742585772436518,487.3911584224404,78750.0,0.6234898018587336,0.7818314824680298,0.0,0.0,0.0,0.0,0.0,0.0,1.0,0.0,0.0,0.0,0.0,0.0,0.0,1.0,0.0,0.0,0.0,0.0,1.0,0.0,1.0,0.0,0.0,0.0,0.0,1.0,0.0,0.0,0.0,0.0,0.0,0.0,0.0,0.0,0.0,0.0,0.0,0.0,0.0,0.0,0.0,0.0,0.0,0.0,0.0,0.0,0.0,0.0,0.0,0.0,0.0,0.0,0.0,1.0,0.0,0.0,0.0,0.0,0.0,0.0,0.0,0.0,0.0,0.0,0.0,0.0,0.0,0.0,0.0,0.0,0.0,0.0,0.0,0.0,0.0,0.0,0.0,0.0,0.0,0.0,0.0,0.0,0.0,0.0,0.0,0.0,0.0,0.0,0.0,0.0,0.0,0.0,0.0,0.0,0.0,0.0,0.0,0.0,0.0,0.0,0.0,0.0,0.0,0.0,0.0,0.0,0.0,0.0,0.0,0.0,0.0,0.0,0.0,0.0,0.0,0.0,0.0,0.0,0.0,0.0
104779,0,0.0,0.0,0.0,1.0,0.0,157500.0,555939.0,21087.0,459000.0,0.0196889999999999,56.53972602739726,,-637.0,-566.0,,2.0,2.0,2.0,8.0,0.7526391766651709,0.5632359827261758,0.6910212267577837,,,,,,,,,,,,,,,,,,,,,,,,,,,,,,,,,,,,,,,,,,,,,0.0,0.0,0.0,0.0,-1800.0,0.0,0.0,0.0,0.0,0.0,2.0,1.0,0.0,0.0,1.0,0.0,0.0,0.0,0.0,0.0,0.0,0.0,0.0,0.0,0.0,0.0,0.0,1.0,0.0,0.0,0.0,0.0,0.0,0.0,0.0,0.0,0.0,0.0,0.0,0.0,0.0,0.0,0.0,9.0,14445.0,10834.83,675000.0,0.0,0.0,0.0,0.0,0.0,-1335.0,492.0,-578.0,-980.0,438.0,-25.0,1.0,3743.595,21060.0,18360.0,2700.0,21060.0,6.0,-1800.0,365243.0,-1755.0,-1605.0,-1605.0,365243.0,17.0,0.0,0.1396270396270396,40.0,58.0,6.0,0.0,-30.5,0.0,0.0,6.0,3743.595,3743.595,-1687.0,-1680.0,3.5,1.0,0.0,,,,,,,,,,,,,,,,,,,,,8355212262.0,184546302583.5,165716460036.0,52021265905.935,1863.0,1706.0,71125.0,70934.0,9141.0,506582.0,,,,,,,128546.0,663478.0,,,,13540690.920547536,,-922806399.0,-296805796.0,-1536710543.0416667,44070.0,30740.0,,,,,,,67550.13776133198,158191.58715140395,126232.04677469251,,,,,,,3717736.0,,,,,,,,,,,,,,,,436893.0,431686.0,,6431.061405002894,632583.0,626131.0,,,,,,,,,44.0,78248461.14000002,27119133.58499999,7821718806.82499,2602396930.635001,90029666.06999998,784675.8449999999,143.0,17162.0,-25742746.0,11541168.0,-13340936.0,-14528978.0,-21.5,10035.0,0.0,675000.0,0.0,0.0,0.0,0.0,0.0,-1721.0,-796.0,-797.0,-980.0,277362631.8900001,3952831382.8200026,4444381372.410003,64684385.14499995,3952831382.8200026,287350.0,-19819203.0,4606392496.0,203420838.0,1034748848.0,445401113.0,1082566080.0,284617.0,4496.0,803.9668552674655,6640059.0,2362888.0,1455146.0,-4776802.5,1496137.5,103052.0,3130694679.6676264,3159740504.2275987,-189867045.0,-188277956.5,3292964.5,157592.5,,,,,,,,,,,,,,,,,,,,,1468932.0,14838271.0,3235602.0,8564666.0,11619524.0,1417300.0,1060832199.6945012,802176966.9899952,72177880251.12715,21696700654.237617,583233287.0669987,5792665.7475,689.5,94245.0,-277200560.5,22012840.5,-123900361.0,-218916916.5,-2023732.5,,,,,,,,,,,,,,,,,,,,,4277458.5,2481882.0,-9012817.0,921269.0,37582.5,3737503855.39496,3662180445.217461,-260896625.5,-257581228.0,2528872.5,269490.0,3930165756.629953,33285241991.07092,36716902355.63265,1731530635.582549,48132593645.108215,3992202.5,-247831783.5,103192130503.0,1055723917.5,17288629680.0,3506829709.0,18902472085.0,3675708.5,72009.0,20889.88041682632,89855522.0,,3.529771428571429,7.469056764831412,422.2984231666462,26.36406316688007,1490.6169084243943,78750.0,0.6234898018587336,0.7818314824680298,0.0,0.0,0.0,0.0,0.0,0.0,1.0,0.0,0.0,1.0,0.0,0.0,0.0,0.0,0.0,0.0,0.0,0.0,1.0,0.0,1.0,0.0,0.0,0.0,0.0,1.0,0.0,0.0,0.0,0.0,0.0,0.0,0.0,0.0,0.0,0.0,0.0,0.0,0.0,0.0,0.0,0.0,0.0,0.0,0.0,0.0,0.0,0.0,0.0,0.0,0.0,0.0,0.0,0.0,0.0,0.0,0.0,0.0,0.0,0.0,0.0,0.0,0.0,0.0,0.0,0.0,0.0,0.0,0.0,0.0,0.0,0.0,0.0,0.0,0.0,0.0,0.0,0.0,0.0,0.0,0.0,0.0,0.0,0.0,0.0,0.0,0.0,0.0,0.0,0.0,0.0,0.0,0.0,0.0,0.0,0.0,0.0,0.0,0.0,0.0,0.0,0.0,0.0,0.0,0.0,1.0,0.0,0.0,0.0,0.0,0.0,0.0,0.0,0.0,0.0,0.0,0.0,0.0,0.0,0.0
104814,0,0.0,0.0,0.0,1.0,0.0,67500.0,431280.0,20745.0,360000.0,0.031329,46.50684931506849,-832.0,-7302.0,-517.0,,2.0,2.0,2.0,15.0,0.3228713797438159,0.7778070840051852,0.7922644738669378,,,,,,,,,,,,,,,,,,,,,,,,,,,,,,,,,,,,,,,,,,,,,6.0,0.0,6.0,0.0,-2463.0,0.0,0.0,0.0,0.0,0.0,2.0,1.0,1.0,0.0,1.0,0.0,0.0,0.0,0.0,0.0,0.0,0.0,0.0,0.0,1.0,0.0,0.0,0.0,0.0,0.0,0.0,0.0,0.0,0.0,0.0,0.0,0.0,0.0,0.0,0.0,0.0,0.0,0.0,4.0,0.0,,80527.5,0.0,0.0,0.0,0.0,0.0,-1646.0,-1389.0,-905.5,-1265.5,214.0,-26.5,3.0,4500.0,51790.5,90000.0,36000.0,250895.25,6.0,-756.0,365243.0,-726.0,-66.0,-36.0,365243.0,12.0,1.0,0.7457611292242804,-1.0,32.0,24.0,8.5,-18.5,0.0,0.0,29.0,26191.395,26191.395,-487.0,-486.0,9.0,1.0,23.0,0.0,90000.0,,0.0,,,0.0,,0.0,0.0,0.0,0.0,,0.0,,,0.0,-14.0,0.0,0.0,8355233007.0,184546733863.5,165716820036.0,52021333405.935,1863.0,1706.0,71125.0,70934.0,9141.0,506584.0,,,,,,,128546.0,663480.0,,,,13540737.42739685,-602538777.0,-922806916.0,-296808259.0,-1536717845.0416667,44070.0,30740.0,,,,,,,67550.46063271172,158192.36495848795,126232.8390391664,,,,,,,3717751.0,,,,,,,,,,,,,,,,436899.0,431692.0,,6431.092734002896,632585.0,626133.0,,,,,,,,,54.5,78681823.73999998,,7902709362.404987,2636856113.3550005,92108767.72499998,785629.8449999999,144.0,17246.0,-25970047.0,11528899.0,-13465305.5,-14656947.0,-26.75,0.0,,93325.5,0.0,0.0,0.0,0.0,0.0,-1722.0,-1389.0,-1183.0,-1345.0,278732868.8399999,3970784088.8550034,4464601109.910003,65025999.17999995,3970809984.1050034,289090.0,-19955202.0,4634142483.0,204044541.0,1037957707.0,447890287.0,1087239901.0,286135.0,4517.0,809.0485988440591,6677565.0,2378711.0,1463726.0,-4812854.5,1500814.0,103102.0,3147056267.130143,3175788918.6901164,-191379308.0,-189778819.0,3322516.0,158547.0,2914101972.359969,7873015500.0,,377623654.6049995,,,165014047.4849989,,382334316.65999895,2798004315.2850013,2903382647.23496,2903521540.544959,,33282.0,,,942844.0,-1666803.0,681099.0,1601.0,1468936.0,14838485.0,3235625.0,8564698.0,11619553.0,1417303.0,1060832199.6945012,,72177960778.62715,21696700654.237617,583233287.0669987,5792665.7475,689.5,94245.0,-277202206.5,22011451.5,-123901266.5,-218918182.0,-2023759.0,5927117661.989961,18742279500.0,,448276957.44749767,,,309324672.8774986,,459450723.77999926,5712128314.200034,5890368525.794997,5890611708.539999,,80933.5,,,972227.0,-1700105.0,177364.0,6755.0,4277482.5,2481890.5,-9012835.5,921269.0,37582.5,3737530046.78996,3662206636.612461,-260897112.5,-257581714.0,2528881.5,269491.0,3930170256.629953,33285293781.57092,36716992355.63265,1731566635.582549,48132844540.358215,3992208.5,-247832539.5,103192495746.0,1055723191.5,17288629614.0,3506829673.0,18902837328.0,3675720.5,72010.0,20890.626177955543,89855521.0,-17.889837997054492,6.389333333333332,3.2537960954446854,151.3238047128042,20.789587852494574,966.8582295783436,33750.0,-0.9009688679024191,0.4338837391175582,0.0,1.0,0.0,0.0,0.0,0.0,0.0,0.0,0.0,0.0,0.0,0.0,0.0,1.0,0.0,0.0,0.0,0.0,1.0,0.0,1.0,0.0,0.0,0.0,0.0,1.0,0.0,0.0,0.0,0.0,0.0,0.0,0.0,0.0,0.0,0.0,0.0,0.0,0.0,0.0,0.0,0.0,0.0,0.0,1.0,0.0,0.0,0.0,0.0,0.0,0.0,0.0,0.0,1.0,0.0,0.0,0.0,0.0,0.0,0.0,0.0,0.0,0.0,0.0,0.0,0.0,0.0,0.0,0.0,0.0,0.0,0.0,0.0,0.0,0.0,0.0,0.0,0.0,0.0,0.0,0.0,0.0,0.0,0.0,0.0,0.0,0.0,0.0,0.0,0.0,0.0,0.0,0.0,0.0,0.0,0.0,0.0,0.0,0.0,0.0,0.0,0.0,0.0,0.0,0.0,0.0,0.0,0.0,0.0,0.0,0.0,0.0,0.0,0.0,0.0,0.0,0.0,0.0,0.0,0.0
104815,0,0.0,1.0,1.0,1.0,2.0,180000.0,156384.0,16551.0,135000.0,0.014464,34.035616438356165,-4548.0,-6210.0,-3111.0,18.0,4.0,2.0,2.0,8.0,,0.4734032303199432,0.6496203111237195,0.1784,0.0554,0.9806,0.7348,0.0738,0.04,0.069,0.3333,0.375,0.0839,0.1437,0.0849,0.0077,0.0576,0.1817,0.0575,0.9806,0.7452,0.0745,0.0403,0.069,0.3333,0.375,0.0858,0.157,0.0885,0.0078,0.061,0.1801,0.0554,0.9806,0.7383,0.0743,0.04,0.069,0.3333,0.375,0.0854,0.1462,0.0865,0.0078,0.0588,0.1197,1.0,0.0,0.0,0.0,0.0,-894.0,0.0,0.0,0.0,0.0,1.0,3.0,1.0,1.0,0.0,1.0,0.0,0.0,0.0,0.0,0.0,0.0,0.0,0.0,0.0,0.0,0.0,0.0,0.0,0.0,1.0,0.0,0.0,0.0,0.0,0.0,0.0,0.0,0.0,0.0,0.0,0.0,0.0,0.0,6.0,7501.5,0.0,224127.0,0.0,0.0,0.0,0.0,0.0,-539.0,-208.5,-340.5,-464.0,191.0,-16.0,6.0,35265.2175,112500.0,272272.5,0.0,319545.0,6.0,-585.0,182250.0,-782.0,-540.0,182355.0,182342.5,8.5,0.0,0.0,-1.0,12.0,11.0,5.5,-23.5,0.0,0.0,45.0,2250.0,2250.0,-579.0,-578.0,12.0,0.0,24.0,0.0,765000.0,0.0,0.0,0.0,0.0,0.0,2145.06,2145.06,0.0,0.0,0.0,0.0,0.0,0.0,0.0,7.0,-13.5,0.0,0.0,8355249558.0,184546890247.5,165716955036.0,52021513405.935,1863.0,1706.0,71125.0,70935.0,9141.0,506587.0,17826.804600002306,17889.072799999114,17340.13809999801,11306.939500000091,11244.745800000092,11192.15610000006,128548.0,663484.0,4142.228000000115,4139.926100000012,3950.496100000094,13540771.46301329,-602543325.0,-922810027.0,-296809153.0,-1536724055.0416667,44070.0,30740.0,11360.133999999194,11236.079999998989,10720.12159999729,22911.78550000979,22833.54610000976,22218.41430000832,,158192.83836171826,126233.48865947752,35038.125100027995,34978.24290002843,34423.677000028845,22976.406599995888,22949.441799995468,22596.205899995697,3717759.0,8304.263200000163,8408.909800000072,8132.369400000231,9827.078800000716,9942.108300002155,10302.254999999635,16484.167799999723,16669.5832999997,16266.2794999997,829.2077000001768,814.385000000046,760.3044000000133,3917.587800000124,3900.829800000162,3733.50750000016,436899.0,431692.0,1264426.0,6431.107198002896,632587.0,626135.0,,16348.4848999998,154341.69609999072,154344.43769999026,154236.15959998718,77685.60719999635,78023.72930000661,78425.59200000657,18.5,78689325.23999998,27236390.535,7903690981.154987,2636941300.6050005,92108767.72499998,785629.8449999999,144.0,17246.0,-25976544.5,11524978.5,-13468327.0,-14659370.0,-8.75,3750.75,0.0,234387.0,0.0,0.0,0.0,0.0,0.0,-976.0,-795.0,-587.0,-464.0,278808726.3074999,3972410879.3550034,4466388703.410003,65025999.17999995,3972410879.3550034,289162.0,-19959351.0,4634872597.5,204043327.5,1037956885.5,448072375.5,1087421964.5,286176.5,4518.0,809.0485988440591,6677662.5,2378994.5,1463875.5,-4813862.0,1500814.0,103102.0,3148247262.285141,3176979913.8451147,-191409579.0,-189808869.0,3322926.0,158580.0,2914101972.359969,7883568000.0,243984587.085,377628462.4049995,11964272.535000002,121319589.68999983,165038741.7749989,414817594.694998,382861540.529999,2798004315.2850013,2903382647.23496,2903521540.544959,12552.0,33283.0,165.0,20566.0,942930.5,-1667086.0,681099.0,1601.0,1468942.0,14838676.0,3235649.0,8564710.0,11619598.0,1417309.0,1060839701.1945012,802176966.9899952,72178184905.62715,21696700654.237617,583233287.0669987,5792665.7475,689.5,94245.0,-277202745.5,22011243.0,-123901607.0,-218918646.0,-2023775.0,5927117661.989961,18743044500.0,198877107.825,448276957.44749767,1948107.735,256971504.8025008,309324672.8774986,636987612.2849978,459452868.83999926,5712128314.200034,5890368525.794997,5890611708.539999,13393.5,80933.5,44.0,70433.5,972234.0,-1700118.5,177364.0,6755.0,4277493.5,2481896.0,-9012859.0,921269.0,37582.5,3737532296.78996,3662208886.612461,-260897691.5,-257582292.0,2528893.5,269491.0,3930205521.847455,33285406281.57092,36717264628.13265,1731566635.582549,48133164085.358215,3992214.5,-247833124.5,103192677996.0,1055722409.5,17288629074.0,3507012028.0,18903019670.5,3675729.0,72010.0,20890.626177955543,89855520.0,-133.62472832649118,0.8688,10.87547580206634,370.1535229837538,9.448613376835237,321.5893807682853,45000.0,-0.9009688679024191,-0.433883739117558,0.0,0.0,0.0,0.0,0.0,0.0,1.0,0.0,0.0,0.0,0.0,0.0,0.0,1.0,0.0,0.0,0.0,0.0,1.0,0.0,1.0,0.0,0.0,0.0,0.0,1.0,0.0,0.0,0.0,0.0,0.0,0.0,0.0,1.0,0.0,0.0,0.0,0.0,0.0,0.0,0.0,0.0,0.0,0.0,0.0,0.0,0.0,0.0,0.0,0.0,0.0,0.0,0.0,0.0,0.0,0.0,0.0,0.0,0.0,0.0,0.0,0.0,0.0,0.0,0.0,0.0,0.0,0.0,0.0,0.0,0.0,0.0,0.0,0.0,0.0,0.0,0.0,0.0,0.0,0.0,0.0,0.0,1.0,0.0,0.0,0.0,0.0,0.0,0.0,0.0,0.0,0.0,0.0,0.0,0.0,0.0,0.0,0.0,0.0,0.0,0.0,0.0,0.0,0.0,0.0,0.0,0.0,0.0,1.0,0.0,1.0,0.0,0.0,0.0,0.0,0.0,0.0,0.0,1.0,0.0
104830,0,0.0,1.0,1.0,1.0,0.0,180000.0,495000.0,25402.5,495000.0,0.028663,23.45205479452055,-262.0,-1388.0,-1219.0,25.0,2.0,2.0,2.0,15.0,,0.5380705859834183,0.4561097392782771,0.0928,0.0995,0.9776,0.6940000000000001,0.014,0.0,0.2069,0.1667,0.2083,0.0173,0.0756,0.0868,0.0,0.0,0.0945,0.1033,0.9777,0.706,0.0141,0.0,0.2069,0.1667,0.2083,0.0177,0.0826,0.0905,0.0,0.0,0.0937,0.0995,0.9776,0.6981,0.0141,0.0,0.2069,0.1667,0.2083,0.0176,0.077,0.0884,0.0,0.0,0.0759,1.0,2.0,0.0,2.0,0.0,-1261.0,0.0,0.0,0.0,0.0,0.0,1.0,1.0,1.0,0.0,1.0,0.0,0.0,0.0,0.0,0.0,0.0,0.0,0.0,0.0,1.0,0.0,0.0,0.0,0.0,0.0,0.0,0.0,0.0,0.0,0.0,0.0,0.0,0.0,0.0,0.0,0.0,0.0,0.0,2.0,6300.0,,308650.5,139693.5,0.0,0.0,0.0,0.0,-1016.5,-301.5,-433.0,-885.0,68.0,-16.5,3.0,21818.25,225000.0,225000.0,0.0,225000.0,12.0,-1021.0,365243.0,-990.0,-750.0,-660.0,-746.0,12.0,0.0,0.0,20.0,23.0,12.0,9.0,-30.0,0.0,0.0,20.0,21818.25,21818.25,-930.5,-915.0,4.0,1.0,0.0,,,,,,,,,,,,,,,,,,,,,8355274960.5,184547385247.5,165717450036.0,52021693405.935,1863.0,1706.0,71125.0,70935.0,9141.0,506588.0,17826.897400002304,17889.166499999115,17340.23259999801,11307.039000000092,11244.845300000094,11192.259400000064,128548.0,663486.0,4142.242000000115,4139.940200000014,3950.510200000094,13540794.915068084,-602543587.0,-922811246.0,-296810414.0,-1536725443.0416667,44070.0,30740.0,11360.133999999194,11236.079999998989,10720.12159999729,22911.9924000098,22833.75300000976,22218.62120000832,,158193.37643230427,126233.9447692168,35038.291800028,34978.40960002843,34423.84370002885,22976.61489999589,22949.650099995462,22596.4141999957,3717774.0,8304.280500000164,8408.927400000071,8132.387100000233,9827.154400000716,9942.185300002157,10302.337599999635,16484.254599999724,16669.6716999997,16266.3699999997,829.2077000001768,814.385000000046,760.3044000000133,3917.587800000124,3900.829800000162,3733.50750000016,436901.0,431694.0,1264451.0,6431.135861002896,632589.0,626137.0,,16348.5607999998,154342.6736999907,154345.41529999027,154237.13729998714,77686.30119999635,78024.4274000066,78426.29800000659,34.0,78774520.81499995,,7922816775.674988,2644573884.3450003,92200450.67999998,785629.8449999999,144.0,17246.0,-26042074.0,11534022.5,-13499952.5,-14689963.0,-16.5,6300.0,,50301.0,0.0,0.0,0.0,0.0,0.0,-1101.0,-766.0,-859.0,-885.0,279486857.9249999,3981382681.545003,4476745568.700003,65167156.07999994,3981382681.545003,289937.0,-20001935.0,4647655237.0,204747639.0,1040495126.0,449339096.0,1089777983.0,287050.0,4531.0,810.724994902229,6685388.0,2383961.0,1467079.0,-4821118.0,1500841.0,103129.0,3154363366.815141,3183578689.5001154,-191622882.0,-190017646.0,3325885.0,158897.5,,,,,,,,,,,,,,,,,,,,,1468944.0,14838744.0,3235649.0,8564733.0,11619618.0,1417312.0,1060846001.1945012,,72178493556.12715,21696840347.737617,583233287.0669987,5792665.7475,689.5,94245.0,-277203762.0,22010941.5,-123902040.0,-218919531.0,-2023791.5,,,,,,,,,,,,,,,,,,,,,4277505.5,2481905.0,-9012889.0,921269.0,37582.5,3737554115.03996,3662230704.862461,-260898622.0,-257583207.0,2528897.5,269492.0,3930227340.097455,33285631281.57092,36717489628.13265,1731566635.582549,48133389085.358215,3992226.5,-247834145.5,103193043239.0,1055721419.5,17288628324.0,3507011368.0,18903018924.5,3675741.0,72010.0,20890.626177955543,89855540.0,-11.171728971962615,2.75,7.085916740478298,166.1793076671075,19.486271036315323,456.9930960845457,90000.0,-0.9009688679024191,0.4338837391175582,0.0,1.0,0.0,0.0,0.0,0.0,0.0,0.0,1.0,0.0,0.0,0.0,0.0,0.0,0.0,0.0,0.0,0.0,1.0,1.0,0.0,0.0,0.0,0.0,0.0,1.0,0.0,0.0,0.0,0.0,0.0,0.0,0.0,0.0,0.0,0.0,0.0,0.0,1.0,0.0,0.0,0.0,0.0,0.0,0.0,0.0,0.0,0.0,0.0,0.0,0.0,0.0,0.0,1.0,0.0,0.0,0.0,0.0,0.0,0.0,0.0,0.0,0.0,0.0,0.0,0.0,0.0,0.0,0.0,0.0,0.0,0.0,0.0,0.0,0.0,0.0,0.0,0.0,0.0,0.0,0.0,0.0,0.0,0.0,0.0,0.0,0.0,0.0,0.0,0.0,0.0,0.0,0.0,0.0,0.0,0.0,0.0,0.0,0.0,0.0,0.0,0.0,0.0,0.0,0.0,0.0,0.0,0.0,1.0,0.0,1.0,0.0,0.0,0.0,0.0,0.0,0.0,1.0,0.0,0.0
104831,0,0.0,1.0,1.0,1.0,0.0,337500.0,339633.0,31279.5,283500.0,0.04622,25.63561643835617,-1099.0,-4154.0,-2018.0,7.0,1.0,1.0,1.0,16.0,0.1414495744600326,0.3751193954120754,0.4101025731788671,,,,,,,,,,,,,,,,,,,,,,,,,,,,,,,,,,,,,,,,,,,,,1.0,0.0,1.0,0.0,-1138.0,0.0,0.0,0.0,0.0,1.0,6.0,1.0,1.0,0.0,1.0,0.0,0.0,0.0,1.0,1.0,0.0,0.0,0.0,0.0,1.0,0.0,0.0,0.0,0.0,0.0,0.0,0.0,0.0,0.0,0.0,0.0,0.0,0.0,0.0,0.0,0.0,0.0,0.0,6.0,0.0,0.0,270000.0,14571.0,0.0,0.0,0.0,0.0,-719.0,-84.0,-193.0,-534.0,149.0,-12.0,43.0,4611.555,0.0,0.0,0.0,52155.0,10.0,-564.0,365243.0,-860.0,-590.0,-590.0,-586.0,14.0,0.0,0.0,-1.0,24.0,10.0,6.0,-26.5,0.0,0.0,22.0,10852.8075,10852.8075,-773.0,-755.0,4.0,1.0,0.0,,,,,,,,,,,,,,,,,,,,,8355306240.0,184547724880.5,165717733536.0,52022030905.935,1863.0,1706.0,71125.0,70936.0,9141.0,506594.0,,,,,,,128548.0,663487.0,,,,13540820.550684525,-602544686.0,-922813264.0,-296811552.0,-1536729597.0416667,44070.0,30740.0,,,,,,,67550.60208228618,158193.75155169965,126234.35487178994,,,,,,,3717790.0,,,,,,,,,,,,,,,,436902.0,431695.0,1264458.0,6431.182081002896,632590.0,626138.0,,,,,,,,,24.0,78824457.31499995,27260637.25499999,7925261733.674988,2646085726.8450003,92200450.67999998,785629.8449999999,144.0,17246.0,-26044699.5,11534082.0,-13500716.0,-14690843.0,-11.5,0.0,0.0,225000.0,0.0,0.0,0.0,0.0,0.0,-801.0,-255.0,-340.0,-534.0,279513228.5549999,3981671469.045003,4477054331.700003,65168281.07999994,3981682264.545003,289971.0,-20013997.0,4648750966.0,204744444.0,1040492561.0,449336831.0,1089775436.0,287386.0,4531.0,810.7768366248628,6685483.0,2384216.0,1467246.0,-4821808.0,1500841.0,103129.0,3154863891.84764,3184079214.532613,-191641346.5,-190035798.0,3325980.0,158920.5,,,,,,,,,,,,,,,,,,,,,1468950.0,14838893.0,3235649.0,8564757.0,11619640.0,1417355.0,1060846001.1945012,802176966.9899952,72178763556.12715,21696854918.737617,583233287.0669987,5792665.7475,689.5,94245.0,-277204481.0,22010857.5,-123902233.0,-218920065.0,-2023803.5,,,,,,,,,,,,,,,,,,,,,4277515.5,2481911.0,-9012915.5,921269.0,37582.5,3737564967.84746,3662241557.669961,-260899395.0,-257583962.0,2528901.5,269493.0,3930231951.652455,33285631281.57092,36717489628.13265,1731566635.582549,48133441240.358215,3992236.5,-247834709.5,103193408482.0,1055720559.5,17288627734.0,3507010778.0,18903018338.5,3675755.0,72010.0,20890.626177955543,89855539.0,-42.87004381746287,1.00632,10.789814415192057,276.6035437889098,10.858006042296074,278.35167818565566,337500.0,-0.9009688679024191,-0.433883739117558,0.0,0.0,0.0,0.0,0.0,0.0,1.0,0.0,1.0,0.0,0.0,0.0,0.0,0.0,0.0,0.0,0.0,0.0,1.0,0.0,0.0,0.0,1.0,0.0,0.0,1.0,0.0,0.0,0.0,0.0,0.0,0.0,0.0,0.0,1.0,0.0,0.0,0.0,0.0,0.0,0.0,0.0,0.0,0.0,0.0,0.0,0.0,0.0,0.0,0.0,0.0,0.0,1.0,0.0,0.0,0.0,0.0,0.0,0.0,0.0,0.0,0.0,0.0,0.0,0.0,0.0,0.0,0.0,0.0,0.0,0.0,0.0,0.0,0.0,0.0,0.0,0.0,0.0,0.0,0.0,0.0,0.0,0.0,0.0,0.0,0.0,0.0,0.0,0.0,0.0,0.0,0.0,0.0,0.0,0.0,0.0,0.0,0.0,0.0,0.0,0.0,0.0,0.0,0.0,0.0,0.0,0.0,0.0,0.0,0.0,0.0,0.0,0.0,0.0,0.0,0.0,0.0,0.0,0.0,0.0
104833,0,0.0,1.0,1.0,1.0,1.0,360000.0,345384.0,36396.0,324000.0,0.006207,31.75342465753425,-4099.0,-10510.0,-3720.0,11.0,2.0,2.0,2.0,10.0,0.541540941168562,0.5420792147293012,0.25533177083329,0.0763,,0.9856,,,,0.0345,0.1667,,,,0.047,,,0.0777,,0.9856,,,,0.0345,0.1667,,,,0.0489,,,0.077,,0.9856,,,,0.0345,0.1667,,,,0.0478,,,0.0369,1.0,0.0,0.0,0.0,0.0,-2904.0,0.0,0.0,0.0,0.0,1.0,3.0,1.0,1.0,0.0,1.0,0.0,1.0,0.0,0.0,0.0,0.0,0.0,0.0,0.0,0.0,0.0,0.0,0.0,0.0,1.0,0.0,0.0,0.0,0.0,0.0,0.0,0.0,0.0,0.0,0.0,0.0,0.0,0.0,7.0,14559.75,0.0,45814.5,0.0,0.0,0.0,0.0,0.0,-781.0,-498.0,-495.0,-599.0,229.0,-19.0,15.0,4256.55,21478.5,20506.5,2198.25,38632.5,10.0,-451.0,365243.0,-899.5,-659.5,-659.5,-655.5,17.0,0.0,0.1029041203293322,-1.0,71.0,12.0,6.0,-22.0,0.0,0.0,69.0,4250.745,4186.98,-624.0,-605.0,5.0,1.0,14.0,0.0,180000.0,,0.0,,,0.0,,0.0,0.0,0.0,0.0,,0.0,,,0.0,-8.5,0.0,0.0,8355342636.0,184548070264.5,165718057536.0,52022390905.935,1863.0,1706.0,71125.0,70937.0,9141.0,506597.0,17826.973700002305,17889.243499999116,17340.31029999801,,,,128549.0,663489.0,,,,13540852.30410918,-602548785.0,-922816984.0,-296814456.0,-1536740107.0416667,44070.0,30740.0,,,,22912.026900009794,22833.78750000976,22218.65570000832,67551.14362322734,158194.29363091438,126234.6102035608,35038.458500028,34978.576300028435,34424.01040002885,,,,3717800.0,,,,,,,16484.301599999722,16669.7194999997,16266.4188999997,,,,,,,436902.0,431695.0,1264469.0,6431.188288002895,632592.0,626140.0,,16348.597699999797,154343.65929999072,154346.4008999903,154238.12289998718,,,,26.0,78877870.06499995,27260637.25499999,7928550320.174988,2647966699.8450003,92200450.67999998,785629.8449999999,144.0,17246.0,-26052026.0,11564722.0,-13502960.0,-14694045.0,-12.5,14559.75,0.0,39312.0,0.0,0.0,0.0,0.0,0.0,-1431.0,-700.0,-591.0,-700.0,279569414.24999994,3982439421.045003,4477865830.200003,65194329.32999994,3982439421.045003,290059.0,-20033639.0,4651125045.5,204742920.5,1041221066.0,449336642.5,1090503950.5,287821.0,4534.5,811.329851288517,6688859.0,2384977.0,1467767.0,-4823198.0,1500841.0,103129.0,3155501842.920136,3184950854.430109,-191681073.0,-190075098.0,3326249.0,159015.0,2920542087.554968,7908835500.0,,379287155.29499936,,,165299025.059999,,383797821.0599991,2804225113.170002,2909774312.234959,2909913205.5449576,,33402.0,,,943082.0,-1667546.0,681099.0,1601.0,1468957.0,14839122.0,3235663.0,8564828.0,11619709.0,1417370.0,1060860560.9445012,802176966.9899952,72178809370.62715,21696854918.737617,583233287.0669987,5792665.7475,689.5,94245.0,-277205262.0,22010359.5,-123902728.0,-218920664.0,-2023822.5,5927117661.989961,18743224500.0,,448276957.44749767,,,309324672.8774986,,459452868.83999926,5712128314.200034,5890368525.794997,5890611708.539999,,80933.5,,,972234.0,-1700127.0,177364.0,6755.0,4277527.5,2481917.0,-9012937.5,921269.0,37582.5,3737569218.59246,3662245744.649961,-260900019.0,-257584567.0,2528906.5,269494.0,3930236208.202455,33285652760.07092,36717510134.63265,1731568833.832549,48133479872.858215,3992246.5,-247835160.5,103193773725.0,1055719660.0,17288627074.5,3507010118.5,18903017683.0,3675772.0,72010.0,20890.729082075868,89855538.0,-129.08843830888694,0.9594,9.891196834817013,314.0793734672032,9.489614243323444,301.3277509044348,180000.0,-0.9009688679024191,-0.433883739117558,0.0,0.0,0.0,0.0,0.0,0.0,1.0,0.0,0.0,0.0,0.0,0.0,0.0,1.0,0.0,0.0,0.0,0.0,1.0,0.0,0.0,0.0,1.0,0.0,0.0,1.0,0.0,0.0,0.0,0.0,0.0,0.0,0.0,0.0,1.0,0.0,0.0,0.0,0.0,0.0,0.0,0.0,0.0,0.0,0.0,0.0,0.0,0.0,0.0,0.0,0.0,0.0,0.0,1.0,0.0,0.0,0.0,0.0,0.0,0.0,0.0,0.0,0.0,0.0,0.0,0.0,0.0,0.0,0.0,0.0,0.0,0.0,0.0,0.0,0.0,0.0,0.0,0.0,0.0,0.0,0.0,0.0,0.0,0.0,0.0,0.0,0.0,0.0,0.0,0.0,0.0,0.0,0.0,0.0,0.0,0.0,0.0,0.0,0.0,0.0,0.0,0.0,0.0,0.0,0.0,0.0,0.0,0.0,0.0,0.0,1.0,0.0,0.0,0.0,0.0,0.0,0.0,0.0,1.0,0.0
104839,0,0.0,0.0,0.0,1.0,1.0,315000.0,526837.5,18121.5,337500.0,0.010006,41.49315068493151,-8516.0,-7453.0,-4227.0,,2.0,2.0,2.0,15.0,0.8200695006448429,0.6496258475162829,0.4118485559242397,0.0144,0.0418,0.9891,0.8504,0.0035,0.0,0.069,0.0417,0.0833,0.0614,0.0118,0.0142,0.0,0.0,0.0147,0.0434,0.9891,0.8563,0.0035,0.0,0.069,0.0417,0.0833,0.0628,0.0129,0.0148,0.0,0.0,0.0146,0.0418,0.9891,0.8524,0.0035,0.0,0.069,0.0417,0.0833,0.0624,0.012,0.0145,0.0,0.0,0.0127,1.0,1.0,1.0,1.0,1.0,-1799.0,0.0,0.0,0.0,0.0,2.0,5.0,1.0,1.0,0.0,1.0,0.0,1.0,0.0,0.0,0.0,0.0,0.0,0.0,0.0,1.0,0.0,0.0,0.0,0.0,0.0,0.0,0.0,0.0,0.0,0.0,0.0,0.0,0.0,0.0,0.0,0.0,0.0,0.0,9.0,0.0,4014.0,630000.0,0.0,0.0,0.0,0.0,0.0,-635.0,96.0,-209.0,-327.0,254.0,-15.0,8.0,33022.4625,328702.5,362261.25,0.0,328702.5,12.0,-688.5,365243.0,-1006.0,-300.0,-142.0,-297.0,11.5,1.0,0.0,-1.0,57.0,18.0,8.0,-26.0,0.0,0.0,55.0,49626.0,49626.0,-737.0,-736.0,7.0,1.0,0.0,,,,,,,,,,,,,,,,,,,,,8355360757.5,184548597102.0,165718395036.0,52022705905.935,1863.0,1706.0,71125.0,70939.0,9141.0,506602.0,17826.988100002305,17889.258099999115,17340.32499999801,11307.080800000092,11244.887100000093,11192.302800000063,128550.0,663491.0,4142.245500000115,4139.9437000000125,3950.513700000093,13540893.797259863,-602557301.0,-922821211.0,-296816255.0,-1536747560.0416667,44071.0,30741.0,11360.133999999194,11236.079999998989,10720.12159999729,22912.095900009797,22833.856500009755,22218.72470000832,67551.96369272798,158194.9432567619,126235.02205211676,35038.500200028,34978.61800002844,34424.05210002885,22976.698199995888,22949.733399995464,22596.497499995698,3717815.0,8304.341900000163,8408.989800000072,8132.449900000231,9827.166200000716,9942.197300002155,10302.350499999637,16484.315799999724,16669.733999999702,16266.4336999997,829.2077000001768,814.385000000046,760.3044000000133,3917.587800000124,3900.829800000162,3733.50750000016,436903.0,431696.0,,6431.198294002896,632594.0,626142.0,,16348.610399999798,154344.64839999072,154347.3899999903,154239.11199998722,77687.15159999634,78025.27980000661,78427.15430000659,21.0,78892429.81499995,27264678.07499999,7935205373.324987,2650509924.3450003,92613303.17999998,785629.8449999999,144.0,17246.0,-26080884.0,11615030.0,-13517684.0,-14709100.0,-10.0,0.0,4014.0,480937.5,0.0,0.0,0.0,0.0,0.0,-1259.0,-327.0,-311.0,-327.0,279899838.72,3986163751.995003,4482104146.200003,65259645.02999994,3986163751.995003,290343.0,-20057957.0,4657516049.0,205085478.0,1042300489.0,450051946.0,1091583466.0,288204.0,4539.0,812.1544007357111,6692727.5,2387961.0,1469579.0,-4829601.0,1500841.0,103129.0,3159944946.090139,3189487121.235112,-191877589.0,-190268650.0,3328823.0,159204.0,,,,,,,,,,,,,,,,,,,,,1468966.0,14839376.0,3235663.0,8564885.0,11619764.0,1417378.0,1060860560.9445012,802180980.9899952,72179439370.62715,21696854918.737617,583233287.0669987,5792665.7475,689.5,94245.0,-277205897.0,22010455.5,-123902937.0,-218920991.0,-2023837.5,,,,,,,,,,,,,,,,,,,,,4277545.5,2481925.0,-9012963.5,921269.0,37582.5,3737618844.59246,3662295370.649961,-260900756.0,-257585303.0,2528913.5,269495.0,3930269230.664954,33285981462.57092,36717872395.88265,1731568833.832549,48133808575.358215,3992258.5,-247835849.0,103194138968.0,1055718654.0,17288626774.5,3507009976.5,18903017386.0,3675783.5,72011.0,20890.729082075868,89855537.0,-205.23869263783428,1.6725,17.382666997765085,721.2616210442526,29.072510553762108,1206.3100611965124,157500.0,-0.2225209339563143,0.9749279121818236,0.0,0.0,0.0,0.0,0.0,0.0,1.0,0.0,0.0,0.0,0.0,0.0,0.0,1.0,0.0,1.0,0.0,0.0,0.0,0.0,0.0,1.0,0.0,0.0,0.0,1.0,0.0,0.0,0.0,0.0,0.0,0.0,0.0,0.0,0.0,0.0,0.0,0.0,0.0,0.0,0.0,0.0,0.0,0.0,0.0,0.0,0.0,0.0,0.0,0.0,0.0,0.0,0.0,0.0,0.0,0.0,0.0,0.0,0.0,0.0,0.0,0.0,0.0,0.0,0.0,0.0,0.0,0.0,0.0,0.0,0.0,0.0,0.0,0.0,0.0,0.0,0.0,0.0,0.0,0.0,0.0,1.0,0.0,0.0,0.0,0.0,0.0,0.0,0.0,0.0,0.0,0.0,0.0,0.0,0.0,0.0,0.0,0.0,0.0,0.0,0.0,0.0,0.0,0.0,0.0,0.0,0.0,0.0,1.0,0.0,1.0,0.0,0.0,0.0,0.0,0.0,1.0,0.0,0.0,0.0
104840,0,0.0,0.0,0.0,1.0,0.0,90000.0,174132.0,18283.5,157500.0,0.025164,24.046575342465754,-963.0,-6374.0,-1446.0,,1.0,2.0,2.0,12.0,0.3802855522350143,0.4686085767322271,0.6738300778602003,,,,,,,,,,,,,,,,,,,,,,,,,,,,,,,,,,,,,,,,,,,,,0.0,0.0,0.0,0.0,-727.0,0.0,0.0,0.0,0.0,0.0,2.0,1.0,1.0,0.0,1.0,1.0,0.0,0.0,0.0,0.0,0.0,0.0,0.0,0.0,0.0,0.0,0.0,0.0,0.0,1.0,0.0,0.0,0.0,0.0,0.0,0.0,0.0,0.0,0.0,0.0,0.0,0.0,0.0,5.0,0.0,,42363.0,0.0,0.0,0.0,0.0,0.0,-941.0,-299.0,-311.0,-704.0,147.0,-14.0,1.0,4969.845,49216.5,48969.0,4923.0,49216.5,12.0,-727.0,365243.0,-696.0,-366.0,-366.0,-362.0,12.0,0.0,0.099487763405599,40.0,13.0,12.0,6.0,-18.0,0.0,0.0,12.0,4969.845,4969.845,-541.0,-531.0,6.5,1.0,0.0,,,,,,,,,,,,,,,,,,,,,8355379041.0,184548771234.0,165718552536.0,52022795905.935,1863.0,1706.0,71125.0,70939.0,9141.0,506604.0,,,,,,,128550.0,663492.0,,,,13540917.843835209,-602558264.0,-922822657.0,-296816982.0,-1536753934.0416667,44071.0,30741.0,,,,,,,67552.34397828023,158195.41186533865,126235.6958821946,,,,,,,3717827.0,,,,,,,,,,,,,,,,436903.0,431696.0,,6431.223458002895,632596.0,626144.0,,,,,,,,,31.0,78989256.49499996,,7938708893.324987,2651527018.8450003,92613303.17999998,785629.8449999999,144.0,17246.0,-26086417.0,11614061.0,-13519504.0,-14711246.0,-15.0,0.0,,42363.0,0.0,0.0,0.0,0.0,0.0,-941.0,-299.0,-311.0,-704.0,280040487.345,3988082920.995003,4484391500.700003,65264568.02999994,3988082920.995003,290427.0,-20062456.0,4658611778.0,205082007.0,1042298308.0,450050185.0,1091581299.0,288256.0,4541.0,812.2538884991168,6692836.0,2388790.0,1470050.0,-4830713.0,1500841.0,103129.0,3161405403.832638,3190808426.827611,-191906926.0,-190297730.0,3329227.5,159238.5,,,,,,,,,,,,,,,,,,,,,1468971.0,14839523.0,3235663.0,8564898.0,11619776.0,1417379.0,1060860560.9445012,,72179481733.62715,21696854918.737617,583233287.0669987,5792665.7475,689.5,94245.0,-277206838.0,22010156.5,-123903248.0,-218921695.0,-2023851.5,,,,,,,,,,,,,,,,,,,,,4277557.5,2481931.0,-9012981.5,921269.0,37582.5,3737623814.43746,3662300340.49496,-260901297.0,-257585834.0,2528920.0,269496.0,3930274200.5099545,33286030679.07092,36717921364.88265,1731573756.832549,48133857791.858215,3992270.5,-247836576.0,103194504211.0,1055717958.0,17288626408.5,3507009610.5,18903017024.0,3675795.5,72011.0,20890.82856983928,89855577.0,-40.04728267061638,1.9348,4.922471080482403,118.36857170792888,9.523997046517351,229.0195125405008,90000.0,-0.9009688679024191,-0.433883739117558,0.0,0.0,0.0,0.0,0.0,0.0,1.0,0.0,0.0,0.0,0.0,0.0,0.0,1.0,0.0,0.0,1.0,0.0,0.0,0.0,0.0,0.0,1.0,0.0,0.0,1.0,0.0,0.0,0.0,0.0,0.0,0.0,0.0,1.0,0.0,0.0,0.0,0.0,0.0,0.0,0.0,0.0,0.0,0.0,0.0,0.0,0.0,0.0,0.0,0.0,0.0,0.0,0.0,0.0,0.0,0.0,0.0,0.0,0.0,0.0,0.0,0.0,0.0,0.0,0.0,0.0,0.0,0.0,0.0,0.0,0.0,0.0,0.0,0.0,0.0,0.0,0.0,0.0,0.0,0.0,0.0,0.0,0.0,0.0,0.0,0.0,0.0,1.0,0.0,0.0,0.0,0.0,0.0,0.0,0.0,0.0,0.0,0.0,0.0,0.0,0.0,0.0,0.0,0.0,0.0,0.0,0.0,0.0,0.0,0.0,0.0,0.0,0.0,0.0,0.0,0.0,0.0,0.0,0.0,0.0
104860,0,0.0,1.0,1.0,1.0,1.0,157500.0,550980.0,43659.0,450000.0,0.003069,41.81643835616438,-1836.0,-358.0,-587.0,9.0,3.0,3.0,3.0,17.0,0.6390610671966463,0.3582667859944271,0.6263042766749393,0.1959,0.103,0.9776,,,0.0,0.1724,0.1667,,0.0575,,0.0523,,0.0,0.1996,0.1069,0.9777,,,0.0,0.1724,0.1667,,0.0588,,0.0545,,0.0,0.1978,0.103,0.9776,,,0.0,0.1724,0.1667,,0.0585,,0.0532,,0.0,0.0869,1.0,0.0,0.0,0.0,0.0,-8.0,0.0,0.0,0.0,0.0,2.0,0.0,1.0,1.0,0.0,1.0,0.0,0.0,0.0,0.0,0.0,0.0,0.0,0.0,0.0,1.0,0.0,0.0,0.0,0.0,0.0,0.0,0.0,0.0,0.0,0.0,0.0,0.0,0.0,0.0,0.0,0.0,0.0,0.0,1.0,0.0,,80280.0,0.0,,0.0,0.0,0.0,-470.0,-269.0,-246.0,-269.0,16.0,-7.5,4.0,13783.725,112234.5,114655.5,4005.0,112234.5,9.0,-388.0,365243.0,-415.0,-265.0,-265.0,-256.0,16.5,0.5,0.0497287471949714,158.0,15.0,6.0,3.0,-12.0,0.0,0.0,16.0,18180.18,13914.18,-345.0,-340.0,4.0,1.0,0.0,,,,,,,,,,,,,,,,,,,,,8355422700.0,184549322214.0,165719002536.0,52022953405.935,1863.0,1706.0,71125.0,70941.0,9141.0,506604.0,17827.184000002304,17889.455899999117,17340.52459999801,11307.183800000092,11244.990100000094,11192.409700000064,128551.0,663495.0,,,,13540959.660273563,-602560100.0,-922823244.0,-296816990.0,-1536754292.0416667,44071.0,30741.0,11360.133999999194,11236.079999998989,10720.12159999729,22912.268300009797,22834.028900009755,22218.89710000832,67552.98303934741,158195.77013212466,126236.32218647128,35038.666900027994,34978.78470002844,34424.218800028844,,,,3717844.0,8304.399400000164,8409.048300000071,8132.508700000232,,,,16484.368099999723,16669.7871999997,16266.4881999997,,,,3917.587800000124,3900.829800000162,3733.50750000016,436903.0,431696.0,1264478.0,6431.226527002896,632599.0,626147.0,,16348.697299999798,154345.62599999073,154348.3675999903,154240.08969998718,,,,16.0,79055059.99499996,,7979579244.224987,2659268235.15,,785629.8449999999,144.0,17246.0,-26283962.0,11560446.0,-13623050.0,-14825233.0,-7.5,0.0,,80280.0,0.0,,0.0,0.0,0.0,-470.0,-269.0,-246.0,-269.0,281182467.9825,4003631446.950004,4501218181.095003,65571455.33999994,4003631446.950004,291571.0,-20151133.0,4678878893.5,206113363.5,1047363516.5,451836711.5,1097013011.0,289467.0,4560.5,816.2038552385728,6727826.0,2397921.0,1475530.0,-4851722.0,1500843.0,103131.0,3172496239.4176345,3201915486.2176137,-192694723.5,-191078295.5,3343529.0,159880.5,,,,,,,,,,,,,,,,,,,,,1468972.0,14839539.0,3235663.0,8564913.0,11619792.0,1417383.0,1060860560.9445012,,72179562013.62715,21696854918.737617,,5792665.7475,689.5,94245.0,-277207308.0,22009887.5,-123903494.0,-218921964.0,-2023859.0,,,,,,,,,,,,,,,,,,,,,4277563.5,2481934.0,-9012993.5,921269.0,37582.5,3737641994.6174593,3662314254.67496,-260901642.0,-257586174.0,2528924.0,269497.0,3930287984.234953,33286142913.57092,36718036020.38265,1731577761.832549,48133970026.358215,3992279.5,-247836964.0,103194869454.0,1055717543.0,17288626143.5,3507009345.5,18903016768.0,3675812.0,72011.5,20890.87829858647,89855735.0,-43.906178339775934,3.498285714285714,3.6075036075036073,150.85295222281522,12.620078334364049,527.7267277189,52500.0,-0.9009688679024191,0.4338837391175582,0.0,1.0,0.0,0.0,0.0,0.0,0.0,0.0,1.0,0.0,0.0,0.0,0.0,0.0,0.0,0.0,0.0,0.0,1.0,0.0,1.0,0.0,0.0,0.0,0.0,1.0,0.0,0.0,0.0,0.0,0.0,0.0,0.0,0.0,0.0,0.0,0.0,0.0,1.0,0.0,0.0,0.0,0.0,0.0,0.0,0.0,0.0,0.0,0.0,0.0,0.0,0.0,0.0,1.0,0.0,0.0,0.0,0.0,0.0,0.0,0.0,0.0,0.0,0.0,0.0,0.0,0.0,0.0,0.0,0.0,0.0,0.0,0.0,0.0,0.0,0.0,0.0,0.0,0.0,0.0,0.0,0.0,0.0,0.0,0.0,0.0,0.0,0.0,0.0,0.0,0.0,0.0,0.0,0.0,0.0,0.0,0.0,0.0,0.0,0.0,0.0,0.0,0.0,0.0,0.0,0.0,0.0,0.0,0.0,0.0,1.0,0.0,0.0,0.0,0.0,0.0,0.0,1.0,0.0,0.0
104861,0,0.0,0.0,0.0,1.0,0.0,180000.0,512446.5,28741.5,463500.0,0.032561,56.6958904109589,-2926.0,-14837.0,-3425.0,,2.0,1.0,1.0,12.0,0.8872823306590727,0.6770881303940531,0.175605979469379,0.1103,0.1735,0.9732,0.6328,0.0237,0.0,0.2414,0.1667,0.2083,0.0833,0.0841,0.1233,0.027,0.052,0.1124,0.18,0.9732,0.6472,0.0239,0.0,0.2414,0.1667,0.2083,0.0852,0.0918,0.1284,0.0272,0.0551,0.1114,0.1735,0.9732,0.6377,0.0239,0.0,0.2414,0.1667,0.2083,0.0848,0.0855,0.1255,0.0272,0.0531,0.1083,1.0,3.0,0.0,3.0,0.0,-1777.0,0.0,0.0,0.0,0.0,1.0,0.0,1.0,1.0,0.0,1.0,1.0,1.0,0.0,0.0,0.0,0.0,0.0,0.0,0.0,1.0,0.0,0.0,0.0,0.0,0.0,0.0,0.0,0.0,0.0,0.0,0.0,0.0,0.0,0.0,0.0,0.0,0.0,0.0,5.0,13842.0,0.0,675000.0,31918.5,0.0,0.0,0.0,0.0,-525.0,923.0,-18.0,-151.0,97.0,-9.0,1.0,19903.095,162130.5,145917.0,16213.5,162130.5,10.0,-1777.0,365243.0,-1699.0,-1489.0,-1429.0,-1482.0,17.0,0.0,0.1089121137265687,724.0,11.0,8.0,5.0,-54.0,0.0,0.0,8.0,19903.095,19903.095,-1654.5,-1594.0,4.5,1.0,0.0,,,,,,,,,,,,,,,,,,,,,8355451441.5,184549834660.5,165719466036.0,52023133405.935,1863.0,1706.0,71125.0,70942.0,9141.0,506604.0,17827.294300002304,17889.56729999912,17340.636999998012,11307.357300000092,11245.163600000093,11192.589700000064,128551.0,663497.0,4142.269200000114,4139.967600000014,3950.537600000094,13541016.356163977,-602563026.0,-922826669.0,-296818767.0,-1536769129.0416667,44071.0,30741.0,11360.133999999194,11236.079999998989,10720.12159999729,22912.50970000979,22834.27030000976,22219.13850000832,67553.87032167807,158196.44722025507,126236.49779245074,35038.833600028,34978.95140002844,34424.385500028846,22976.90649999589,22949.941699995463,22596.7057999957,3717856.0,8304.482700000164,8409.133100000072,8132.593900000234,9827.250300000716,9942.282800002156,10302.442299999637,16484.491399999722,16669.9126999997,16266.6165999997,829.234700000177,814.412200000046,760.3316000000133,3917.639800000123,3900.882900000162,3733.56260000016,436906.0,431699.0,,6431.259088002896,632600.0,626148.0,,16348.805599999798,154346.59919999074,154349.34079999028,154241.06289998716,77687.78439999635,78025.91750000662,78427.80150000661,18.0,79076286.49499996,27341267.355,7980375744.224987,2659300153.65,93977102.83499998,785629.8449999999,144.0,17246.0,-26285244.0,11571721.0,-13623315.0,-14825384.0,-8.5,27657.0,0.0,1125000.0,0.0,0.0,0.0,0.0,0.0,-692.0,923.0,-18.0,-151.0,281230971.88500005,4003957363.950004,4501533028.095003,65593737.08999994,4003957363.950004,291593.0,-20153453.0,4679426758.0,206111505.0,1047361943.0,451835198.0,1097011450.0,289508.0,4561.0,816.3624960994945,6728669.0,2398017.0,1475566.0,-4852093.0,1500843.0,103131.0,3172790701.282632,3202165051.537612,-192703785.0,-191087088.5,3343582.5,159893.5,,,,,,,,,,,,,,,,,,,,,1468977.0,14839636.0,3235663.0,8564924.0,11619800.0,1417384.0,1060874402.9445012,802180980.9899952,72180237013.62715,21696886837.237617,583233287.0669987,5792665.7475,689.5,94245.0,-277207833.0,22010810.5,-123903512.0,-218922115.0,-2023868.0,,,,,,,,,,,,,,,,,,,,,4277571.5,2481939.0,-9013047.5,921269.0,37582.5,3737661897.71246,3662334157.76996,-260903296.5,-257587768.0,2528928.5,269498.0,3930307887.3299537,33286305044.07092,36718181937.38265,1731593975.332549,48134132156.858215,3992289.5,-247838741.0,103195234697.0,1055715844.0,17288624654.5,3507007916.5,18903015286.0,3675829.0,72011.5,20890.9872107002,89856459.0,-51.6086788441094,2.846925,6.262721152340692,355.07055212750214,17.829497416627525,1010.859231615589,90000.0,-0.9009688679024191,-0.433883739117558,0.0,0.0,0.0,0.0,0.0,1.0,0.0,0.0,1.0,0.0,0.0,0.0,0.0,0.0,0.0,1.0,0.0,0.0,0.0,0.0,1.0,0.0,0.0,0.0,0.0,1.0,0.0,0.0,0.0,0.0,0.0,0.0,0.0,0.0,0.0,0.0,0.0,0.0,0.0,0.0,0.0,0.0,0.0,0.0,0.0,0.0,0.0,0.0,0.0,0.0,0.0,0.0,0.0,0.0,0.0,0.0,0.0,0.0,0.0,0.0,1.0,0.0,0.0,0.0,0.0,0.0,0.0,0.0,0.0,0.0,0.0,0.0,0.0,0.0,0.0,0.0,0.0,0.0,0.0,0.0,0.0,0.0,0.0,0.0,0.0,0.0,0.0,0.0,0.0,0.0,0.0,0.0,0.0,0.0,0.0,0.0,0.0,0.0,0.0,0.0,0.0,0.0,0.0,0.0,0.0,0.0,0.0,0.0,1.0,0.0,1.0,0.0,0.0,0.0,0.0,0.0,0.0,0.0,1.0,0.0
104866,0,0.0,0.0,0.0,1.0,1.0,130500.0,1037128.5,44073.0,927000.0,0.016612,36.890410958904106,-4262.0,-590.0,-5088.0,,2.0,2.0,2.0,15.0,0.4753715786772471,0.5743805419798349,,0.0278,0.0412,0.9856,0.8028,0.0036,0.0,0.1034,0.0833,0.0417,0.0352,0.0227,0.0251,0.0,0.0,0.0284,0.0427,0.9856,0.8105,0.0036,0.0,0.1034,0.0833,0.0417,0.036,0.0248,0.0261,0.0,0.0,0.0281,0.0412,0.9856,0.8054,0.0036,0.0,0.1034,0.0833,0.0417,0.0359,0.0231,0.0255,0.0,0.0,0.0288,1.0,6.0,0.0,5.0,0.0,-489.0,,,,,,,1.0,1.0,0.0,1.0,0.0,0.0,0.0,0.0,0.0,0.0,0.0,0.0,0.0,0.0,0.0,1.0,0.0,0.0,0.0,0.0,0.0,0.0,0.0,0.0,0.0,0.0,0.0,0.0,0.0,0.0,0.0,0.0,0.0,,,,,,,,,,,,,0.0,,2.0,7809.75,58783.5,56877.75,7258.5,58783.5,3.0,-489.0,365243.0,182392.5,182452.5,182467.5,182453.5,15.0,0.0,0.1039961896971131,24.0,7.0,6.0,3.0,-14.0,0.0,0.0,5.0,13369.5,13369.5,-420.0,-398.0,3.0,1.0,16.0,0.0,135000.0,,0.0,,,0.0,,0.0,0.0,0.0,0.0,,0.0,,,0.0,-9.5,0.0,0.0,8355495514.5,184550871789.0,165720393036.0,52023263905.935,,,,,,,17827.322100002304,17889.595399999118,17340.66539999801,11307.398500000092,11245.204800000092,11192.632400000064,128552.0,663499.0,4142.272800000114,4139.971200000014,3950.541200000094,13541053.246574936,-602567288.0,-922831757.0,-296819256.0,-1536769719.0416667,44071.0,30741.0,11360.133999999194,11236.079999998989,10720.12159999729,22912.61310000979,22834.37370000976,22219.24190000832,67554.34569325675,158197.02160079704,,35038.916900027994,34979.03470002844,34424.468800028844,22976.948199995888,22949.983399995464,22596.747499995698,3717871.0,8304.517900000164,8409.169000000073,8132.629900000233,9827.273000000716,9942.305900002157,10302.467099999636,16484.516499999718,16669.9381999997,16266.6426999997,829.234700000177,814.412200000046,760.3316000000133,3917.639800000123,3900.882900000162,3733.56260000016,436912.0,431704.0,,6431.275700002895,632602.0,626150.0,,16348.834399999798,154347.58479999076,154350.32639999033,154242.0484999872,77688.58719999637,78026.72290000661,78428.6120000066,,,,,,,,,,,,,,,,,,,,,,,,,,,281457005.49000007,4007963893.950004,4506138103.095003,65645356.58999994,4007963893.950004,291859.0,-20170355.5,4683624668.5,206282713.5,1048266258.5,452377147.5,1098282366.5,289791.5,4564.0,817.4702204408634,6735946.0,2398761.0,1476036.0,-4854416.0,1500896.0,103184.0,3174442886.250135,3203699011.4251146,-192875132.0,-191257798.0,3347233.0,159973.0,2936456968.814967,7950465000.0,,381996240.3449994,,,166181885.144999,,386723621.294999,2819477368.7100024,2925592845.929958,2925731739.239957,,33602.0,,,948789.0,-1680032.0,681142.0,1644.0,1468977.0,14839636.0,3235679.0,8564931.0,11619805.0,1417386.0,,,,,,,,,,,,,,5927117661.989961,18743359500.0,,448276957.44749767,,,309324672.8774986,,459452868.83999926,5712128314.200034,5890368525.794997,5890611708.539999,,80933.5,,,972234.0,-1700136.5,177364.0,6755.0,4277577.5,2481942.0,-9013061.5,921269.0,37582.5,3737675267.21246,3662347527.26996,-260903716.5,-257588166.0,2528931.5,269499.0,3930315697.0799537,33286363827.57092,36718238815.13265,1731601233.832549,48134190940.358215,3992292.5,-247839230.0,103195599940.0,1055898236.5,17288807107.0,3507190384.0,18903197739.5,3675844.0,72011.5,20891.09120688989,89856483.0,-115.5313776457482,7.947344827586208,2.9609965284868287,109.23237878376754,23.53206044517051,868.1073805321123,65250.0,0.6234898018587334,-0.7818314824680299,0.0,0.0,0.0,0.0,0.0,0.0,1.0,0.0,0.0,0.0,0.0,0.0,0.0,1.0,0.0,0.0,0.0,0.0,1.0,0.0,0.0,1.0,0.0,0.0,0.0,1.0,0.0,0.0,0.0,0.0,0.0,0.0,0.0,0.0,0.0,0.0,0.0,0.0,1.0,0.0,0.0,0.0,0.0,0.0,0.0,0.0,0.0,0.0,0.0,0.0,0.0,0.0,0.0,0.0,0.0,1.0,0.0,0.0,0.0,0.0,0.0,0.0,0.0,0.0,0.0,0.0,0.0,0.0,0.0,0.0,0.0,0.0,0.0,0.0,0.0,0.0,0.0,0.0,0.0,0.0,0.0,0.0,0.0,0.0,0.0,0.0,0.0,0.0,0.0,0.0,0.0,0.0,0.0,0.0,0.0,0.0,0.0,0.0,0.0,0.0,0.0,0.0,0.0,0.0,0.0,0.0,0.0,0.0,1.0,0.0,1.0,0.0,0.0,0.0,0.0,0.0,0.0,1.0,0.0,0.0
104870,0,0.0,0.0,0.0,1.0,0.0,117000.0,260640.0,19615.5,225000.0,0.04622,66.4876712328767,-2915.0,-6098.0,-4275.0,,2.0,1.0,1.0,16.0,0.617930776853037,0.707153487920907,0.4276573700350293,,,0.9841,,,,0.2069,,,,,0.148,,,,,0.9841,,,,0.2069,,,,,0.1542,,,,,0.9841,,,,0.2069,,,,,0.1507,,,0.194,1.0,0.0,0.0,0.0,0.0,-917.0,0.0,0.0,0.0,0.0,0.0,0.0,1.0,1.0,0.0,1.0,0.0,0.0,0.0,0.0,0.0,0.0,0.0,0.0,0.0,1.0,0.0,0.0,0.0,0.0,0.0,0.0,0.0,0.0,0.0,0.0,0.0,0.0,0.0,0.0,0.0,0.0,0.0,0.0,1.0,20956.5,0.0,125748.0,106083.0,0.0,0.0,0.0,0.0,-64.0,119.0,-34.0,,3.0,-1.0,2.0,47461.545,530977.5,550579.5,0.0,530977.5,12.0,-798.5,365243.0,-767.0,-437.0,-437.0,-433.5,15.5,0.5,0.0,9.5,26.0,18.0,6.0,-16.5,0.0,0.0,24.0,65499.12,65499.12,-488.5,-485.0,6.5,1.0,0.0,,,,,,,,,,,,,,,,,,,,,8355515130.0,184551132429.0,165720618036.0,52023380905.935,1863.0,1706.0,71125.0,70942.0,9141.0,506604.0,,,,,,,128552.0,663501.0,,,,13541119.73424617,-602570203.0,-922836032.0,-296820173.0,-1536775817.0416667,44071.0,30741.0,,,,22912.820000009797,22834.580600009755,22219.44880000832,67554.9636240336,158197.72875428494,126236.9254498208,,,,,,,3717887.0,,,,,,,16484.664499999722,16670.088899999693,16266.7968999997,,,,,,,436912.0,431704.0,,6431.321920002895,632603.0,626151.0,,16349.028399999796,154348.56889999073,154351.31049999033,154243.0325999872,,,,3.0,79308261.49499996,27412169.355,7991341660.844988,2662786991.025,93992678.45999998,785661.3449999999,145.0,17263.0,-26311810.0,11618321.0,-13633684.0,,-1.0,20956.5,0.0,125748.0,106083.0,0.0,0.0,0.0,0.0,-64.0,119.0,-34.0,,281854804.41000015,4012930813.950004,4511299729.095003,65713122.08999994,4012930813.950004,292078.0,-20195159.0,4686544445.5,206451219.0,1048802242.0,452914855.0,1098820888.0,290043.5,4569.5,818.7377446512859,6741011.5,2399675.0,1476367.5,-4860364.5,1522189.0,103184.0,3176978678.6851315,3206751276.645111,-193097964.5,-191481277.0,3350394.5,160056.5,,,,,,,,,,,,,,,,,,,,,1468978.0,14839639.0,3235679.0,8564957.0,11619829.0,1417388.0,1060895359.4445012,802180980.9899952,72180362761.62715,21696992920.237617,583233287.0669987,5792665.7475,689.5,94245.0,-277207897.0,22010929.5,-123903546.0,,-2023869.0,,,,,,,,,,,,,,,,,,,,,4277595.5,2481948.0,-9013078.0,921269.0,37582.5,3737740766.332459,3662413026.38996,-260904205.0,-257588651.0,2528938.0,269500.0,3930363158.6249537,33286894805.07092,36718789394.63265,1731601233.832549,48134721917.858215,3992304.5,-247840028.5,103195965183.0,1055897469.5,17288806670.0,3507189947.0,18903197306.0,3675859.5,72012.0,20891.09120688989,89856492.5,-43.84271468600627,2.2276923076923083,5.964670796054142,396.5770709003887,13.287451250286765,883.4516902519429,58500.0,-0.2225209339563143,0.9749279121818236,1.0,0.0,0.0,0.0,0.0,0.0,0.0,0.0,0.0,0.0,1.0,0.0,0.0,0.0,0.0,0.0,0.0,0.0,1.0,0.0,1.0,0.0,0.0,0.0,0.0,1.0,0.0,0.0,0.0,0.0,0.0,0.0,0.0,0.0,0.0,0.0,0.0,0.0,0.0,0.0,0.0,0.0,0.0,0.0,0.0,0.0,0.0,1.0,0.0,0.0,0.0,0.0,0.0,0.0,0.0,0.0,0.0,0.0,0.0,0.0,0.0,0.0,0.0,0.0,0.0,0.0,0.0,0.0,0.0,0.0,0.0,0.0,0.0,0.0,0.0,0.0,0.0,0.0,0.0,0.0,0.0,1.0,0.0,0.0,0.0,0.0,0.0,0.0,0.0,0.0,0.0,0.0,0.0,0.0,0.0,0.0,0.0,0.0,0.0,0.0,0.0,0.0,0.0,0.0,0.0,0.0,0.0,0.0,0.0,0.0,0.0,0.0,0.0,0.0,0.0,0.0,0.0,0.0,0.0,0.0
104877,0,0.0,0.0,0.0,1.0,0.0,108000.0,568800.0,20430.0,450000.0,0.020713,50.17260273972602,-1130.0,-8011.0,-1849.0,,1.0,3.0,3.0,8.0,,0.6420985841195989,0.4740512892789932,0.0124,0.0425,0.9816,0.7484,0.0026,0.0,0.1034,0.0417,0.0833,0.0363,0.0101,0.0142,0.0,0.0,0.0126,0.0441,0.9816,0.7583,0.0026,0.0,0.1034,0.0417,0.0833,0.0371,0.011,0.0148,0.0,0.0,0.0125,0.0425,0.9816,0.7518,0.0026,0.0,0.1034,0.0417,0.0833,0.0369,0.0103,0.0145,0.0,0.0,0.0126,1.0,0.0,0.0,0.0,0.0,-2558.0,0.0,0.0,0.0,0.0,1.0,0.0,1.0,1.0,1.0,1.0,1.0,0.0,0.0,0.0,0.0,0.0,0.0,0.0,0.0,1.0,0.0,0.0,0.0,0.0,0.0,0.0,0.0,0.0,0.0,0.0,0.0,0.0,0.0,0.0,0.0,0.0,0.0,0.0,4.0,9306.0,0.0,269239.5,156253.5,0.0,0.0,0.0,0.0,-295.0,448.0,-34.5,-237.0,56.0,-7.5,3.0,10886.31,157500.0,167895.0,0.0,157500.0,12.0,-1740.0,365243.0,-2118.5,-1518.5,-1518.5,-1510.0,12.0,0.5,0.0,-1.0,44.0,30.0,10.0,-62.5,0.0,0.0,42.0,10886.31,10886.31,-1922.0,-1913.0,11.0,1.0,0.0,,,,,,,,,,,,,,,,,,,,,8355535560.0,184551701229.0,165721068036.0,52023488905.935,1863.0,1706.0,71125.0,70943.0,9141.0,506604.0,17827.334500002304,17889.60789999912,17340.67799999801,11307.441000000092,11245.247300000094,11192.676500000063,128552.0,663502.0,4142.275400000114,4139.9738000000125,3950.5438000000936,13541169.90684891,-602571333.0,-922837881.0,-296822731.0,-1536783828.0416667,44071.0,30741.0,11360.133999999194,11236.079999998989,10720.12159999729,22912.923400009797,22834.684000009755,22219.55220000832,,158198.37085286903,126237.39950111006,35038.958600028,34979.07640002844,34424.510500028846,22977.03149999589,22950.066699995463,22596.8307999957,3717895.0,8304.554200000164,8409.205900000072,8132.667000000232,9827.283100000715,9942.316200002157,10302.478099999636,16484.678699999724,16670.103399999698,16266.811699999702,829.234700000177,814.412200000046,760.3316000000133,3917.639800000123,3900.882900000162,3733.56260000016,436912.0,431704.0,,6431.342633002895,632606.0,626154.0,,16349.040999999796,154349.55049999073,154352.29209999033,154244.0141999872,77689.33559999635,78027.47470000661,78429.3703000066,10.5,79331004.49499996,27426045.64499999,7994949518.474987,2663740622.025,94065450.07499996,785661.3449999999,145.0,17263.0,-26328694.5,11615928.0,-13642193.5,-14845001.5,-4.75,0.0,0.0,517500.0,156253.5,0.0,0.0,0.0,0.0,-929.0,448.0,-335.0,-335.0,282173203.035,4016282377.950004,4515119644.095003,65741719.58999994,4016282377.950004,292345.0,-20216923.0,4692752433.5,206431434.0,1049885564.0,453268465.0,1099904306.0,290281.0,4575.5,819.1334915837587,6742439.0,2404092.0,1478742.0,-4866838.5,1522219.0,103195.0,3182989925.8351336,3213044817.795108,-193343311.0,-191724677.0,3355550.5,160342.5,,,,,,,,,,,,,,,,,,,,,1468982.0,14839695.0,3235679.0,8565001.0,11619871.0,1417391.0,1060904665.4445012,802180980.9899952,72180632001.12715,21697149173.737617,583233287.0669987,5792665.7475,689.5,94245.0,-277208192.0,22011377.5,-123903580.5,-218922352.0,-2023876.5,,,,,,,,,,,,,,,,,,,,,4277625.5,2481958.0,-9013140.5,921269.0,37582.5,3737751652.6424594,3662423912.69996,-260906127.0,-257590564.0,2528949.0,269501.0,3930374044.9349537,33287052305.07092,36718957289.63265,1731601233.832549,48134879417.858215,3992316.5,-247841768.5,103196330426.0,1055895351.0,17288805151.5,3507188428.5,18903195796.0,3675871.5,72012.5,20891.09120688989,89856491.5,-22.522251952165128,5.266666666666667,5.286343612334802,265.22961800736226,27.841409691629963,1396.8759881721078,108000.0,-0.9009688679024191,-0.433883739117558,0.0,0.0,0.0,0.0,0.0,0.0,1.0,0.0,1.0,0.0,0.0,0.0,0.0,0.0,0.0,0.0,0.0,0.0,1.0,0.0,0.0,1.0,0.0,0.0,0.0,0.0,1.0,0.0,0.0,0.0,0.0,0.0,0.0,0.0,0.0,0.0,0.0,0.0,0.0,0.0,0.0,0.0,0.0,0.0,0.0,0.0,0.0,0.0,0.0,0.0,0.0,0.0,0.0,0.0,0.0,0.0,0.0,0.0,0.0,0.0,0.0,0.0,0.0,0.0,0.0,0.0,0.0,0.0,0.0,0.0,0.0,0.0,0.0,0.0,0.0,0.0,0.0,0.0,0.0,0.0,0.0,0.0,0.0,0.0,0.0,0.0,0.0,0.0,0.0,0.0,1.0,0.0,0.0,0.0,0.0,0.0,0.0,0.0,0.0,0.0,0.0,0.0,0.0,0.0,0.0,0.0,0.0,0.0,0.0,0.0,1.0,0.0,0.0,0.0,0.0,0.0,0.0,0.0,0.0,1.0
104878,0,0.0,0.0,0.0,1.0,0.0,112500.0,223884.0,22270.5,202500.0,0.031329,64.08767123287672,,-811.0,-4711.0,,2.0,2.0,2.0,9.0,0.7063297191359207,0.6954600262829301,0.5691487713619409,,,0.9737,,,,,,,,,0.0391,,,,,0.9737,,,,,,,,,0.0407,,,,,0.9737,,,,,,,,,0.0398,,,0.0307,1.0,8.0,0.0,8.0,0.0,-1346.0,0.0,0.0,0.0,0.0,1.0,3.0,1.0,0.0,0.0,1.0,1.0,0.0,0.0,0.0,0.0,0.0,0.0,0.0,0.0,1.0,0.0,0.0,0.0,0.0,0.0,0.0,0.0,0.0,0.0,0.0,0.0,0.0,0.0,0.0,0.0,0.0,0.0,0.0,13.0,0.0,0.0,45000.0,0.0,0.0,0.0,0.0,0.0,-1785.0,-1450.0,-1187.0,-1392.0,811.0,-31.0,8.0,6467.04,32130.0,36342.0,1302.75,52245.0,8.0,-1021.0,365243.0,-1146.0,-985.0,-985.0,-981.0,11.0,0.0,0.0499987025343828,7.0,42.0,12.0,6.5,-37.5,0.0,0.0,59.0,5417.865,5417.865,-819.0,-803.0,7.0,1.0,11.0,218911.14,247500.0,0.0,0.0,0.0,0.0,11756.7,13500.0,13500.0,214024.545,218911.14,218911.14,0.0,0.0,0.0,0.0,5.0,-6.0,0.0,0.0,8355557830.5,184551925113.0,165721270536.0,52023601405.935,1863.0,1706.0,71125.0,70944.0,9141.0,506607.0,,,,,,,128552.0,663504.0,,,,13541233.994520145,,-922842592.0,-296824077.0,-1536784639.0416667,44071.0,30741.0,,,,,,,67555.66995375273,158199.06631289533,126237.96864988144,,,,,,,3717904.0,,,,,,,16484.717799999726,16670.143199999693,16266.8523999997,,,,,,,436920.0,431712.0,,6431.373962002896,632608.0,626156.0,,16349.071699999797,154350.52419999073,154353.26579999033,154244.9878999872,,,,59.0,79331004.49499996,27426045.64499999,7995798026.774987,2663885492.775,94065450.07499996,785661.3449999999,145.0,17263.0,-26340625.0,11608510.0,-13648634.0,-14852311.0,-29.0,0.0,0.0,45000.0,0.0,0.0,0.0,0.0,0.0,-2250.0,-1520.0,-1331.0,-1553.0,282211134.255,4016776117.950004,4515679448.595003,65753181.08999994,4016598367.950004,292385.0,-20222666.5,4694030446.0,206426876.0,1049884172.0,453267313.0,1099902920.0,290352.5,4576.0,819.4523689886852,6742685.5,2404997.0,1479221.5,-4868977.5,1522219.0,103195.0,3183499034.460132,3213553926.420107,-193412551.0,-191793098.0,3356065.0,160390.0,2952184314.1499662,7974787500.0,248066841.06,382888007.81999934,12099218.535000002,122361912.94499986,166960324.57499903,420047319.0149978,387784674.044999,2834574726.6900034,2941290361.934957,2941429255.2449565,12709.0,33649.0,166.0,20774.0,950880.0,-1683385.0,681150.0,1652.0,1468995.0,14840506.0,3235690.0,8565043.0,11619930.0,1417399.0,1060904665.4445012,802180980.9899952,72180677001.12715,21697149173.737617,583233287.0669987,5792665.7475,689.5,94245.0,-277209977.0,22009927.5,-123904767.5,-218923744.0,-2023907.5,5927336573.129961,18743607000.0,198877107.825,448276957.44749767,1948107.735,256971504.8025008,309336429.5774986,637001112.2849978,459466368.83999926,5712342338.745034,5890587436.934999,5890830619.679999,13393.5,80933.5,44.0,70433.5,972239.0,-1700142.5,177364.0,6755.0,4277637.5,2481964.5,-9013178.0,921269.0,37582.5,3737757070.507458,3662429330.56496,-260906946.0,-257591367.0,2528956.0,269502.0,3930380511.974954,33287084435.07092,36718993631.63265,1731602536.582549,48134931662.858215,3992324.5,-247842789.5,103196695669.0,1055894205.0,17288804166.5,3507187443.5,18903194815.0,3675882.5,72012.5,20891.14120559243,89856498.5,,1.99008,5.0515255607193374,323.7405093598541,10.05293998787634,644.2695128668586,56250.0,1.0,0.0,0.0,1.0,0.0,0.0,0.0,0.0,0.0,0.0,0.0,1.0,0.0,0.0,0.0,0.0,0.0,0.0,0.0,0.0,1.0,0.0,1.0,0.0,0.0,0.0,0.0,1.0,0.0,0.0,0.0,0.0,0.0,0.0,0.0,0.0,0.0,0.0,0.0,0.0,0.0,0.0,0.0,0.0,0.0,0.0,0.0,0.0,0.0,0.0,0.0,0.0,0.0,0.0,0.0,0.0,0.0,0.0,0.0,0.0,0.0,0.0,0.0,0.0,0.0,0.0,0.0,0.0,0.0,0.0,0.0,0.0,0.0,0.0,0.0,0.0,0.0,0.0,0.0,0.0,0.0,0.0,0.0,0.0,0.0,0.0,0.0,0.0,0.0,0.0,0.0,0.0,0.0,0.0,0.0,0.0,0.0,0.0,0.0,0.0,0.0,0.0,0.0,0.0,0.0,0.0,0.0,1.0,0.0,0.0,0.0,0.0,0.0,0.0,0.0,0.0,0.0,0.0,0.0,0.0,0.0,0.0
104879,0,0.0,0.0,1.0,1.0,0.0,261000.0,336204.0,35433.0,297000.0,0.030755,52.66027397260274,-1052.0,-858.0,-1948.0,15.0,2.0,2.0,2.0,11.0,0.71682566282172,0.6400355781056022,0.475849908720221,,,,,,,,,,,,,,,,,,,,,,,,,,,,,,,,,,,,,,,,,,,,,0.0,0.0,0.0,0.0,-1583.0,0.0,0.0,0.0,0.0,1.0,2.0,1.0,1.0,0.0,1.0,0.0,0.0,0.0,0.0,0.0,0.0,0.0,0.0,0.0,1.0,0.0,0.0,0.0,0.0,0.0,0.0,0.0,0.0,0.0,0.0,0.0,0.0,0.0,0.0,0.0,0.0,0.0,0.0,8.0,0.0,,87709.5,0.0,0.0,0.0,0.0,0.0,-1164.5,-566.0,-457.5,-781.0,295.0,-20.0,7.0,13500.0,58410.0,46728.0,5841.0,199552.5,9.0,-554.0,365243.0,-524.0,365243.0,1246.0,365243.0,12.0,0.0,0.1089090909090909,-1.0,28.0,60.0,46.5,-14.5,0.0,0.0,29.0,13000.5,13000.5,-471.0,-434.0,7.0,5.0,10.0,0.0,18000.0,,0.0,,,0.0,,0.0,0.0,0.0,0.0,,0.0,,,0.0,-5.5,0.0,0.0,8355593263.5,184552261317.0,165721567536.0,52023862405.935,1863.0,1706.0,71125.0,70945.0,9141.0,506609.0,,,,,,,128552.0,663506.0,,,,13541286.654794116,-602572385.0,-922844540.0,-296825660.0,-1536785497.0416667,44071.0,30741.0,,,,,,,67556.38677941555,158199.70634847347,126238.44449979016,,,,,,,3717915.0,,,,,,,,,,,,,,,,436920.0,431712.0,1264493.0,6431.404717002895,632610.0,626158.0,,,,,,,,,38.5,79331004.49499996,,7996853497.274987,2664030363.525,94065450.07499996,785661.3449999999,145.0,17263.0,-26358376.0,11596464.5,-13660621.0,-14865082.0,-18.75,0.0,,46314.0,0.0,0.0,0.0,0.0,0.0,-1572.0,-1402.0,-780.0,-1402.0,282275865.40500003,4017113437.950004,4516004803.095003,65767468.58999994,4017788437.950004,292472.0,-20228605.0,4695126175.0,206422881.0,1050609490.0,453628634.0,1100628253.0,290449.0,4577.0,819.7701845755721,6742834.0,2405603.0,1479636.0,-4870631.0,1522219.0,103195.0,3183786304.2901325,3214266045.750108,-193454100.0,-191834391.0,3356447.0,160439.0,2953332497.429966,7976376000.0,,383135507.81999934,,,167008608.85499904,,387838674.044999,2835693412.605004,2942429122.214957,2942568015.524956,,33655.0,,,950899.0,-1683450.0,681150.0,1652.0,1469003.0,14840801.0,3235700.0,8565071.0,11619959.0,1417406.0,1060904665.4445012,,72180764710.62715,21697149173.737617,583233287.0669987,5792665.7475,689.5,94245.0,-277211141.5,22009361.5,-123905225.0,-218924525.0,-2023927.5,5927336573.129961,18743625000.0,,448276957.44749767,,,309336429.5774986,,459466368.83999926,5712342338.745034,5890587436.934999,5890830619.679999,,80933.5,,,972239.0,-1700148.0,177364.0,6755.0,4277697.5,2482011.0,-9013192.5,921269.0,37582.5,3737770071.007458,3662442331.06496,-260907417.0,-257591801.0,2528963.0,269507.0,3930394011.974954,33287142845.07092,36719040359.63265,1731608377.582549,48135131215.358215,3992333.5,-247843343.5,103197060912.0,1055893681.0,17289169409.5,3507188689.5,18903560058.0,3675894.5,72012.5,20891.25011468334,89856497.5,-19.97710837105249,1.2881379310344827,7.366014732029464,387.8963538748996,9.488442976885953,499.6640067362327,130500.0,-0.9009688679024191,-0.433883739117558,0.0,0.0,0.0,1.0,0.0,0.0,0.0,0.0,1.0,0.0,0.0,0.0,0.0,0.0,0.0,0.0,0.0,0.0,1.0,0.0,1.0,0.0,0.0,0.0,0.0,1.0,0.0,0.0,0.0,0.0,0.0,0.0,0.0,0.0,0.0,0.0,0.0,0.0,0.0,0.0,0.0,0.0,0.0,0.0,1.0,0.0,0.0,0.0,0.0,0.0,0.0,0.0,0.0,0.0,0.0,0.0,0.0,0.0,0.0,0.0,0.0,0.0,0.0,0.0,0.0,0.0,0.0,0.0,0.0,0.0,0.0,0.0,0.0,0.0,0.0,0.0,0.0,0.0,0.0,0.0,0.0,1.0,0.0,0.0,0.0,0.0,0.0,0.0,0.0,0.0,0.0,0.0,0.0,0.0,0.0,0.0,0.0,0.0,0.0,0.0,0.0,0.0,0.0,0.0,0.0,0.0,0.0,0.0,0.0,0.0,0.0,0.0,0.0,0.0,0.0,0.0,0.0,0.0,0.0,0.0
104880,0,0.0,0.0,0.0,0.0,0.0,157500.0,900000.0,48955.5,900000.0,0.00712,42.54520547945207,-3486.0,-1152.0,-632.0,,2.0,2.0,2.0,11.0,0.5370650689563642,0.7133724704366401,0.4241303111942548,,,,,,,,,,,,,,,,,,,,,,,,,,,,,,,,,,,,,,,,,,,,,2.0,2.0,2.0,2.0,-1769.0,0.0,0.0,0.0,0.0,1.0,2.0,1.0,1.0,1.0,1.0,0.0,0.0,0.0,0.0,0.0,0.0,0.0,0.0,0.0,1.0,0.0,0.0,0.0,0.0,0.0,0.0,0.0,0.0,0.0,0.0,0.0,0.0,0.0,0.0,0.0,0.0,0.0,0.0,6.0,4252.5,0.0,321030.0,97319.25,0.0,0.0,0.0,0.0,-809.0,378.0,-102.0,-1380.0,214.0,-26.0,9.0,16568.4375,68845.5,100849.5,0.0,323340.75,36.0,-305.0,365243.0,-1360.0,-340.0,50.0,-338.0,8.0,0.0,0.0,-1.0,66.0,48.0,21.0,-37.5,0.0,0.0,63.0,21886.875,21886.875,-1103.0,-1090.0,9.0,1.0,0.0,,,,,,,,,,,,,,,,,,,,,8355642219.0,184553161317.0,165722467536.0,52024019905.935,1863.0,1706.0,71125.0,70946.0,9141.0,506611.0,,,,,,,128552.0,663508.0,,,,13541329.199999597,-602575871.0,-922845172.0,-296827429.0,-1536786649.0416667,44073.0,30743.0,,,,,,,67556.92384448451,158200.41972094387,126238.86863010137,,,,,,,3717926.0,,,,,,,,,,,,,,,,436922.0,431714.0,,6431.411837002896,632612.0,626160.0,,,,,,,,,27.0,79352235.49499996,27426045.64499999,7998303352.274987,2664529487.775,94065450.07499996,785661.3449999999,145.0,17263.0,-26368578.5,11592887.0,-13665578.5,-14871273.0,-13.0,0.0,0.0,238365.0,0.0,0.0,0.0,0.0,0.0,-1937.0,-841.0,-585.0,-1380.0,282339810.63,4019931783.450004,4518955408.095003,65767468.58999994,4019973874.200004,292616.0,-20232609.0,4696221904.0,206785965.0,1050974238.0,453993927.0,1100993009.0,290519.0,4578.0,819.7701845755721,6744332.0,2408008.0,1481312.5,-4871686.5,1522219.0,103195.0,3185775463.5901327,3216746376.6751075,-193486708.0,-191866557.0,3357116.0,160534.0,,,,,,,,,,,,,,,,,,,,,1469009.0,14841015.0,3235700.0,8565137.0,11620022.0,1417415.0,1060908917.9445012,802180980.9899952,72181085740.62715,21697246492.987617,583233287.0669987,5792665.7475,689.5,94245.0,-277211950.5,22009739.5,-123905327.0,-218925905.0,-2023953.5,,,,,,,,,,,,,,,,,,,,,4277745.5,2482032.0,-9013230.0,921269.0,37582.5,3737791957.882458,3662464217.93996,-260908520.0,-257592891.0,2528972.0,269508.0,3930410580.412454,33287211690.57092,36719141209.13265,1731608377.582549,48135454556.108215,3992369.5,-247843648.5,103197426155.0,1055892321.0,17289169069.5,3507188739.5,18903559720.0,3675902.5,72012.5,20891.25011468334,89856496.5,-81.93637710090799,5.7142857142857135,3.217207463921316,136.87675262255925,18.384042650978948,782.1528721289101,78750.0,1.0,0.0,0.0,0.0,0.0,0.0,0.0,0.0,1.0,0.0,1.0,0.0,0.0,0.0,0.0,0.0,0.0,0.0,0.0,0.0,1.0,0.0,1.0,0.0,0.0,0.0,0.0,1.0,0.0,0.0,0.0,0.0,0.0,0.0,0.0,0.0,0.0,0.0,0.0,0.0,1.0,0.0,0.0,0.0,0.0,0.0,0.0,0.0,0.0,0.0,0.0,0.0,0.0,0.0,0.0,0.0,0.0,0.0,0.0,0.0,0.0,0.0,0.0,0.0,0.0,0.0,0.0,0.0,0.0,0.0,0.0,0.0,0.0,0.0,0.0,0.0,0.0,0.0,0.0,0.0,0.0,0.0,0.0,1.0,0.0,0.0,0.0,0.0,0.0,0.0,0.0,0.0,0.0,0.0,0.0,0.0,0.0,0.0,0.0,0.0,0.0,0.0,0.0,0.0,0.0,0.0,0.0,0.0,0.0,0.0,0.0,0.0,0.0,0.0,0.0,0.0,0.0,0.0,0.0,0.0,0.0,0.0
104899,0,0.0,0.0,0.0,1.0,0.0,76500.0,208512.0,20443.5,180000.0,0.014464,49.06849315068493,-558.0,-428.0,-1456.0,,2.0,2.0,2.0,3.0,,0.6074679642874528,,,,,,,,,,,,,,,,,,,,,,,,,,,,,,,,,,,,,,,,,,,,,,0.0,0.0,0.0,0.0,-1837.0,0.0,0.0,0.0,0.0,2.0,3.0,1.0,1.0,0.0,1.0,1.0,0.0,0.0,0.0,0.0,0.0,0.0,0.0,0.0,1.0,0.0,0.0,0.0,0.0,0.0,0.0,0.0,0.0,0.0,0.0,0.0,0.0,0.0,0.0,0.0,0.0,0.0,0.0,5.0,8203.5,180.0,75838.5,0.0,90000.0,0.0,0.0,0.0,-1653.0,-993.0,-1359.0,-930.0,264.0,-26.0,7.0,4874.04,22680.0,23904.0,2250.0,22680.0,6.0,-1837.0,365243.0,-2066.5,-1856.5,-1826.5,-1851.0,6.0,0.5,0.1000003312409943,20.0,52.0,11.0,4.0,-69.5,0.0,0.0,52.0,4874.04,5112.81,-1799.0,-1767.0,5.0,1.0,22.0,0.0,450000.0,,0.0,,,0.0,,0.0,0.0,0.0,0.0,,0.0,,,0.0,-14.5,0.0,0.0,8355662662.5,184553369829.0,165722647536.0,52024096405.935,1863.0,1706.0,71125.0,70948.0,9141.0,506614.0,,,,,,,128552.0,663510.0,,,,13541378.268492743,-602576429.0,-922846628.0,-296829266.0,-1536787077.0416667,44073.0,30743.0,,,,,,,,158201.02718890813,,,,,,,,3717929.0,,,,,,,,,,,,,,,,436922.0,431714.0,,6431.426301002895,632614.0,626162.0,,,,,,,,,55.0,79678349.00999996,27543146.445,8024985616.859987,2676132021.8700004,94503433.00499998,786331.8449999999,148.0,17263.0,-26462387.0,11637563.0,-13716249.0,-14924715.0,-27.0,8203.5,180.0,75838.5,0.0,90000.0,0.0,0.0,0.0,-1742.5,-1323.0,-1506.0,-930.0,283356896.26499987,4034444636.700004,4535148457.845003,65909308.58999994,4034444636.700004,293476.0,-20291062.0,4710648230.5,207838311.5,1054594566.5,455428517.5,1104613615.5,291353.0,4589.5,822.0448441615491,6771552.0,2415680.5,1486074.5,-4886244.0,1522284.0,103228.0,3198456887.850141,3230253133.3801103,-193931623.5,-192307018.0,3362529.5,161299.5,2956762168.3349648,7997800500.0,,384082778.6999993,,,167174344.93499902,,388444196.4749991,2838997420.5150023,2945838802.9949565,2945977696.3049555,,33817.0,,,951188.0,-1684045.5,681150.0,1652.0,1469014.0,14841279.0,3235722.0,8565189.0,11620074.0,1417422.0,1060917121.4445012,802181160.9899952,72181161579.12715,21697246492.987617,583323287.0669987,5792665.7475,689.5,94245.0,-277213603.5,22008746.5,-123906686.0,-218926835.0,-2023979.5,5927336573.129961,18744075000.0,,448276957.44749767,,,309336429.5774986,,459466368.83999926,5712342338.745034,5890587436.934999,5890830619.679999,,80933.5,,,972239.0,-1700162.5,177364.0,6755.0,4277756.5,2482036.0,-9013299.5,921269.0,37582.5,3737796831.922458,3662469330.74996,-260910319.0,-257594658.0,2528977.0,269509.0,3930415454.452454,33287234370.57092,36719165113.13265,1731610627.582549,48135477236.108215,3992375.5,-247845485.5,103197791398.0,1055890254.5,17289167213.0,3507186913.0,18903557869.0,3675908.5,72013.0,20891.35011501458,89856516.5,-11.371859296482413,2.725647058823529,3.7420206911732334,183.6153166545551,10.199427690953115,500.4705477944392,38250.0,-0.2225209339563143,0.9749279121818236,0.0,0.0,0.0,0.0,0.0,0.0,1.0,0.0,0.0,0.0,0.0,0.0,0.0,1.0,0.0,0.0,0.0,0.0,1.0,0.0,1.0,0.0,0.0,0.0,0.0,1.0,0.0,0.0,0.0,0.0,0.0,0.0,0.0,1.0,0.0,0.0,0.0,0.0,0.0,0.0,0.0,0.0,0.0,0.0,0.0,0.0,0.0,0.0,0.0,0.0,0.0,0.0,0.0,0.0,0.0,0.0,0.0,0.0,0.0,0.0,1.0,0.0,0.0,0.0,0.0,0.0,0.0,0.0,0.0,0.0,0.0,0.0,0.0,0.0,0.0,0.0,0.0,0.0,0.0,0.0,0.0,0.0,0.0,0.0,0.0,0.0,0.0,0.0,0.0,0.0,0.0,0.0,0.0,0.0,0.0,0.0,0.0,0.0,0.0,0.0,0.0,0.0,0.0,0.0,0.0,0.0,0.0,0.0,0.0,0.0,0.0,0.0,0.0,0.0,0.0,0.0,0.0,0.0,0.0,0.0
104906,0,0.0,0.0,0.0,1.0,0.0,315000.0,272520.0,16803.0,225000.0,0.032561,67.03835616438356,,-7015.0,-4608.0,,1.0,1.0,1.0,17.0,0.4727158584296699,0.5561765956845396,0.3996756156233169,,,0.9826,0.762,0.1691,,,,,0.1972,,0.7104,,0.0,,,0.9826,0.7713,0.1706,,,,,0.2017,,0.7401,,0.0,,,0.9826,0.7652,0.1702,,,,,0.2006,,0.7231,,0.0,0.6512,1.0,1.0,0.0,1.0,0.0,-1157.0,0.0,0.0,0.0,0.0,1.0,4.0,1.0,0.0,0.0,1.0,1.0,0.0,0.0,0.0,0.0,0.0,0.0,0.0,0.0,0.0,0.0,0.0,1.0,0.0,0.0,0.0,0.0,0.0,0.0,0.0,0.0,0.0,0.0,0.0,0.0,0.0,0.0,0.0,9.0,3825.0,3822.75,243000.0,0.0,0.0,0.0,0.0,0.0,-714.0,16.0,-27.0,-438.0,236.0,-14.0,13.0,13712.6475,80955.0,80554.5,7758.0,180000.0,21.0,-555.0,365243.0,-818.5,-488.5,-488.5,-482.5,14.0,0.5,0.1017108447472665,-1.0,42.0,12.0,6.5,-21.5,0.0,0.0,38.0,14504.8275,14504.8275,-677.0,-638.5,5.0,1.0,0.0,,,,,,,,,,,,,,,,,,,,,8355679465.5,184553642349.0,165722872536.0,52024411405.935,1863.0,1706.0,71125.0,70949.0,9141.0,506618.0,,,,,,,128552.0,663511.0,4142.444500000114,4140.144000000013,3950.7144000000935,13541445.30684891,,-922851236.0,-296830423.0,-1536794092.0416667,44073.0,30743.0,,,,,,,67557.39656034294,158201.58336550384,126239.26830571696,,,,,,,3717946.0,8304.751400000165,8409.406500000072,8132.868700000232,,,,16485.428199999726,16670.866299999696,16267.592499999702,,,,3917.639800000123,3900.882900000162,3733.56260000016,436923.0,431715.0,,6431.458862002895,632615.0,626163.0,,16349.722899999795,154351.50679999075,154354.24839999032,154245.97049998722,77690.09759999637,78028.2399000066,78430.1416000066,24.0,79879071.55499996,27546969.195,8039071328.489985,2679089016.8700004,94503433.00499998,786331.8449999999,148.0,17263.0,-26495346.0,11640211.0,-13733367.0,-14941490.5,-11.5,0.0,7645.5,156244.5,0.0,0.0,0.0,0.0,0.0,-967.0,-699.0,-696.0,-1080.0,283722174.22499985,4042246984.200004,4543815651.345003,65966154.83999994,4042284086.700004,293925.0,-20317159.0,4716124321.5,207820260.0,1056041826.0,455787068.0,1106427583.0,291705.0,4594.0,822.9618081135936,6778334.0,2420694.0,1489731.5,-4891452.0,1522284.0,103228.0,3206010371.782651,3237806617.31262,-194229731.5,-192601577.0,3369522.5,161460.5,,,,,,,,,,,,,,,,,,,,,1469023.0,14841515.0,3235722.0,8565231.0,11620112.0,1417435.0,1060920946.4445012,802184983.7399952,72181404579.12715,21697246492.987617,583323287.0669987,5792665.7475,689.5,94245.0,-277214317.5,22008762.5,-123906713.0,-218927273.0,-2023993.5,,,,,,,,,,,,,,,,,,,,,4277768.5,2482042.5,-9013321.0,921269.0,37582.5,3737811336.74996,3662483835.5774593,-260910996.0,-257595296.5,2528982.0,269510.0,3930429167.099954,33287315325.57092,36719245667.63265,1731618385.582549,48135657236.108215,3992396.5,-247846040.5,103198156641.0,1055889436.0,17289166724.5,3507186424.5,18903557386.5,3675922.5,72013.5,20891.451825859327,89856515.5,,0.8651428571428571,18.746652383502944,1256.7447593751606,16.218532404927693,1087.2637518251388,315000.0,-0.2225209339563143,0.9749279121818236,0.0,0.0,0.0,0.0,0.0,0.0,1.0,0.0,0.0,1.0,0.0,0.0,0.0,0.0,0.0,0.0,0.0,0.0,1.0,0.0,0.0,0.0,0.0,1.0,0.0,1.0,0.0,0.0,0.0,0.0,0.0,0.0,0.0,0.0,0.0,0.0,0.0,0.0,0.0,0.0,0.0,0.0,0.0,0.0,0.0,0.0,0.0,0.0,0.0,0.0,0.0,0.0,0.0,0.0,0.0,0.0,0.0,0.0,0.0,0.0,0.0,0.0,0.0,0.0,0.0,0.0,0.0,0.0,0.0,0.0,0.0,0.0,0.0,0.0,0.0,0.0,0.0,0.0,0.0,0.0,0.0,0.0,0.0,0.0,0.0,0.0,0.0,0.0,0.0,0.0,0.0,0.0,0.0,0.0,0.0,0.0,0.0,0.0,0.0,0.0,0.0,0.0,0.0,0.0,0.0,1.0,0.0,0.0,0.0,0.0,1.0,0.0,0.0,0.0,0.0,0.0,0.0,0.0,1.0,0.0
104907,0,0.0,0.0,0.0,1.0,1.0,90000.0,474408.0,24349.5,396000.0,0.00496,31.556164383561644,-4544.0,-3099.0,-3393.0,,2.0,2.0,2.0,10.0,,0.235062023802568,0.6894791426446275,,,,,,,,,,,,,,,,,,,,,,,,,,,,,,,,,,,,,,,,,,,,,0.0,0.0,0.0,0.0,-990.0,0.0,0.0,0.0,0.0,0.0,1.0,1.0,1.0,0.0,1.0,0.0,0.0,0.0,0.0,0.0,0.0,1.0,1.0,0.0,1.0,0.0,0.0,0.0,0.0,0.0,0.0,0.0,0.0,0.0,0.0,0.0,0.0,0.0,0.0,0.0,0.0,0.0,0.0,4.0,0.0,0.0,63180.0,0.0,0.0,0.0,0.0,0.0,-587.5,-345.0,-343.5,-384.0,94.0,-12.0,1.0,11002.725,94945.5,59971.5,37980.0,94945.5,6.0,-990.0,365243.0,-955.0,-805.0,-805.0,-799.0,9.0,0.0,0.4222872822496105,80.0,8.0,6.0,2.5,-29.5,0.0,0.0,6.0,11002.725,11002.725,-890.5,-880.0,3.5,1.0,0.0,,,,,,,,,,,,,,,,,,,,,8355703815.0,184554116757.0,165723268536.0,52024501405.935,1863.0,1706.0,71125.0,70949.0,9141.0,506619.0,,,,,,,128553.0,663513.0,,,,13541476.863013295,-602580973.0,-922854629.0,-296831413.0,-1536797191.0416667,44073.0,30743.0,,,,,,,,158201.81842752764,126239.9577848596,,,,,,,3717956.0,,,,,,,,,,,,,,,,436923.0,431715.0,,6431.463822002896,632617.0,626165.0,,,,,,,,,20.0,79907610.55499996,27550791.945,8040344945.489985,2679132045.8700004,94503433.00499998,786331.8449999999,148.0,17263.0,-26500354.5,11637139.0,-13736520.5,-14944760.0,-9.5,0.0,0.0,57150.0,0.0,0.0,0.0,0.0,0.0,-688.0,-384.0,-382.0,-1171.0,283781517.705,4042911134.700004,4544491425.345003,66007845.08999994,4042911134.700004,293988.0,-20322039.0,4717037429.0,207817978.0,1056040804.0,455785565.0,1106426569.0,291802.0,4595.0,823.4360784602492,6779669.0,2420931.0,1489850.5,-4892090.0,1522284.0,103228.0,3206309838.8176517,3238106084.347619,-194246500.0,-192618069.5,3369641.0,161482.5,,,,,,,,,,,,,,,,,,,,,1469027.0,14841609.0,3235722.0,8565239.0,11620118.0,1417436.0,1060920946.4445012,802184983.7399952,72181467759.12715,21697246492.987617,583323287.0669987,5792665.7475,689.5,94245.0,-277214905.0,22008417.5,-123907056.5,-218927657.0,-2024005.5,,,,,,,,,,,,,,,,,,,,,4277774.5,2482045.0,-9013350.5,921269.0,37582.5,3737822339.4749584,3662494838.3024592,-260911886.5,-257596176.5,2528985.5,269511.0,3930440169.824954,33287410271.07092,36719305639.13265,1731656365.582549,48135752181.608215,3992402.5,-247847030.5,103198521884.0,1055888481.0,17289165919.5,3507185619.5,18903556587.5,3675931.5,72013.5,20891.874113141577,89856595.5,-143.99722173988542,5.2712,3.6961744594344847,116.63708883223671,19.483274810571057,614.8174226524862,45000.0,1.0,0.0,0.0,0.0,0.0,0.0,0.0,0.0,1.0,0.0,1.0,0.0,0.0,0.0,0.0,0.0,0.0,0.0,0.0,0.0,1.0,0.0,0.0,0.0,1.0,0.0,0.0,1.0,0.0,0.0,0.0,0.0,0.0,0.0,0.0,0.0,0.0,0.0,0.0,0.0,1.0,0.0,0.0,0.0,0.0,0.0,0.0,0.0,0.0,0.0,0.0,0.0,0.0,0.0,0.0,0.0,0.0,0.0,0.0,0.0,0.0,0.0,0.0,0.0,0.0,0.0,0.0,0.0,0.0,0.0,1.0,0.0,0.0,0.0,0.0,0.0,0.0,0.0,0.0,0.0,0.0,0.0,0.0,0.0,0.0,0.0,0.0,0.0,0.0,0.0,0.0,0.0,0.0,0.0,0.0,0.0,0.0,0.0,0.0,0.0,0.0,0.0,0.0,0.0,0.0,0.0,0.0,0.0,0.0,0.0,0.0,0.0,0.0,0.0,0.0,0.0,0.0,0.0,0.0,0.0,0.0,0.0
104913,0,0.0,0.0,0.0,0.0,0.0,90000.0,296280.0,23409.0,225000.0,0.010006,53.34520547945207,-5351.0,-7028.0,-1669.0,,2.0,2.0,2.0,8.0,,0.3504422905009275,,0.0021,0.0,0.9707,0.5988,0.0,0.0,0.0345,0.0,0.0417,0.0008,0.0017,0.0011,0.0,0.0,0.0021,0.0,0.9707,0.6145,0.0,0.0,0.0345,0.0,0.0417,0.0008,0.0018,0.0011,0.0,0.0,0.0021,0.0,0.9707,0.6042,0.0,0.0,0.0345,0.0,0.0417,0.0008,0.0017,0.0011,0.0,0.0,0.0009,1.0,0.0,0.0,0.0,0.0,-311.0,,,,,,,1.0,1.0,1.0,1.0,0.0,0.0,0.0,0.0,0.0,0.0,0.0,0.0,0.0,1.0,0.0,0.0,0.0,0.0,0.0,0.0,0.0,0.0,0.0,0.0,0.0,0.0,0.0,0.0,0.0,0.0,0.0,0.0,0.0,,,,,,,,,,,,,0.0,,2.0,24079.0275,185463.0,175511.25,22500.0,185463.0,10.0,-311.0,365243.0,-281.0,-41.0,-11.0,-34.0,17.0,1.0,0.1237634498027799,30.0,9.0,10.0,6.0,-6.0,0.0,0.0,9.0,24323.715,24323.715,-165.0,-161.0,5.0,1.0,0.0,,,,,,,,,,,,,,,,,,,,,8355727224.0,184554413037.0,165723493536.0,52024591405.935,,,,,,,17827.336600002305,17889.60999999912,17340.68009999801,11307.441000000092,11245.247300000094,11192.676500000063,128553.0,663515.0,4142.444500000114,4140.144000000013,3950.7144000000935,13541530.208218776,-602586324.0,-922856298.0,-296831724.0,-1536804219.0416667,44073.0,30743.0,11360.133999999194,11236.079999998989,10720.12159999729,22912.957900009795,22834.71850000976,22219.58670000832,,158202.16886981815,,35038.958600028,34979.07640002844,34424.510500028846,22977.073199995888,22950.108399995464,22596.872499995698,3717964.0,8304.752200000165,8409.407300000072,8132.869500000232,9827.284800000716,9942.317900002156,10302.479899999636,16485.42929999973,16670.867399999694,16267.593599999702,829.234700000177,814.412200000046,760.3316000000133,3917.639800000123,3900.882900000162,3733.56260000016,436923.0,431715.0,,6431.473828002897,632619.0,626167.0,,16349.723799999794,154352.47749999075,154355.21909999033,154246.9411999872,77690.69639999636,78028.84410000661,78430.75610000659,,,,,,,,,,,,,,,,,,,,,,,,,,,283875190.04249984,4043682871.200004,4545347390.595003,66101125.58999994,4043682871.200004,294077.0,-20335403.5,4719591392.0,207808347.0,1056034193.0,456145890.0,1106786536.0,291970.5,4596.0,824.8565126196594,6782105.0,2421730.0,1490264.0,-4894463.0,1522284.0,103228.0,3207260541.15015,3239056430.370118,-194472234.0,-192846535.0,3373885.0,161545.0,,,,,,,,,,,,,,,,,,,,,1469027.0,14841609.0,3235722.0,8565248.0,11620127.0,1417438.0,,,,,,,,,,,,,,,,,,,,,,,,,,,,,,,,,,4277784.5,2482051.0,-9013356.5,921269.0,37582.5,3737846663.18996,3662519162.0174594,-260912051.5,-257596337.5,2528990.5,269512.0,3930464248.8524537,33287595734.07092,36719481150.38265,1731678865.582549,48135937644.608215,3992412.5,-247847341.5,103198887127.0,1055888200.0,17289165878.5,3507185608.5,18903556553.5,3675948.5,72014.5,20891.99787659138,89856625.5,-100.30892095937548,3.292,3.8446751249519417,205.0949845422993,12.656670511341794,675.1726891132494,45000.0,-0.2225209339563143,0.9749279121818236,0.0,0.0,0.0,0.0,0.0,0.0,1.0,0.0,1.0,0.0,0.0,0.0,0.0,0.0,0.0,0.0,0.0,0.0,1.0,0.0,1.0,0.0,0.0,0.0,0.0,1.0,0.0,0.0,0.0,0.0,0.0,0.0,0.0,0.0,0.0,0.0,0.0,0.0,0.0,0.0,0.0,0.0,0.0,0.0,0.0,0.0,0.0,0.0,0.0,0.0,0.0,0.0,0.0,0.0,0.0,0.0,0.0,0.0,0.0,0.0,0.0,0.0,0.0,0.0,0.0,0.0,0.0,0.0,0.0,0.0,0.0,0.0,0.0,0.0,0.0,0.0,0.0,0.0,0.0,0.0,0.0,1.0,0.0,0.0,0.0,0.0,0.0,0.0,0.0,0.0,0.0,0.0,0.0,0.0,0.0,0.0,0.0,0.0,0.0,0.0,0.0,0.0,0.0,0.0,0.0,0.0,0.0,0.0,0.0,0.0,1.0,0.0,0.0,0.0,0.0,0.0,1.0,0.0,0.0,0.0
104916,0,0.0,0.0,0.0,0.0,2.0,67500.0,135000.0,11542.5,135000.0,0.019101,31.94794520547945,-3288.0,-1228.0,-3855.0,,3.0,2.0,2.0,10.0,0.3106233722776981,0.6579411127290289,0.3842068130556564,0.0165,,0.9757,,,0.0,0.069,0.0417,,,,,,,0.0168,,0.9757,,,0.0,0.069,0.0417,,,,,,,0.0167,,0.9757,,,0.0,0.069,0.0417,,,,,,,0.0121,1.0,0.0,0.0,0.0,0.0,-418.0,0.0,0.0,0.0,0.0,0.0,0.0,1.0,1.0,1.0,1.0,0.0,0.0,0.0,0.0,0.0,0.0,0.0,0.0,0.0,1.0,0.0,0.0,0.0,0.0,0.0,0.0,0.0,0.0,0.0,0.0,0.0,0.0,0.0,0.0,0.0,0.0,0.0,0.0,3.0,1607.31,0.0,45004.5,0.0,0.0,0.0,0.0,0.0,-540.0,195.0,-235.0,-247.5,46.0,-7.5,4.0,4134.465,34816.5,35793.0,0.0,34816.5,6.0,-379.5,365243.0,-311.0,-161.0,-68.0,-65.0,14.5,0.0,0.0,40.0,15.0,6.0,3.0,-7.0,0.0,0.0,19.0,5596.2,4821.705,-218.0,-218.0,3.0,1.0,12.0,0.0,0.0,0.0,0.0,0.0,0.0,0.0,0.0,0.0,0.0,0.0,0.0,0.0,0.0,0.0,0.0,2.0,-8.5,0.0,0.0,8355738766.5,184554548037.0,165723628536.0,52024658905.935,1863.0,1706.0,71125.0,70949.0,9141.0,506619.0,17827.353100002307,17889.62669999912,17340.696899998013,,,,128555.0,663518.0,,,,13541562.15616398,-602589612.0,-922860153.0,-296832142.0,-1536805447.0416667,44073.0,30743.0,11360.133999999194,11236.079999998989,10720.12159999729,22913.026900009794,22834.78750000976,22219.65570000832,67557.70718371522,158202.82681093088,126240.34199167269,35039.000300028005,34979.118100028434,34424.552200028855,,,,3717974.0,,,,,,,,,,,,,,,,436923.0,431715.0,,6431.492929002897,632621.0,626169.0,,16349.735899999794,154353.45319999073,154356.19479999036,154247.9168999872,,,,18.0,79983047.56499997,27550791.945,8050988263.589988,2683607106.0150003,94566768.29999998,786331.8449999999,148.0,17263.0,-26546993.0,11795680.0,-13757384.0,-14973271.5,-8.5,0.0,0.0,45004.5,0.0,0.0,0.0,0.0,0.0,-540.0,195.0,-235.0,-257.0,284036576.985,4045708969.200004,4547433979.845003,66266059.58999994,4045708969.200004,294284.0,-20344457.0,4722148093.0,208169076.0,1057126661.0,456874088.0,1108609818.0,292220.5,4600.0,826.1923695575764,6782674.0,2422530.0,1490757.0,-4895332.0,1522290.0,103228.0,3208390219.170146,3240037495.980115,-194495869.0,-192869300.0,3374283.0,161612.0,2964180757.5899696,8025250500.0,249191391.06,384448213.8899993,12099218.535000002,122797533.82499988,167730873.839999,421563040.9199979,389153487.2399991,2846056720.680004,2953226381.44496,2953366849.754959,12769.0,33840.0,166.0,20905.0,956619.0,-1692311.5,710041.0,1654.0,1469030.0,14841655.0,3235734.0,8565263.0,11620146.0,1417442.0,1060922553.7545012,802184983.7399952,72181512763.62715,21697246492.987617,583323287.0669987,5792665.7475,689.5,94245.0,-277215445.0,22008612.5,-123907291.5,-218927904.5,-2024013.0,5927336573.129961,18744075000.0,198877107.825,448276957.44749767,1948107.735,256971504.8025008,309336429.5774986,637001112.2849978,459466368.83999926,5712342338.745034,5890587436.934999,5890830619.679999,13393.5,80933.5,44.0,70433.5,972241.0,-1700171.0,177364.0,6755.0,4277790.5,2482054.0,-9013363.5,921269.0,37582.5,3737852259.3899584,3662523983.7224593,-260912269.5,-257596555.5,2528993.5,269513.0,3930468383.317455,33287630550.57092,36719516943.38265,1731678865.582549,48135972461.108215,3992418.5,-247847721.0,103199252370.0,1055887889.0,17289165717.5,3507185540.5,18903556488.5,3675963.0,72014.5,20891.99787659138,89856665.5,-102.9174170311294,2.0,5.847953216374268,186.83008892093247,11.695906432748536,373.66017784186494,22500.0,0.6234898018587336,0.7818314824680298,0.0,0.0,0.0,0.0,0.0,0.0,1.0,0.0,0.0,0.0,0.0,0.0,0.0,1.0,0.0,0.0,0.0,0.0,1.0,0.0,0.0,0.0,1.0,0.0,0.0,0.0,0.0,0.0,0.0,1.0,0.0,0.0,0.0,0.0,0.0,0.0,1.0,0.0,0.0,0.0,0.0,0.0,0.0,0.0,0.0,0.0,0.0,0.0,0.0,1.0,0.0,0.0,0.0,0.0,0.0,0.0,0.0,0.0,0.0,0.0,0.0,0.0,0.0,0.0,0.0,0.0,0.0,0.0,0.0,0.0,0.0,0.0,0.0,0.0,0.0,0.0,0.0,0.0,0.0,0.0,0.0,0.0,0.0,0.0,0.0,0.0,0.0,0.0,0.0,0.0,0.0,0.0,0.0,0.0,0.0,0.0,0.0,0.0,0.0,0.0,0.0,0.0,0.0,0.0,0.0,0.0,0.0,0.0,0.0,0.0,1.0,0.0,0.0,0.0,0.0,0.0,0.0,0.0,1.0,0.0
104921,0,0.0,1.0,0.0,1.0,1.0,135000.0,539100.0,27652.5,450000.0,0.022625,34.630136986301366,-290.0,-10373.0,-4748.0,,3.0,2.0,2.0,14.0,0.2223970134844198,0.7578015965224335,0.7958031328748403,0.0928,0.1,0.9767,0.8028,0.0801,0.0,0.2069,0.1667,0.2083,0.0,0.0756,0.0408,0.0,0.0,0.0945,0.1038,0.9677,0.8105,0.0808,0.0,0.2069,0.1667,0.2083,0.0,0.0826,0.0018,0.0,0.0,0.0937,0.1,0.9767,0.8054,0.0806,0.0,0.2069,0.1667,0.2083,0.0,0.077,0.0415,0.0,0.0,0.1066,2.0,1.0,1.0,1.0,1.0,-1091.0,0.0,0.0,0.0,0.0,0.0,2.0,1.0,1.0,0.0,1.0,0.0,0.0,0.0,0.0,0.0,0.0,0.0,0.0,0.0,1.0,0.0,0.0,0.0,0.0,0.0,0.0,0.0,0.0,0.0,0.0,0.0,0.0,0.0,0.0,0.0,0.0,0.0,0.0,4.0,10203.75,,267745.86,0.0,0.0,0.0,0.0,0.0,-1229.5,-65.5,-85.0,-1634.5,191.0,-23.0,4.0,4260.195,29749.5,24383.25,6552.0,32760.0,6.0,-816.0,365243.0,-784.5,-604.5,-544.5,-599.0,12.5,0.0,0.2090043974741482,20.0,16.0,12.0,5.5,-28.5,0.0,0.0,14.0,3554.55,3554.55,-899.0,-865.0,4.0,1.0,0.0,,,,,,,,,,,,,,,,,,,,,8355766419.0,184555087137.0,165724078536.0,52024793905.935,1863.0,1706.0,71125.0,70949.0,9141.0,506621.0,17827.445900002305,17889.720399999118,17340.791399998012,11307.541000000092,11245.347300000092,11192.780300000064,128556.0,663521.0,4142.524600000114,4140.224600000013,3950.795200000093,13541596.786300968,-602589902.0,-922864901.0,-296833233.0,-1536815820.0416667,44074.0,30744.0,11360.133999999194,11236.079999998989,10720.12159999729,22913.233800009795,22834.99440000976,22219.86260000832,67557.9295807287,158203.5846125274,126241.13779480556,35039.167000028014,34979.28480002844,34424.718900028856,22977.28149999589,22950.316699995463,22597.0807999957,3717988.0,8304.752200000165,8409.407300000072,8132.869500000232,9827.360400000716,9942.394900002157,10302.562499999636,16485.470099999726,16670.908899999697,16267.595399999702,829.234700000177,814.412200000046,760.3316000000133,3917.639800000123,3900.882900000162,3733.56260000016,436924.0,431716.0,,6431.515554002895,632623.0,626171.0,,16349.842499999795,154354.42989999073,154357.17149999033,154248.8845999872,77691.49919999638,78029.6495000066,78431.5666000066,41.0,80056949.62499997,,8055273494.159986,2686575103.5150003,94566768.29999998,786331.8449999999,148.0,17263.0,-26568830.0,11792220.5,-13769767.5,-14983375.0,-20.0,0.0,,450000.0,0.0,0.0,0.0,0.0,0.0,-1675.0,-693.0,-149.0,-1716.0,284114734.785,4046279924.700004,4547970928.845003,66331773.08999994,4046279924.700004,294376.0,-20359599.5,4725617063.5,208157418.0,1057847742.0,457230237.0,1109331045.5,292390.0,4602.0,827.5637848739244,6793042.5,2423234.0,1491139.5,-4898564.5,1522290.0,103228.0,3208979015.1901426,3240629723.250112,-194593864.5,-192966114.0,3375138.5,161724.5,,,,,,,,,,,,,,,,,,,,,1469034.0,14841846.0,3235734.0,8565279.0,11620160.0,1417446.0,1060932757.5045012,,72181780509.48715,21697246492.987617,583323287.0669987,5792665.7475,689.5,94245.0,-277216674.5,22008547.0,-123907376.5,-218929539.0,-2024036.0,,,,,,,,,,,,,,,,,,,,,4277802.5,2482059.5,-9013392.0,921269.0,37582.5,3737855813.93996,3662527538.27246,-260913168.5,-257597420.5,2528997.5,269514.0,3930472643.512455,33287660300.07092,36719541326.63265,1731685417.582549,48136005221.108215,3992424.5,-247848537.0,103199617613.0,1055887104.5,17289165113.0,3507184996.0,18903555889.5,3675975.5,72014.5,20892.20688098885,89856685.5,-8.374208860759492,3.993333333333333,4.8820179007323015,169.0649486719351,19.49552481692433,675.1326950299276,45000.0,-0.9009688679024191,0.4338837391175582,0.0,0.0,0.0,0.0,0.0,1.0,0.0,0.0,0.0,0.0,0.0,0.0,0.0,1.0,0.0,0.0,0.0,0.0,1.0,0.0,1.0,0.0,0.0,0.0,0.0,1.0,0.0,0.0,0.0,0.0,0.0,0.0,0.0,0.0,0.0,0.0,0.0,0.0,0.0,0.0,0.0,0.0,0.0,0.0,0.0,0.0,1.0,0.0,0.0,0.0,0.0,0.0,0.0,1.0,0.0,0.0,0.0,0.0,0.0,0.0,0.0,0.0,0.0,0.0,0.0,0.0,0.0,0.0,0.0,0.0,0.0,0.0,0.0,0.0,0.0,0.0,0.0,0.0,0.0,0.0,0.0,0.0,0.0,0.0,0.0,0.0,0.0,0.0,0.0,0.0,0.0,0.0,0.0,0.0,0.0,0.0,0.0,0.0,0.0,0.0,0.0,0.0,0.0,0.0,0.0,0.0,0.0,0.0,1.0,0.0,1.0,0.0,0.0,0.0,0.0,0.0,0.0,1.0,0.0,0.0
104930,0,0.0,0.0,0.0,0.0,0.0,112500.0,739440.0,23980.5,585000.0,0.006233,48.26027397260274,-381.0,-1342.0,-1062.0,,2.0,2.0,2.0,11.0,0.710294562778975,0.5960232830155215,,0.0371,0.0042,0.9742,0.6464,0.0073,0.0,0.069,0.1667,0.2083,,0.0252,0.0241,0.0232,0.0476,0.0378,0.0044,0.9742,0.6602,0.0074,0.0,0.069,0.1667,0.2083,,0.0275,0.0251,0.0233,0.0504,0.0375,0.0042,0.9742,0.6511,0.0074,0.0,0.069,0.1667,0.2083,,0.0257,0.0245,0.0233,0.0486,0.0293,1.0,0.0,0.0,0.0,0.0,-2851.0,,,,,,,1.0,1.0,1.0,1.0,1.0,0.0,0.0,0.0,0.0,0.0,0.0,0.0,0.0,1.0,0.0,0.0,0.0,0.0,0.0,0.0,0.0,0.0,0.0,0.0,0.0,0.0,0.0,0.0,0.0,0.0,0.0,0.0,0.0,,,,,,,,,,,,,0.0,,3.0,10125.0,51700.5,202500.0,13500.0,194600.25,0.0,-2726.0,181199.0,-2738.5,-2526.5,181351.0,181353.0,16.0,0.5,0.2743532393377048,24.0,14.0,6.0,3.5,-89.5,0.0,0.0,116.0,478.26,478.26,-1765.5,-1765.5,46.5,0.0,94.0,0.0,0.0,0.0,0.0,0.0,0.0,0.0,478.26,0.0,0.0,0.0,0.0,0.0,0.0,0.0,0.0,10.0,-47.5,0.0,0.0,8355790399.5,184555826577.0,165724663536.0,52024906405.935,,,,,,,17827.483000002307,17889.75789999912,17340.82919999801,11307.545200000091,11245.351500000092,11192.784700000064,128556.0,663523.0,4142.531900000115,4140.232000000014,3950.802600000093,13541645.04657494,-602590283.0,-922865963.0,-296836084.0,-1536817162.0416667,44074.0,30744.0,11360.133999999194,11236.079999998989,10720.12159999729,22913.302800009795,22835.06340000976,22219.93160000832,67558.63987529147,158204.18063581042,,35039.333700028015,34979.451500028445,34424.885600028865,22977.489799995885,22950.524999995458,22597.28909999569,3717999.0,,,,9827.385600000716,9942.420600002157,10302.589999999636,16485.494199999725,16670.933399999696,16267.620499999704,829.257900000177,814.4355000000461,760.3549000000132,3917.687400000124,3900.9315000001616,3733.61300000016,436924.0,431716.0,,6431.521787002896,632625.0,626173.0,,16349.871799999795,154355.40409999073,154358.14569999033,154249.8587999872,77692.14559999638,78030.30060000661,78432.2268000066,,,,,,,,,,,,,,,,,,,,,,,,,,,284738832.9900001,4055342960.700004,4557382489.845003,66402337.58999994,4055174210.700004,294920.0,-20392544.0,4732737375.5,208134940.0,1060021871.0,458129226.5,1111689163.5,292921.0,4608.0,828.9299375807843,6796427.0,2425978.0,1492890.0,-4905101.5,1522311.0,103244.0,3213067531.6351447,3245409382.9051147,-194864974.0,-193235294.0,3379016.5,161984.0,2969505381.059969,8033170500.0,249782241.06,385286204.8349994,12144146.535000002,122999746.76999986,167969602.88999897,421940231.77499753,389489805.089999,2851166153.5650034,2958491415.734958,2958631884.0449576,12796.0,33924.0,167.0,20961.0,957197.0,-1694744.5,710041.0,1654.0,1469034.0,14841846.0,3235828.0,8565293.0,11620276.0,1417449.0,,,,,,,,,,,,,,5927336573.129961,18744075000.0,198877107.825,448276957.44749767,1948107.735,256971504.8025008,309336429.5774986,637001590.5449978,459466368.83999926,5712342338.745034,5890587436.934999,5890830619.679999,13393.5,80933.5,44.0,70433.5,972251.0,-1700218.5,177364.0,6755.0,4277808.5,2482063.0,-9013481.5,921269.0,37582.5,3737856292.1999593,3662528016.53246,-260914934.0,-257599186.0,2529044.0,269514.0,3930482768.512455,33287712000.57092,36719743826.63265,1731698917.582549,48136199821.358215,3992424.5,-247851263.0,103199798812.0,1055884366.0,17289162586.5,3507366347.0,18903737242.5,3675991.5,72015.0,20892.48123422819,89856709.5,-7.894692023843316,6.5728,4.6913116907487336,226.40398748640808,30.835053480953277,1488.1081289506628,56250.0,0.6234898018587336,0.7818314824680298,0.0,0.0,0.0,0.0,0.0,0.0,1.0,0.0,0.0,0.0,1.0,0.0,0.0,0.0,0.0,0.0,0.0,0.0,1.0,0.0,1.0,0.0,0.0,0.0,0.0,1.0,0.0,0.0,0.0,0.0,0.0,0.0,0.0,0.0,0.0,0.0,0.0,0.0,1.0,0.0,0.0,0.0,0.0,0.0,0.0,0.0,0.0,0.0,0.0,0.0,0.0,0.0,0.0,0.0,0.0,0.0,0.0,0.0,0.0,0.0,0.0,0.0,0.0,0.0,0.0,0.0,0.0,0.0,0.0,0.0,0.0,0.0,0.0,0.0,0.0,0.0,0.0,0.0,0.0,0.0,0.0,0.0,0.0,0.0,0.0,0.0,0.0,0.0,0.0,0.0,1.0,0.0,0.0,0.0,0.0,0.0,0.0,0.0,0.0,0.0,0.0,0.0,0.0,0.0,0.0,0.0,0.0,0.0,1.0,0.0,1.0,0.0,0.0,0.0,0.0,0.0,0.0,0.0,1.0,0.0
104931,0,0.0,0.0,0.0,1.0,1.0,135000.0,237024.0,17374.5,180000.0,0.0072739999999999,36.73972602739725,-533.0,-7563.0,-3150.0,,2.0,2.0,2.0,17.0,,0.0525383717048906,0.3572932680336494,0.0722,0.0642,0.9821,0.7552,0.0202,0.0,0.1379,0.1667,0.0417,0.0,0.0588,0.0458,0.0,0.0,0.0735,0.0666,0.9821,0.7648,0.0204,0.0,0.1379,0.1667,0.0417,0.0,0.0643,0.0477,0.0,0.0,0.0729,0.0642,0.9821,0.7585,0.0203,0.0,0.1379,0.1667,0.0417,0.0,0.0599,0.0466,0.0,0.0,0.0519,1.0,1.0,0.0,1.0,0.0,-703.0,0.0,0.0,0.0,0.0,1.0,3.0,1.0,1.0,0.0,1.0,1.0,0.0,0.0,0.0,0.0,0.0,0.0,0.0,0.0,1.0,0.0,0.0,0.0,0.0,0.0,0.0,0.0,0.0,0.0,0.0,0.0,0.0,0.0,0.0,0.0,0.0,0.0,0.0,1.0,0.0,,36135.0,0.0,,0.0,0.0,0.0,-494.0,30909.0,-8.0,,17.0,-8.0,6.0,14086.305,39352.5,37287.0,7870.5,135000.0,6.0,-324.0,365243.0,-294.0,365243.0,396.0,365243.0,13.0,0.0,0.1039692156541673,-1.0,18.0,24.0,15.5,-9.5,0.0,0.0,33.0,14086.305,14086.305,-180.0,-174.0,6.0,0.0,11.0,47106.135,135000.0,3375.0,19535.715,0.0,20300.1525,2250.0,13500.0,7875.0,46711.35,46858.815,46858.815,0.5,4.0,0.0,7.5,2.0,-6.0,0.0,0.0,8355807774.0,184556063601.0,165724843536.0,52025041405.935,1863.0,1706.0,71125.0,70950.0,9141.0,506624.0,17827.555200002305,17889.83079999912,17340.90269999801,11307.609400000092,11245.415700000092,11192.851300000064,128557.0,663525.0,4142.5521000001145,4140.252300000014,3950.8230000000935,13541681.786300968,-602590816.0,-922869113.0,-296836787.0,-1536824725.0416667,44074.0,30744.0,11360.133999999194,11236.079999998989,10720.12159999729,22913.4407000098,22835.20130000976,22220.06950000832,,158204.23317418213,126241.4950880736,35039.50040002801,34979.618200028446,34425.05230002886,22977.53149999589,22950.566699995463,22597.3307999957,3718016.0,8304.752200000165,8409.407300000072,8132.869500000232,9827.444400000715,9942.480500002155,10302.654299999636,16485.539999999724,16670.979999999698,16267.668199999702,829.257900000177,814.4355000000461,760.3549000000132,3917.687400000124,3900.9315000001616,3733.61300000016,436925.0,431717.0,,6431.529061002895,632627.0,626175.0,,16349.923699999796,154356.38619999075,154359.12779999033,154250.8408999872,77692.90079999638,78031.0591000066,78432.9916000066,17.0,80067153.37499997,,8063912159.909986,2689135852.7250004,,786331.8449999999,148.0,17263.0,-26609547.0,11843122.0,-13782992.0,,-8.0,0.0,,36135.0,0.0,,0.0,0.0,0.0,-494.0,30909.0,-8.0,,284769794.29500014,4055517313.200004,4557757276.845003,66410208.08999994,4055556665.700004,294926.0,-20396560.5,4733100940.0,208132662.0,1060385858.0,458676968.0,1112237028.0,292984.5,4608.0,829.0339067964385,6796485.0,2426137.0,1492985.0,-4905864.5,1522311.0,103244.0,3213363573.8551555,3245705425.1251264,-194956623.0,-193326807.0,3382169.0,161984.0,2970477534.86997,8036433000.0,249902841.06,385530351.29999936,12144146.535000002,123113525.37749986,168015168.674999,422118620.009997,389650824.089999,2852069477.670003,2959440489.179959,2959580957.489957,12807.0,33983.0,167.0,21004.5,957648.0,-1697038.0,710041.0,1654.0,1469035.0,14841863.0,3235839.0,8565311.0,11620309.0,1417455.0,1060932757.5045012,,72181816644.48715,21697246492.987617,,5792665.7475,689.5,94245.0,-277217168.5,22039456.0,-123907384.5,,-2024044.0,5927383679.264961,18744210000.0,198880482.825,448296493.1624976,1948107.735,256991804.9550008,309338679.5774986,637015090.5449978,459474243.83999926,5712389050.095036,5890634295.749998,5890877478.494999,13394.0,80937.5,44.0,70441.0,972253.0,-1700224.5,177364.0,6755.0,4277832.5,2482078.5,-9013491.0,921269.0,37582.5,3737870378.50496,3662542102.83746,-260915114.0,-257599360.0,2529050.0,269514.0,3930496854.817455,33287751353.07092,36719781113.63265,1731706788.082549,48136334821.358215,3992430.5,-247851587.0,103200164055.0,1055884072.0,17289527829.5,3507366743.0,18904102485.5,3676004.5,72015.0,20892.585203443847,89856708.5,-14.50745712155108,1.7557333333333334,7.77000777000777,285.46795670083344,13.64206164206164,501.20560717820985,67500.0,1.0,0.0,0.0,0.0,0.0,0.0,0.0,0.0,1.0,0.0,1.0,0.0,0.0,0.0,0.0,0.0,0.0,0.0,0.0,0.0,1.0,0.0,0.0,0.0,1.0,0.0,0.0,1.0,0.0,0.0,0.0,0.0,0.0,0.0,0.0,0.0,0.0,0.0,0.0,0.0,1.0,0.0,0.0,0.0,0.0,0.0,0.0,0.0,0.0,0.0,0.0,0.0,0.0,0.0,0.0,0.0,0.0,0.0,0.0,0.0,0.0,0.0,0.0,0.0,0.0,0.0,0.0,0.0,0.0,0.0,0.0,0.0,0.0,0.0,0.0,0.0,0.0,0.0,0.0,0.0,0.0,0.0,0.0,1.0,0.0,0.0,0.0,0.0,0.0,0.0,0.0,0.0,0.0,0.0,0.0,0.0,0.0,0.0,0.0,0.0,0.0,0.0,0.0,0.0,0.0,0.0,0.0,0.0,0.0,0.0,1.0,0.0,1.0,0.0,0.0,0.0,0.0,0.0,0.0,1.0,0.0,0.0
104936,0,0.0,1.0,1.0,1.0,0.0,157500.0,540000.0,22878.0,540000.0,0.011703,31.898630136986306,-3452.0,-5245.0,-4234.0,14.0,2.0,2.0,2.0,8.0,0.3665740995404255,0.6231294660951605,0.6594055320683344,,,,,,,,,,,,,,,,,,,,,,,,,,,,,,,,,,,,,,,,,,,,1.0,0.0,0.0,0.0,0.0,-432.0,0.0,0.0,0.0,0.0,0.0,3.0,1.0,1.0,0.0,1.0,0.0,0.0,0.0,0.0,0.0,0.0,1.0,1.0,0.0,1.0,0.0,0.0,0.0,0.0,0.0,0.0,0.0,0.0,0.0,0.0,0.0,0.0,0.0,0.0,0.0,0.0,0.0,0.0,3.0,,0.0,116865.0,0.0,0.0,0.0,0.0,0.0,-1845.0,-1659.0,-700.0,-1659.0,187.0,-32.0,7.0,7847.7750000000015,35086.5,65407.5,4500.0,72675.0,7.0,-1180.0,365243.0,-1149.0,-1029.0,-999.0,-1023.0,16.0,0.0,0.1089090909090909,27.0,62.0,6.0,0.0,-63.5,182.5,0.0,23.0,11568.645,11568.645,-1039.0,-1029.0,4.0,1.0,0.0,,,,,,,,,,,,,,,,,,,,,8355830652.0,184556603601.0,165725383536.0,52025198905.935,1863.0,1706.0,71125.0,70950.0,9141.0,506627.0,,,,,,,128557.0,663527.0,,,,13541713.684931103,-602594268.0,-922873347.0,-296837219.0,-1536829970.0416667,44074.0,30744.0,,,,,,,67559.00644939103,158204.8563036482,126242.15449360565,,,,,,,3718024.0,,,,,,,,,,,,,,,,436925.0,431717.0,1264507.0,6431.540764002895,632629.0,626177.0,,,,,,,,,61.0,,27596661.75,8073342670.769986,2692645335.2250004,94567011.56999998,786331.8449999999,148.0,17263.0,-26649348.0,11817834.0,-13810088.0,-15030581.0,-30.0,,0.0,398880.0,0.0,0.0,0.0,0.0,0.0,-2922.0,-1826.0,-4.0,-1821.0,285566021.14500016,4067397916.200004,4570436922.345003,66448849.58999994,4067397916.200004,295460.0,-20426591.0,4738944547.0,208116531.0,1062200193.0,459034377.0,1114051453.0,293562.0,4615.0,829.8837292408925,6805284.0,2430073.0,1495549.0,-4911521.5,1523820.5,103244.0,3221036223.3451533,3253461949.1251225,-195082754.0,-193451333.0,3383780.0,162180.0,,,,,,,,,,,,,,,,,,,,,1469038.0,14842050.0,3235839.0,8565373.0,11620332.0,1417462.0,,802184983.7399952,72181933509.48715,21697246492.987617,583323287.0669987,5792665.7475,689.5,94245.0,-277219013.5,22037797.0,-123908084.5,-218931198.0,-2024076.0,,,,,,,,,,,,,,,,,,,,,4277838.5,2482078.5,-9013554.5,921451.5,37582.5,3737881947.14996,3662553671.48246,-260916153.0,-257600389.0,2529054.0,269515.0,3930504702.592455,33287786439.57092,36719846521.13265,1731711288.082549,48136407496.358215,3992437.5,-247852767.0,103200529298.0,1055882923.0,17289526800.5,3507365744.0,18904101462.5,3676020.5,72015.0,20892.694112534755,89856735.5,-108.2178132783647,3.4285714285714284,6.884343036978757,219.6011122727224,23.603461841070025,752.9180992207623,78750.0,1.0,0.0,0.0,0.0,0.0,0.0,0.0,0.0,0.0,0.0,1.0,0.0,0.0,0.0,0.0,0.0,0.0,0.0,0.0,0.0,1.0,0.0,1.0,0.0,0.0,0.0,0.0,1.0,0.0,0.0,0.0,0.0,0.0,0.0,0.0,0.0,1.0,0.0,0.0,0.0,0.0,0.0,0.0,0.0,0.0,0.0,0.0,0.0,0.0,0.0,0.0,0.0,0.0,0.0,0.0,0.0,0.0,0.0,0.0,0.0,0.0,0.0,0.0,0.0,0.0,0.0,0.0,0.0,0.0,0.0,0.0,0.0,0.0,0.0,0.0,0.0,0.0,0.0,0.0,0.0,0.0,0.0,0.0,0.0,0.0,0.0,0.0,0.0,0.0,0.0,0.0,0.0,1.0,0.0,0.0,0.0,0.0,0.0,0.0,0.0,0.0,0.0,0.0,0.0,0.0,0.0,0.0,0.0,0.0,0.0,0.0,0.0,0.0,0.0,0.0,0.0,0.0,0.0,0.0,0.0,0.0,0.0
104937,0,0.0,1.0,1.0,1.0,0.0,292500.0,732915.0,86980.5,675000.0,0.018029,43.83561643835616,-2695.0,-6154.0,-4411.0,4.0,2.0,3.0,3.0,5.0,,0.4439728718238079,0.6986675550534175,0.0825,0.2275,0.9871,0.8232,0.0411,0.0,0.1379,0.1667,0.0417,0.0,,0.0825,,0.0,0.084,0.2361,0.9871,0.8301,0.0415,0.0,0.1379,0.1667,0.0417,0.0,,0.086,,0.0,0.0833,0.2275,0.9871,0.8256,0.0414,0.0,0.1379,0.1667,0.0417,0.0,,0.084,,0.0,0.0874,1.0,0.0,0.0,0.0,0.0,-15.0,0.0,0.0,0.0,0.0,0.0,0.0,1.0,1.0,1.0,1.0,1.0,0.0,0.0,0.0,0.0,0.0,0.0,0.0,0.0,0.0,0.0,0.0,0.0,0.0,1.0,0.0,0.0,0.0,0.0,0.0,0.0,0.0,0.0,0.0,0.0,0.0,0.0,0.0,2.0,,0.0,80989.3125,0.0,0.0,0.0,0.0,0.0,-844.0,-706.5,-734.0,-736.0,57.0,-14.0,4.0,16513.605,69522.75,59602.5,22500.0,76270.5,6.0,-161.0,365243.0,-213.0,-153.0,-123.0,-149.0,8.0,0.0,0.1767000744854237,268.5,10.0,4.0,2.5,-7.5,0.0,0.0,10.0,21332.205,24450.075,-206.0,-198.0,2.0,1.0,0.0,,,,,,,,,,,,,,,,,,,,,8355917632.5,184557336516.0,165726058536.0,52025491405.935,1863.0,1706.0,71125.0,70950.0,9141.0,506627.0,17827.637700002306,17889.914099999118,17340.986699998008,11307.836900000091,11245.643200000091,11193.087400000064,128557.0,663529.0,4142.593200000115,4140.293700000014,3950.864500000093,13541757.52054754,-602596963.0,-922877758.0,-296837234.0,-1536836124.0416667,44074.0,30744.0,11360.133999999194,11236.079999998989,10720.12159999729,22913.5786000098,22835.33920000976,22220.207400008327,,158205.30027652002,126242.85316116072,35039.66710002801,34979.784900028455,34425.21900002886,22977.573199995888,22950.608399995464,22597.372499995698,3718029.0,8304.752200000165,8409.407300000072,8132.869500000232,,,,16485.622499999725,16671.063999999697,16267.7541999997,,,,3917.687400000124,3900.9315000001616,3733.61300000016,436925.0,431717.0,1264511.0,6431.558793002895,632632.0,626180.0,,16350.011099999794,154357.37329999075,154360.11489999032,154251.8279999872,77693.72399999636,78031.8847000066,78433.8217000066,28.5,,27596661.75,8073531149.894986,2692645335.2250004,94567011.56999998,786331.8449999999,148.0,17263.0,-26652254.5,11815343.0,-13812603.5,-15033101.5,-13.75,,0.0,19980.0,0.0,0.0,0.0,0.0,0.0,-1253.0,-1162.0,-1221.0,-1221.0,285622774.60500014,4068918524.700004,4572048561.345003,66472978.58999994,4068918524.700004,295506.0,-20434481.5,4740040276.0,208111339.0,1062195301.0,459029679.0,1114047696.0,293632.0,4615.0,830.2597439729736,6809054.5,2430276.0,1495562.5,-4913840.5,1543124.0,103244.0,3221252639.167652,3253673865.217622,-195110813.5,-193480349.5,3383840.0,162197.5,,,,,,,,,,,,,,,,,,,,,1469040.0,14842107.0,3235839.0,8565383.0,11620342.0,1417466.0,,802184983.7399952,72182014498.79965,21697246492.987617,583323287.0669987,5792665.7475,689.5,94245.0,-277219857.5,22037090.5,-123908818.5,-218931934.0,-2024090.0,,,,,,,,,,,,,,,,,,,,,4277842.5,2482081.0,-9013562.0,921451.5,37582.5,3737903279.35496,3662578121.5574594,-260916359.0,-257600587.0,2529056.0,269516.0,3930521216.1974554,33287855962.32092,36719906123.63265,1731733788.082549,48136483766.858215,3992443.5,-247852928.0,103200894541.0,1055882710.0,17289526647.5,3507365621.0,18904101313.5,3676028.5,72015.0,20892.87081260924,89857004.0,-61.4796875,2.5056923076923083,3.362822701640023,147.41140609928866,8.42619897563247,369.36762632909455,146250.0,0.6234898018587336,0.7818314824680298,0.0,0.0,0.0,0.0,0.0,0.0,1.0,0.0,0.0,0.0,0.0,0.0,0.0,1.0,0.0,0.0,0.0,0.0,1.0,0.0,1.0,0.0,0.0,0.0,0.0,1.0,0.0,0.0,0.0,0.0,0.0,0.0,0.0,0.0,0.0,0.0,0.0,0.0,0.0,0.0,1.0,0.0,0.0,0.0,0.0,0.0,0.0,0.0,0.0,0.0,0.0,0.0,0.0,1.0,0.0,0.0,0.0,0.0,0.0,0.0,0.0,0.0,0.0,0.0,0.0,0.0,0.0,0.0,0.0,0.0,0.0,0.0,0.0,0.0,0.0,0.0,0.0,0.0,0.0,0.0,0.0,0.0,0.0,0.0,0.0,0.0,0.0,0.0,0.0,0.0,0.0,0.0,0.0,0.0,0.0,0.0,0.0,0.0,0.0,0.0,0.0,0.0,0.0,0.0,0.0,0.0,0.0,0.0,0.0,0.0,1.0,0.0,0.0,0.0,0.0,0.0,0.0,1.0,0.0,0.0
104942,0,0.0,0.0,0.0,1.0,0.0,265500.0,534204.0,37309.5,495000.0,0.00702,35.405479452054784,-3299.0,-697.0,-4364.0,,2.0,2.0,2.0,13.0,0.4170144395793522,0.5760476146705981,0.8327850252992314,,,,,,,,,,,,,,,,,,,,,,,,,,,,,,,,,,,,,,,,,,,,,2.0,0.0,2.0,0.0,-1090.0,0.0,0.0,0.0,0.0,0.0,5.0,1.0,1.0,0.0,1.0,0.0,0.0,0.0,0.0,0.0,0.0,0.0,0.0,0.0,1.0,0.0,0.0,0.0,0.0,0.0,0.0,0.0,0.0,0.0,0.0,0.0,0.0,0.0,0.0,0.0,0.0,0.0,0.0,6.0,0.0,0.0,48960.0,0.0,0.0,0.0,0.0,0.0,-2742.5,-2199.0,-1548.0,-2351.5,518.0,-43.0,8.0,11250.0,114311.25,180774.0,0.0,117877.5,18.0,-1178.5,365243.0,-1060.0,-640.0,-550.0,-617.0,10.5,0.0,0.0,-1.0,80.0,18.0,12.0,-36.0,0.0,0.0,78.0,22059.0,15573.5325,-1017.0,-1015.0,7.0,1.0,47.0,0.0,225000.0,,0.0,,,0.0,,0.0,0.0,0.0,0.0,,0.0,,,0.0,-24.0,0.0,0.0,8355954942.0,184557870720.0,165726553536.0,52025756905.935,1863.0,1706.0,71125.0,70950.0,9141.0,506632.0,,,,,,,128557.0,663531.0,,,,13541792.926026992,-602600262.0,-922882122.0,-296838324.0,-1536836821.0416667,44074.0,30744.0,,,,,,,67559.4234638306,158205.8763241347,126243.685946186,,,,,,,3718042.0,,,,,,,,,,,,,,,,436927.0,431719.0,,6431.565813002895,632634.0,626182.0,,,,,,,,,90.5,80515997.23499997,27609923.25,8091264913.559986,2698461414.2250004,94622135.53499998,786331.8449999999,148.0,17263.0,-26689273.0,11876316.0,-13827827.0,-15052811.0,-44.75,0.0,0.0,57420.0,0.0,0.0,0.0,0.0,0.0,-2878.0,-2300.0,-1081.0,-2403.0,285821693.10000014,4071178711.642504,4574605170.442503,66546535.18499994,4071297632.490004,295672.0,-20450985.0,4744788435.0,208462011.0,1063278229.0,459384867.0,1115130834.0,293804.5,4620.0,831.6089249003529,6810540.5,2432561.0,1496972.0,-4918914.0,1543263.0,103244.0,3224805085.102639,3257144848.552608,-195724841.0,-194091323.0,3418558.0,162329.5,2980407491.2349696,8064513000.0,,386359531.91999936,,,168717519.269999,,390744526.13999903,2861534185.200004,2969344208.2049603,2969484676.51496,,34139.0,,,966944.0,-1706956.0,710041.0,1654.0,1469046.0,14842625.0,3235886.0,8565463.0,11620420.0,1417474.0,1060932757.5045012,802184983.7399952,72182063458.79965,21697246492.987617,583323287.0669987,5792665.7475,689.5,94245.0,-277222600.0,22034891.5,-123910366.5,-218934285.5,-2024133.0,5927383679.264961,18744435000.0,,448296493.1624976,,,309338679.5774986,,459474243.83999926,5712389050.095036,5890634295.749998,5890877478.494999,,80937.5,,,972253.0,-1700248.5,177364.0,6755.0,4277860.5,2482093.0,-9013598.0,921451.5,37582.5,3737925338.35496,3662593695.089959,-260917376.0,-257601602.0,2529063.0,269517.0,3930532466.1974554,33287970273.57092,36720086897.63265,1731733788.082549,48136601644.358215,3992461.5,-247854106.5,103201259784.0,1055881650.0,17289526007.5,3507365071.0,18904100696.5,3676039.0,72015.0,20892.87081260924,89857003.0,-93.17766772421264,2.012067796610169,7.11615004221445,251.9507040973625,14.318176335785791,506.941898047561,132750.0,-0.2225209339563146,-0.9749279121818236,0.0,0.0,0.0,0.0,0.0,0.0,1.0,0.0,1.0,0.0,0.0,0.0,0.0,0.0,0.0,0.0,0.0,0.0,1.0,0.0,1.0,0.0,0.0,0.0,0.0,1.0,0.0,0.0,0.0,0.0,0.0,0.0,0.0,0.0,0.0,0.0,1.0,0.0,0.0,0.0,0.0,0.0,0.0,0.0,0.0,0.0,0.0,0.0,0.0,0.0,0.0,0.0,0.0,1.0,0.0,0.0,0.0,0.0,0.0,0.0,0.0,0.0,0.0,0.0,0.0,0.0,0.0,0.0,0.0,0.0,0.0,0.0,0.0,0.0,0.0,0.0,0.0,0.0,0.0,0.0,0.0,0.0,0.0,0.0,0.0,0.0,0.0,0.0,0.0,0.0,0.0,0.0,0.0,0.0,0.0,0.0,0.0,0.0,0.0,0.0,0.0,0.0,0.0,0.0,0.0,0.0,0.0,0.0,0.0,0.0,0.0,0.0,0.0,0.0,0.0,0.0,0.0,0.0,0.0,0.0
104943,0,0.0,0.0,1.0,1.0,0.0,157500.0,595453.5,28777.5,445500.0,0.010276,54.03287671232878,-1001.0,-12025.0,-3216.0,8.0,2.0,2.0,2.0,14.0,,0.6568575834920057,0.5136937663039473,,,,,,,,,,,,,,,,,,,,,,,,,,,,,,,,,,,,,,,,,,,,,4.0,0.0,4.0,0.0,-1659.0,0.0,0.0,0.0,0.0,0.0,0.0,1.0,1.0,0.0,1.0,0.0,0.0,0.0,0.0,0.0,0.0,0.0,0.0,0.0,1.0,0.0,0.0,0.0,0.0,0.0,0.0,0.0,0.0,0.0,0.0,0.0,0.0,0.0,0.0,0.0,0.0,0.0,0.0,6.0,7650.0,0.0,212506.65,0.0,153992.43,0.0,0.0,0.0,-1140.5,-12.0,-136.5,-863.0,188.0,-16.0,9.0,10940.58,57375.0,67702.5,2252.025,225000.0,36.0,-508.0,365243.0,-1179.5,181945.0,-189.5,181946.5,15.0,0.0,0.0339785225132035,-1.0,43.0,60.0,39.0,-22.0,0.0,0.0,90.0,13393.755,16776.72,-436.5,-418.5,15.0,1.0,31.0,0.0,225000.0,0.0,0.0,0.0,0.0,0.0,6750.0,378.0,0.0,0.0,0.0,0.0,0.0,0.0,0.0,0.0,-16.0,0.0,0.0,8355983719.5,184558466173.5,165726999036.0,52025914405.935,1863.0,1706.0,71125.0,70950.0,9141.0,506632.0,,,,,,,128557.0,663533.0,,,,13541846.958903706,-602601263.0,-922885338.0,-296839983.0,-1536848846.0416667,44074.0,30744.0,,,,,,,,158206.5331817182,126244.19963995232,,,,,,,3718056.0,,,,,,,,,,,,,,,,436931.0,431723.0,1264519.0,6431.576089002895,632636.0,626184.0,,,,,,,,,38.0,80544306.73499997,27609923.25,8092221932.609986,2699014968.2250004,94776127.965,786331.8449999999,148.0,17263.0,-26699366.5,11874391.0,-13834496.5,-15060799.0,-18.5,15300.0,0.0,186088.5,0.0,153992.43,0.0,0.0,0.0,-1141.0,-775.0,-252.0,-863.0,285938436.7575002,4073608629.990004,4577376825.540003,66551037.20999994,4073861277.765004,295806.0,-20458545.0,4746431680.5,208455740.0,1063640121.0,459746083.0,1115492737.5,293912.0,4621.0,831.6768420613545,6815045.0,2434030.0,1497944.0,-4921281.0,1543263.0,103244.0,3226174204.9276395,3258552100.252609,-195793810.0,-194158987.0,3419608.5,162380.5,2980896602.57997,8072028000.0,250488165.465,386675454.41999936,12144146.535000002,123503071.94999988,168739520.71499902,423440632.4849986,390994450.28999895,2861999676.405004,2969824299.2099605,2969964767.5199594,12867.0,34147.0,167.0,21109.0,966979.0,-1707797.0,710041.0,1654.0,1469052.0,14842813.0,3235917.0,8565506.0,11620510.0,1417483.0,1060940407.5045012,802184983.7399952,72182275965.44965,21697246492.987617,583477279.4969988,5792665.7475,689.5,94245.0,-277223740.5,22034879.5,-123910503.0,-218935148.5,-2024149.0,5927383679.264961,18744660000.0,198880482.825,448296493.1624976,1948107.735,256991804.9550008,309338679.5774986,637021840.5449978,459474621.83999926,5712389050.095036,5890634295.749998,5890877478.494999,13394.0,80937.5,44.0,70441.0,972253.0,-1700264.5,177364.0,6755.0,4277920.5,2482132.0,-9013620.0,921451.5,37582.5,3737938732.10996,3662610471.80996,-260917812.5,-257602020.5,2529078.0,269518.0,3930543406.777455,33288027648.57092,36720154600.13265,1731736040.1075494,48136826644.358215,3992497.5,-247854614.5,103201625027.0,1055880470.5,17289707952.5,3507364881.5,18904282643.0,3676054.0,72015.0,20892.90479113175,89857002.0,-18.525758036710275,3.780657142857143,5.473025801407349,295.72332837083763,20.691634089132133,1118.0285137146957,78750.0,-0.2225209339563146,-0.9749279121818236,0.0,0.0,0.0,0.0,0.0,0.0,1.0,0.0,1.0,0.0,0.0,0.0,0.0,0.0,0.0,0.0,0.0,0.0,1.0,0.0,1.0,0.0,0.0,0.0,0.0,1.0,0.0,0.0,0.0,0.0,0.0,0.0,0.0,0.0,0.0,0.0,0.0,0.0,0.0,0.0,0.0,0.0,0.0,0.0,1.0,0.0,0.0,0.0,0.0,0.0,0.0,0.0,0.0,1.0,0.0,0.0,0.0,0.0,0.0,0.0,0.0,0.0,0.0,0.0,0.0,0.0,0.0,0.0,0.0,0.0,0.0,0.0,0.0,0.0,0.0,0.0,0.0,0.0,0.0,0.0,0.0,0.0,0.0,0.0,0.0,0.0,0.0,0.0,0.0,0.0,0.0,0.0,0.0,0.0,0.0,0.0,0.0,0.0,0.0,0.0,0.0,0.0,0.0,0.0,0.0,0.0,0.0,0.0,0.0,0.0,0.0,0.0,0.0,0.0,0.0,0.0,0.0,0.0,0.0,0.0
104969,0,0.0,0.0,0.0,1.0,4.0,157500.0,301464.0,22068.0,238500.0,0.00823,47.6958904109589,-620.0,-5067.0,-945.0,,6.0,2.0,2.0,13.0,,0.3419097306723598,0.6722428897082422,,,,,,,,,,,,,,,,,,,,,,,,,,,,,,,,,,,,,,,,,,,,,0.0,0.0,0.0,0.0,-420.0,0.0,0.0,0.0,0.0,1.0,0.0,1.0,1.0,0.0,1.0,0.0,1.0,0.0,0.0,0.0,0.0,0.0,0.0,0.0,1.0,0.0,0.0,0.0,0.0,0.0,0.0,0.0,0.0,0.0,0.0,0.0,0.0,0.0,0.0,0.0,0.0,0.0,0.0,1.0,,0.0,142200.0,0.0,0.0,0.0,0.0,0.0,-523.0,-219.0,-218.0,-219.0,18.0,-8.5,1.0,13728.33,144585.0,144585.0,0.0,144585.0,12.0,-420.0,365243.0,-386.0,-56.0,-56.0,-53.0,10.0,0.0,0.0,60.0,12.0,12.0,6.5,-8.5,0.0,0.0,12.0,13728.33,13728.33,-228.5,-221.0,6.5,1.0,0.0,,,,,,,,,,,,,,,,,,,,,8356005787.5,184558767637.5,165727237536.0,52026071905.935,1863.0,1706.0,71125.0,70951.0,9141.0,506632.0,,,,,,,128561.0,663539.0,,,,13541894.654794116,-602601883.0,-922886283.0,-296840403.0,-1536853913.0416667,44074.0,30744.0,,,,,,,,158206.87509144883,126244.87188284202,,,,,,,3718069.0,,,,,,,,,,,,,,,,436931.0,431723.0,,6431.584319002895,632638.0,626186.0,,,,,,,,,18.0,,27670083.975,8128969858.124986,2716634948.985001,95170323.33,786331.8449999999,149.0,17263.0,-26833500.0,11952918.0,-13904361.0,-15130200.0,-8.5,,0.0,142200.0,0.0,0.0,0.0,0.0,0.0,-523.0,-219.0,-218.0,-219.0,287388378.13499993,4094175872.565004,4601152214.865004,66800413.93499994,4094175872.565004,297570.0,-20553211.0,4772175155.0,208384561.0,1067608922.0,460814241.0,1120194632.0,295337.0,4651.0,835.0492851590848,6862405.0,2449275.0,1507840.5,-4943804.5,1543347.0,103273.0,3248643288.735143,3282614563.86012,-196973685.0,-195330734.0,3445199.0,163814.5,,,,,,,,,,,,,,,,,,,,,1469053.0,14842831.0,3235917.0,8565518.0,11620522.0,1417484.0,,802184983.7399952,72182418165.44965,21697246492.987617,583477279.4969988,5792665.7475,689.5,94245.0,-277224263.5,22034660.5,-123910721.0,-218935367.5,-2024157.5,,,,,,,,,,,,,,,,,,,,,4277932.5,2482138.5,-9013628.5,921451.5,37582.5,3737952460.43996,3662624200.1399593,-260918041.0,-257602241.5,2529084.5,269519.0,3930557135.107455,33288172233.57092,36720299185.13265,1731736040.1075494,48136971229.358215,3992509.5,-247855034.5,103201990270.0,1055880084.5,17289707896.5,3507364825.5,18904282590.0,3676064.0,72015.0,20892.90479113175,89857062.0,-12.999023493595269,1.914057142857143,7.137030995106037,340.4070482021945,13.660685154975528,651.558542090326,26250.0,-0.9009688679024191,0.4338837391175582,0.0,1.0,0.0,0.0,0.0,0.0,0.0,0.0,0.0,0.0,0.0,0.0,0.0,1.0,0.0,0.0,0.0,0.0,1.0,0.0,1.0,0.0,0.0,0.0,0.0,0.0,1.0,0.0,0.0,0.0,0.0,1.0,0.0,0.0,0.0,0.0,0.0,0.0,0.0,0.0,0.0,0.0,0.0,0.0,0.0,0.0,0.0,0.0,0.0,0.0,0.0,0.0,0.0,0.0,0.0,0.0,0.0,0.0,0.0,0.0,0.0,0.0,0.0,0.0,0.0,0.0,0.0,0.0,0.0,0.0,0.0,0.0,0.0,0.0,0.0,0.0,0.0,0.0,0.0,0.0,0.0,0.0,0.0,0.0,0.0,0.0,0.0,0.0,0.0,0.0,0.0,0.0,0.0,0.0,0.0,0.0,0.0,0.0,0.0,0.0,0.0,0.0,0.0,0.0,1.0,0.0,0.0,0.0,0.0,0.0,0.0,0.0,0.0,0.0,0.0,0.0,0.0,0.0,0.0,0.0
104972,0,0.0,0.0,0.0,0.0,0.0,112500.0,194922.0,15759.0,157500.0,0.006629,43.27671232876714,-646.0,-2700.0,-4914.0,,1.0,2.0,2.0,5.0,,0.0991978666999672,0.3506958432829587,,,,,,,,,,,,,,,,,,,,,,,,,,,,,,,,,,,,,,,,,,,,,0.0,0.0,0.0,0.0,-1009.0,0.0,0.0,0.0,0.0,2.0,3.0,1.0,1.0,1.0,1.0,1.0,0.0,0.0,0.0,0.0,1.0,1.0,0.0,0.0,1.0,0.0,0.0,0.0,0.0,0.0,0.0,0.0,0.0,0.0,0.0,0.0,0.0,0.0,0.0,0.0,0.0,0.0,0.0,1.0,0.0,,53473.5,0.0,0.0,0.0,0.0,0.0,-609.0,-427.0,-546.0,-547.0,21.0,-10.0,8.0,11656.2825,97353.0,52735.5,45000.0,116997.75,6.0,-374.0,365243.0,-322.0,182464.5,129.0,182466.5,7.5,0.0,0.4964403815712046,4.0,13.0,6.0,4.5,-24.0,0.0,0.0,39.0,3780.0,3780.0,-211.0,-208.0,14.0,0.0,12.0,106527.4875,247500.0,0.0,77235.3,0.0,77235.3,4556.6100000000015,14898.78,12644.302500000002,103790.655,105406.9875,105406.9875,0.0,28.0,0.0,28.0,4.5,-6.5,0.0,0.0,8356021546.5,184558962559.5,165727395036.0,52026184405.935,1863.0,1706.0,71125.0,70953.0,9141.0,506635.0,,,,,,,128561.0,663540.0,,,,13541937.931506446,-602602529.0,-922891197.0,-296841412.0,-1536856613.0416667,44074.0,30744.0,,,,,,,,158206.97428931555,126245.22257868534,,,,,,,3718074.0,,,,,,,,,,,,,,,,436931.0,431723.0,,6431.590948002897,632640.0,626188.0,,,,,,,,,21.0,80956484.81999998,,8130695477.624986,2717549303.985001,95170323.33,786331.8449999999,149.0,17263.0,-26835751.0,11955182.0,-13905492.0,-15131312.0,-10.0,0.0,,53473.5,0.0,0.0,0.0,0.0,0.0,-609.0,-427.0,-546.0,-547.0,287458964.66249985,4094948992.815004,4601888050.365004,66904395.43499994,4094948992.815004,297625.0,-20556114.0,4773818402.5,208747341.5,1069068292.5,461179012.0,1121654020.0,295417.0,4652.5,836.303826597623,6862902.0,2449605.0,1508062.5,-4944256.0,1543347.0,103273.0,3249302677.920141,3283273953.0451183,-196987084.0,-195343653.0,3445670.0,163839.0,3002357929.274972,8114528250.0,252538815.465,389113880.0174994,12144146.535000002,124070847.54749988,169987255.53749895,426280948.74000007,393723932.6024989,2882755623.735008,2991259993.724961,2991400462.0349603,12951.0,34418.0,167.0,21300.0,976867.5,-1720743.0,710076.0,1689.0,1469054.0,14842852.0,3235929.0,8565531.0,11620561.0,1417492.0,1060940407.5045012,,72182471638.94965,21697246492.987617,583477279.4969988,5792665.7475,689.5,94245.0,-277224872.5,22034233.5,-123911267.0,-218935914.5,-2024167.5,5927490206.7524605,18744907500.0,198880482.825,448373728.46249765,1948107.735,257069040.25500083,309343236.1874986,637036739.3249979,459487266.14249927,5712492840.750034,5890739702.737497,5890982885.482499,13394.0,80965.5,44.0,70469.0,972257.5,-1700271.0,177364.0,6755.0,4277938.5,2482143.0,-9013652.5,921451.5,37582.5,3737956240.43996,3662627980.1399593,-260918252.0,-257602449.5,2529098.5,269519.0,3930568791.389954,33288269586.57092,36720351920.63265,1731781040.1075494,48137088227.108215,3992515.5,-247855408.5,103202355513.0,1055879762.5,17289890361.0,3507364954.5,18904465056.5,3676071.5,72015.0,20893.40123151332,89857066.0,-14.927196758673078,1.7326400000000002,7.138777841233582,308.9428350140429,12.368932038834954,535.2867136587313,112500.0,0.6234898018587336,0.7818314824680298,0.0,0.0,0.0,0.0,0.0,0.0,1.0,0.0,0.0,0.0,0.0,0.0,0.0,1.0,0.0,0.0,0.0,0.0,1.0,0.0,0.0,0.0,1.0,0.0,0.0,1.0,0.0,0.0,0.0,0.0,0.0,0.0,0.0,0.0,0.0,0.0,0.0,0.0,0.0,0.0,0.0,0.0,0.0,0.0,0.0,0.0,0.0,0.0,0.0,0.0,0.0,0.0,0.0,1.0,0.0,0.0,0.0,0.0,0.0,0.0,0.0,0.0,0.0,0.0,0.0,0.0,0.0,0.0,0.0,0.0,0.0,0.0,0.0,0.0,0.0,0.0,0.0,0.0,0.0,0.0,0.0,0.0,0.0,0.0,0.0,0.0,0.0,0.0,0.0,0.0,0.0,0.0,0.0,0.0,0.0,0.0,0.0,0.0,0.0,0.0,0.0,0.0,0.0,0.0,0.0,0.0,0.0,0.0,0.0,0.0,0.0,0.0,0.0,0.0,0.0,0.0,0.0,0.0,0.0,0.0
104988,0,0.0,1.0,0.0,1.0,0.0,247500.0,338832.0,26901.0,292500.0,0.04622,37.55342465753424,-3269.0,-6288.0,-534.0,,2.0,1.0,1.0,14.0,0.5404170843060305,0.4183266935611654,0.4830501881366946,0.1031,0.1144,0.9776,0.6940000000000001,0.0137,0.0,0.2069,0.1667,0.2083,0.0886,0.0841,0.0905,0.0,0.0,0.105,0.1187,0.9777,0.706,0.0138,0.0,0.2069,0.1667,0.2083,0.0907,0.0918,0.0942,0.0,0.0,0.1041,0.1144,0.9776,0.6981,0.0138,0.0,0.2069,0.1667,0.2083,0.0902,0.0855,0.0921,0.0,0.0,0.0711,1.0,0.0,0.0,0.0,0.0,-179.0,0.0,0.0,0.0,0.0,0.0,2.0,1.0,1.0,0.0,1.0,0.0,0.0,0.0,0.0,0.0,0.0,0.0,0.0,0.0,1.0,0.0,0.0,0.0,0.0,0.0,0.0,0.0,0.0,0.0,0.0,0.0,0.0,0.0,0.0,0.0,0.0,0.0,0.0,8.0,0.0,0.0,668250.0,0.0,0.0,0.0,0.0,0.0,-974.5,615.0,-512.5,-985.0,316.0,-23.0,8.0,13233.8925,43953.75,48595.5,0.0,112250.25,18.0,-180.0,365243.0,-1028.5,-878.5,-728.5,-874.0,16.5,0.5,0.0,-1.0,32.0,11.0,6.0,-39.5,0.0,0.0,29.0,16935.3,16935.3,-1213.0,-1194.0,4.0,1.0,0.0,,,,,,,,,,,,,,,,,,,,,8356048447.5,184559301391.5,165727687536.0,52026431905.935,1863.0,1706.0,71125.0,70953.0,9141.0,506637.0,17827.740800002306,17890.01819999912,17341.091699998007,11307.951300000092,11245.757600000095,11193.206100000065,128561.0,663542.0,4142.606900000114,4140.3075000000135,3950.8783000000935,13541975.484931106,-602605798.0,-922891731.0,-296841591.0,-1536862901.0416667,44074.0,30744.0,11360.133999999194,11236.079999998989,10720.12159999729,22913.7855000098,22835.54610000976,22220.414300008324,67559.9638809149,158207.3926160091,126245.70562887346,35039.83380002801,34979.95160002845,34425.38570002886,22977.78149999589,22950.816699995463,22597.5807999957,3718088.0,8304.840800000164,8409.497500000072,8132.9602000002305,9827.528500000715,9942.566000002154,10302.746099999636,16485.712999999723,16671.1560999997,16267.8483999997,829.257900000177,814.4355000000461,760.3549000000132,3917.687400000124,3900.9315000001616,3733.61300000016,436931.0,431723.0,,6431.637168002897,632641.0,626189.0,,16350.082199999795,154358.35089999074,154361.09249999037,154252.80569998722,77694.41799999638,78032.5828000066,78434.52770000661,32.5,81134340.56999998,27673876.17,8150068670.939986,2724812864.9550004,95760630.36,786331.8449999999,151.0,17263.0,-26895731.0,12009551.0,-13933560.5,-15160108.0,-15.75,0.0,0.0,661500.0,0.0,0.0,0.0,0.0,0.0,-2566.0,-740.0,-1013.0,-1015.0,288774380.0699998,4114646267.715004,4623979596.615004,67061059.33499994,4114646267.715004,298933.0,-20633269.5,4792076253.5,209056050.0,1071217094.5,462609826.5,1123804825.5,296508.5,4674.0,838.4399482634641,6872180.0,2456924.0,1512875.5,-4960732.0,1543347.0,103273.0,3265454361.5101547,3298898100.780129,-197664015.0,-196012984.0,3455682.0,164292.0,,,,,,,,,,,,,,,,,,,,,1469062.0,14843168.0,3235929.0,8565563.0,11620590.0,1417500.0,1060940407.5045012,802184983.7399952,72183139888.94965,21697246492.987617,583477279.4969988,5792665.7475,689.5,94245.0,-277225847.0,22034848.5,-123911779.5,-218936899.5,-2024190.5,,,,,,,,,,,,,,,,,,,,,4277949.5,2482149.0,-9013692.0,921451.5,37582.5,3737973175.7399592,3662644915.43996,-260919465.0,-257603643.5,2529102.5,269520.0,3930582025.282454,33288313540.32092,36720400516.13265,1731781040.1075494,48137200477.358215,3992533.5,-247855588.5,103202720756.0,1055878734.0,17289889482.5,3507364226.0,18904464182.5,3676088.0,72015.5,20893.40123151332,89857065.0,-87.04931786678341,1.369018181818182,9.200401472064236,345.5065835002314,12.595516895282705,473.00479474969865,123750.0,-0.2225209339563146,-0.9749279121818236,0.0,0.0,0.0,0.0,0.0,0.0,1.0,0.0,1.0,0.0,0.0,0.0,0.0,0.0,0.0,0.0,0.0,0.0,1.0,0.0,1.0,0.0,0.0,0.0,0.0,1.0,0.0,0.0,0.0,0.0,0.0,0.0,0.0,0.0,0.0,0.0,0.0,0.0,1.0,0.0,0.0,0.0,0.0,0.0,0.0,0.0,0.0,0.0,0.0,0.0,0.0,0.0,0.0,0.0,0.0,0.0,0.0,0.0,0.0,0.0,0.0,0.0,1.0,0.0,0.0,0.0,0.0,0.0,0.0,0.0,0.0,0.0,0.0,0.0,0.0,0.0,0.0,0.0,0.0,0.0,0.0,0.0,0.0,0.0,0.0,0.0,0.0,0.0,0.0,0.0,0.0,0.0,0.0,0.0,0.0,0.0,0.0,0.0,0.0,0.0,0.0,0.0,0.0,0.0,0.0,0.0,0.0,0.0,1.0,0.0,1.0,0.0,0.0,0.0,0.0,0.0,0.0,0.0,1.0,0.0
105013,0,0.0,0.0,0.0,1.0,0.0,157500.0,725328.0,27472.5,540000.0,0.031329,55.21917808219178,-3522.0,-11918.0,-3680.0,,2.0,2.0,2.0,10.0,,0.6103321141632545,0.7180328113294772,,,,,,,,,,,,,,,,,,,,,,,,,,,,,,,,,,,,,,,,,,,,,12.0,3.0,12.0,1.0,-1761.0,0.0,0.0,0.0,0.0,3.0,1.0,1.0,1.0,0.0,1.0,0.0,0.0,0.0,0.0,0.0,0.0,1.0,1.0,0.0,1.0,0.0,0.0,0.0,0.0,0.0,0.0,0.0,0.0,0.0,0.0,0.0,0.0,0.0,0.0,0.0,0.0,0.0,0.0,3.0,5683.5,0.0,337500.0,0.0,0.0,0.0,0.0,0.0,-1781.0,-671.0,-643.0,-677.0,176.0,-29.0,5.0,12963.51,127746.0,146295.0,0.0,127746.0,12.0,-81.0,365243.0,-51.0,365243.0,279.0,365243.0,11.0,0.0,0.0,150.0,26.0,12.0,12.0,-21.5,0.0,0.0,26.0,37208.655,43605.855,-569.0,-568.0,6.0,1.5,2.0,0.0,45000.0,,0.0,,,0.0,,0.0,0.0,0.0,0.0,,0.0,,,0.0,-1.5,0.0,0.0,8356075920.0,184560026719.5,165728227536.0,52026589405.935,1863.0,1706.0,71125.0,70956.0,9141.0,506638.0,,,,,,,128561.0,663544.0,,,,13542030.704109184,-602609320.0,-922895411.0,-296843352.0,-1536874819.0416667,44077.0,30745.0,,,,,,,,158208.00294812323,126246.42366168476,,,,,,,3718098.0,,,,,,,,,,,,,,,,436943.0,431735.0,,6431.668497002896,632643.0,626191.0,,,,,,,,,59.0,81584936.45999998,27702150.93,8248221115.964984,2743342861.4550004,95999130.36,786336.3449999999,151.0,17296.0,-27038210.0,12088321.0,-14004816.0,-15233441.0,-29.0,5683.5,0.0,337500.0,0.0,0.0,0.0,0.0,0.0,-1781.0,-671.0,-643.0,-677.0,290182210.46999985,4133761755.255004,4644280473.615004,67855237.87499994,4133761755.255004,300429.0,-20748715.0,4820015153.0,211166910.0,1079192191.0,465118099.0,1131415522.0,298078.0,4694.0,844.4125158664219,6913081.0,2472150.0,1522041.5,-4987450.5,1543347.0,103273.0,3279869204.9176416,3313422046.125119,-198463999.5,-196802142.5,3464291.5,165174.0,3024006988.049973,8179510500.0,,392271643.0799994,,,171238398.52499893,,397055281.364999,2903424022.5750074,3012848809.5599627,3012993057.8699613,,34767.0,,,981234.0,-1728081.0,710088.0,1701.0,1469065.0,14843344.0,3235931.0,8565589.0,11620616.0,1417505.0,1060946091.0045012,802184983.7399952,72183477388.94965,21697246492.987617,583477279.4969988,5792665.7475,689.5,94245.0,-277227628.0,22034177.5,-123912422.5,-218937576.5,-2024219.5,5927490206.7524605,18744952500.0,,448373728.46249765,,,309343236.1874986,,459487266.14249927,5712492840.750034,5890739702.737497,5890982885.482499,,80965.5,,,972257.5,-1700272.5,177364.0,6755.0,4277961.5,2482161.0,-9013713.5,921451.5,37582.5,3738010384.39496,3662688521.29496,-260920034.0,-257604211.5,2529108.5,269521.5,3930594988.792455,33288441286.32092,36720546811.13265,1731781040.1075494,48137328223.358215,3992545.5,-247855669.5,103203085999.0,1055878683.0,17290254725.5,3507364505.0,18904829425.5,3676099.0,72015.5,20893.40123151332,89857215.0,-63.78218804266932,4.605257142857143,5.733005733005732,316.57186451707,26.401965601965603,1457.8948402948404,78750.0,0.6234898018587334,-0.7818314824680299,0.0,1.0,0.0,0.0,0.0,0.0,0.0,0.0,0.0,0.0,0.0,0.0,0.0,1.0,0.0,0.0,0.0,0.0,1.0,0.0,1.0,0.0,0.0,0.0,1.0,0.0,0.0,0.0,0.0,0.0,0.0,0.0,0.0,0.0,0.0,0.0,0.0,0.0,1.0,0.0,0.0,0.0,0.0,0.0,0.0,0.0,0.0,0.0,0.0,0.0,0.0,0.0,0.0,0.0,0.0,0.0,0.0,0.0,0.0,0.0,0.0,1.0,0.0,0.0,0.0,0.0,0.0,0.0,0.0,0.0,0.0,0.0,0.0,0.0,0.0,0.0,0.0,0.0,0.0,0.0,0.0,0.0,0.0,0.0,0.0,0.0,0.0,0.0,0.0,0.0,0.0,0.0,0.0,0.0,0.0,0.0,0.0,0.0,0.0,0.0,0.0,0.0,0.0,0.0,0.0,0.0,0.0,0.0,0.0,0.0,0.0,0.0,0.0,0.0,0.0,0.0,0.0,0.0,0.0,0.0
105015,0,0.0,0.0,0.0,0.0,0.0,112500.0,710640.0,70416.0,675000.0,0.019101,54.53972602739726,-4964.0,-5974.0,-3450.0,,2.0,2.0,2.0,10.0,0.7785593076394364,0.5953070027921077,0.6347055309763198,,,,,,,,,,,,,,,,,,,,,,,,,,,,,,,,,,,,,,,,,,,,,5.0,0.0,5.0,0.0,0.0,0.0,0.0,0.0,0.0,0.0,1.0,1.0,1.0,0.0,1.0,0.0,0.0,0.0,0.0,0.0,0.0,0.0,0.0,0.0,1.0,0.0,0.0,0.0,0.0,0.0,0.0,0.0,0.0,0.0,0.0,0.0,0.0,0.0,0.0,0.0,0.0,0.0,0.0,1.0,16833.735,0.0,101002.5,69669.0,0.0,0.0,0.0,0.0,-91.0,90.0,-29.0,,4.0,-1.5,5.0,7201.215,0.0,47376.0,27000.0,121347.0,6.0,-927.0,181276.5,-1773.5,-1291.5,182518.5,182522.5,11.0,0.0,0.2900632747933883,19.0,29.0,24.0,10.0,-21.0,0.0,0.0,126.0,1288.89,1288.89,-1144.5,-1144.5,34.5,0.0,90.0,0.0,0.0,0.0,0.0,0.0,0.0,0.0,1288.89,0.0,0.0,0.0,0.0,0.0,0.0,0.0,0.0,10.0,-45.5,0.0,0.0,8356146336.0,184560737359.5,165728902536.0,52026701905.935,1863.0,1706.0,71125.0,70956.0,9141.0,506639.0,,,,,,,128561.0,663546.0,,,,13542085.243835216,-602614284.0,-922898861.0,-296843352.0,-1536880793.0416667,44077.0,30745.0,,,,,,,67560.74244022254,158208.59825512607,126247.05836721574,,,,,,,3718108.0,,,,,,,,,,,,,,,,436948.0,431740.0,,6431.687598002897,632645.0,626193.0,,,,,,,,,4.0,81601770.19499998,27702150.93,8248359526.964984,2743412530.4550004,95999130.36,786336.3449999999,151.0,17296.0,-27040082.0,12086816.0,-14006473.0,,-1.5,16833.735,0.0,101002.5,69669.0,0.0,0.0,0.0,0.0,-91.0,90.0,-29.0,,290224202.84999985,4134226749.255004,4644858485.115004,67882237.87499994,4134276249.255004,300477.0,-20754667.0,4821109318.0,211527334.5,1079919768.5,465664956.5,1132326926.5,298155.0,4694.0,844.7025791412153,6913598.0,2472638.0,1522321.0,-4988328.0,1543347.0,103273.0,3280595457.1951423,3314409707.520119,-198553381.0,-196891165.0,3466560.0,165225.0,3024363490.604974,8180568000.0,254324415.465,392371093.0799994,12144146.535000002,125516045.24999988,171269898.52499893,429850162.79999965,397141663.904999,2903760655.290008,3013201397.834964,3013345646.1449623,13029.0,34775.0,167.0,21579.0,981678.0,-1730045.0,710089.0,1702.0,1469066.0,14843348.0,3236021.0,8565618.0,11620742.0,1417510.0,1060962924.7395012,802184983.7399952,72183578391.44965,21697316161.987617,583477279.4969988,5792665.7475,689.5,94245.0,-277227719.0,22034267.5,-123912451.5,,-2024221.0,5927490206.7524605,18744952500.0,198880482.825,448373728.46249765,1948107.735,257069040.25500083,309343236.1874986,637038028.2149979,459487266.14249927,5712492840.750034,5890739702.737497,5890982885.482499,13394.0,80965.5,44.0,70469.0,972267.5,-1700318.0,177364.0,6755.0,4277985.5,2482171.0,-9013734.5,921451.5,37582.5,3738011673.2849593,3662689810.18496,-260921178.5,-257605356.0,2529143.0,269521.5,3930602190.007455,33288441286.32092,36720594187.13265,1731808040.1075494,48137449570.358215,3992551.5,-247856596.5,103203267275.5,1055876909.5,17290253434.0,3507547023.5,18905011948.0,3676110.0,72015.5,20893.69129478812,89857234.0,-91.01622544833477,6.3168,1.5976482617586911,87.13529848446647,10.0920245398773,550.4162534666779,56250.0,0.6234898018587336,0.7818314824680298,0.0,0.0,0.0,0.0,0.0,0.0,1.0,0.0,0.0,0.0,0.0,0.0,0.0,1.0,0.0,0.0,0.0,0.0,1.0,0.0,1.0,0.0,0.0,0.0,0.0,1.0,0.0,0.0,0.0,0.0,0.0,0.0,0.0,0.0,0.0,0.0,0.0,0.0,1.0,0.0,0.0,0.0,0.0,0.0,0.0,0.0,0.0,0.0,0.0,1.0,0.0,0.0,0.0,0.0,0.0,0.0,0.0,0.0,0.0,0.0,0.0,0.0,0.0,0.0,0.0,0.0,0.0,0.0,0.0,0.0,0.0,0.0,0.0,0.0,0.0,0.0,0.0,0.0,0.0,0.0,0.0,0.0,0.0,0.0,0.0,0.0,0.0,0.0,0.0,0.0,0.0,0.0,0.0,0.0,0.0,0.0,0.0,0.0,0.0,0.0,0.0,0.0,0.0,0.0,0.0,0.0,0.0,0.0,0.0,0.0,0.0,0.0,0.0,0.0,0.0,0.0,0.0,0.0,0.0,0.0
105019,0,0.0,0.0,0.0,1.0,0.0,202500.0,332946.0,16146.0,238500.0,0.018634,58.88219178082193,,-2443.0,-4639.0,,2.0,2.0,2.0,9.0,,0.5048180694167108,0.4632753280912678,0.1258,0.0,0.9861,,,0.0,0.069,0.1667,,0.0156,,0.057,,0.0772,0.1282,0.0,0.9861,,,0.0,0.069,0.1667,,0.016,,0.0594,,0.0817,0.127,0.0,0.9861,,,0.0,0.069,0.1667,,0.0159,,0.058,,0.0788,0.0616,1.0,0.0,0.0,0.0,0.0,-1282.0,0.0,0.0,0.0,0.0,0.0,0.0,1.0,0.0,0.0,1.0,0.0,0.0,0.0,0.0,0.0,0.0,0.0,0.0,0.0,1.0,0.0,0.0,0.0,0.0,0.0,0.0,0.0,0.0,0.0,0.0,0.0,0.0,0.0,0.0,0.0,0.0,0.0,0.0,5.0,0.0,,13500.0,0.0,,0.0,0.0,0.0,-45.0,,-21.0,-32.5,10.0,-1.0,5.0,11250.0,100354.5,90315.0,10039.5,100354.5,4.0,-959.0,365243.0,-927.0,-837.0,-597.0,-829.0,12.0,0.0,0.2119640546220662,23.0,25.0,8.0,4.0,-31.0,0.0,0.0,20.0,14287.59,14287.59,-914.0,-882.0,3.0,1.0,22.0,0.0,225000.0,,0.0,,,0.0,,0.0,0.0,0.0,0.0,,0.0,,,0.0,-14.5,0.0,0.0,8356162482.0,184561070305.5,165729141036.0,52026904405.935,1863.0,1706.0,71125.0,70956.0,9141.0,506639.0,17827.866600002308,17890.14519999912,17341.219899998006,11307.951300000092,11245.757600000095,11193.206100000065,128561.0,663548.0,,,,13542144.126026995,,-922903500.0,-296844634.0,-1536883236.0416667,44077.0,30745.0,11360.133999999194,11236.079999998989,10720.12159999729,22913.8545000098,22835.61510000976,22220.483300008324,,158209.1030731955,126247.52164254384,35040.000500028014,34980.11830002845,34425.552400028864,,,,3718117.0,8304.856400000164,8409.513400000073,8132.976200000231,,,,16485.769999999724,16671.2140999997,16267.9077999997,,,,3917.764600000123,3901.010300000162,3733.694700000161,436948.0,431740.0,,6431.706232002896,632647.0,626195.0,,16350.143799999794,154359.33699999074,154362.07859999035,154253.7917999872,,,,2.0,81601770.19499998,,8258339539.889984,2746210515.840001,,786336.3449999999,153.0,17296.0,-27063374.0,,-14019362.0,-15247386.5,-0.75,0.0,,13500.0,0.0,,0.0,0.0,0.0,-83.0,,-44.0,-44.0,290734854.0749998,4139957926.755004,4650806895.615004,68004610.87499994,4139957926.755004,300745.0,-20771378.0,4826951670.0,212244757.0,1082101178.0,466571676.0,1134692195.0,298348.0,4700.0,845.8203779581329,6916370.0,2474787.0,1523772.0,-4991974.0,1543348.0,103274.0,3283671573.6526327,3317519689.492611,-198732200.0,-197067943.5,3470414.0,165364.5,3024759026.384974,8186395500.0,,393176344.49999934,,,171314177.66999894,,397891986.7499991,2904145416.405008,3013589200.139965,3013733448.449964,,34795.0,,,982102.0,-1732426.0,710090.0,1702.0,1469071.0,14843358.0,3236043.0,8565643.0,11620762.0,1417515.0,1060962924.7395012,,72183591891.44965,21697316161.987617,,5792665.7475,689.5,94245.0,-277227764.0,,-123912472.5,-218937609.0,-2024222.0,5927490206.7524605,18745177500.0,,448373728.46249765,,,309343236.1874986,,459487266.14249927,5712492840.750034,5890739702.737497,5890982885.482499,,80965.5,,,972267.5,-1700332.5,177364.0,6755.0,4277993.5,2482175.0,-9013765.5,921451.5,37582.5,3738025960.87496,3662704097.77496,-260922092.5,-257606238.0,2529146.0,269522.5,3930613440.007455,33288541640.82092,36720684502.13265,1731818079.6075494,48137549924.858215,3992555.5,-247857555.5,103203632518.5,1055875982.5,17290252597.0,3507546426.5,18905011119.0,3676122.0,72015.5,20893.90325884274,89857257.0,,1.6441777777777775,12.541806020066891,738.4890273514454,20.62095875139353,1214.207247903972,101250.0,-0.2225209339563143,0.9749279121818236,0.0,0.0,0.0,0.0,0.0,0.0,1.0,0.0,0.0,1.0,0.0,0.0,0.0,0.0,0.0,0.0,0.0,0.0,1.0,0.0,1.0,0.0,0.0,0.0,0.0,1.0,0.0,0.0,0.0,0.0,0.0,0.0,0.0,0.0,0.0,0.0,0.0,0.0,0.0,0.0,0.0,0.0,0.0,0.0,0.0,0.0,0.0,0.0,0.0,0.0,0.0,0.0,0.0,0.0,0.0,0.0,0.0,0.0,0.0,0.0,0.0,0.0,0.0,0.0,0.0,0.0,0.0,0.0,0.0,0.0,0.0,0.0,0.0,0.0,0.0,0.0,0.0,0.0,0.0,0.0,0.0,0.0,0.0,0.0,0.0,0.0,0.0,0.0,0.0,0.0,0.0,0.0,0.0,0.0,0.0,0.0,0.0,0.0,0.0,0.0,0.0,0.0,0.0,0.0,0.0,1.0,0.0,0.0,0.0,0.0,0.0,1.0,0.0,0.0,0.0,0.0,0.0,0.0,1.0,0.0
105027,0,0.0,0.0,0.0,0.0,0.0,135000.0,248877.0,12834.0,189000.0,0.009334,62.12328767123286,,-773.0,-4742.0,,1.0,2.0,2.0,11.0,,0.2559699921151201,0.7091891096653581,,,,,,,,,,,,,,,,,,,,,,,,,,,,,,,,,,,,,,,,,,,,,8.0,0.0,8.0,0.0,0.0,0.0,0.0,0.0,0.0,0.0,2.0,1.0,0.0,0.0,1.0,0.0,0.0,0.0,0.0,0.0,0.0,0.0,0.0,0.0,0.0,0.0,0.0,1.0,0.0,0.0,0.0,0.0,0.0,0.0,0.0,0.0,0.0,0.0,0.0,0.0,0.0,0.0,0.0,2.0,17673.75,,1118250.0,499027.5,0.0,0.0,0.0,0.0,-1015.5,719.5,-194.0,-797.0,68.0,-16.5,2.0,10741.455,113726.25,104982.75,13500.0,113726.25,12.0,-549.5,365243.0,-519.0,182300.0,-189.0,182305.5,14.0,0.5,0.09856918355425,716.5,17.0,12.0,8.0,-22.0,0.0,0.0,21.0,8195.625,8195.625,-676.0,-682.0,6.0,1.0,0.0,,,,,,,,,,,,,,,,,,,,,8356175316.0,184561319182.5,165729330036.0,52027039405.935,1863.0,1706.0,71125.0,70956.0,9141.0,506641.0,,,,,,,128561.0,663549.0,,,,13542206.249314666,,-922908242.0,-296844634.0,-1536884009.0416667,44077.0,30745.0,,,,,,,,158209.3590431876,126248.23083165348,,,,,,,3718128.0,,,,,,,,,,,,,,,,436956.0,431748.0,,6431.7155660028975,632649.0,626197.0,,,,,,,,,34.0,81669207.55499998,,8263994304.329986,2748748620.2850013,96296918.85,786461.8049999998,155.0,17326.0,-27106015.0,12128220.5,-14043104.5,-15274299.0,-16.5,0.0,,895500.0,0.0,0.0,0.0,0.0,0.0,-1468.0,359.0,-375.0,-797.0,291357719.79749995,4150237949.370004,4662060243.615004,68091017.48999994,4150237949.370004,301492.0,-20811301.0,4836995189.5,213309706.5,1084268035.5,467647848.5,1136493591.0,298846.0,4708.0,847.2739532996496,6923562.0,2478503.0,1526367.0,-5000914.0,1543366.0,103292.0,3288338495.910137,3323587898.5651164,-198992553.0,-197325671.0,3472777.0,165668.0,,,,,,,,,,,,,,,,,,,,,1469073.0,14843426.0,3236043.0,8565660.0,11620783.0,1417517.0,1060980598.4895012,,72184710141.44965,21697815189.487617,583477279.4969988,5792665.7475,689.5,94245.0,-277228779.5,22034987.0,-123912666.5,-218938406.0,-2024238.5,,,,,,,,,,,,,,,,,,,,,4278005.5,2482183.0,-9013787.5,921451.5,37582.5,3738034156.49996,3662712293.39996,-260922768.5,-257606920.0,2529152.0,269523.5,3930624181.462455,33288655367.07092,36720789484.88265,1731831579.6075494,48137663651.108215,3992567.5,-247858105.0,103203997761.5,1055875463.5,17290434897.0,3507546237.5,18905193424.5,3676136.0,72016.0,20894.001828026296,89857973.5,,1.8435333333333328,10.518934081346424,653.4707679302195,19.392005610098177,1204.6951430382908,135000.0,0.6234898018587336,0.7818314824680298,0.0,0.0,0.0,0.0,0.0,0.0,1.0,0.0,0.0,1.0,0.0,0.0,0.0,0.0,0.0,0.0,0.0,0.0,1.0,0.0,0.0,0.0,1.0,0.0,0.0,0.0,1.0,0.0,0.0,0.0,0.0,0.0,0.0,0.0,0.0,0.0,0.0,0.0,0.0,0.0,0.0,0.0,0.0,0.0,0.0,0.0,0.0,0.0,0.0,0.0,0.0,0.0,0.0,0.0,0.0,0.0,0.0,0.0,0.0,0.0,0.0,0.0,0.0,0.0,0.0,0.0,0.0,0.0,0.0,0.0,0.0,0.0,0.0,0.0,0.0,0.0,0.0,0.0,0.0,0.0,0.0,0.0,0.0,0.0,0.0,0.0,0.0,0.0,0.0,0.0,0.0,0.0,0.0,0.0,0.0,0.0,0.0,0.0,0.0,0.0,0.0,0.0,0.0,0.0,0.0,1.0,0.0,0.0,0.0,0.0,0.0,0.0,0.0,0.0,0.0,0.0,0.0,0.0,0.0,0.0
105030,0,0.0,1.0,0.0,0.0,2.0,180000.0,630000.0,32296.5,630000.0,0.026392,34.34794520547945,-324.0,-646.0,-2565.0,,4.0,2.0,2.0,12.0,,0.5373965518429507,,,,,,,,,,,,,,,,,,,,,,,,,,,,,,,,,,,,,,,,,,,,,,0.0,0.0,0.0,0.0,-1.0,0.0,0.0,0.0,0.0,1.0,0.0,1.0,1.0,0.0,1.0,0.0,0.0,0.0,0.0,0.0,0.0,0.0,0.0,0.0,0.0,0.0,1.0,0.0,0.0,0.0,0.0,0.0,0.0,0.0,0.0,0.0,0.0,0.0,0.0,0.0,0.0,0.0,0.0,2.0,,,72572.85,0.0,,0.0,0.0,0.0,-1066.0,-610.0,-526.5,-865.5,71.0,-26.0,1.0,10514.79,87858.0,95589.0,0.0,87858.0,10.0,-1035.0,365243.0,-1004.0,-734.0,-734.0,-725.0,13.0,0.0,0.0,56.0,11.0,10.0,5.0,-29.0,0.0,0.0,10.0,10514.79,10514.79,-875.5,-869.0,5.5,1.0,0.0,,,,,,,,,,,,,,,,,,,,,8356207612.5,184561949182.5,165729960036.0,52027219405.935,1863.0,1706.0,71125.0,70957.0,9141.0,506641.0,,,,,,,128563.0,663553.0,,,,13542240.597259872,-602614608.0,-922910807.0,-296844635.0,-1536884655.0416667,44077.0,30745.0,,,,,,,,158209.89643973944,,,,,,,,3718140.0,,,,,,,,,,,,,,,,436956.0,431748.0,,6431.741958002896,632651.0,626199.0,,,,,,,,,35.5,,,8267354910.989984,2750110977.2850013,,786461.8049999998,155.0,17326.0,-27126270.0,12150349.0,-14054000.5,-15287265.5,-17.25,,,101187.0,0.0,,0.0,0.0,0.0,-1866.0,-1532.0,-882.0,-1558.0,291408217.2,4151058114.870004,4662908457.615004,68095292.48999994,4151058114.870004,301540.0,-20818018.0,4838273540.0,213305412.0,1084630059.0,467644889.0,1136855634.0,298930.0,4709.0,847.3928770196077,6925195.0,2479109.0,1526732.0,-5002099.0,1543371.0,103297.0,3288627197.3701377,3323866632.5251174,-199027526.5,-197360249.0,3473107.0,165715.5,,,,,,,,,,,,,,,,,,,,,1469075.0,14843497.0,3236043.0,8565671.0,11620793.0,1417518.0,,,72184782714.29965,21697815189.487617,,5792665.7475,689.5,94245.0,-277229845.5,22034377.0,-123913193.0,-218939271.5,-2024264.5,,,,,,,,,,,,,,,,,,,,,4278015.5,2482188.0,-9013816.5,921451.5,37582.5,3738044671.28996,3662722808.18996,-260923644.0,-257607789.0,2529157.5,269524.5,3930634696.252455,33288743225.07092,36720885073.88265,1731831579.6075494,48137751509.108215,3992577.5,-247859140.0,103204363004.5,1055874459.5,17290434163.0,3507545503.5,18905192699.5,3676149.0,72016.0,20894.001828026296,89858029.5,-9.432878679109834,3.5,5.573359342343597,191.4334413012649,19.50675769820259,670.0170445544271,45000.0,-0.2225209339563143,0.9749279121818236,0.0,0.0,0.0,0.0,0.0,0.0,1.0,0.0,0.0,0.0,0.0,0.0,0.0,1.0,0.0,1.0,0.0,0.0,0.0,0.0,1.0,0.0,0.0,0.0,0.0,1.0,0.0,0.0,0.0,0.0,0.0,0.0,0.0,0.0,0.0,0.0,0.0,0.0,1.0,0.0,0.0,0.0,0.0,0.0,0.0,0.0,0.0,0.0,0.0,0.0,0.0,0.0,0.0,0.0,0.0,0.0,0.0,0.0,0.0,0.0,0.0,0.0,0.0,0.0,0.0,0.0,0.0,0.0,0.0,0.0,0.0,0.0,0.0,0.0,0.0,0.0,0.0,0.0,0.0,0.0,0.0,1.0,0.0,0.0,0.0,0.0,0.0,0.0,0.0,0.0,0.0,0.0,0.0,0.0,0.0,0.0,0.0,0.0,0.0,0.0,0.0,0.0,0.0,0.0,0.0,0.0,0.0,0.0,0.0,0.0,0.0,0.0,0.0,0.0,0.0,0.0,0.0,0.0,0.0,0.0
105035,1,0.0,1.0,1.0,0.0,0.0,67500.0,312840.0,24844.5,247500.0,0.020713,30.523287671232875,-1362.0,-5122.0,-3700.0,12.0,2.0,3.0,3.0,7.0,0.3731831233428927,0.1265083587722582,0.3859146722745145,,,,,,,,,,,,,,,,,,,,,,,,,,,,,,,,,,,,,,,,,,,,,3.0,1.0,3.0,1.0,-190.0,0.0,0.0,0.0,0.0,0.0,4.0,1.0,1.0,0.0,1.0,0.0,1.0,0.0,0.0,0.0,0.0,1.0,1.0,0.0,1.0,0.0,0.0,0.0,0.0,0.0,0.0,0.0,0.0,0.0,0.0,0.0,0.0,0.0,0.0,0.0,0.0,0.0,0.0,6.0,12816.0,0.0,186134.04,117828.0,0.0,0.0,0.0,0.0,-1123.5,-27.0,-431.5,-833.0,212.0,-17.0,10.0,5325.075,21575.25,22500.0,0.0,52600.5,12.0,-198.5,365243.0,-537.0,182465.5,-27.0,182467.0,10.0,0.0,0.0,-1.0,28.0,24.0,11.5,-15.5,0.0,0.0,27.0,5325.075,5325.075,-487.0,-462.0,7.0,1.0,0.0,,,,,,,,,,,,,,,,,,,,,8356232457.0,184562262022.5,165730207536.0,52027286905.935,1863.0,1706.0,71125.0,70957.0,9141.0,506645.0,,,,,,,128563.0,663555.0,,,,13542271.120547542,-602615970.0,-922914507.0,-296844825.0,-1536889777.0416667,44078.0,30746.0,,,,,,,67561.11562334589,158210.02294809822,126248.61674632574,,,,,,,3718147.0,,,,,,,,,,,,,,,,436959.0,431751.0,1264531.0,6431.762671002897,632654.0,626202.0,,,,,,,,,37.5,81746027.05499998,27872331.21,8274343022.234984,2751639267.2850013,96297213.96,786461.8049999998,155.0,17326.0,-27187737.5,12143083.0,-14092121.5,-15326432.0,-18.25,12816.0,0.0,236250.0,235656.0,0.0,0.0,0.0,0.0,-1200.0,-833.0,-687.0,-833.0,292171114.2599999,4159458939.870004,4672466268.615004,68176418.48999994,4159555689.870004,302026.0,-20864879.0,4845395778.5,213277129.0,1085155235.5,467624181.0,1137380965.5,299376.0,4716.0,848.6295801147031,6930241.5,2482350.0,1528682.5,-5012252.0,1543428.0,103336.0,3293231839.515136,3328236009.045116,-199327699.0,-197658680.0,3474524.0,165949.0,,,,,,,,,,,,,,,,,,,,,1469081.0,14843709.0,3236043.0,8565699.0,11620820.0,1417528.0,1060993414.4895012,802184983.7399952,72184968848.33965,21697933017.487617,583477279.4969988,5792665.7475,689.5,94245.0,-277230969.0,22034350.0,-123913624.5,-218940104.5,-2024281.5,,,,,,,,,,,,,,,,,,,,,4278039.5,2482199.5,-9013832.0,921451.5,37582.5,3738049996.3649592,3662728133.2649593,-260924131.0,-257608251.0,2529164.5,269525.5,3930640021.327454,33288764800.32092,36720907573.88265,1731831579.6075494,48137804109.608215,3992589.5,-247859338.5,103204728247.5,1055873922.5,17290616628.5,3507545476.5,18905375166.5,3676159.0,72016.0,20894.001828026296,89858028.5,-44.62166771384975,4.634666666666667,2.716899112479623,82.92869318393281,12.59192175330556,384.34685000980073,33750.0,1.0,0.0,0.0,0.0,0.0,0.0,0.0,0.0,1.0,0.0,0.0,0.0,0.0,0.0,0.0,1.0,0.0,0.0,0.0,0.0,1.0,0.0,1.0,0.0,0.0,0.0,0.0,0.0,1.0,0.0,0.0,0.0,0.0,0.0,0.0,0.0,0.0,0.0,0.0,0.0,1.0,0.0,0.0,0.0,0.0,0.0,0.0,0.0,0.0,0.0,0.0,0.0,0.0,0.0,0.0,0.0,0.0,1.0,0.0,0.0,0.0,0.0,0.0,0.0,0.0,0.0,0.0,0.0,0.0,0.0,0.0,0.0,0.0,0.0,0.0,0.0,0.0,0.0,0.0,0.0,0.0,0.0,0.0,0.0,0.0,0.0,0.0,0.0,0.0,0.0,0.0,0.0,0.0,0.0,0.0,0.0,0.0,0.0,0.0,0.0,0.0,0.0,0.0,0.0,0.0,0.0,0.0,0.0,0.0,0.0,0.0,0.0,0.0,0.0,0.0,0.0,0.0,0.0,0.0,0.0,0.0,0.0
105041,0,0.0,0.0,0.0,1.0,0.0,112500.0,278460.0,21676.5,225000.0,0.005084,60.68767123287671,,-2733.0,-4547.0,,2.0,2.0,2.0,12.0,0.6003916634304629,0.6593963543558583,0.6940926425266661,,0.1882,0.9851,0.7959999999999999,,0.0,,0.125,0.1667,,0.1454,0.0631,,,,0.1953,0.9851,0.804,,0.0,,0.125,0.1667,,0.1589,0.0658,,,,0.1882,0.9851,0.7987,,0.0,,0.125,0.1667,,0.1479,0.0643,,,0.0747,1.0,23.0,0.0,23.0,0.0,-202.0,0.0,0.0,0.0,0.0,1.0,0.0,1.0,0.0,0.0,1.0,0.0,0.0,0.0,0.0,0.0,0.0,0.0,0.0,0.0,0.0,0.0,0.0,1.0,0.0,0.0,0.0,0.0,0.0,0.0,0.0,0.0,0.0,0.0,0.0,0.0,0.0,0.0,0.0,7.0,0.0,0.0,18630.0,0.0,0.0,0.0,0.0,0.0,-1286.0,-531.0,-526.0,-1268.0,236.0,-21.5,1.0,9194.22,67455.0,47623.5,22500.0,67455.0,6.0,-202.0,365243.0,-172.0,-22.0,-22.0,-15.0,15.0,1.0,0.3494484082304143,10.0,6.0,6.0,3.5,-4.5,0.0,0.0,6.0,9194.22,9194.22,-102.5,-97.0,3.5,1.0,0.0,,,,,,,,,,,,,,,,,,,,,8356254133.5,184562540482.5,165730432536.0,52027399405.935,1863.0,1706.0,71125.0,70958.0,9141.0,506645.0,,,,11308.139500000096,11245.945800000096,11193.401400000064,128563.0,663557.0,,,,13542331.808218775,,-922919054.0,-296845027.0,-1536892510.0416667,44078.0,30746.0,11360.133999999194,11236.079999998989,10720.12159999729,,,,67561.71601500933,158210.68234445257,126249.3108389683,35040.125500028014,34980.24330002845,34425.677400028864,22977.948199995888,22950.983399995464,22597.747499995698,3718159.0,,,,9827.673900000716,9942.713900002154,10302.904999999637,16485.833099999723,16671.278399999694,16267.9735999997,,,,,,,436982.0,431774.0,,6431.7677550028975,632656.0,626204.0,,16350.218499999795,154360.32209999074,154363.06369999037,154254.77689998722,77695.21399999638,78033.3815000066,78435.33170000662,43.0,81769652.05499998,27872331.21,8278832776.049984,2753757605.700001,96409345.72499998,786461.8049999998,155.0,17326.0,-27215443.0,12163181.0,-14103143.0,-15341549.0,-21.0,0.0,0.0,32053.05,0.0,0.0,0.0,0.0,0.0,-1372.0,-1281.0,-917.0,-1281.0,292497665.8499998,4166197118.370004,4679732094.615004,68263250.48999994,4166197118.370004,302558.0,-20889735.0,4852883260.0,213621595.0,1087148133.0,467980422.0,1139373968.0,299802.0,4725.0,849.993886401342,6940417.0,2486600.0,1531643.5,-5019480.0,1543490.0,103336.0,3298374822.195141,3333288464.865119,-199539976.5,-197868775.0,3475826.5,166148.5,,,,,,,,,,,,,,,,,,,,,1469088.0,14843945.0,3236043.0,8565705.0,11620826.0,1417529.0,1060993414.4895012,802184983.7399952,72184987478.33965,21697933017.487617,583477279.4969988,5792665.7475,689.5,94245.0,-277232255.0,22033819.0,-123914150.5,-218941372.5,-2024303.0,,,,,,,,,,,,,,,,,,,,,4278045.5,2482203.0,-9013836.5,921451.5,37582.5,3738059190.58496,3662737327.48496,-260924233.5,-257608348.0,2529168.0,269526.5,3930649215.547454,33288832255.32092,36720955197.38265,1731854079.6075494,48137871564.608215,3992595.5,-247859540.5,103205093490.5,1055873750.5,17290616606.5,3507545454.5,18905375151.5,3676174.0,72017.0,20894.351276434525,89858038.5,,2.4752,5.189952252439277,314.96611601036284,12.8461698152377,779.6041303488499,56250.0,1.0,0.0,0.0,1.0,0.0,0.0,0.0,0.0,0.0,0.0,0.0,1.0,0.0,0.0,0.0,0.0,0.0,0.0,0.0,0.0,1.0,1.0,0.0,0.0,0.0,0.0,0.0,1.0,0.0,0.0,0.0,0.0,0.0,0.0,0.0,0.0,0.0,0.0,0.0,0.0,0.0,0.0,0.0,0.0,0.0,0.0,0.0,0.0,0.0,0.0,0.0,0.0,0.0,0.0,0.0,0.0,0.0,0.0,0.0,0.0,0.0,0.0,0.0,0.0,0.0,0.0,0.0,0.0,0.0,0.0,0.0,0.0,0.0,0.0,0.0,0.0,0.0,0.0,0.0,0.0,0.0,0.0,0.0,0.0,0.0,0.0,0.0,0.0,0.0,0.0,0.0,0.0,0.0,0.0,0.0,0.0,0.0,0.0,0.0,0.0,0.0,0.0,0.0,0.0,0.0,0.0,0.0,1.0,0.0,0.0,0.0,1.0,0.0,1.0,0.0,0.0,0.0,0.0,0.0,0.0,1.0,0.0
105051,0,0.0,1.0,1.0,0.0,0.0,180000.0,399559.5,36774.0,342000.0,0.00496,30.65205479452055,-1726.0,-4715.0,-516.0,11.0,1.0,2.0,2.0,9.0,,0.5687204318633907,,,,,,,,,,,,,,,,,,,,,,,,,,,,,,,,,,,,,,,,,,,,,,0.0,0.0,0.0,0.0,-339.0,,,,,,,1.0,1.0,0.0,1.0,0.0,0.0,0.0,0.0,0.0,0.0,0.0,0.0,0.0,0.0,0.0,0.0,0.0,0.0,1.0,0.0,0.0,0.0,0.0,0.0,0.0,0.0,0.0,0.0,0.0,0.0,0.0,0.0,0.0,,,,,,,,,,,,,0.0,,1.0,14563.89,107365.5,118705.5,0.0,107365.5,12.0,-339.0,365243.0,-308.0,365243.0,22.0,365243.0,10.0,0.0,0.0,110.0,11.0,12.0,7.0,-6.0,0.0,0.0,14.0,14563.89,14563.89,-161.0,-173.0,5.5,1.0,0.0,,,,,,,,,,,,,,,,,,,,,8356290907.5,184562940042.0,165730774536.0,52027579405.935,,,,,,,,,,,,,128563.0,663558.0,,,,13542362.46027357,-602617696.0,-922919570.0,-296845366.0,-1536897225.0416667,44078.0,30746.0,,,,,,,,158211.25106488445,,,,,,,,3718168.0,,,,,,,,,,,,,,,,436982.0,431774.0,1264542.0,6431.772715002898,632658.0,626206.0,,,,,,,,,,,,,,,,,,,,,,,,,,,,,,,,,,,292760420.0399998,4168147701.870004,4682136129.615004,68327078.48999994,4168147701.870004,302734.0,-20912689.0,4858361055.0,213604714.0,1087865620.0,468333715.0,1140457017.0,300124.0,4726.0,851.2257838625229,6944814.0,2488073.0,1532444.0,-5023724.0,1543531.0,103346.0,3300974171.3701363,3335835571.740114,-199683109.5,-198010425.0,3477799.5,166280.5,,,,,,,,,,,,,,,,,,,,,1469088.0,14843945.0,3236043.0,8565716.0,11620840.0,1417530.0,,,,,,,,,,,,,,,,,,,,,,,,,,,,,,,,,,4278057.5,2482210.0,-9013842.5,921451.5,37582.5,3738073754.4749584,3662751891.37496,-260924394.5,-257608521.0,2529173.5,269527.5,3930663779.437453,33288939620.82092,36721073902.88265,1731854079.6075494,48137978930.108215,3992607.5,-247859879.5,103205458733.5,1055873442.5,17290981849.5,3507545476.5,18905740394.5,3676184.0,72017.0,20894.351276434525,89858148.5,-56.30943868430461,2.219775,4.894762604013706,150.0345315443982,10.865271659324524,333.0429022589665,180000.0,0.6234898018587336,0.7818314824680298,0.0,0.0,0.0,0.0,0.0,0.0,1.0,0.0,0.0,0.0,0.0,0.0,0.0,1.0,0.0,0.0,0.0,0.0,1.0,0.0,0.0,0.0,1.0,0.0,0.0,0.0,0.0,0.0,0.0,1.0,0.0,0.0,0.0,0.0,0.0,0.0,0.0,0.0,0.0,0.0,0.0,0.0,0.0,0.0,0.0,0.0,0.0,0.0,0.0,0.0,0.0,0.0,0.0,0.0,0.0,0.0,0.0,0.0,0.0,0.0,0.0,0.0,0.0,0.0,0.0,0.0,0.0,0.0,0.0,0.0,0.0,0.0,0.0,0.0,0.0,0.0,0.0,0.0,0.0,0.0,0.0,0.0,0.0,0.0,0.0,0.0,0.0,0.0,0.0,0.0,1.0,0.0,0.0,0.0,0.0,0.0,0.0,0.0,0.0,0.0,0.0,0.0,0.0,0.0,0.0,0.0,0.0,0.0,0.0,0.0,0.0,0.0,0.0,0.0,0.0,0.0,0.0,0.0,0.0,0.0
105056,0,0.0,0.0,0.0,1.0,0.0,85500.0,52128.0,5602.5,45000.0,0.018634,68.2,,-10269.0,-4764.0,,2.0,2.0,2.0,11.0,,0.4718498362187465,,,,,,,,,,,,,,,,,,,,,,,,,,,,,,,,,,,,,,,,,,,,,,7.0,2.0,7.0,1.0,-441.0,,,,,,,1.0,0.0,0.0,1.0,0.0,0.0,0.0,0.0,0.0,0.0,0.0,0.0,0.0,0.0,0.0,0.0,1.0,0.0,0.0,0.0,0.0,0.0,0.0,0.0,0.0,0.0,0.0,0.0,0.0,0.0,0.0,0.0,0.0,,,,,,,,,,,,,0.0,,3.0,9176.805,172237.5,172237.5,0.0,172237.5,24.0,-441.0,365243.0,-393.0,365243.0,297.0,365243.0,16.0,0.0,0.0,72.0,14.0,24.0,17.5,-7.5,0.0,0.0,14.0,9176.805,9176.805,-206.0,-198.0,7.5,1.0,0.0,,,,,,,,,,,,,,,,,,,,,8356296510.0,184562992170.0,165730819536.0,52027664905.935,,,,,,,,,,,,,128563.0,663560.0,,,,13542430.660273569,,-922924334.0,-296845807.0,-1536907494.0416667,44080.0,30747.0,,,,,,,,158211.72291472062,,,,,,,,3718179.0,,,,,,,,,,,,,,,,436989.0,431781.0,,6431.791349002898,632660.0,626208.0,,,,,,,,,,,,,,,,,,,,,,,,,,,,,,,,,,,292937061.95999974,4170897143.370004,4685443998.615004,68332788.98999994,4170897143.370004,302942.0,-20924517.0,4861648020.0,213961244.0,1088955944.0,469060953.0,1141547391.0,300300.0,4732.0,851.3271671051607,6946213.0,2490919.0,1534262.0,-5028174.0,1543545.0,103346.0,3305010700.822625,3339829530.967604,-199964986.0,-198290299.5,3486108.0,166412.5,,,,,,,,,,,,,,,,,,,,,1469088.0,14843945.0,3236043.0,8565730.0,11620854.0,1417533.0,,,,,,,,,,,,,,,,,,,,,,,,,,,,,,,,,,4278081.5,2482227.5,-9013850.0,921451.5,37582.5,3738082931.279959,3662761068.179959,-260924600.5,-257608719.0,2529181.0,269528.5,3930672956.242453,33289111858.32092,36721246140.38265,1731854079.6075494,48138151167.608215,3992631.5,-247860320.5,103205823976.5,1055873049.5,17291347092.5,3507545773.5,18906105637.5,3676200.0,72017.0,20894.351276434525,89858220.5,,0.6096842105263158,15.261044176706829,1040.8032128514055,9.304417670682732,634.5612851405623,42750.0,-0.9009688679024191,-0.433883739117558,0.0,1.0,0.0,0.0,0.0,0.0,0.0,0.0,0.0,1.0,0.0,0.0,0.0,0.0,0.0,0.0,0.0,0.0,1.0,0.0,1.0,0.0,0.0,0.0,0.0,1.0,0.0,0.0,0.0,0.0,0.0,0.0,0.0,0.0,0.0,0.0,0.0,0.0,0.0,0.0,0.0,0.0,0.0,0.0,0.0,0.0,0.0,0.0,0.0,0.0,0.0,0.0,0.0,0.0,0.0,0.0,0.0,0.0,0.0,0.0,0.0,0.0,0.0,0.0,0.0,0.0,0.0,0.0,0.0,0.0,0.0,0.0,0.0,0.0,0.0,0.0,0.0,0.0,0.0,0.0,0.0,0.0,0.0,0.0,0.0,0.0,0.0,0.0,0.0,0.0,0.0,0.0,0.0,0.0,0.0,0.0,0.0,0.0,0.0,0.0,0.0,0.0,0.0,0.0,0.0,1.0,0.0,0.0,0.0,0.0,0.0,0.0,0.0,0.0,0.0,0.0,0.0,0.0,0.0,0.0
105067,1,0.0,1.0,1.0,1.0,0.0,117000.0,473841.0,37566.0,387000.0,0.022625,23.257534246575347,-915.0,-8489.0,-1130.0,17.0,1.0,2.0,2.0,8.0,,0.0728674364260409,0.1176137317080569,,,,,,,,,,,,,,,,,,,,,,,,,,,,,,,,,,,,,,,,,,,,,0.0,0.0,0.0,0.0,-5.0,0.0,0.0,0.0,0.0,0.0,3.0,1.0,1.0,0.0,1.0,0.0,1.0,0.0,0.0,0.0,0.0,1.0,1.0,0.0,1.0,0.0,0.0,0.0,0.0,0.0,0.0,0.0,0.0,0.0,0.0,0.0,0.0,0.0,0.0,0.0,0.0,0.0,0.0,2.0,3008.07,0.0,47346.75,27058.5,0.0,0.0,0.0,0.0,-155.0,44.0,-54.0,-85.0,11.0,-2.0,3.0,10945.26,78943.5,72193.5,4950.0,78943.5,10.0,-294.0,365243.0,-372.0,182389.5,-162.0,182393.0,18.0,0.0,0.0926599118261272,5.0,14.0,10.0,5.0,-8.5,0.0,0.0,11.0,15467.22,15467.22,-179.0,-160.0,4.0,1.0,0.0,,,,,,,,,,,,,,,,,,,,,8356334076.0,184563466011.0,165731206536.0,52027781905.935,1863.0,1706.0,71125.0,70958.0,9141.0,506648.0,,,,,,,128563.0,663561.0,,,,13542453.917807816,-602618611.0,-922925464.0,-296845812.0,-1536915983.0416667,44080.0,30747.0,,,,,,,,158211.79578215705,126249.4284527,,,,,,,3718187.0,,,,,,,,,,,,,,,,436989.0,431781.0,1264559.0,6431.813974002896,632662.0,626210.0,,,,,,,,,5.5,81934313.17499998,27969967.260000005,8323601359.229984,2770073223.255001,96796788.34499995,805391.7749999998,155.0,17392.0,-27341208.0,12338036.5,-14171173.5,-15406055.0,-2.25,6016.14,0.0,72193.5,54117.0,0.0,0.0,0.0,0.0,-168.0,197.0,-33.0,-85.0,293324235.56999964,4175747981.370004,4691294759.115004,68402507.48999994,4175747981.370004,303474.0,-20976250.0,4871318813.5,214287915.0,1093680435.0,471232171.0,1146637901.5,301093.0,4736.0,852.5676093101532,6954898.0,2496438.0,1537488.0,-5040482.5,1543545.0,103346.0,3311208695.56514,3345815938.140119,-200630488.0,-198955775.0,3499481.0,166735.0,,,,,,,,,,,,,,,,,,,,,1469090.0,14843956.0,3236043.0,8565744.0,11620865.0,1417536.0,1060996422.5595012,802184983.7399952,72185034825.08965,21697960075.987617,583477279.4969988,5792665.7475,689.5,94245.0,-277232410.0,22033863.0,-123914204.5,-218941457.5,-2024305.0,,,,,,,,,,,,,,,,,,,,,4278091.5,2482232.5,-9013858.5,921451.5,37582.5,3738098398.499958,3662776535.3999577,-260924779.5,-257608879.0,2529185.0,269529.5,3930683901.502454,33289190801.82092,36721318333.88265,1731859029.6075494,48138230111.108215,3992641.5,-247860614.5,103206189219.5,1055872677.5,17291529482.0,3507545611.5,18906288030.5,3676218.0,72017.0,20894.44393634635,89858225.5,-39.34208976322299,4.0499230769230765,3.114518447532343,72.43601945507416,12.613560134163867,293.3603067915537,117000.0,0.6234898018587336,0.7818314824680298,0.0,0.0,0.0,0.0,0.0,0.0,1.0,0.0,0.0,0.0,0.0,0.0,0.0,1.0,0.0,0.0,0.0,0.0,1.0,0.0,0.0,0.0,1.0,0.0,0.0,1.0,0.0,0.0,0.0,0.0,0.0,0.0,0.0,0.0,0.0,0.0,0.0,0.0,1.0,0.0,0.0,0.0,0.0,0.0,0.0,0.0,0.0,0.0,0.0,0.0,0.0,0.0,0.0,0.0,0.0,0.0,0.0,0.0,0.0,0.0,0.0,0.0,0.0,0.0,0.0,0.0,0.0,0.0,0.0,0.0,0.0,0.0,0.0,0.0,0.0,0.0,0.0,0.0,0.0,0.0,0.0,0.0,0.0,0.0,0.0,0.0,0.0,0.0,0.0,0.0,1.0,0.0,0.0,0.0,0.0,0.0,0.0,0.0,0.0,0.0,0.0,0.0,0.0,0.0,0.0,0.0,0.0,0.0,0.0,0.0,0.0,0.0,0.0,0.0,0.0,0.0,0.0,0.0,0.0,0.0
105071,0,0.0,0.0,0.0,0.0,0.0,135000.0,450000.0,35554.5,450000.0,0.026392,25.58082191780822,-209.0,-3973.0,-1999.0,,1.0,2.0,2.0,15.0,0.6695120294994386,0.5719624307900548,0.3490552510751822,0.2711,0.0547,0.9791,,,0.08,0.069,0.3333,,0.1078,,0.077,,0.0288,0.2763,0.0568,0.9791,,,0.0806,0.069,0.3333,,0.1102,,0.0803,,0.0305,0.2738,0.0547,0.9791,,,0.08,0.069,0.3333,,0.1096,,0.0784,,0.0294,0.0798,1.0,1.0,0.0,1.0,0.0,-342.0,0.0,0.0,0.0,0.0,1.0,0.0,1.0,1.0,1.0,1.0,0.0,1.0,0.0,0.0,0.0,0.0,0.0,0.0,0.0,1.0,0.0,0.0,0.0,0.0,0.0,0.0,0.0,0.0,0.0,0.0,0.0,0.0,0.0,0.0,0.0,0.0,0.0,0.0,7.0,0.0,0.0,52636.5,0.0,0.0,0.0,0.0,0.0,-1494.0,-1341.0,-989.0,-1340.0,304.0,-22.0,1.0,24462.27,146202.75,131580.0,14622.75,146202.75,6.0,-342.0,365243.0,-312.0,-192.0,-162.0,-187.0,15.0,0.0,0.1089275276348022,179.0,6.0,6.0,3.5,-8.5,0.0,0.0,5.0,24462.27,24462.27,-261.0,-252.0,3.0,1.0,0.0,,,,,,,,,,,,,,,,,,,,,8356369630.5,184563916011.0,165731656536.0,52027916905.935,1863.0,1706.0,71125.0,70959.0,9141.0,506648.0,17828.13770000231,17890.418999999118,17341.496199998008,11308.194200000094,11246.000500000097,11193.458200000065,128563.0,663562.0,,,,13542479.498629736,-602618820.0,-922927463.0,-296846154.0,-1536919956.0416667,44080.0,30747.0,11360.213999999194,11236.159999998988,10720.20219999729,22913.9235000098,22835.68410000976,22220.552300008327,67562.38552703883,158212.36774458786,126249.77750795108,35040.45880002801,34980.57660002845,34426.01070002886,,,,3718202.0,8304.964200000164,8409.623000000072,8133.086400000231,,,,16485.910099999724,16671.356799999696,16268.0538999997,,,,3917.7934000001233,3901.0397000001617,3733.72520000016,436990.0,431782.0,,6431.840366002897,632664.0,626212.0,,16350.298299999797,154361.30119999073,154364.04279999033,154255.75599998722,,,,50.0,81937321.24499997,27969967.260000005,8324215579.979984,2770143883.650001,96796848.91499996,805391.7749999998,155.0,17392.0,-27356994.0,12351998.0,-14183370.0,-15417652.0,-24.5,0.0,0.0,52636.5,0.0,0.0,0.0,0.0,0.0,-1572.0,-1390.0,-989.0,-1367.0,293478893.0549996,4177058401.620004,4692628356.615004,68424825.23999994,4177058401.620004,303560.0,-20983305.0,4875153852.0,215012350.0,1095136859.0,471958631.0,1148094366.0,301311.0,4739.0,852.8727272137778,6964185.0,2497024.5,1537832.0,-5042002.0,1543547.0,103348.0,3312128469.420141,3346722057.645121,-200670684.0,-198995142.0,3499748.0,166799.0,,,,,,,,,,,,,,,,,,,,,1469097.0,14844260.0,3236043.0,8565750.0,11620870.0,1417537.0,1060996422.5595012,802184983.7399952,72185087461.58965,21697960075.987617,583477279.4969988,5792665.7475,689.5,94245.0,-277233904.0,22032522.0,-123915193.5,-218942797.5,-2024327.0,,,,,,,,,,,,,,,,,,,,,4278097.5,2482236.0,-9013867.0,921451.5,37582.5,3738122860.769958,3662800997.6699576,-260925040.5,-257609131.0,2529188.0,269530.5,3930708363.772454,33289337004.57092,36721449913.88265,1731873652.3575494,48138376313.858215,3992647.5,-247860956.5,103206554462.5,1055872365.5,17291529290.0,3507545449.5,18906287843.5,3676233.0,72017.0,20894.552863873985,89858404.5,-8.170183142336937,3.333333333333333,3.7969877230730287,97.13006676803526,12.656625743576765,323.76688922678414,135000.0,-0.9009688679024191,-0.433883739117558,0.0,0.0,0.0,0.0,0.0,0.0,1.0,0.0,0.0,0.0,0.0,0.0,0.0,1.0,0.0,0.0,0.0,0.0,1.0,0.0,0.0,0.0,1.0,0.0,0.0,1.0,0.0,0.0,0.0,0.0,0.0,0.0,0.0,0.0,0.0,0.0,0.0,0.0,0.0,0.0,0.0,0.0,0.0,0.0,1.0,0.0,0.0,0.0,0.0,0.0,0.0,0.0,0.0,1.0,0.0,0.0,0.0,0.0,0.0,0.0,0.0,0.0,0.0,0.0,0.0,0.0,0.0,0.0,0.0,0.0,0.0,0.0,0.0,0.0,0.0,0.0,0.0,0.0,0.0,0.0,0.0,0.0,0.0,0.0,0.0,0.0,0.0,0.0,0.0,0.0,0.0,0.0,0.0,0.0,0.0,0.0,0.0,0.0,0.0,0.0,0.0,0.0,0.0,0.0,0.0,0.0,0.0,0.0,0.0,0.0,1.0,0.0,0.0,0.0,0.0,0.0,0.0,0.0,1.0,0.0
105072,0,0.0,0.0,0.0,1.0,0.0,157500.0,130320.0,13018.5,112500.0,0.020713,57.2054794520548,,-9895.0,-4231.0,,1.0,3.0,2.0,8.0,,0.6587821744386536,,0.2196,0.1016,0.9866,0.8164,0.0579,0.24,0.2069,0.375,0.4167,0.0947,0.179,0.27,0.0,0.0,0.2237,0.1054,0.9866,0.8236,0.0585,0.2417,0.2069,0.375,0.4167,0.0968,0.1956,0.2813,0.0,0.0,0.2217,0.1016,0.9866,0.8189,0.0583,0.24,0.2069,0.375,0.4167,0.0963,0.1821,0.2749,0.0,0.0,0.2441,1.0,0.0,0.0,0.0,0.0,-500.0,0.0,0.0,0.0,0.0,0.0,0.0,1.0,0.0,0.0,1.0,0.0,0.0,0.0,0.0,0.0,0.0,0.0,0.0,0.0,0.0,0.0,0.0,1.0,0.0,0.0,0.0,0.0,0.0,0.0,0.0,0.0,0.0,0.0,0.0,0.0,0.0,0.0,0.0,1.0,,184.5,23040.0,,,0.0,0.0,0.0,-2282.0,-2062.0,-2058.0,-2062.0,75.0,-37.0,5.0,9718.2225,90000.0,101880.0,5152.5,101250.0,15.0,-500.0,365243.0,-647.0,-47.0,43.0,-44.0,8.0,1.0,0.1089281176545327,40.0,48.0,18.0,10.0,-12.5,0.0,0.0,47.0,8049.555,8049.555,-381.0,-371.0,8.0,1.0,0.0,,,,,,,,,,,,,,,,,,,,,8356382649.0,184564046331.0,165731769036.0,52028074405.935,1863.0,1706.0,71125.0,70959.0,9141.0,506648.0,17828.35730000231,17890.640699999116,17341.719899998006,11308.295800000094,11246.102100000096,11193.563600000063,128563.0,663563.0,4142.664800000115,4140.365800000013,3950.936800000093,13542536.704109184,,-922931694.0,-296846654.0,-1536929851.0416667,44080.0,30747.0,11360.453999999194,11236.399999998986,10720.44389999729,22914.1304000098,22835.89100000976,22220.759200008324,,158213.02652676226,,35040.83380002801,34980.95160002845,34426.38570002886,22978.36489999589,22951.400099995462,22598.1641999957,3718210.0,8305.058900000164,8409.719300000072,8133.1832000002305,9827.852900000717,9942.896000002154,10303.100599999636,16486.180099999725,16671.631699999696,16268.3351999997,829.257900000177,814.4355000000461,760.3549000000132,3917.7934000001233,3901.0397000001617,3733.72520000016,436990.0,431782.0,,6431.861079002897,632667.0,626214.0,,16350.542399999797,154362.28779999074,154365.02939999037,154256.74259998722,77696.03039999638,78034.20040000661,78436.15530000662,75.0,,27970151.760000005,8324436619.979984,,,805391.7749999998,155.0,17392.0,-27363301.0,12346580.0,-14188679.0,-15423070.0,-37.0,,184.5,23040.0,,,0.0,0.0,0.0,-2282.0,-2062.0,-2058.0,-2062.0,293498850.37499964,4177199917.620004,4692776600.115004,68429977.73999994,4177292167.620004,303605.0,-20987091.0,4875884338.0,215009116.0,1095134542.0,471956417.0,1148092054.0,301336.0,4740.0,852.9816553314322,6966399.0,2497484.0,1538097.5,-5043014.5,1543547.0,103348.0,3312395554.2301397,3346989142.455119,-200700699.0,-199024664.0,3499975.0,166828.0,,,,,,,,,,,,,,,,,,,,,1469098.0,14844335.0,3236043.0,8565798.0,11620917.0,1417542.0,,802185168.2399952,72185110501.58965,,,5792665.7475,689.5,94245.0,-277236186.0,22030460.0,-123917251.5,-218944859.5,-2024364.0,,,,,,,,,,,,,,,,,,,,,4278115.5,2482246.0,-9013879.5,921451.5,37582.5,3738130910.324958,3662809047.224958,-260925421.5,-257609502.0,2529196.0,269531.5,3930718081.994953,33289427004.57092,36721551793.88265,1731878804.8575494,48138477563.858215,3992662.5,-247861456.5,103206919705.5,1055871718.5,17291529243.0,3507545492.5,18906287799.5,3676241.0,72018.0,20894.66179199164,89858444.5,,0.8274285714285714,12.098167991704113,692.0815004569366,10.010369858278604,572.6480072352252,157500.0,0.6234898018587336,0.7818314824680298,0.0,0.0,0.0,0.0,1.0,0.0,0.0,0.0,0.0,1.0,0.0,0.0,0.0,0.0,0.0,0.0,0.0,0.0,1.0,0.0,0.0,0.0,1.0,0.0,0.0,1.0,0.0,0.0,0.0,0.0,0.0,0.0,0.0,0.0,0.0,0.0,0.0,0.0,0.0,0.0,0.0,0.0,0.0,0.0,0.0,0.0,0.0,0.0,0.0,0.0,0.0,0.0,0.0,0.0,0.0,0.0,0.0,0.0,0.0,0.0,0.0,0.0,0.0,0.0,0.0,0.0,0.0,0.0,0.0,0.0,0.0,0.0,0.0,0.0,0.0,0.0,0.0,0.0,0.0,0.0,0.0,0.0,0.0,0.0,0.0,0.0,0.0,0.0,0.0,0.0,0.0,0.0,0.0,0.0,0.0,0.0,0.0,0.0,0.0,0.0,0.0,0.0,0.0,0.0,0.0,1.0,0.0,0.0,1.0,0.0,1.0,0.0,0.0,0.0,0.0,0.0,0.0,1.0,0.0,0.0
105074,0,0.0,1.0,0.0,0.0,0.0,112500.0,481320.0,20362.5,315000.0,0.019101,25.65205479452055,-1443.0,-5909.0,-2039.0,,1.0,2.0,2.0,17.0,0.5391127202048036,0.3590766349557833,0.375711009574066,,,,,,,,,,,,,,,,,,,,,,,,,,,,,,,,,,,,,,,,,,,,,0.0,0.0,0.0,0.0,-541.0,0.0,0.0,0.0,0.0,0.0,2.0,1.0,1.0,1.0,1.0,1.0,0.0,0.0,0.0,0.0,0.0,0.0,0.0,0.0,1.0,0.0,0.0,0.0,0.0,0.0,0.0,0.0,0.0,0.0,0.0,0.0,0.0,0.0,0.0,0.0,0.0,0.0,0.0,5.0,8365.5,,119781.0,170221.5,0.0,0.0,0.0,0.0,-537.0,-351.0,-226.0,-333.0,83.0,-8.0,2.0,4686.502500000001,58063.5,61818.75,0.0,58063.5,6.0,-541.0,365243.0,182366.5,182501.5,182531.5,182503.0,15.0,0.0,0.0,200.0,11.0,12.0,7.0,-13.0,0.0,0.0,10.0,7123.005,7123.005,-385.0,-375.0,5.5,1.0,16.0,0.0,135000.0,,0.0,,,0.0,,0.0,0.0,0.0,0.0,,0.0,,,0.0,-10.5,0.0,0.0,8356403011.5,184564527651.0,165732084036.0,52028186905.935,1863.0,1706.0,71125.0,70959.0,9141.0,506650.0,,,,,,,128563.0,663564.0,,,,13542562.35616398,-602620263.0,-922933733.0,-296847195.0,-1536935760.0416667,44080.0,30747.0,,,,,,,67562.92463975902,158213.3856033972,126250.15321896068,,,,,,,3718227.0,,,,,,,,,,,,,,,,436990.0,431782.0,,6431.880180002897,632669.0,626216.0,,,,,,,,,18.0,81959456.74499997,,8326222451.774984,2771373432.150001,96796848.91499996,805391.7749999998,155.0,17392.0,-27365481.0,12348812.0,-14189412.0,-15423881.0,-8.5,4182.75,,119781.0,170221.5,0.0,0.0,0.0,0.0,-639.0,-358.0,-326.0,-333.0,293537686.9274996,4177866651.120004,4693486333.365004,68429977.73999994,4177866651.120004,303656.0,-20990163.5,4877527931.5,215738407.0,1096229895.0,472687073.0,1149187414.5,301410.5,4741.0,852.9816553314322,6968737.0,2498274.0,1538597.0,-5043440.0,1543547.0,103348.0,3312799898.715141,3347393486.940121,-200713581.0,-199036829.0,3500258.0,166868.0,3056851686.149965,8275473000.0,,396212369.03999937,,,173243537.459999,,400911029.909999,2934941620.2300096,3045658326.029958,3045802574.339957,,34949.0,,,991988.0,-1749573.5,752367.0,1714.0,1469103.0,14844418.0,3236059.0,8565809.0,11620927.0,1417544.0,1061004788.0595012,,72185230282.58965,21698130297.487617,583477279.4969988,5792665.7475,689.5,94245.0,-277236723.0,22030109.0,-123917477.5,-218945192.5,-2024372.0,5927490206.7524605,18745312500.0,,448373728.46249765,,,309343236.1874986,,459487266.14249927,5712492840.750034,5890739702.737497,5890982885.482499,,80965.5,,,972267.5,-1700343.0,177364.0,6755.0,4278127.5,2482253.0,-9013892.5,921451.5,37582.5,3738138033.329958,3662816170.2299576,-260925806.5,-257609877.0,2529201.5,269532.5,3930722768.497453,33289485068.07092,36721613612.63265,1731878804.8575494,48138535627.358215,3992668.5,-247861997.5,103207284948.5,1056054085.0,17291711744.5,3507728024.0,18906470302.5,3676256.0,72018.0,20894.66179199164,89858644.5,-56.2528035885934,4.2784,5.524861878453039,141.7240596382351,23.637569060773483,606.352216756225,112500.0,-0.9009688679024191,-0.433883739117558,0.0,0.0,0.0,0.0,0.0,0.0,1.0,0.0,0.0,0.0,1.0,0.0,0.0,0.0,0.0,0.0,0.0,0.0,1.0,0.0,0.0,0.0,1.0,0.0,0.0,1.0,0.0,0.0,0.0,0.0,0.0,0.0,0.0,0.0,0.0,0.0,0.0,0.0,0.0,0.0,0.0,0.0,0.0,0.0,0.0,0.0,0.0,0.0,0.0,0.0,0.0,0.0,0.0,1.0,0.0,0.0,0.0,0.0,0.0,0.0,0.0,0.0,0.0,0.0,0.0,0.0,0.0,0.0,0.0,0.0,0.0,0.0,0.0,0.0,0.0,0.0,0.0,0.0,0.0,0.0,0.0,0.0,0.0,0.0,0.0,0.0,0.0,0.0,0.0,0.0,0.0,0.0,0.0,0.0,0.0,0.0,0.0,0.0,0.0,0.0,0.0,0.0,0.0,0.0,0.0,0.0,0.0,0.0,0.0,0.0,0.0,0.0,0.0,0.0,0.0,0.0,0.0,0.0,0.0,0.0
105091,0,0.0,1.0,1.0,0.0,1.0,67500.0,270000.0,17383.5,270000.0,0.00712,52.17260273972602,-2306.0,-3848.0,-2449.0,7.0,3.0,2.0,2.0,17.0,,0.627203257724614,,,,,,,,,,,,,,,,,,,,,,,,,,,,,,,,,,,,,,,,,,,,,,11.0,0.0,11.0,0.0,-1845.0,,,,,,,1.0,1.0,1.0,1.0,0.0,0.0,0.0,0.0,0.0,0.0,0.0,0.0,0.0,1.0,0.0,0.0,0.0,0.0,0.0,0.0,0.0,0.0,0.0,0.0,0.0,0.0,0.0,0.0,0.0,0.0,0.0,0.0,0.0,,,,,,,,,,,,,0.0,,3.0,8563.5,47700.0,47700.0,0.0,47700.0,6.0,-631.0,365243.0,-599.0,-329.0,-329.0,-325.0,8.0,0.0,0.0,68.0,18.0,10.0,4.0,-18.5,0.0,0.0,16.0,8563.5,8563.5,-561.0,-554.0,4.5,1.0,0.0,,,,,,,,,,,,,,,,,,,,,8356420395.0,184564797651.0,165732354036.0,52028254405.935,,,,,,,,,,,,,128564.0,663567.0,,,,13542614.52876672,-602622569.0,-922936182.0,-296849040.0,-1536939608.0416667,44080.0,30747.0,,,,,,,,158214.01280665494,,,,,,,,3718244.0,,,,,,,,,,,,,,,,437001.0,431793.0,1264566.0,6431.887300002897,632671.0,626218.0,,,,,,,,,,,,,,,,,,,,,,,,,,,,,,,,,,,294302864.7899995,4186251604.620004,4702344077.115004,68547805.73999994,4186251604.620004,304178.0,-21026249.0,4890128621.0,217903170.0,1099861372.0,474131054.0,1152088326.0,302063.0,4745.0,855.1427928107203,6972811.0,2501536.0,1540638.5,-5050195.5,1543649.0,103390.0,3317091452.1001525,3352215096.450132,-201071827.0,-199391666.5,3508443.5,167229.5,,,,,,,,,,,,,,,,,,,,,1469103.0,14844418.0,3236059.0,8565827.0,11620943.0,1417547.0,,,,,,,,,,,,,,,,,,,,,,,,,,,,,,,,,,4278137.5,2482257.0,-9013911.0,921451.5,37582.5,3738146596.829958,3662824733.7299576,-260926367.5,-257610431.0,2529206.0,269533.5,3930731331.997453,33289532768.07092,36721661312.63265,1731878804.8575494,48138583327.358215,3992674.5,-247862628.5,103207650191.5,1056053486.0,17291711415.5,3507727695.0,18906469977.5,3676264.0,72018.0,20894.66179199164,89858712.5,-44.19944336501601,4.0,3.882992492881181,202.58582477242825,15.531969971524722,810.343299089713,22500.0,1.0,0.0,0.0,0.0,0.0,0.0,0.0,0.0,1.0,0.0,0.0,0.0,0.0,0.0,0.0,1.0,0.0,0.0,0.0,0.0,1.0,0.0,1.0,0.0,0.0,0.0,0.0,1.0,0.0,0.0,0.0,0.0,0.0,0.0,0.0,0.0,0.0,0.0,0.0,0.0,1.0,0.0,0.0,0.0,0.0,0.0,0.0,0.0,0.0,0.0,0.0,0.0,0.0,0.0,0.0,0.0,0.0,0.0,0.0,0.0,0.0,0.0,0.0,0.0,0.0,0.0,0.0,0.0,0.0,0.0,0.0,0.0,0.0,0.0,0.0,0.0,0.0,0.0,0.0,0.0,0.0,0.0,0.0,0.0,0.0,0.0,0.0,0.0,0.0,0.0,0.0,0.0,1.0,0.0,0.0,0.0,0.0,0.0,0.0,0.0,0.0,0.0,0.0,0.0,0.0,0.0,0.0,0.0,0.0,0.0,0.0,0.0,0.0,0.0,0.0,0.0,0.0,0.0,0.0,0.0,0.0,0.0
105101,0,0.0,0.0,0.0,1.0,0.0,315000.0,792162.0,40446.0,630000.0,0.072508,42.60273972602739,-581.0,-4256.0,-3371.0,,2.0,1.0,1.0,11.0,0.5147715534888018,0.6832341831245897,0.5406544504453575,,,,,,,,,,,,,,,,,,,,,,,,,,,,,,,,,,,,,,,,,,,,,4.0,0.0,4.0,0.0,-814.0,0.0,0.0,0.0,1.0,1.0,0.0,1.0,1.0,1.0,1.0,1.0,0.0,0.0,0.0,0.0,0.0,0.0,0.0,0.0,1.0,0.0,0.0,0.0,0.0,0.0,0.0,0.0,0.0,0.0,0.0,0.0,0.0,0.0,0.0,0.0,0.0,0.0,0.0,3.0,,0.0,169393.5,0.0,0.0,0.0,0.0,0.0,-1632.0,-901.0,-534.0,-771.5,127.0,-25.0,5.0,9841.41,77557.5,56200.5,15853.5,84366.0,4.0,-478.0,365243.0,-599.0,-328.0,-178.0,-324.0,18.0,0.0,0.2099108356273932,-1.0,10.0,7.5,5.0,-15.5,0.0,0.0,49.0,8520.66,8520.66,-359.0,-356.0,17.0,0.0,21.0,231193.395,225000.0,0.0,15899.355,0.0,10656.855,10556.46,13500.0,13500.0,222050.52,231193.395,231193.395,0.0,3.0,0.0,3.0,9.0,-12.0,0.0,0.0,8356460841.0,184565589813.0,165732984036.0,52028569405.935,1863.0,1706.0,71126.0,70960.0,9141.0,506650.0,,,,,,,128564.0,663569.0,,,,13542657.131506445,-602623150.0,-922939553.0,-296849854.0,-1536943864.0416667,44080.0,30747.0,,,,,,,67563.43941131253,158214.69604083803,126250.69387341112,,,,,,,3718255.0,,,,,,,,,,,,,,,,437005.0,431797.0,,6431.959808002896,632672.0,626219.0,,,,,,,,,54.0,,28123861.00500001,8357979978.719984,2777698757.07,96798018.91499996,805391.7749999998,161.0,17392.0,-27485983.0,12388452.0,-14248250.0,-15492843.5,-26.5,,0.0,169393.5,0.0,0.0,0.0,0.0,0.0,-1632.0,-901.0,-534.0,-1532.0,294695376.5249995,4192339173.120004,4709254502.115004,68655951.98999994,4192339173.120004,304606.0,-21070257.0,4898159050.0,217868657.0,1100931792.0,475206836.0,1153892554.0,302445.0,4752.0,857.1988055143232,6984649.0,2507025.0,1543882.0,-5060522.0,1543656.0,103397.0,3325291198.5151486,3359860148.565126,-201862423.0,-200178127.0,3534697.0,167523.0,3068302853.8349643,8305866000.0,258215421.375,397566865.25999945,12292466.535000002,126663266.5199999,174214519.73999903,435805653.5099983,402686324.909999,2945865981.2850084,3057102405.764955,3057257994.074954,13192.0,35016.0,170.0,21654.0,1001588.0,-1764498.0,752369.0,1715.0,1469106.0,14844545.0,3236080.0,8565837.0,11620992.0,1417552.0,,802185168.2399952,72185399676.08965,21698130297.487617,583477279.4969988,5792665.7475,689.5,94245.0,-277238355.0,22029208.0,-123918011.5,-218945964.0,-2024397.0,5927721400.147462,18745537500.0,198880482.825,448389627.8174977,1948107.735,257079697.1100008,309353792.6474986,637051528.2149979,459500766.14249927,5712714891.270035,5890970896.1325,5891214078.8775,13394.0,80968.5,44.0,70472.0,972276.5,-1700355.0,177364.0,6755.0,4278145.0,2482262.0,-9013926.5,921451.5,37582.5,3738155117.489958,3662833254.389958,-260926726.5,-257610787.0,2529223.0,269533.5,3930741173.407453,33289610325.57092,36721717513.13265,1731894658.3575494,48138667693.358215,3992678.5,-247863106.5,103208015434.5,1056052887.0,17291711087.5,3507727517.0,18906469653.5,3676282.0,72018.0,20894.871702827262,89858711.5,-13.637620578778137,2.5148,7.788161993769472,331.79703836469935,19.585669781931465,834.4031920795459,157500.0,0.6234898018587336,0.7818314824680298,0.0,0.0,0.0,0.0,0.0,0.0,1.0,0.0,0.0,0.0,1.0,0.0,0.0,0.0,0.0,0.0,0.0,0.0,1.0,0.0,1.0,0.0,0.0,0.0,0.0,1.0,0.0,0.0,0.0,0.0,0.0,0.0,0.0,0.0,0.0,0.0,0.0,0.0,0.0,0.0,0.0,0.0,0.0,0.0,0.0,0.0,0.0,0.0,0.0,0.0,0.0,0.0,0.0,0.0,0.0,0.0,0.0,0.0,0.0,0.0,0.0,0.0,0.0,0.0,0.0,0.0,0.0,0.0,0.0,0.0,0.0,0.0,0.0,0.0,0.0,0.0,0.0,0.0,0.0,0.0,0.0,0.0,0.0,0.0,0.0,0.0,0.0,1.0,0.0,0.0,0.0,0.0,0.0,0.0,0.0,0.0,0.0,0.0,0.0,0.0,0.0,0.0,0.0,0.0,0.0,0.0,0.0,0.0,0.0,0.0,0.0,0.0,0.0,0.0,0.0,0.0,0.0,0.0,0.0,0.0
105103,0,0.0,0.0,1.0,1.0,0.0,135000.0,301464.0,19395.0,238500.0,0.035792,30.997260273972607,-424.0,-5295.0,-2697.0,8.0,2.0,2.0,2.0,11.0,0.2818136427916061,0.6602602124225859,0.5691487713619409,,,,,,,,,,,,,,,,,,,,,,,,,,,,,,,,,,,,,,,,,,,,,1.0,0.0,1.0,0.0,-914.0,0.0,0.0,0.0,0.0,0.0,1.0,1.0,1.0,0.0,1.0,0.0,0.0,0.0,0.0,0.0,1.0,1.0,0.0,0.0,0.0,0.0,0.0,0.0,0.0,1.0,0.0,0.0,0.0,0.0,0.0,0.0,0.0,0.0,0.0,0.0,0.0,0.0,0.0,1.0,,7466.67,80950.5,0.0,0.0,0.0,0.0,0.0,-615.0,-311.0,-399.0,-403.0,21.0,-10.0,2.0,11805.975,77262.75,77262.75,0.0,77262.75,6.0,-764.5,365243.0,-883.0,-733.0,-733.0,-722.0,11.0,0.0,0.0,62.5,8.0,6.0,2.5,-26.5,0.0,0.0,6.0,11805.975,11805.975,-813.5,-808.0,3.5,1.0,0.0,,,,,,,,,,,,,,,,,,,,,8356480236.0,184565891277.0,165733222536.0,52028704405.935,1863.0,1706.0,71126.0,70960.0,9141.0,506651.0,,,,,,,128564.0,663571.0,,,,13542688.12876672,-602623574.0,-922942250.0,-296850768.0,-1536949159.0416667,44080.0,30747.0,,,,,,,67563.72122495531,158215.35630105052,126251.26302218248,,,,,,,3718266.0,,,,,,,,,,,,,,,,437006.0,431798.0,1264574.0,6431.995600002897,632674.0,626221.0,,,,,,,,,21.0,,28131327.67500001,8361108457.064984,2778800627.07,96798018.91499996,805391.7749999998,161.0,17392.0,-27491811.0,12385958.0,-14250999.0,-15495509.0,-10.0,,7466.67,80950.5,0.0,0.0,0.0,0.0,0.0,-615.0,-311.0,-399.0,-403.0,294962615.81999946,4197335034.870004,4714526294.865004,68697592.73999994,4197335034.870004,304746.0,-21079009.5,4900350508.0,217862261.0,1101293160.0,475203380.0,1154253949.0,302629.5,4754.0,857.4620383127212,6990430.5,2509150.0,1545093.5,-5063311.5,1543661.0,103402.0,3329197658.932653,3365018237.542625,-201966018.0,-200280918.5,3536148.5,167700.5,,,,,,,,,,,,,,,,,,,,,1469107.0,14844566.0,3236080.0,8565845.0,11620998.0,1417554.0,,802192634.9099952,72185480626.58965,21698130297.487617,583477279.4969988,5792665.7475,689.5,94245.0,-277238970.0,22028897.0,-123918410.5,-218946367.0,-2024407.0,,,,,,,,,,,,,,,,,,,,,4278151.0,2482264.5,-9013953.0,921451.5,37582.5,3738166923.4649577,3662845060.364958,-260927540.0,-257611595.0,2529226.5,269534.5,3930752979.382453,33289687588.32092,36721794775.88265,1731894658.3575494,48138744956.108215,3992684.5,-247863871.0,103208380677.5,1056052004.0,17291710354.5,3507726784.0,18906468931.5,3676293.0,72018.0,20894.871702827262,89858774.0,-13.678628248188083,2.2330666666666668,6.960556844547564,215.75819216222231,15.54338747099768,481.80242697772,67500.0,1.0,0.0,0.0,0.0,0.0,0.0,0.0,0.0,1.0,0.0,0.0,0.0,0.0,0.0,0.0,1.0,0.0,1.0,0.0,0.0,0.0,1.0,0.0,0.0,0.0,0.0,0.0,1.0,0.0,0.0,0.0,0.0,0.0,0.0,0.0,0.0,0.0,0.0,0.0,0.0,0.0,0.0,0.0,0.0,0.0,0.0,1.0,0.0,0.0,0.0,0.0,0.0,0.0,0.0,0.0,1.0,0.0,0.0,0.0,0.0,0.0,0.0,0.0,0.0,0.0,0.0,0.0,0.0,0.0,0.0,0.0,0.0,0.0,0.0,0.0,0.0,0.0,0.0,0.0,0.0,0.0,0.0,0.0,0.0,0.0,0.0,0.0,0.0,0.0,0.0,0.0,0.0,0.0,0.0,0.0,0.0,0.0,0.0,0.0,0.0,0.0,0.0,0.0,0.0,0.0,0.0,0.0,0.0,0.0,0.0,0.0,0.0,0.0,0.0,0.0,0.0,0.0,0.0,0.0,0.0,0.0,0.0
105134,0,0.0,1.0,1.0,1.0,1.0,180000.0,1066320.0,38299.5,900000.0,0.030755,40.92876712328767,-1213.0,-7647.0,-4419.0,12.0,3.0,2.0,2.0,17.0,,0.5724120780212882,0.6594055320683344,,,,,,,,,,,,,,,,,,,,,,,,,,,,,,,,,,,,,,,,,,,,,0.0,0.0,0.0,0.0,-2215.0,0.0,0.0,0.0,0.0,0.0,5.0,1.0,1.0,0.0,1.0,0.0,0.0,0.0,0.0,0.0,0.0,0.0,0.0,0.0,1.0,0.0,0.0,0.0,0.0,0.0,0.0,0.0,0.0,0.0,0.0,0.0,0.0,0.0,0.0,0.0,0.0,0.0,0.0,3.0,0.0,,57834.0,0.0,0.0,0.0,0.0,0.0,-1118.0,-935.0,-16.0,-1284.5,104.0,-22.0,7.0,5983.74,32517.0,32517.0,0.0,40338.0,10.0,-609.0,365243.0,-1055.0,-755.0,-725.0,-748.0,14.0,0.0,0.0,40.0,65.0,10.0,5.0,-35.0,0.0,0.0,58.0,5983.74,5983.74,-1062.0,-1040.0,6.0,1.0,0.0,,,,,,,,,,,,,,,,,,,,,8356518535.5,184566957597.0,165734122536.0,52028884405.935,1863.0,1706.0,71126.0,70960.0,9141.0,506656.0,,,,,,,128565.0,663574.0,,,,13542729.057533843,-602624787.0,-922946669.0,-296852983.0,-1536956806.0416667,44080.0,30747.0,,,,,,,,158215.9287131285,126251.92242771455,,,,,,,3718283.0,,,,,,,,,,,,,,,,437006.0,431798.0,1264586.0,6432.026355002897,632676.0,626223.0,,,,,,,,,37.0,82579942.21499997,,8407078102.529984,2794104895.275,97125623.09999996,805463.7749999998,162.0,17420.0,-27639636.0,12460465.0,-14331909.0,-15583673.5,-18.0,0.0,,24528.96,0.0,0.0,0.0,0.0,0.0,-1820.0,-1605.0,-16.0,-1634.0,296382748.1399996,4216883941.620004,4737317951.115004,69138165.23999994,4216883941.620004,306078.0,-21191581.0,4927373422.0,218863888.0,1108159946.0,477698950.0,1161488245.0,304088.0,4780.0,863.6085793929084,7054653.0,2522096.0,1552998.0,-5093647.0,1543770.0,103477.0,3346768663.6501245,3383879484.825098,-203199769.5,-201504217.5,3564616.5,168508.5,,,,,,,,,,,,,,,,,,,,,1469110.0,14844670.0,3236080.0,8565910.0,11621056.0,1417561.0,1061004788.0595012,,72185538460.58965,21698130297.487617,583477279.4969988,5792665.7475,689.5,94245.0,-277240088.0,22027962.0,-123918426.5,-218947651.5,-2024429.0,,,,,,,,,,,,,,,,,,,,,4278161.0,2482269.5,-9013988.0,921451.5,37582.5,3738172907.204958,3662851044.1049576,-260928602.0,-257612635.0,2529232.5,269535.5,3930758963.122453,33289720105.32092,36721827292.88265,1731894658.3575494,48138785294.108215,3992694.5,-247864480.0,103208745920.5,1056050949.0,17291709599.5,3507726059.0,18906468183.5,3676307.0,72018.0,20894.871702827262,89858814.0,-29.63685654996988,5.924,4.699800258489014,192.357030305664,27.841616731288923,1139.523047530754,60000.0,-0.2225209339563146,-0.9749279121818236,0.0,1.0,0.0,0.0,0.0,0.0,0.0,0.0,1.0,0.0,0.0,0.0,0.0,0.0,0.0,0.0,0.0,0.0,1.0,0.0,1.0,0.0,0.0,0.0,0.0,1.0,0.0,0.0,0.0,0.0,0.0,0.0,0.0,0.0,0.0,0.0,0.0,0.0,1.0,0.0,0.0,0.0,0.0,0.0,0.0,0.0,0.0,0.0,0.0,0.0,0.0,0.0,0.0,1.0,0.0,0.0,0.0,0.0,0.0,0.0,0.0,0.0,0.0,0.0,0.0,0.0,0.0,0.0,0.0,0.0,0.0,0.0,0.0,0.0,0.0,0.0,0.0,0.0,0.0,0.0,0.0,0.0,0.0,0.0,0.0,0.0,0.0,0.0,0.0,0.0,0.0,0.0,0.0,0.0,0.0,0.0,0.0,0.0,0.0,0.0,0.0,0.0,0.0,0.0,0.0,0.0,0.0,0.0,0.0,0.0,0.0,0.0,0.0,0.0,0.0,0.0,0.0,0.0,0.0,0.0
105139,0,0.0,0.0,0.0,1.0,1.0,135000.0,352422.0,27400.5,315000.0,0.011703,38.983561643835614,-691.0,-1244.0,-4982.0,,2.0,2.0,2.0,17.0,0.646085375274032,0.6428068469163533,0.6925590674998008,,,,,,,,,,,,,,,,,,,,,,,,,,,,,,,,,,,,,,,,,,,,,0.0,0.0,0.0,0.0,0.0,0.0,0.0,0.0,0.0,0.0,1.0,1.0,1.0,0.0,1.0,0.0,0.0,0.0,0.0,0.0,0.0,0.0,0.0,0.0,1.0,0.0,0.0,0.0,0.0,0.0,0.0,0.0,0.0,0.0,0.0,0.0,0.0,0.0,0.0,0.0,0.0,0.0,0.0,4.0,0.0,0.0,47292.3225,0.0,0.0,0.0,0.0,0.0,-1111.5,-960.5,-711.5,-1515.0,132.0,-20.5,3.0,12413.295,134536.5,121081.5,33367.5,134536.5,12.0,-536.0,365243.0,-506.0,-26.0,4.0,-23.0,16.0,0.0,0.1532059423394992,3000.0,25.0,18.0,9.0,-13.0,0.0,0.0,25.0,12413.295,12413.295,-342.0,-326.0,7.0,2.0,17.0,0.0,45000.0,,0.0,,,0.0,,0.0,0.0,0.0,0.0,,0.0,,,0.0,-9.0,0.0,0.0,8356545936.0,184567310019.0,165734437536.0,52029019405.935,1863.0,1706.0,71126.0,70960.0,9141.0,506657.0,,,,,,,128566.0,663576.0,,,,13542768.041095488,-602625478.0,-922951651.0,-296852983.0,-1536958050.0416667,44080.0,30747.0,,,,,,,67564.36731033059,158216.5715199754,126252.61498678203,,,,,,,3718300.0,,,,,,,,,,,,,,,,437006.0,431798.0,,6432.038058002897,632678.0,626225.0,,,,,,,,,37.0,82585369.21499997,28318993.110000007,8414576783.347485,2794548572.775,97125623.09999996,805463.7749999998,162.0,17420.0,-27658903.5,12483858.0,-14344938.0,-15597405.0,-18.0,0.0,0.0,23170.5,0.0,0.0,0.0,0.0,0.0,-1637.0,-1516.0,-1022.0,-1515.0,296626047.47999966,4220052928.920004,4740804074.115004,69300230.03999993,4220052928.920004,306386.0,-21209212.0,4931756338.0,219585862.0,1109614675.0,478424254.0,1162943010.0,304540.0,4785.0,864.4849723829452,7062578.0,2523265.0,1553672.0,-5096535.0,1543812.0,103477.0,3348075185.055121,3385207766.1600947,-203291663.0,-201594999.0,3565163.0,168650.0,3081739968.4949613,8377141500.0,,400683904.55999935,,,175072832.86499906,,405498653.414999,2958764484.960009,3070468772.5049515,3070624360.8149505,,35157.0,,,1007555.0,-1776004.0,752370.0,1716.0,1469114.0,14844802.0,3236097.0,8565935.0,11621081.0,1417564.0,1061004788.0595012,802192634.9099952,72185585752.91214,21698130297.487617,583477279.4969988,5792665.7475,689.5,94245.0,-277241199.5,22027001.5,-123919138.0,-218949166.5,-2024449.5,5927721400.147462,18745582500.0,,448389627.8174977,,,309353792.6474986,,459500766.14249927,5712714891.270035,5890970896.1325,5891214078.8775,,80968.5,,,972276.5,-1700364.0,177364.0,6755.0,4278179.0,2482278.5,-9014001.0,921451.5,37582.5,3738185320.499958,3662863457.3999577,-260928944.0,-257612961.0,2529239.5,269537.5,3930771376.417453,33289854641.82092,36721948374.38265,1731928025.8575494,48138919830.608215,3992706.5,-247865016.0,103209111163.5,1056050443.0,17291709573.5,3507726063.0,18906468160.5,3676323.0,72018.0,20895.024908769607,89861814.0,-17.725419917070774,2.610533333333333,4.926917392018393,192.06878786583488,12.861882082443753,501.4019730166908,67500.0,0.6234898018587336,0.7818314824680298,0.0,0.0,0.0,0.0,0.0,0.0,1.0,0.0,1.0,0.0,0.0,0.0,0.0,0.0,0.0,0.0,0.0,0.0,1.0,0.0,0.0,1.0,0.0,0.0,0.0,1.0,0.0,0.0,0.0,0.0,0.0,0.0,0.0,0.0,0.0,0.0,0.0,0.0,0.0,0.0,0.0,0.0,0.0,0.0,1.0,0.0,0.0,0.0,0.0,0.0,0.0,0.0,0.0,1.0,0.0,0.0,0.0,0.0,0.0,0.0,0.0,0.0,0.0,0.0,0.0,0.0,0.0,0.0,0.0,0.0,0.0,0.0,0.0,0.0,0.0,0.0,0.0,0.0,0.0,0.0,0.0,0.0,0.0,0.0,0.0,0.0,0.0,0.0,0.0,0.0,0.0,0.0,0.0,0.0,0.0,0.0,0.0,0.0,0.0,0.0,0.0,0.0,0.0,0.0,0.0,0.0,0.0,0.0,0.0,0.0,0.0,0.0,0.0,0.0,0.0,0.0,0.0,0.0,0.0,0.0
105142,0,0.0,1.0,0.0,0.0,0.0,270000.0,104256.0,10813.5,90000.0,0.035792,32.824657534246576,-87.0,-5668.0,-4389.0,,2.0,2.0,2.0,14.0,,0.3665634581247626,0.3979463219016906,,,,,,,,,,,,,,,,,,,,,,,,,,,,,,,,,,,,,,,,,,,,,1.0,0.0,1.0,0.0,-68.0,0.0,0.0,0.0,0.0,0.0,1.0,1.0,1.0,0.0,1.0,0.0,0.0,1.0,0.0,1.0,1.0,0.0,1.0,0.0,1.0,0.0,0.0,0.0,0.0,0.0,0.0,0.0,0.0,0.0,0.0,0.0,0.0,0.0,0.0,0.0,0.0,0.0,0.0,6.0,0.0,0.0,100458.54,0.0,0.0,0.0,0.0,0.0,-771.5,-955.5,-573.0,-999.5,198.0,-18.0,2.0,2425.275,12127.5,10914.75,2425.5,24255.0,12.0,-1018.0,365243.0,-1930.0,-1600.0,-1600.0,-1592.0,15.0,0.0,0.1089090909090909,13.5,13.0,12.0,6.0,-58.0,0.0,0.0,109.0,0.27,0.27,-1619.0,-1630.0,48.0,0.0,96.0,0.0,0.0,0.0,0.0,0.0,0.0,0.0,0.27,0.0,0.0,0.0,0.0,0.0,0.0,0.0,0.0,8.0,-48.5,0.0,0.0,8356556749.5,184567414275.0,165734527536.0,52029289405.935,1863.0,1706.0,71126.0,70960.0,9141.0,506658.0,,,,,,,128566.0,663578.0,,,,13542800.86575302,-602625565.0,-922956040.0,-296853051.0,-1536963718.0416667,44080.0,30747.0,,,,,,,,158216.93808343352,126253.01293310396,,,,,,,3718314.0,,,,,,,,,,,,,,,,437007.0,431799.0,,6432.0738500028965,632680.0,626227.0,,,,,,,,,25.5,82746956.02499998,28387695.87,8422950438.044985,2797290537.525,97125951.73499995,805463.7749999998,162.0,17420.0,-27688699.0,12490039.0,-14356174.5,-15611579.0,-12.25,0.0,0.0,97111.08,0.0,0.0,0.0,0.0,0.0,-1505.0,-1182.0,-813.0,-1182.0,296690892.0299996,4220537358.420004,4741455179.115004,69323652.53999993,4220537358.420004,306462.0,-21225592.0,4934678282.0,220307013.0,1110702514.0,479147235.0,1164030895.0,304691.5,4785.0,865.0949862051087,7066235.5,2524049.0,1554081.0,-5100564.0,1543812.0,103477.0,3348744952.815124,3385877533.920097,-203471003.0,-201773464.0,3568127.0,168747.0,3081927696.884961,8381461500.0,260013621.375,400683904.55999935,12292466.535000002,127982105.81999987,175081832.86499906,438827391.0899972,405503166.914999,2958939583.920009,3070656500.0849514,3070812088.3949504,13245.0,35157.0,170.0,21742.0,1007938.0,-1782011.0,752434.0,1718.0,1469120.0,14845000.0,3236193.0,8565948.0,11621190.0,1417566.0,1061004788.0595012,802192634.9099952,72185686211.45212,21698130297.487617,583477279.4969988,5792665.7475,689.5,94245.0,-277241971.0,22026046.0,-123919711.0,-218950166.0,-2024467.5,5927721400.147462,18745582500.0,198880482.825,448389627.8174977,1948107.735,257079697.1100008,309353792.6474986,637051528.4849979,459500766.14249927,5712714891.270035,5890970896.1325,5891214078.8775,13394.0,80968.5,44.0,70472.0,972284.5,-1700412.5,177364.0,6755.0,4278191.0,2482284.5,-9014059.0,921451.5,37582.5,3738185320.769958,3662863457.6699576,-260930563.0,-257614591.0,2529287.5,269537.5,3930773801.692453,33289866769.32092,36721959289.13265,1731930451.3575494,48138944085.608215,3992718.5,-247866034.0,103209476406.5,1056048513.0,17291707973.5,3507724463.0,18906466568.5,3676338.0,72018.0,20895.133817860515,89861827.5,-2.650446540355563,0.3861333333333333,24.968789013732835,819.5919484206386,9.641281731169371,316.47177101682263,135000.0,-0.2225209339563143,0.9749279121818236,0.0,0.0,0.0,0.0,0.0,0.0,1.0,0.0,1.0,0.0,0.0,0.0,0.0,0.0,0.0,0.0,0.0,0.0,1.0,0.0,1.0,0.0,0.0,0.0,0.0,0.0,0.0,0.0,0.0,1.0,0.0,0.0,0.0,0.0,0.0,0.0,1.0,0.0,0.0,0.0,0.0,0.0,0.0,0.0,0.0,0.0,0.0,0.0,0.0,0.0,0.0,0.0,1.0,0.0,0.0,0.0,0.0,0.0,0.0,0.0,0.0,0.0,0.0,0.0,0.0,0.0,0.0,0.0,0.0,0.0,0.0,0.0,0.0,0.0,0.0,0.0,0.0,0.0,0.0,0.0,0.0,0.0,0.0,0.0,0.0,0.0,0.0,0.0,0.0,0.0,0.0,0.0,0.0,0.0,0.0,0.0,0.0,0.0,0.0,0.0,0.0,0.0,0.0,0.0,0.0,0.0,0.0,0.0,0.0,0.0,0.0,0.0,0.0,0.0,0.0,0.0,0.0,0.0,0.0,0.0
105146,0,0.0,1.0,1.0,1.0,1.0,360000.0,746280.0,59094.0,675000.0,0.04622,38.88767123287671,-785.0,-1430.0,-685.0,4.0,3.0,1.0,1.0,12.0,,0.6658442697128529,0.5691487713619409,0.0722,0.0725,0.9856,,,0.24,0.0345,0.625,,,,0.1499,,,0.0735,0.0753,0.9856,,,0.2417,0.0345,0.625,,,,0.1562,,,0.0729,0.0725,0.9856,,,0.24,0.0345,0.625,,,,0.1526,,,0.1179,1.0,2.0,0.0,2.0,0.0,-353.0,0.0,0.0,0.0,0.0,0.0,2.0,1.0,1.0,0.0,1.0,0.0,1.0,0.0,0.0,0.0,0.0,1.0,1.0,0.0,0.0,0.0,0.0,0.0,0.0,1.0,0.0,0.0,0.0,0.0,0.0,0.0,0.0,0.0,0.0,0.0,0.0,0.0,0.0,4.0,5280.75,26986.5,455532.75,178618.5,0.0,0.0,0.0,0.0,-867.5,640.0,-13.5,-1389.0,127.0,-20.0,4.0,13842.585,87727.5,87727.5,0.0,130455.0,12.0,-352.0,365243.0,182460.5,365243.0,182625.5,365243.0,15.0,0.0,0.0,800.0,11.0,12.0,7.0,-6.0,0.0,0.0,11.0,13842.585,13842.585,-198.0,-172.0,6.0,1.0,11.0,0.0,45000.0,,0.0,,,0.0,,0.0,0.0,0.0,0.0,,0.0,,,0.0,-6.0,0.0,0.0,8356615843.5,184568160555.0,165735202536.0,52029649405.935,1863.0,1706.0,71126.0,70960.0,9141.0,506660.0,17828.42950000231,17890.713599999115,17341.793399998,11308.368300000096,11246.174600000097,11193.638900000064,128567.0,663581.0,,,,13542839.753424251,-602626350.0,-922956725.0,-296853404.0,-1536965148.0416667,44080.0,30747.0,11360.693999999194,11236.639999998986,10720.68559999729,22914.1649000098,22835.92550000976,22220.79370000833,,158217.60392770325,126253.58208187531,35041.45880002801,34981.57660002845,34427.01070002886,,,,3718326.0,,,,,,,16486.329999999725,16671.784299999694,16268.4913999997,,,,,,,437009.0,431801.0,1264590.0,6432.120070002897,632681.0,626228.0,,16350.660299999796,154363.27339999078,154366.01499999035,154257.7281999872,,,,29.0,82756736.77499998,28769849.37,8449910051.624985,2798910661.275,97125951.73499995,805463.7749999998,162.0,17420.0,-27716844.0,12490382.0,-14373414.0,-15628624.0,-14.0,1561.5,52461.0,461065.5,0.0,0.0,0.0,0.0,0.0,-1379.0,452.0,-24.0,-1389.0,296791393.31999964,4221530638.920004,4742620278.615004,69333125.03999993,4221595866.420004,306562.0,-21241170.0,4938510637.5,221024516.0,1111605301.5,480235189.0,1165300838.5,304858.5,4788.0,865.5097345563993,7076333.5,2525019.0,1554612.0,-5104446.0,1543812.0,103477.0,3349849747.2301235,3386899788.615097,-203717340.0,-202024388.0,3571873.0,168828.0,3083279129.639947,8391946500.0,,400773904.55999935,,,175191527.83499905,,405755346.914999,2960196420.510009,3072009024.9899364,3072167133.299936,,35160.0,,,1010224.0,-1788418.0,813857.0,1725.0,1469124.0,14845127.0,3236204.0,8565959.0,11621201.0,1417570.0,1061010068.8095012,802219621.4099952,72186141744.20212,21698308915.987617,583477279.4969988,5792665.7475,689.5,94245.0,-277242838.5,22026686.0,-123919724.5,-218951555.0,-2024487.5,5927721400.147462,18745627500.0,,448389627.8174977,,,309353792.6474986,,459500766.14249927,5712714891.270035,5890970896.1325,5891214078.8775,,80968.5,,,972284.5,-1700418.5,177364.0,6755.0,4278203.0,2482291.5,-9014065.0,921451.5,37582.5,3738199163.3549576,3662877300.2549577,-260930761.0,-257614763.0,2529293.5,269538.5,3930787644.277453,33289954496.82092,36722047016.63265,1731930451.3575494,48139074540.608215,3992730.5,-247866386.0,103209841649.5,1056230973.5,17292073216.5,3507907088.5,18906831811.5,3676353.0,72018.0,20895.133817860515,89862627.5,-20.186346343525432,2.073,6.091989034419737,236.90326672480484,12.628693268352118,491.1004719205204,120000.0,-0.9009688679024191,0.4338837391175582,0.0,0.0,0.0,0.0,0.0,0.0,1.0,0.0,0.0,0.0,0.0,0.0,0.0,1.0,0.0,0.0,0.0,0.0,1.0,0.0,1.0,0.0,0.0,0.0,0.0,1.0,0.0,0.0,0.0,0.0,0.0,0.0,0.0,0.0,0.0,0.0,0.0,0.0,1.0,0.0,0.0,0.0,0.0,0.0,0.0,0.0,0.0,0.0,0.0,0.0,0.0,0.0,0.0,1.0,0.0,0.0,0.0,0.0,0.0,0.0,0.0,0.0,0.0,0.0,0.0,0.0,0.0,0.0,0.0,0.0,0.0,0.0,0.0,0.0,0.0,0.0,0.0,0.0,0.0,0.0,0.0,0.0,0.0,0.0,0.0,0.0,0.0,0.0,0.0,0.0,0.0,0.0,0.0,0.0,0.0,0.0,0.0,0.0,0.0,0.0,0.0,0.0,0.0,0.0,0.0,0.0,0.0,0.0,0.0,0.0,0.0,0.0,0.0,0.0,0.0,0.0,0.0,0.0,0.0,0.0
105163,0,0.0,1.0,0.0,1.0,0.0,216000.0,900000.0,46084.5,900000.0,0.026392,45.48219178082192,-6497.0,-9120.0,-139.0,,2.0,2.0,2.0,12.0,,0.721049391125357,0.5262949398096192,0.1649,,0.9866,,,0.16,0.1379,0.375,,,,0.1707,,0.0,0.1681,,0.9866,,,0.1611,0.1379,0.375,,,,0.1778,,0.0,0.1665,,0.9866,,,0.16,0.1379,0.375,,,,0.1737,,0.0,0.1557,1.0,0.0,0.0,0.0,0.0,-334.0,0.0,0.0,0.0,0.0,0.0,2.0,1.0,1.0,0.0,1.0,0.0,0.0,0.0,0.0,0.0,0.0,0.0,0.0,0.0,1.0,0.0,0.0,0.0,0.0,0.0,0.0,0.0,0.0,0.0,0.0,0.0,0.0,0.0,0.0,0.0,0.0,0.0,0.0,21.0,0.0,0.0,148500.0,0.0,0.0,0.0,0.0,0.0,-462.0,-588.5,-313.0,-461.5,538.0,-18.0,4.0,5568.4125,33187.5,29868.75,6637.5,78187.5,5.0,-334.0,365243.0,-2650.0,-2470.0,-2380.0,-2466.0,11.0,0.0,0.1089090909090909,-1.0,8.0,7.0,3.5,-84.5,0.0,0.0,7.0,6636.825,6636.825,-2560.0,-2560.0,4.0,1.0,0.0,,,,,,,,,,,,,,,,,,,,,8356661928.0,184569060555.0,165736102536.0,52029865405.935,1863.0,1706.0,71126.0,70960.0,9141.0,506662.0,17828.59440000231,17890.880099999114,17341.961499998004,,,,128567.0,663583.0,,,,13542885.235616036,-602632847.0,-922956864.0,-296853738.0,-1536974268.0416667,44080.0,30747.0,11360.853999999194,11236.799999998986,10720.84669999729,22914.3028000098,22836.063400009767,22220.93160000833,,158218.32497709437,126254.10837681511,35041.83380002801,34981.95160002845,34427.38570002886,,,,3718338.0,,,,,,,16486.500699999724,16671.957999999693,16268.6691999997,,,,3917.7934000001233,3901.0397000001617,3733.72520000016,437009.0,431801.0,,6432.146462002896,632683.0,626230.0,,16350.815999999792,154364.25999999078,154367.00159999036,154258.7147999872,,,,16.0,82891091.02499998,28834735.23,8472263697.314984,2808599269.0950003,97630393.85999995,805463.7749999998,165.0,17420.0,-27824991.0,12607544.5,-14433028.0,-15695922.5,-7.5,0.0,0.0,135000.0,0.0,0.0,0.0,0.0,0.0,-1330.0,-1027.0,-769.0,-1019.0,297895799.2724996,4238603971.335004,4761307844.280004,69505490.78999993,4238570783.835004,307949.0,-21315959.0,4956952412.0,221340878.0,1114675195.0,481306749.0,1168737300.0,306068.5,4806.0,867.7358406678744,7087432.5,2534157.5,1560314.5,-5121095.0,1543874.0,103539.0,3360267242.010127,3396982011.0751038,-204366250.0,-202666670.0,3579827.0,169375.0,,,,,,,,,,,,,,,,,,,,,1469145.0,14845665.0,3236204.0,8565967.0,11621208.0,1417574.0,1061010068.8095012,802219621.4099952,72186290244.20212,21698308915.987617,583477279.4969988,5792665.7475,689.5,94245.0,-277243300.5,22026097.5,-123920037.5,-218952016.5,-2024505.5,,,,,,,,,,,,,,,,,,,,,4278210.0,2482295.0,-9014149.5,921451.5,37582.5,3738205800.179957,3662883937.079958,-260933321.0,-257617323.0,2529297.5,269539.5,3930793212.689953,33289987684.32092,36722076885.38265,1731937088.8575494,48139152728.108215,3992735.5,-247866720.0,103210206892.5,1056228323.5,17292070746.5,3507904708.5,18906829345.5,3676364.0,72018.0,20895.242726951423,89862626.5,-142.84711764351545,4.166666666666667,4.687042281027243,213.1769559105021,19.52934283761352,888.2373162937587,108000.0,0.6234898018587336,0.7818314824680298,0.0,0.0,0.0,0.0,0.0,0.0,1.0,0.0,1.0,0.0,0.0,0.0,0.0,0.0,0.0,0.0,0.0,0.0,1.0,0.0,1.0,0.0,0.0,0.0,0.0,1.0,0.0,0.0,0.0,0.0,0.0,0.0,0.0,0.0,0.0,0.0,0.0,0.0,0.0,0.0,0.0,0.0,0.0,0.0,0.0,0.0,0.0,0.0,0.0,0.0,0.0,0.0,0.0,0.0,0.0,0.0,0.0,0.0,0.0,1.0,0.0,0.0,0.0,0.0,0.0,0.0,0.0,0.0,0.0,0.0,0.0,0.0,0.0,0.0,0.0,0.0,0.0,0.0,0.0,0.0,0.0,0.0,0.0,0.0,0.0,0.0,0.0,0.0,0.0,0.0,0.0,0.0,0.0,0.0,0.0,0.0,0.0,0.0,0.0,0.0,0.0,0.0,0.0,0.0,0.0,0.0,0.0,0.0,0.0,0.0,1.0,0.0,0.0,1.0,0.0,0.0,0.0,0.0,0.0,0.0
105168,0,0.0,1.0,0.0,1.0,1.0,225000.0,983160.0,62964.0,900000.0,0.0196889999999999,46.07123287671233,-3649.0,-710.0,-352.0,,3.0,2.0,2.0,8.0,,0.5663964870055069,0.4471785780453068,0.0814,,0.9821,,,0.0,0.0345,0.1667,,0.0458,,0.0233,,0.0,0.083,,0.9821,,,0.0,0.0345,0.1667,,0.0468,,0.0243,,0.0,0.0822,,0.9821,,,0.0,0.0345,0.1667,,0.0465,,0.0238,,0.0,0.0381,1.0,0.0,0.0,0.0,0.0,-1114.0,0.0,0.0,0.0,0.0,1.0,2.0,1.0,1.0,0.0,1.0,0.0,0.0,0.0,0.0,0.0,1.0,1.0,0.0,0.0,1.0,0.0,0.0,0.0,0.0,0.0,0.0,0.0,0.0,0.0,0.0,0.0,0.0,0.0,0.0,0.0,0.0,0.0,0.0,2.0,36432.0,0.0,1037250.0,17860.5,0.0,0.0,0.0,0.0,-1102.5,-104.5,-108.5,-211.0,74.0,-18.0,5.0,33750.0,450000.0,450000.0,,675000.0,0.0,-509.0,365243.0,-1073.0,-233.0,-23.0,-229.0,10.0,0.0,,-1.0,30.0,36.0,21.5,-21.5,0.0,0.0,30.0,62660.565,62660.565,-671.0,-668.0,14.5,1.0,0.0,,,,,,,,,,,,,,,,,,,,,8356724892.0,184570043715.0,165737002536.0,52030090405.935,1863.0,1706.0,71126.0,70961.0,9141.0,506664.0,17828.675800002307,17890.962299999115,17342.044499998003,,,,128568.0,663586.0,,,,13542931.30684891,-602636496.0,-922957216.0,-296854852.0,-1536974978.0416667,44080.0,30747.0,11360.853999999194,11236.799999998986,10720.84669999729,22914.337300009804,22836.097900009765,22220.96610000833,,158218.89137358134,126254.55555539318,35042.000500028014,34982.11830002845,34427.552400028864,,,,3718346.0,8305.104700000164,8409.765800000072,8133.23000000023,,,,16486.523999999725,16671.981799999696,16268.6934999997,,,,3917.7934000001233,3901.0397000001617,3733.72520000016,437009.0,431801.0,,6432.166151002895,632685.0,626232.0,,16350.854099999791,154365.24209999078,154367.98369999035,154259.6968999872,,,,37.0,83020326.52499998,28903753.485,8483225889.689984,2811352442.8050003,97630393.85999995,805594.2749999998,165.0,17440.0,-27850926.5,12596604.5,-14448779.0,-15713048.0,-18.0,36432.0,0.0,1037250.0,17860.5,0.0,0.0,0.0,0.0,-1102.5,-104.5,-108.5,-211.0,298007336.87999964,4240261186.335004,4762969847.280004,,4240261186.335004,308032.0,-21324662.0,4959874356.0,221334116.0,1115401851.0,481303167.0,1169829236.0,306253.0,4809.0,,7087786.0,2535976.0,1561309.0,-5124275.0,1543883.0,103548.0,3362246590.4326296,3398956518.7576056,-204457279.5,-202756818.5,3580706.0,169481.5,,,,,,,,,,,,,,,,,,,,,1469147.0,14845739.0,3236204.0,8565997.0,11621238.0,1417579.0,1061046500.8095012,802219621.4099952,72187327494.20212,21698326776.487617,583477279.4969988,5792665.7475,689.5,94245.0,-277244403.0,22025993.0,-123920146.0,-218952227.5,-2024523.5,,,,,,,,,,,,,,,,,,,,,4278246.0,2482316.5,-9014171.0,921451.5,37582.5,3738268460.744957,3662946597.644958,-260933992.0,-257617991.0,2529312.0,269540.5,3930826962.689953,33290437684.32092,36722526885.38265,,48139827728.108215,3992735.5,-247867229.0,103210572135.5,1056227250.5,17292070513.5,3507904685.5,18906829116.5,3676374.0,72018.0,,89862625.5,-79.20343720266413,4.3696,3.57347055460263,164.6341940991721,15.614636935391651,719.3855745357425,75000.0,-0.9009688679024191,-0.433883739117558,0.0,1.0,0.0,0.0,0.0,0.0,0.0,0.0,1.0,0.0,0.0,0.0,0.0,0.0,0.0,0.0,0.0,0.0,1.0,0.0,1.0,0.0,0.0,0.0,0.0,1.0,0.0,0.0,0.0,0.0,0.0,0.0,0.0,0.0,1.0,0.0,0.0,0.0,0.0,0.0,0.0,0.0,0.0,0.0,0.0,0.0,0.0,0.0,0.0,0.0,0.0,0.0,0.0,0.0,0.0,0.0,0.0,0.0,0.0,0.0,0.0,0.0,0.0,0.0,0.0,0.0,0.0,0.0,0.0,0.0,1.0,0.0,0.0,0.0,0.0,0.0,0.0,0.0,0.0,0.0,0.0,0.0,0.0,0.0,0.0,0.0,0.0,0.0,0.0,0.0,0.0,0.0,0.0,0.0,0.0,0.0,0.0,0.0,0.0,0.0,0.0,0.0,0.0,0.0,0.0,0.0,0.0,0.0,0.0,0.0,0.0,1.0,0.0,0.0,0.0,0.0,0.0,0.0,1.0,0.0
105172,0,0.0,0.0,0.0,1.0,0.0,180000.0,1298970.0,46786.5,1147500.0,0.010276,56.3013698630137,-1008.0,-3418.0,-4055.0,,1.0,2.0,2.0,13.0,0.8090293849976106,0.8031074978602103,0.4258928980051529,0.0698,0.0588,0.9737,0.6396,0.0337,0.0,0.1379,0.1354,0.1388,0.0581,0.058,0.0587,0.0,0.0018,0.0672,0.0188,0.9742,0.6602,0.0079,0.0,0.1379,0.125,0.0417,0.0545,0.0579,0.0533,0.0,0.0,0.0666,0.0791,0.9742,0.6511,0.0126,0.0,0.1379,0.125,0.1667,0.0586,0.0547,0.0573,0.0,0.0,0.0418,1.0,2.0,0.0,2.0,0.0,-2658.0,0.0,0.0,0.0,0.0,0.0,1.0,1.0,1.0,0.0,1.0,0.0,0.0,0.0,0.0,0.0,0.0,0.0,0.0,0.0,0.0,0.0,0.0,1.0,0.0,0.0,0.0,0.0,0.0,0.0,0.0,0.0,0.0,0.0,0.0,0.0,0.0,0.0,0.0,7.0,0.0,,270000.0,0.0,0.0,0.0,0.0,0.0,-2165.0,-1603.0,-869.0,-1735.0,504.0,-35.5,1.0,4629.555,31401.0,23067.0,9423.0,31401.0,6.0,-2658.0,365243.0,-2627.0,-2477.0,-2477.0,-2467.0,17.0,1.0,0.315866532359607,2170.0,8.0,6.0,2.5,-84.5,0.0,0.0,6.0,4629.555,4629.555,-2572.0,-2552.0,3.5,1.0,0.0,,,,,,,,,,,,,,,,,,,,,8356771678.5,184571342685.0,165738150036.0,52030270405.935,1863.0,1706.0,71126.0,70961.0,9141.0,506665.0,17828.74560000231,17891.02889999911,17342.111699998004,11308.427100000095,11246.253700000096,11193.657700000063,128568.0,663587.0,4142.698500000115,4140.378400000013,3950.944700000093,13542987.608218772,-602637504.0,-922961271.0,-296857510.0,-1536978396.0416667,44080.0,30747.0,11360.853999999194,11236.799999998986,10720.84669999729,22914.475200009805,22836.235800009767,22221.10400000833,67565.17633971559,158219.6944810792,126254.98144829118,35042.13590002801,34982.24330002845,34427.677400028864,22978.50369999589,22951.566799995468,22598.205899995697,3718359.0,8305.162800000164,8409.824400000072,8133.284500000232,9827.910900000716,9942.950700002157,10303.158499999636,16486.582699999726,16672.039099999696,16268.7467999997,829.257900000177,814.4355000000461,760.3549000000132,3917.7952000001233,3901.0397000001617,3733.72520000016,437011.0,431803.0,,6432.176427002895,632687.0,626234.0,,16350.895899999796,154366.21579999078,154368.95789999035,154260.6710999872,77696.66999999636,78034.8515000066,78436.81550000662,72.0,83025227.02499998,,8491328471.339984,2816310560.8050003,97630393.85999995,805594.2749999998,165.0,17440.0,-27868277.0,12594820.0,-14452799.0,-15719632.0,-35.5,0.0,,135133.65,0.0,0.0,0.0,0.0,0.0,-2430.0,-2096.0,-869.0,-1735.0,298239181.3349996,4246092578.835004,4769670374.280004,69530488.28999993,4246092578.835004,308428.0,-21335170.0,4961700090.0,221327310.0,1116492125.0,481663687.0,1170919536.0,306471.0,4811.0,868.5193612797264,7090273.0,2537043.0,1561925.5,-5127395.5,1543906.0,103571.0,3363675664.5451303,3400287338.160109,-204573635.5,-202872669.5,3581645.0,169550.5,,,,,,,,,,,,,,,,,,,,,1469154.0,14846243.0,3236204.0,8566005.0,11621244.0,1417580.0,1061046500.8095012,,72187597494.20212,21698326776.487617,583477279.4969988,5792665.7475,689.5,94245.0,-277246568.0,22024390.0,-123921015.0,-218953962.5,-2024559.0,,,,,,,,,,,,,,,,,,,,,4278252.0,2482319.0,-9014255.5,921451.5,37582.5,3738273090.299957,3662951227.199957,-260936564.0,-257620543.0,2529315.5,269541.5,3930831592.244953,33290469085.32092,36722549952.38265,1731946511.8575494,48139859129.108215,3992741.5,-247869887.0,103210937378.5,1056224623.5,17292068036.5,3507902208.5,18906826649.5,3676391.0,72019.0,20895.558593483784,89864795.5,-17.903649635036498,7.2165,3.847263633740502,216.6062128037461,27.763778012888327,1563.1387346982335,180000.0,-0.2225209339563143,0.9749279121818236,0.0,0.0,0.0,0.0,0.0,0.0,1.0,0.0,1.0,0.0,0.0,0.0,0.0,0.0,0.0,1.0,0.0,0.0,0.0,0.0,0.0,0.0,0.0,1.0,0.0,1.0,0.0,0.0,0.0,0.0,1.0,0.0,0.0,0.0,0.0,0.0,0.0,0.0,0.0,0.0,0.0,0.0,0.0,0.0,0.0,0.0,0.0,0.0,0.0,0.0,0.0,0.0,0.0,0.0,0.0,0.0,0.0,0.0,0.0,0.0,0.0,0.0,0.0,0.0,0.0,0.0,0.0,0.0,0.0,0.0,0.0,0.0,0.0,0.0,0.0,0.0,0.0,0.0,1.0,0.0,0.0,0.0,0.0,0.0,0.0,0.0,0.0,0.0,0.0,0.0,0.0,0.0,0.0,0.0,0.0,0.0,0.0,0.0,0.0,0.0,0.0,0.0,0.0,0.0,0.0,0.0,0.0,0.0,1.0,0.0,1.0,0.0,0.0,0.0,0.0,0.0,0.0,1.0,0.0,0.0
105176,1,0.0,0.0,1.0,0.0,0.0,247500.0,450000.0,32877.0,450000.0,0.018029,22.482191780821925,-892.0,-5669.0,-371.0,2.0,1.0,3.0,3.0,5.0,0.0846063933804411,0.3766481424552216,0.1131963530622281,,,,,,,,,,,,,,,,,,,,,,,,,,,,,,,,,,,,,,,,,,,,,1.0,0.0,1.0,0.0,-462.0,0.0,0.0,0.0,1.0,2.0,2.0,1.0,1.0,1.0,1.0,0.0,1.0,0.0,0.0,0.0,0.0,0.0,0.0,0.0,1.0,0.0,0.0,0.0,0.0,0.0,0.0,0.0,0.0,0.0,0.0,0.0,0.0,0.0,0.0,0.0,0.0,0.0,0.0,11.0,6106.5,1440.0,126000.0,0.0,0.0,0.0,0.0,0.0,-868.0,-350.0,-208.0,-715.0,297.0,-14.0,10.0,9964.71,45308.25,45159.75,990.0,67500.0,6.0,-462.0,365243.0,-572.0,-392.0,-152.0,-386.5,9.0,0.0,0.0465875947890336,-1.0,29.0,12.0,6.0,-21.0,0.0,0.0,49.0,6429.42,6429.42,-409.0,-404.0,7.0,1.0,14.0,0.0,0.0,0.0,0.0,0.0,0.0,0.0,9.45,9.45,0.0,0.0,0.0,0.0,0.0,0.0,0.0,5.0,-8.5,0.0,0.0,8356804555.5,184571792685.0,165738600036.0,52030517905.935,1863.0,1706.0,71127.0,70963.0,9141.0,506667.0,,,,,,,128568.0,663588.0,,,,13543010.090410553,-602638396.0,-922961642.0,-296857972.0,-1536984065.0416667,44080.0,30747.0,,,,,,,67565.26094610897,158220.07112922167,126255.09464464424,,,,,,,3718364.0,,,,,,,,,,,,,,,,437012.0,431804.0,1264592.0,6432.194456002895,632690.0,626237.0,,,,,,,,,29.0,83320116.56999998,28989919.53,8497032021.854984,2816522894.5200005,97630393.85999995,805594.2749999998,165.0,17440.0,-27900876.0,12616052.0,-14470813.0,-15740284.0,-14.0,5224.5,0.0,101250.0,0.0,0.0,0.0,0.0,0.0,-981.0,-715.0,-712.0,-981.0,298387987.7399997,4247606806.335004,4771347384.780004,69556498.28999993,4247741806.335004,308548.0,-21347102.0,4965534705.5,221685820.5,1117948698.5,482390792.0,1172376540.0,306759.5,4815.0,868.8317312998876,7099804.5,2538110.0,1562546.0,-5129526.0,1543906.0,103571.0,3365157132.090136,3401844871.410116,-204640078.0,-202937969.0,3582577.0,169776.0,3093747779.1824484,8413951500.0,260904621.375,401898282.56999946,12292466.535000002,128305483.82999992,175801729.8824991,440550543.9149964,407064513.734999,2970264024.7425103,3082450452.6374373,3082608560.9474354,13281.0,35293.0,170.0,21842.0,1013266.5,-1792563.5,813858.0,1725.0,1469165.0,14846540.0,3236218.0,8566034.0,11621293.0,1417590.0,1061052607.3095012,802221061.4099952,72187723494.20212,21698326776.487617,583477279.4969988,5792665.7475,689.5,94245.0,-277247436.0,22024040.0,-123921223.0,-218954677.5,-2024573.0,5927721400.147462,18745627500.0,198880482.825,448389627.8174977,1948107.735,257079697.1100008,309353792.6474986,637051537.9349978,459500775.59249926,5712714891.270035,5890970896.1325,5891214078.8775,13394.0,80968.5,44.0,70472.0,972289.5,-1700427.0,177364.0,6755.0,4278264.0,2482325.0,-9014276.5,921451.5,37582.5,3738279519.719957,3662957656.619957,-260936973.0,-257620947.0,2529322.5,269542.5,3930841556.954953,33290514393.57092,36722595112.13265,1731947501.8575494,48139926629.108215,3992747.5,-247870349.0,103211302621.5,1056224051.5,17292067644.5,3507902056.5,18906826263.0,3676400.0,72019.0,20895.60518107857,89864794.5,-39.67584694126249,1.818181818181818,7.528059129482617,169.2472690863955,13.68738023542294,307.7223074298101,247500.0,-0.9009688679024191,-0.433883739117558,0.0,0.0,0.0,0.0,0.0,0.0,1.0,0.0,0.0,0.0,0.0,0.0,0.0,1.0,0.0,0.0,0.0,0.0,1.0,0.0,0.0,1.0,0.0,0.0,0.0,1.0,0.0,0.0,0.0,0.0,0.0,0.0,0.0,1.0,0.0,0.0,0.0,0.0,0.0,0.0,0.0,0.0,0.0,0.0,0.0,0.0,0.0,0.0,0.0,0.0,0.0,0.0,0.0,0.0,0.0,0.0,0.0,0.0,0.0,0.0,0.0,0.0,0.0,0.0,0.0,0.0,0.0,0.0,0.0,0.0,0.0,0.0,0.0,0.0,0.0,0.0,0.0,0.0,0.0,0.0,0.0,0.0,0.0,0.0,0.0,0.0,0.0,1.0,0.0,0.0,0.0,0.0,0.0,0.0,0.0,0.0,0.0,0.0,0.0,0.0,0.0,0.0,0.0,0.0,0.0,0.0,0.0,0.0,0.0,0.0,0.0,0.0,0.0,0.0,0.0,0.0,0.0,0.0,0.0,0.0
105195,0,0.0,0.0,0.0,0.0,0.0,90000.0,285430.5,22234.5,255123.0,0.00963,53.816438356164376,-4354.0,-435.0,-3206.0,,1.0,2.0,2.0,12.0,,0.4554069454271559,0.5082869913916046,0.0825,0.0702,0.9742,,,0.0,0.1379,0.1667,,0.0682,,0.0689,,0.0,0.084,0.0728,0.9742,,,0.0,0.1379,0.1667,,0.0697,,0.0718,,0.0,0.0833,0.0702,0.9742,,,0.0,0.1379,0.1667,,0.0694,,0.0702,,0.0,0.0542,1.0,2.0,0.0,2.0,0.0,-2224.0,0.0,0.0,0.0,0.0,0.0,1.0,1.0,1.0,1.0,1.0,0.0,0.0,0.0,0.0,0.0,0.0,0.0,0.0,0.0,1.0,0.0,0.0,0.0,0.0,0.0,0.0,0.0,0.0,0.0,0.0,0.0,0.0,0.0,0.0,0.0,0.0,0.0,0.0,3.0,90000.0,,135000.0,0.0,0.0,0.0,0.0,0.0,-335.0,761.0,-159.0,-302.0,50.0,-8.5,1.0,4051.935,33066.0,32706.0,3307.5,33066.0,12.0,-2224.0,365243.0,-2193.0,-2073.0,-1863.0,-2067.0,14.0,0.0,0.1000227187531948,1880.0,5.0,5.0,2.0,-71.0,0.0,0.0,5.0,4051.935,4051.935,-2143.0,-2133.0,3.0,1.0,0.0,,,,,,,,,,,,,,,,,,,,,8356826790.0,184572078115.5,165738855159.0,52030607905.935,1863.0,1706.0,71127.0,70963.0,9141.0,506668.0,17828.82810000231,17891.112199999112,17342.195699998003,11308.497300000095,11246.323900000096,11193.730500000063,128568.0,663589.0,,,,13543063.90684891,-602642750.0,-922964848.0,-296860196.0,-1536984500.0416667,44080.0,30747.0,11360.853999999194,11236.799999998986,10720.84669999729,22914.61310000981,22836.373700009764,22221.24190000833,,158220.5265361671,126255.60293163564,35042.302600028015,34982.41000002845,34427.844100028866,,,,3718376.0,8305.231000000163,8409.893800000073,8133.354200000232,,,,16486.651599999725,16672.109299999694,16268.8185999997,,,,3917.7952000001233,3901.0397000001617,3733.72520000016,437014.0,431806.0,,6432.204086002896,632692.0,626239.0,,16350.950099999794,154367.18999999078,154369.93209999034,154261.6452999872,,,,11.0,83546660.06999998,,8542959238.754984,2834886687.84,97899140.83499998,805594.2749999998,168.0,17440.0,-28024801.0,12688923.0,-14531825.0,-15805765.0,-6.0,90000.0,,0.0,0.0,0.0,0.0,0.0,0.0,-916.0,181.0,-232.0,-302.0,299579398.9199997,4263575596.335004,4787892102.780004,69788990.78999993,4263575596.335004,309454.0,-21396128.0,4980325348.0,222381809.0,1121212553.0,484201562.0,1176006166.0,307743.0,4823.0,870.7935392838845,7119141.0,2545145.0,1566844.0,-5141264.0,1543974.0,103611.0,3376036792.0351253,3413350351.215104,-205192793.0,-203486203.0,3594913.0,170266.0,,,,,,,,,,,,,,,,,,,,,1469168.0,14846590.0,3236218.0,8566039.0,11621298.0,1417591.0,1061142607.3095012,,72187858494.20212,21698326776.487617,583477279.4969988,5792665.7475,689.5,94245.0,-277247771.0,22024801.0,-123921382.0,-218954979.5,-2024581.5,,,,,,,,,,,,,,,,,,,,,4278269.0,2482327.0,-9014347.5,921451.5,37582.5,3738283571.654957,3662961708.554957,-260939116.0,-257623080.0,2529325.5,269543.5,3930845608.889953,33290547459.57092,36722627818.13265,1731950809.3575494,48139959695.108215,3992759.5,-247872573.0,103211667864.5,1056221858.5,17292065571.5,3507900193.5,18906824196.0,3676414.0,72019.0,20895.70520379733,89866674.5,-80.90464796619659,3.17145,4.0477636106051404,217.8362208304569,12.837279902853671,690.8566825527527,90000.0,1.0,0.0,0.0,0.0,0.0,0.0,0.0,0.0,1.0,0.0,0.0,0.0,1.0,0.0,0.0,0.0,0.0,0.0,0.0,0.0,1.0,0.0,0.0,1.0,0.0,0.0,0.0,1.0,0.0,0.0,0.0,0.0,0.0,0.0,0.0,0.0,0.0,0.0,0.0,0.0,0.0,0.0,0.0,0.0,0.0,0.0,0.0,0.0,1.0,0.0,0.0,0.0,0.0,0.0,0.0,0.0,0.0,0.0,0.0,0.0,0.0,1.0,0.0,0.0,0.0,0.0,0.0,0.0,0.0,0.0,0.0,0.0,0.0,0.0,0.0,0.0,0.0,0.0,0.0,0.0,0.0,0.0,0.0,0.0,0.0,0.0,0.0,0.0,0.0,0.0,0.0,0.0,0.0,0.0,0.0,0.0,0.0,0.0,0.0,0.0,0.0,0.0,0.0,0.0,0.0,0.0,0.0,0.0,0.0,0.0,0.0,0.0,1.0,0.0,0.0,0.0,0.0,0.0,0.0,1.0,0.0,0.0
105196,1,0.0,1.0,0.0,1.0,0.0,180000.0,543037.5,43033.5,463500.0,0.035792,35.86027397260274,-1318.0,-632.0,-4740.0,,2.0,2.0,2.0,10.0,,0.5541730779830135,0.2567055724393002,,,,,,,,,,,,,,,,,,,,,,,,,,,,,,,,,,,,,,,,,,,,,0.0,0.0,0.0,0.0,-245.0,0.0,0.0,0.0,0.0,1.0,0.0,1.0,1.0,0.0,1.0,0.0,0.0,0.0,0.0,0.0,0.0,1.0,1.0,0.0,1.0,0.0,0.0,0.0,0.0,0.0,0.0,0.0,0.0,0.0,0.0,0.0,0.0,0.0,0.0,0.0,0.0,0.0,0.0,4.0,6907.5,0.0,63022.815,27285.75,0.0,0.0,0.0,0.0,-649.5,-373.0,-200.0,-491.0,79.0,-11.0,1.0,11350.035,249007.5,243004.5,24903.0,249007.5,36.0,-245.0,365243.0,-215.0,-185.0,835.0,-179.0,10.0,1.0,0.1012350565366438,20.0,3.0,36.0,35.0,-7.0,0.0,0.0,2.0,128992.1175,128992.1175,-201.5,-200.0,1.5,1.5,0.0,,,,,,,,,,,,,,,,,,,,,8356869823.5,184572621153.0,165739318659.0,52030787905.935,1863.0,1706.0,71127.0,70964.0,9141.0,506668.0,,,,,,,128568.0,663591.0,,,,13543099.76712288,-602644068.0,-922969588.0,-296860441.0,-1536985132.0416667,44080.0,30747.0,,,,,,,,158221.08070924509,126255.85963720804,,,,,,,3718386.0,,,,,,,,,,,,,,,,437014.0,431806.0,,6432.239878002895,632694.0,626241.0,,,,,,,,,22.0,83555975.06999998,29145967.155,8543328072.704985,2835002461.59,97899953.30999996,805594.2749999998,168.0,17440.0,-28026467.0,12689104.0,-14532485.0,-15806560.5,-10.5,9000.0,0.0,58635.63,0.0,0.0,0.0,0.0,0.0,-677.0,-580.0,-368.0,-609.0,299590748.95499974,4263824603.835004,4788135107.280004,69813893.78999993,4263824603.835004,309490.0,-21396373.0,4980690591.0,222381594.0,1121212368.0,484202397.0,1176005987.0,307753.0,4824.0,870.8947743404211,7119161.0,2545193.0,1566885.0,-5141421.0,1543974.0,103611.0,3376297205.122625,3413610764.302604,-205197416.0,-203490791.5,3594920.5,170270.5,,,,,,,,,,,,,,,,,,,,,1469172.0,14846669.0,3236218.0,8566042.0,11621300.0,1417592.0,1061149514.8095012,802221061.4099952,72187921517.01714,21698354062.237617,583477279.4969988,5792665.7475,689.5,94245.0,-277248420.5,22024428.0,-123921582.0,-218955470.5,-2024592.5,,,,,,,,,,,,,,,,,,,,,4278305.0,2482362.0,-9014354.5,921451.5,37582.5,3738412563.772457,3663090700.672457,-260939317.5,-257623280.0,2529327.0,269545.0,3930856958.924953,33290796467.07092,36722870822.63265,1731975712.3575494,48140208702.608215,3992795.5,-247872818.0,103212033107.5,1056221643.5,17292065386.5,3507901028.5,18906824017.0,3676424.0,72020.0,20895.806438853862,89866694.5,-36.75376270150508,3.016875,4.18278782808742,149.99591748448287,12.618948028861237,452.5189335609992,90000.0,-0.9009688679024191,0.4338837391175582,0.0,0.0,0.0,0.0,0.0,0.0,1.0,0.0,0.0,0.0,0.0,0.0,0.0,1.0,0.0,0.0,0.0,0.0,1.0,0.0,1.0,0.0,0.0,0.0,0.0,1.0,0.0,0.0,0.0,0.0,0.0,0.0,0.0,0.0,0.0,0.0,0.0,0.0,1.0,0.0,0.0,0.0,0.0,0.0,0.0,0.0,0.0,0.0,0.0,0.0,0.0,0.0,0.0,0.0,0.0,0.0,0.0,0.0,0.0,0.0,0.0,0.0,0.0,0.0,0.0,0.0,0.0,0.0,0.0,0.0,0.0,0.0,0.0,0.0,0.0,0.0,0.0,0.0,0.0,0.0,0.0,0.0,0.0,0.0,0.0,0.0,0.0,0.0,0.0,0.0,0.0,0.0,0.0,0.0,0.0,0.0,0.0,0.0,0.0,0.0,0.0,0.0,0.0,1.0,0.0,0.0,0.0,0.0,0.0,0.0,0.0,0.0,0.0,0.0,0.0,0.0,0.0,0.0,0.0,0.0
105197,0,0.0,0.0,0.0,1.0,0.0,103500.0,248760.0,25488.0,225000.0,0.035792,67.51780821917808,,-1333.0,-4816.0,,1.0,2.0,2.0,12.0,0.6501454750024652,0.6323273556921634,0.7136313997323308,,,,,,,,,,,,,,,,,,,,,,,,,,,,,,,,,,,,,,,,,,,,,0.0,0.0,0.0,0.0,-413.0,0.0,0.0,0.0,0.0,0.0,2.0,1.0,0.0,0.0,1.0,0.0,0.0,0.0,0.0,0.0,0.0,0.0,0.0,0.0,1.0,0.0,0.0,0.0,0.0,0.0,0.0,0.0,0.0,0.0,0.0,0.0,0.0,0.0,0.0,0.0,0.0,0.0,0.0,3.0,0.0,0.0,65610.0,0.0,0.0,0.0,0.0,0.0,-1376.0,-1010.0,-932.0,-1285.0,119.0,-22.0,4.0,10543.23,48285.0,47745.0,2137.5,53820.0,10.0,-413.0,365243.0,-383.0,-153.0,-93.0,-146.0,11.0,0.0,0.0544545454545454,9.5,30.0,10.0,9.5,-10.5,0.0,0.0,34.0,10543.23,10543.23,-375.5,-368.0,5.0,1.0,0.0,,,,,,,,,,,,,,,,,,,,,8356895311.5,184572869913.0,165739543659.0,52030891405.935,1863.0,1706.0,71127.0,70964.0,9141.0,506670.0,,,,,,,128568.0,663592.0,,,,13543167.2849311,,-922974404.0,-296860854.0,-1536986465.0416667,44080.0,30747.0,,,,,,,67565.91109158397,158221.7130366008,126256.5732686078,,,,,,,3718398.0,,,,,,,,,,,,,,,,437014.0,431806.0,,6432.275670002896,632696.0,626243.0,,,,,,,,,46.0,83560475.06999998,29145967.155,8543650408.334985,2835047054.34,97899953.30999996,805594.2749999998,168.0,17440.0,-28029249.0,12687751.0,-14533993.0,-15808228.0,-22.5,0.0,0.0,65610.0,0.0,0.0,0.0,0.0,0.0,-1376.0,-1010.0,-932.0,-1285.0,299615645.11499983,4264103423.835004,4788446822.280004,69816031.28999993,4264103423.835004,309520.0,-21397268.5,4981421077.0,222380968.0,1121577458.0,484202611.0,1176371084.0,307781.5,4825.0,870.9492288858755,7119179.5,2545573.0,1567168.0,-5141541.5,1543974.0,103611.0,3376569312.135124,3413927871.3151026,-205201159.5,-203494321.5,3595031.5,170296.5,,,,,,,,,,,,,,,,,,,,,1469175.0,14846788.0,3236218.0,8566072.0,11621334.0,1417596.0,1061149514.8095012,802221061.4099952,72187987127.01714,21698354062.237617,583477279.4969988,5792665.7475,689.5,94245.0,-277249796.5,22023418.0,-123922514.0,-218956755.5,-2024614.5,,,,,,,,,,,,,,,,,,,,,4278315.0,2482371.5,-9014365.0,921451.5,37582.5,3738423107.002457,3663101243.902457,-260939693.0,-257623648.0,2529332.0,269546.0,3930867502.154953,33290844752.07092,36722918567.63265,1731977849.8575494,48140262522.608215,3992805.5,-247873231.0,103212398350.5,1056221260.5,17292065233.5,3507900935.5,18906823871.0,3676435.0,72020.0,20895.86089339932,89866704.0,,2.4034782608695653,4.0607344632768365,274.1718907205325,9.759887005649716,658.9661790883057,103500.0,-0.2225209339563146,-0.9749279121818236,0.0,0.0,0.0,0.0,0.0,0.0,1.0,0.0,0.0,1.0,0.0,0.0,0.0,0.0,0.0,1.0,0.0,0.0,0.0,0.0,0.0,0.0,0.0,1.0,0.0,1.0,0.0,0.0,0.0,0.0,0.0,0.0,0.0,0.0,0.0,0.0,0.0,0.0,0.0,0.0,0.0,0.0,0.0,0.0,0.0,0.0,0.0,0.0,0.0,0.0,0.0,0.0,0.0,0.0,0.0,0.0,0.0,0.0,0.0,0.0,0.0,0.0,0.0,0.0,0.0,0.0,0.0,0.0,0.0,0.0,0.0,0.0,0.0,0.0,0.0,0.0,0.0,0.0,0.0,0.0,0.0,0.0,0.0,0.0,0.0,0.0,0.0,0.0,0.0,0.0,0.0,0.0,0.0,0.0,0.0,0.0,0.0,0.0,0.0,0.0,0.0,0.0,0.0,0.0,0.0,1.0,0.0,0.0,0.0,0.0,0.0,0.0,0.0,0.0,0.0,0.0,0.0,0.0,0.0,0.0
105203,0,0.0,0.0,1.0,1.0,0.0,180000.0,582804.0,31747.5,463500.0,0.0088659999999999,51.27671232876714,-2441.0,-8019.0,-2086.0,4.0,2.0,2.0,2.0,12.0,0.5813095715337382,0.7057567660035551,0.4489622731076524,0.0082,0.0,0.9617,0.4764,0.0022,0.0,0.0345,0.0417,0.0833,0.0192,0.0067,0.0066,0.0,0.0,0.0084,0.0,0.9618,0.4969,0.0023,0.0,0.0345,0.0417,0.0833,0.0196,0.0073,0.0068,0.0,0.0,0.0083,0.0,0.9617,0.4834,0.0023,0.0,0.0345,0.0417,0.0833,0.0195,0.0068,0.0067,0.0,0.0,0.0064,1.0,0.0,0.0,0.0,0.0,-1795.0,0.0,0.0,0.0,0.0,2.0,8.0,1.0,1.0,0.0,1.0,0.0,0.0,0.0,0.0,0.0,0.0,0.0,0.0,0.0,1.0,0.0,0.0,0.0,0.0,0.0,0.0,0.0,0.0,0.0,0.0,0.0,0.0,0.0,0.0,0.0,0.0,0.0,0.0,5.0,0.0,,249255.0,0.0,0.0,0.0,0.0,0.0,-326.0,-194.0,-194.0,-1073.0,127.0,-20.0,11.0,6750.0,41607.0,56776.5,0.0,125977.5,24.0,-579.0,365243.0,-1173.0,-324.5,48.0,-319.5,13.0,0.5,0.0,-1.0,71.0,24.0,17.0,-29.0,0.0,0.0,185.0,5889.87,5395.5,-773.0,-773.0,23.0,0.0,50.0,8483.76,270000.0,0.0,8543.25,0.0,7416.0,2250.0,12108.735,12108.735,8483.76,8483.76,8483.76,0.0,1.5,0.0,1.0,22.0,-25.5,0.0,0.0,8356927059.0,184573452717.0,165740007159.0,52031071405.935,1863.0,1706.0,71127.0,70966.0,9141.0,506678.0,17828.83630000231,17891.12049999911,17342.204099998,11308.497300000095,11246.323900000096,11193.730500000063,128568.0,663594.0,4142.700700000115,4140.380700000012,3950.947000000094,13543218.56164343,-602646509.0,-922976490.0,-296862649.0,-1536994484.0416667,44080.0,30747.0,11360.853999999194,11236.799999998986,10720.84669999729,22914.64760000981,22836.40820000977,22221.27640000833,67566.4924011555,158222.4187933668,126257.0222308809,35042.34430002802,34982.451700028454,34427.88580002887,22978.58699999589,22951.650099995462,22598.2891999957,3718410.0,8305.250200000164,8409.913300000073,8133.37380000023,9827.917600000716,9942.957500002154,10303.165799999637,16486.658199999725,16672.115999999696,16268.825399999698,829.257900000177,814.4355000000461,760.3549000000132,3917.7952000001233,3901.0397000001617,3733.72520000016,437014.0,431806.0,1264596.0,6432.284536002896,632698.0,626245.0,,16350.956499999797,154368.1516999908,154370.89379999036,154262.60709998722,77697.14639999637,78035.33490000661,78437.31240000662,11.0,83600372.06999998,,8549139444.839984,2837296991.34,97899953.30999996,805594.2749999998,168.0,17440.0,-28037095.0,12686480.0,-14538092.0,-15813443.0,-5.0,0.0,,152149.5,0.0,0.0,0.0,0.0,0.0,-1376.0,-665.0,-1073.0,-1377.0,300046985.54999983,4270500998.505004,4795372100.430002,69848474.30999993,4270971802.005004,310162.0,-21430417.0,4990002490.5,223084500.0,1124112612.5,484919848.5,1178906398.0,308165.0,4833.0,871.7628405904721,7125977.0,2551654.0,1571432.0,-5151611.0,1544069.0,103611.0,3383683341.750107,3420761132.0250893,-205529625.0,-203820492.0,3602516.0,170521.0,3096786451.769949,8431195500.0,261419646.375,403532712.4049996,12400106.535000002,129317243.6249999,176026657.6349991,442327889.9699981,408790713.9599992,2973127876.1775107,3085410056.129937,3085568164.439936,13351.0,35677.0,171.0,22155.0,1015030.5,-1803672.0,813866.0,1733.0,1469180.0,14846915.0,3236268.0,8566143.0,11621519.0,1417607.0,1061149514.8095012,,72188236382.01714,21698354062.237617,583477279.4969988,5792665.7475,689.5,94245.0,-277250122.5,22023224.0,-123922708.0,-218957828.5,-2024634.5,5927729883.907462,18745897500.0,198880482.825,448398171.0674977,1948107.735,257087113.1100008,309356042.6474986,637063646.6699978,459512884.3274993,5712723375.030035,5890979379.892499,5891222562.6375,13394.0,80970.0,44.0,70473.0,972311.5,-1700452.5,177364.0,6755.0,4278339.0,2482388.5,-9014394.0,921451.5,37582.5,3738428996.872457,3663106639.402457,-260940466.0,-257624421.0,2529355.0,269546.0,3930874252.154953,33290886359.07092,36722975344.13265,1731977849.8575494,48140388500.108215,3992829.5,-247873810.0,103212763593.5,1056220087.5,17292064909.0,3507900983.5,18906823551.5,3676448.0,72020.5,20895.86089339932,89866703.0,-47.60445608035905,3.2378,5.669737774627923,290.7255128491404,18.35747696669029,941.3110655029463,90000.0,1.0,0.0,0.0,0.0,0.0,0.0,0.0,0.0,1.0,0.0,0.0,0.0,0.0,0.0,0.0,1.0,0.0,0.0,0.0,0.0,1.0,1.0,0.0,0.0,0.0,0.0,0.0,1.0,0.0,0.0,0.0,0.0,0.0,0.0,1.0,0.0,0.0,0.0,0.0,0.0,0.0,0.0,0.0,0.0,0.0,0.0,0.0,0.0,0.0,0.0,0.0,0.0,0.0,0.0,0.0,0.0,0.0,0.0,0.0,0.0,0.0,0.0,0.0,0.0,0.0,0.0,0.0,0.0,0.0,0.0,0.0,0.0,0.0,0.0,0.0,0.0,0.0,0.0,0.0,0.0,0.0,0.0,0.0,0.0,0.0,0.0,0.0,0.0,1.0,0.0,0.0,0.0,0.0,0.0,0.0,0.0,0.0,0.0,0.0,0.0,0.0,0.0,0.0,0.0,0.0,0.0,0.0,0.0,0.0,0.0,1.0,0.0,1.0,0.0,0.0,0.0,0.0,0.0,0.0,0.0,0.0,1.0
105223,0,0.0,0.0,1.0,1.0,1.0,256500.0,746280.0,41670.0,675000.0,0.018801,49.49589041095891,-1326.0,-4975.0,-1603.0,5.0,2.0,2.0,2.0,15.0,0.7855124676373573,0.5385108074949868,0.2225807646753351,0.0309,,0.9627,,,,0.1724,0.0833,,,,0.0218,,0.0296,0.0315,,0.9628,,,,0.1724,0.0833,,,,0.0227,,0.0314,0.0312,,0.9627,,,,0.1724,0.0833,,,,0.0222,,0.0302,0.0264,1.0,1.0,0.0,1.0,0.0,-2110.0,0.0,0.0,0.0,0.0,0.0,1.0,1.0,1.0,0.0,1.0,0.0,1.0,0.0,0.0,0.0,0.0,0.0,0.0,0.0,1.0,0.0,0.0,0.0,0.0,0.0,0.0,0.0,0.0,0.0,0.0,0.0,0.0,0.0,0.0,0.0,0.0,0.0,0.0,6.0,18751.5,0.0,404006.85,0.0,0.0,0.0,0.0,0.0,-549.5,-305.5,-106.0,-428.0,148.0,-12.0,6.0,7428.42,27225.0,28712.25,0.0,41908.5,6.0,-266.5,365243.0,-1897.0,-1762.0,-1747.0,-1759.0,14.5,0.0,0.0,4.5,13.0,6.0,3.0,-58.0,0.0,0.0,12.0,7428.42,7426.26,-1720.0,-1709.0,3.5,1.0,0.0,,,,,,,,,,,,,,,,,,,,,8356968729.0,184574198997.0,165740682159.0,52031327905.935,1863.0,1706.0,71127.0,70966.0,9141.0,506679.0,17828.86720000231,17891.151699999114,17342.235599998003,,,,128569.0,663596.0,,,,13543268.05753384,-602647835.0,-922978093.0,-296864759.0,-1536999459.0416667,44080.0,30747.0,,,,22914.82000000981,22836.58060000977,22221.44880000833,67567.27791362314,158222.95730417428,126257.24481164556,35042.427600028015,34982.53500002845,34427.969100028866,,,,3718425.0,,,,,,,16486.679999999724,16672.138199999696,16268.848099999695,,,,3917.824800000123,3901.069900000162,3733.75660000016,437015.0,431807.0,1264601.0,6432.303337002895,632700.0,626247.0,,16350.982899999795,154369.1143999908,154371.85649999036,154263.5698999872,,,,19.0,83694651.56999998,29312831.385,8589560951.294985,2850983033.175,98600506.73999998,805594.5899999997,168.0,19303.0,-28157875.5,12703243.0,-14600192.5,-15881027.0,-9.0,18751.5,0.0,133013.7,0.0,0.0,0.0,0.0,0.0,-763.0,-1480.0,-427.0,-1507.0,301597012.4849998,4297254574.005004,4826321192.430002,70225772.30999993,4297637074.005004,311433.0,-21524050.5,5010816120.5,224475501.0,1129176326.0,487801732.0,1183972551.0,309461.5,4849.0,875.0489640592647,7156006.5,2564257.0,1579592.0,-5175034.0,1544141.0,103627.0,3399486285.105093,3437674620.48008,-206615184.0,-204895995.0,3622702.5,171266.5,,,,,,,,,,,,,,,,,,,,,1469186.0,14847063.0,3236268.0,8566156.0,11621531.0,1417613.0,1061168266.3095012,802221061.4099952,72188640388.86714,21698354062.237617,583477279.4969988,5792665.7475,689.5,94245.0,-277250672.0,22022918.5,-123922814.0,-218958256.5,-2024646.5,,,,,,,,,,,,,,,,,,,,,4278345.0,2482391.5,-9014452.0,921451.5,37582.5,3738436425.292457,3663114065.662458,-260942186.0,-257626130.0,2529358.5,269547.0,3930881680.574953,33290913584.07092,36723004056.38265,1731977849.8575494,48140430408.608215,3992835.5,-247874076.5,103213128836.5,1056218190.5,17292063147.0,3507899236.5,18906821792.5,3676462.5,72020.5,20895.86089339932,89866707.5,-26.790102955828623,2.909473684210526,6.155507559395247,304.6723275836564,17.90928725701944,886.436119411817,128250.0,0.6234898018587336,0.7818314824680298,0.0,0.0,0.0,0.0,0.0,0.0,1.0,0.0,0.0,0.0,0.0,0.0,0.0,1.0,0.0,0.0,0.0,0.0,1.0,0.0,0.0,0.0,1.0,0.0,0.0,1.0,0.0,0.0,0.0,0.0,1.0,0.0,0.0,0.0,0.0,0.0,0.0,0.0,0.0,0.0,0.0,0.0,0.0,0.0,0.0,0.0,0.0,0.0,0.0,0.0,0.0,0.0,0.0,1.0,0.0,0.0,0.0,0.0,0.0,0.0,0.0,0.0,0.0,0.0,0.0,0.0,0.0,0.0,0.0,0.0,0.0,0.0,0.0,0.0,0.0,0.0,0.0,0.0,0.0,0.0,0.0,0.0,0.0,0.0,0.0,0.0,0.0,0.0,0.0,0.0,0.0,0.0,0.0,0.0,0.0,0.0,0.0,0.0,0.0,0.0,0.0,0.0,0.0,0.0,0.0,0.0,0.0,0.0,0.0,0.0,1.0,0.0,0.0,0.0,0.0,0.0,0.0,0.0,1.0,0.0
105227,0,0.0,0.0,0.0,1.0,0.0,85500.0,295168.5,16141.5,238500.0,0.025164,55.41095890410959,,-26.0,-3626.0,,2.0,2.0,2.0,9.0,,0.1114133492903066,,,,,,,,,,,,,,,,,,,,,,,,,,,,,,,,,,,,,,,,,,,,,,0.0,0.0,0.0,0.0,0.0,0.0,0.0,0.0,0.0,0.0,0.0,1.0,0.0,0.0,1.0,0.0,0.0,0.0,0.0,0.0,0.0,0.0,0.0,0.0,0.0,0.0,0.0,1.0,0.0,0.0,0.0,0.0,0.0,0.0,0.0,0.0,0.0,0.0,0.0,0.0,0.0,0.0,0.0,1.0,0.0,,13500.0,0.0,,0.0,0.0,0.0,-28.0,,-5.0,-6.0,1.0,0.0,7.0,26501.445,0.0,0.0,6750.0,567000.0,12.0,-319.0,365243.0,182359.0,182509.0,182524.0,182512.0,9.0,0.0,0.0949788583509513,-1.0,12.0,11.0,5.5,-13.5,0.0,0.0,11.0,7243.02,7243.02,-378.0,-375.0,6.0,2.0,8.0,0.0,765000.0,,0.0,,,0.0,,0.0,0.0,0.0,0.0,,0.0,,,0.0,-7.5,0.0,0.0,8356984870.5,184574494165.5,165740920659.0,52031413405.935,1863.0,1706.0,71127.0,70966.0,9141.0,506679.0,,,,,,,128569.0,663598.0,,,,13543323.468492744,,-922981719.0,-296864759.0,-1536999485.0416667,44080.0,30747.0,,,,,,,,158223.06871752357,,,,,,,,3718434.0,,,,,,,,,,,,,,,,437015.0,431807.0,,6432.328501002896,632702.0,626249.0,,,,,,,,,1.0,83747001.50999998,,8594133266.924984,2852719613.4150004,,805594.5899999997,168.0,19303.0,-28190724.0,,-14621426.0,-15907379.0,0.0,0.0,,13500.0,0.0,,0.0,0.0,0.0,-28.0,,-5.0,-6.0,301694005.8449998,4299565346.505004,4828900304.430002,70266047.30999993,4299565346.505004,311593.0,-21536746.0,5013372477.5,224649793.5,1129717361.5,488344642.5,1184513622.5,309670.0,4850.0,875.6777929482448,7158895.0,2564861.5,1580023.5,-5176917.5,1544141.0,103627.0,3400424195.670093,3438575083.035079,-206672640.0,-204952312.0,3623089.0,171320.0,3116124301.769949,8493858000.0,,405412386.6599997,,,177053691.05999908,,410266241.00999904,2991704838.975011,3104681921.8199377,3104840030.129937,,35835.0,,,1021264.0,-1817162.0,813875.0,1734.0,1469187.0,14847064.0,3236276.0,8566168.0,11621542.0,1417620.0,1061168266.3095012,,72188653888.86714,21698354062.237617,,5792665.7475,689.5,94245.0,-277250700.0,,-123922819.0,-218958262.5,-2024646.5,5927729883.907462,18746662500.0,,448398171.0674977,,,309356042.6474986,,459512884.3274993,5712723375.030035,5890979379.892499,5891222562.6375,,80970.0,,,972311.5,-1700460.0,177364.0,6755.0,4278356.0,2482397.0,-9014465.5,921451.5,37582.5,3738443668.312457,3663121308.682458,-260942564.0,-257626505.0,2529364.5,269549.0,3930908182.019953,33290913584.07092,36723004056.38265,1731984599.8575494,48140997408.608215,3992847.5,-247874395.5,103213494079.5,1056400549.5,17292245656.0,3508081760.5,18907004304.5,3676471.5,72020.5,20895.955872257666,89866706.5,,3.4522631578947367,5.296905492054642,293.5066125391922,18.28631168107053,1013.2620650675384,42750.0,0.6234898018587336,0.7818314824680298,0.0,0.0,0.0,0.0,0.0,0.0,1.0,0.0,0.0,1.0,0.0,0.0,0.0,0.0,0.0,0.0,0.0,0.0,1.0,1.0,0.0,0.0,0.0,0.0,0.0,1.0,0.0,0.0,0.0,0.0,0.0,0.0,0.0,0.0,0.0,0.0,0.0,0.0,0.0,0.0,0.0,0.0,0.0,0.0,0.0,0.0,0.0,0.0,0.0,0.0,0.0,0.0,0.0,0.0,0.0,0.0,0.0,0.0,0.0,0.0,0.0,0.0,0.0,0.0,0.0,0.0,0.0,0.0,0.0,0.0,0.0,0.0,0.0,0.0,0.0,0.0,0.0,0.0,0.0,0.0,0.0,0.0,0.0,0.0,0.0,0.0,0.0,0.0,0.0,0.0,0.0,0.0,0.0,0.0,0.0,0.0,0.0,0.0,0.0,0.0,0.0,0.0,0.0,0.0,0.0,1.0,0.0,0.0,0.0,0.0,0.0,0.0,0.0,0.0,0.0,0.0,0.0,0.0,0.0,0.0
105228,0,0.0,0.0,1.0,1.0,1.0,157500.0,382500.0,19660.5,382500.0,0.01885,43.26027397260274,-1955.0,-7665.0,-4901.0,0.0,3.0,2.0,2.0,11.0,,0.733752395859746,0.7380196196295241,0.0144,0.0,0.9667,0.5444,0.0017,0.0,0.069,0.0417,0.0833,0.0318,0.0101,0.0098,0.0077,0.0043,0.0147,0.0,0.9667,0.5622,0.0017,0.0,0.069,0.0417,0.0833,0.0326,0.011,0.0102,0.0078,0.0046,0.0146,0.0,0.9667,0.5505,0.0017,0.0,0.069,0.0417,0.0833,0.0324,0.0103,0.0099,0.0078,0.0044,0.0114,1.0,3.0,0.0,3.0,0.0,-1205.0,0.0,0.0,0.0,0.0,0.0,5.0,1.0,1.0,1.0,1.0,1.0,0.0,0.0,0.0,0.0,0.0,0.0,0.0,0.0,1.0,0.0,0.0,0.0,0.0,0.0,0.0,0.0,0.0,0.0,0.0,0.0,0.0,0.0,0.0,0.0,0.0,0.0,0.0,5.0,0.0,0.0,360000.0,0.0,0.0,0.0,0.0,0.0,-1303.0,-1097.0,-1120.0,-1126.0,228.0,-22.0,7.0,36811.575,62995.5,52110.0,13500.0,922500.0,48.0,-498.0,365243.0,-951.0,182109.5,-171.0,182112.5,15.0,0.5,0.2240927796483352,-1.0,32.0,48.0,32.5,-16.5,0.0,0.0,33.0,6229.575,6229.575,-498.0,-488.0,9.0,5.0,0.0,,,,,,,,,,,,,,,,,,,,,8357004531.0,184574876665.5,165741303159.0,52031570905.935,1863.0,1706.0,71127.0,70966.0,9141.0,506684.0,17828.88160000231,17891.166299999113,17342.250299998002,11308.497300000095,11246.323900000096,11193.730500000063,128570.0,663601.0,4142.702400000115,4140.382400000013,3950.9487000000936,13543366.728766715,-602649790.0,-922986620.0,-296865964.0,-1537007150.0416667,44080.0,30747.0,11360.853999999194,11236.799999998986,10720.84669999729,22914.88900000981,22836.64960000977,22221.51780000833,,158223.80246991946,126257.9828312652,35042.46930002802,34982.576700028454,34428.01080002887,22978.670299995887,22951.733399995464,22598.372499995698,3718445.0,8305.282000000165,8409.945700000073,8133.406400000231,9827.927700000717,9942.967800002154,10303.176799999635,16486.689799999724,16672.148099999697,16268.858299999698,829.265600000177,814.4433000000461,760.3627000000133,3917.829100000123,3901.0743000001617,3733.76120000016,437018.0,431810.0,1264601.0,6432.347351002895,632704.0,626251.0,,16350.994299999797,154370.08109999078,154372.82319999035,154264.53659998722,77697.69079999637,78035.88540000659,78437.87460000662,43.0,83747001.50999998,29321759.385,8594946529.424984,2852719613.4150004,98634031.73999998,805594.5899999997,168.0,19303.0,-28195530.0,12707474.0,-14625155.0,-15911116.0,-21.0,0.0,0.0,360000.0,0.0,0.0,0.0,0.0,0.0,-1675.0,-1097.0,-1338.0,-1338.0,301827318.5474998,4302422842.005004,4832141870.430002,70279547.30999993,4302391344.255004,311692.0,-21540700.0,5014102963.5,224831100.0,1130264714.0,488527434.0,1185060978.0,309755.0,4851.0,875.9018857278933,7161600.0,2565715.0,1580650.0,-5177207.5,1544141.0,103627.0,3400666350.1650906,3438929737.530076,-206681130.0,-204960533.0,3623337.0,171411.0,,,,,,,,,,,,,,,,,,,,,1469192.0,14847292.0,3236276.0,8566200.0,11621575.0,1417627.0,1061168266.3095012,802221061.4099952,72189013888.86714,21698354062.237617,583477279.4969988,5792665.7475,689.5,94245.0,-277252003.0,22021821.5,-123923939.0,-218959388.5,-2024668.5,,,,,,,,,,,,,,,,,,,,,4278404.0,2482429.5,-9014482.0,921451.5,37582.5,3738449897.887457,3663127538.257457,-260943062.0,-257626993.0,2529373.5,269554.0,3930944993.594953,33290976579.57092,36723056166.38265,1731998099.8575494,48141919908.608215,3992895.5,-247874893.5,103213859322.5,1056399598.5,17292427765.5,3508081589.5,18907186417.0,3676486.5,72021.0,20896.17996503732,89866705.5,-45.191576947435095,2.4285714285714284,8.010986495765621,346.5574705976415,19.455252918287933,841.6395714514151,52500.0,-0.2225209339563143,0.9749279121818236,0.0,0.0,0.0,0.0,0.0,0.0,1.0,0.0,0.0,0.0,1.0,0.0,0.0,0.0,0.0,0.0,0.0,0.0,1.0,0.0,1.0,0.0,0.0,0.0,0.0,1.0,0.0,0.0,0.0,0.0,0.0,0.0,0.0,0.0,0.0,0.0,0.0,0.0,0.0,0.0,0.0,1.0,0.0,0.0,0.0,0.0,0.0,0.0,0.0,0.0,0.0,0.0,0.0,0.0,0.0,0.0,0.0,0.0,0.0,0.0,0.0,0.0,0.0,0.0,0.0,0.0,0.0,0.0,0.0,0.0,0.0,0.0,0.0,0.0,0.0,0.0,0.0,0.0,1.0,0.0,0.0,0.0,0.0,0.0,0.0,0.0,0.0,0.0,0.0,0.0,0.0,0.0,0.0,0.0,0.0,0.0,0.0,0.0,0.0,0.0,0.0,0.0,0.0,0.0,0.0,0.0,0.0,0.0,0.0,1.0,1.0,0.0,0.0,0.0,0.0,0.0,0.0,0.0,1.0,0.0
105230,0,0.0,1.0,0.0,1.0,0.0,58500.0,207396.0,10719.0,157500.0,0.031329,63.73424657534247,,-1973.0,-4529.0,,1.0,2.0,2.0,11.0,,0.1571429502491843,,,,,,,,,,,,,,,,,,,,,,,,,,,,,,,,,,,,,,,,,,,,,,0.0,0.0,0.0,0.0,0.0,,,,,,,1.0,0.0,0.0,1.0,0.0,0.0,0.0,0.0,0.0,0.0,0.0,0.0,0.0,1.0,0.0,0.0,0.0,0.0,0.0,0.0,0.0,0.0,0.0,0.0,0.0,0.0,0.0,0.0,0.0,0.0,0.0,0.0,0.0,,,,,,,,,,,,,0.0,,2.0,8124.75,130500.0,130304.25,3600.0,130500.0,18.0,-1338.0,365243.0,-1305.0,181625.0,-795.0,181627.0,13.0,0.0,0.0999968698809511,8.5,28.0,11.0,8.5,-67.5,0.0,0.0,26.0,3685.5,3685.5,-2054.0,-2038.0,7.0,1.0,0.0,,,,,,,,,,,,,,,,,,,,,8357015250.0,184575084061.5,165741460659.0,52031629405.935,,,,,,,,,,,,,128570.0,663602.0,,,,13543430.463013291,,-922991149.0,-296865964.0,-1537009123.0416667,44080.0,30747.0,,,,,,,,158223.95961286972,,,,,,,,3718456.0,,,,,,,,,,,,,,,,437018.0,431810.0,,6432.378680002896,632706.0,626253.0,,,,,,,,,,,,,,,,,,,,,,,,,,,,,,,,,,,301913044.15499985,4304627684.505004,4834437320.430002,70283147.30999993,4304627684.505004,311869.0,-21551258.5,5015926486.5,224822098.5,1130804733.5,488889672.5,1185968710.5,309875.0,4853.0,876.001882597774,7162064.5,2566857.0,1581525.0,-5179611.0,1544141.0,103627.0,3402578439.3375783,3442056851.317562,-206855645.0,-205134244.0,3627692.5,171488.5,,,,,,,,,,,,,,,,,,,,,1469192.0,14847292.0,3236276.0,8566228.0,11621601.0,1417629.0,,,,,,,,,,,,,,,,,,,,,,,,,,,,,,,,,,4278415.0,2482438.0,-9014549.5,921451.5,37582.5,3738453583.387457,3663131223.757457,-260945116.0,-257629031.0,2529380.5,269555.0,3930953118.344953,33291107079.57092,36723186470.63265,1732001699.8575494,48142050408.608215,3992913.5,-247876231.5,103214224565.5,1056398293.5,17292609390.5,3508080794.5,18907368044.0,3676499.5,72021.0,20896.2799619072,89866714.0,,3.5452307692307694,5.4575986565911,347.8359384884349,19.348446683459283,1233.1586717734606,58500.0,1.0,0.0,0.0,0.0,0.0,0.0,1.0,0.0,0.0,0.0,0.0,1.0,0.0,0.0,0.0,0.0,0.0,0.0,0.0,1.0,0.0,0.0,0.0,0.0,1.0,0.0,0.0,1.0,0.0,0.0,0.0,0.0,0.0,0.0,0.0,0.0,0.0,0.0,0.0,0.0,0.0,0.0,0.0,0.0,0.0,0.0,0.0,0.0,0.0,0.0,0.0,0.0,0.0,0.0,0.0,0.0,0.0,0.0,0.0,0.0,0.0,0.0,0.0,0.0,0.0,0.0,0.0,0.0,0.0,0.0,0.0,0.0,0.0,0.0,0.0,0.0,0.0,0.0,0.0,0.0,0.0,0.0,0.0,0.0,0.0,0.0,0.0,0.0,0.0,0.0,0.0,0.0,0.0,0.0,0.0,0.0,0.0,0.0,0.0,0.0,0.0,0.0,0.0,0.0,0.0,0.0,0.0,1.0,0.0,0.0,0.0,0.0,0.0,0.0,0.0,0.0,0.0,0.0,0.0,0.0,0.0,0.0
105231,0,0.0,1.0,0.0,0.0,0.0,180000.0,790830.0,62613.0,675000.0,0.015221,24.246575342465757,-280.0,-3129.0,-1544.0,,1.0,2.0,2.0,12.0,0.1192327356653773,0.6360712584004985,,,,,,,,,,,,,,,,,,,,,,,,,,,,,,,,,,,,,,,,,,,,,,0.0,0.0,0.0,0.0,-681.0,,,,,,,1.0,1.0,0.0,1.0,0.0,0.0,1.0,1.0,1.0,1.0,0.0,0.0,0.0,0.0,0.0,1.0,0.0,0.0,0.0,0.0,0.0,0.0,0.0,0.0,0.0,0.0,0.0,0.0,0.0,0.0,0.0,0.0,0.0,,,,,,,,,,,,,0.0,,1.0,7308.765,90515.025,72414.0,18101.025,90515.025,12.0,-405.0,365243.0,-370.0,-310.0,-40.0,-306.0,14.0,0.0,0.2177943581491278,25.0,5.0,12.0,10.5,-12.0,0.0,0.0,3.0,7308.765,7308.765,-389.0,-340.0,2.0,1.0,0.0,,,,,,,,,,,,,,,,,,,,,8357077863.0,184575874891.5,165742135659.0,52031809405.935,,,,,,,,,,,,,128570.0,663603.0,,,,13543454.709588636,-602650070.0,-922992693.0,-296866645.0,-1537012252.0416667,44080.0,30747.0,,,,,,,67567.39714635881,158224.59568412811,,,,,,,,3718468.0,,,,,,,,,,,,,,,,437018.0,431810.0,,6432.393901002895,632708.0,626255.0,,,,,,,,,,,,,,,,,,,,,,,,,,,,,,,,,,,301926634.91999984,4304830699.530004,4834622234.430002,70301248.33499993,4304830699.530004,311893.0,-21551837.0,5016474351.0,224821570.0,1130987045.0,488889819.0,1186151026.0,309896.0,4853.0,876.2196769559233,7162089.0,2567176.0,1581764.5,-5179948.0,1544141.0,103627.0,3402788139.900077,3442266551.880062,-206862643.0,-205141015.0,3627776.0,171504.0,,,,,,,,,,,,,,,,,,,,,1469192.0,14847292.0,3236276.0,8566233.0,11621604.0,1417630.0,,,,,,,,,,,,,,,,,,,,,,,,,,,,,,,,,,4278427.0,2482448.5,-9014561.5,921451.5,37582.5,3738460892.152457,3663138532.522457,-260945505.0,-257629371.0,2529382.5,269556.0,3930960427.109953,33291197594.59592,36723258884.63265,1732019800.8825498,48142140923.63322,3992925.5,-247876636.5,103214589808.5,1056397923.5,17292609080.5,3508080754.5,18907367738.0,3676513.5,72021.0,20896.497756265344,89866739.0,-11.548022598870055,4.3935,2.8748023573379333,69.70411195189234,12.630444156964211,306.24501586063906,180000.0,-0.9009688679024191,0.4338837391175582,0.0,0.0,0.0,0.0,0.0,0.0,1.0,0.0,0.0,0.0,0.0,0.0,0.0,1.0,0.0,0.0,0.0,0.0,1.0,0.0,0.0,0.0,1.0,0.0,0.0,1.0,0.0,0.0,0.0,0.0,0.0,0.0,0.0,0.0,0.0,0.0,0.0,0.0,0.0,0.0,0.0,0.0,0.0,0.0,0.0,0.0,1.0,0.0,0.0,0.0,0.0,0.0,0.0,0.0,0.0,0.0,0.0,0.0,0.0,0.0,0.0,0.0,0.0,0.0,0.0,0.0,0.0,0.0,0.0,0.0,0.0,0.0,0.0,0.0,0.0,0.0,0.0,0.0,0.0,0.0,0.0,0.0,0.0,0.0,0.0,0.0,0.0,0.0,1.0,0.0,0.0,0.0,0.0,0.0,0.0,0.0,0.0,0.0,0.0,0.0,0.0,0.0,0.0,0.0,0.0,0.0,0.0,0.0,0.0,0.0,0.0,0.0,0.0,0.0,0.0,0.0,0.0,0.0,0.0,0.0
105239,0,0.0,1.0,0.0,0.0,0.0,360000.0,1350000.0,46926.0,1350000.0,0.006629,44.57534246575342,-9256.0,-1479.0,-863.0,,2.0,2.0,2.0,11.0,0.3505013134066844,0.5022159617410833,0.6023863442690867,0.1216,0.1066,0.9881,0.8708,0.0279,0.16,0.1379,0.3333,0.0417,0.0973,0.0614,0.148,0.0,0.0515,0.0767,0.0759,0.9856,0.8759,0.0281,0.0806,0.069,0.3333,0.0417,0.0577,0.067,0.1011,0.0,0.0011,0.1228,0.1066,0.9881,0.8725,0.028,0.16,0.1379,0.3333,0.0417,0.0989,0.0624,0.1506,0.0,0.0525,0.1826,1.0,0.0,0.0,0.0,0.0,-2294.0,0.0,0.0,0.0,0.0,1.0,0.0,1.0,1.0,0.0,1.0,1.0,1.0,0.0,0.0,0.0,0.0,0.0,0.0,0.0,1.0,0.0,0.0,0.0,0.0,0.0,0.0,0.0,0.0,0.0,0.0,0.0,0.0,0.0,0.0,0.0,0.0,0.0,0.0,10.0,0.0,7119.8775,652500.0,0.0,45.0,0.0,0.0,0.0,-1383.0,-1239.0,-981.0,-1269.5,501.0,-26.0,3.0,10251.495,94711.5,92272.5,9472.5,94711.5,10.0,-2468.0,365243.0,-2437.0,-2167.0,-2167.0,-2159.0,11.0,1.0,0.101394797153311,47.0,30.0,10.0,4.5,-75.0,0.0,0.0,31.0,10251.495,10251.495,-2232.0,-2227.0,6.0,1.0,0.0,,,,,,,,,,,,,,,,,,,,,8357124789.0,184577224891.5,165743485659.0,52032169405.935,1863.0,1706.0,71127.0,70967.0,9141.0,506684.0,17829.00320000231,17891.289099999114,17342.326999998004,11308.603900000096,11246.430500000097,11193.806400000063,128570.0,663605.0,4142.730300000115,4140.4104000000125,3950.9768000000936,13543499.2849311,-602659326.0,-922993556.0,-296868939.0,-1537013731.0416667,44080.0,30747.0,11361.013999999192,11236.959999998986,10720.927299997287,22915.02690000981,22836.78750000977,22221.58680000833,67567.74764767222,158225.09790008984,126258.58521760948,35042.802600028015,34982.91000002845,34428.344100028866,22978.71199999589,22951.775099995462,22598.4141999957,3718479.0,8305.379300000164,8410.044600000074,8133.464100000231,9827.989100000716,9943.030200002157,10303.243799999636,16486.837799999725,16672.298699999694,16268.959399999698,829.265600000177,814.4433000000461,760.3627000000133,3917.880600000123,3901.126800000162,3733.76230000016,437018.0,431810.0,,6432.400530002896,632710.0,626257.0,,16351.176899999797,154371.06919999074,154373.81129999034,154265.5221999872,77698.56159999636,78036.75790000659,78438.75050000662,46.0,83906382.50999998,29357290.62,8620394512.139984,2857577586.3,99417403.30499998,805594.5899999997,168.0,19303.0,-28278739.5,12744112.0,-14666831.5,-15958384.5,-22.5,0.0,14239.755,630000.0,0.0,0.0,0.0,0.0,0.0,-2077.0,-1653.0,-1295.0,-1682.0,302941776.28499985,4317606766.080004,4848685881.930002,70412640.88499993,4317606766.080004,312479.0,-21608536.0,5024509361.0,225155363.0,1132421728.0,489596012.0,1187585842.0,310704.0,4862.0,878.0993296167682,7170530.0,2571276.0,1583881.0,-5191701.0,1544153.0,103639.0,3406756855.6800704,3446494631.145056,-207189323.0,-205464817.0,3629942.0,171726.0,,,,,,,,,,,,,,,,,,,,,1469202.0,14847793.0,3236276.0,8566263.0,11621635.0,1417633.0,1061168266.3095012,802228181.2874953,72189666388.86714,21698354062.237617,583477324.4969988,5792665.7475,689.5,94245.0,-277253386.0,22020582.5,-123924920.0,-218960658.0,-2024694.5,,,,,,,,,,,,,,,,,,,,,4278437.0,2482453.0,-9014636.5,921451.5,37582.5,3738471143.647457,3663148784.017457,-260947737.0,-257631598.0,2529388.5,269557.0,3930970678.604953,33291292306.09592,36723351157.13265,1732029273.3825498,48142235635.13322,3992935.5,-247879104.5,103214955051.5,1056395486.5,17292606913.5,3508078587.5,18907365579.0,3676524.5,72022.0,20896.5991510625,89866786.0,-207.6484326982176,3.75,7.671653241273495,341.96657050827326,28.7686996547756,1282.3746394060247,180000.0,0.6234898018587336,0.7818314824680298,0.0,0.0,0.0,0.0,0.0,0.0,1.0,0.0,0.0,0.0,0.0,0.0,0.0,1.0,0.0,1.0,0.0,0.0,0.0,0.0,1.0,0.0,0.0,0.0,0.0,1.0,0.0,0.0,0.0,0.0,0.0,0.0,0.0,0.0,0.0,0.0,0.0,0.0,1.0,0.0,0.0,0.0,0.0,0.0,0.0,0.0,0.0,0.0,0.0,0.0,0.0,0.0,0.0,0.0,0.0,0.0,0.0,0.0,0.0,0.0,0.0,0.0,0.0,0.0,0.0,0.0,0.0,0.0,0.0,0.0,0.0,0.0,0.0,0.0,0.0,0.0,0.0,0.0,0.0,0.0,0.0,1.0,0.0,0.0,0.0,0.0,0.0,0.0,0.0,0.0,0.0,0.0,0.0,0.0,0.0,0.0,0.0,0.0,0.0,0.0,0.0,0.0,0.0,0.0,0.0,0.0,0.0,0.0,1.0,0.0,1.0,0.0,0.0,0.0,0.0,0.0,0.0,1.0,0.0,0.0
105242,0,0.0,0.0,0.0,1.0,0.0,99000.0,149256.0,17712.0,135000.0,0.006233,35.07123287671233,-1492.0,-4952.0,-2904.0,,1.0,2.0,2.0,10.0,,0.6354737318890222,,,,,,,,,,,,,,,,,,,,,,,,,,,,,,,,,,,,,,,,,,,,,,6.0,1.0,6.0,1.0,-951.0,,,,,,,1.0,1.0,0.0,1.0,0.0,0.0,0.0,0.0,0.0,0.0,0.0,0.0,0.0,1.0,0.0,0.0,0.0,0.0,0.0,0.0,0.0,0.0,0.0,0.0,0.0,0.0,0.0,0.0,0.0,0.0,0.0,0.0,0.0,,,,,,,,,,,,,0.0,,3.0,2871.81,0.0,0.0,2250.0,21595.5,10.0,-498.0,365243.0,-914.0,-644.0,-644.0,-638.0,12.0,0.0,0.1051855233813896,4.0,12.0,10.0,4.5,-26.5,0.0,0.0,11.0,2871.81,2871.81,-783.0,-764.0,6.0,1.0,0.0,,,,,,,,,,,,,,,,,,,,,8357142501.0,184577374147.5,165743620659.0,52032268405.935,,,,,,,,,,,,,128570.0,663606.0,,,,13543534.356163977,-602660818.0,-922996460.0,-296869890.0,-1537018683.0416667,44081.0,30748.0,,,,,,,,158225.7333738217,,,,,,,,3718489.0,,,,,,,,,,,,,,,,437024.0,431816.0,,6432.406763002896,632712.0,626259.0,,,,,,,,,,,,,,,,,,,,,,,,,,,,,,,,,,,303075997.3799998,4319074715.580004,4850273351.430002,70459067.38499993,4319096311.080004,312639.0,-21632074.0,5029621821.0,225134546.0,1133135668.0,489945713.0,1188299868.0,310952.0,4868.0,879.4831962011366,7172482.0,2573310.0,1584972.0,-5197849.0,1544153.0,103639.0,3409045835.220069,3448758088.980055,-207385288.0,-205658716.0,3632488.0,171867.0,,,,,,,,,,,,,,,,,,,,,1469202.0,14847793.0,3236276.0,8566275.0,11621646.0,1417636.0,,,,,,,,,,,,,,,,,,,,,,,,,,,,,,,,,,4278447.0,2482457.5,-9014663.0,921451.5,37582.5,3738474015.457457,3663151655.827457,-260948520.0,-257632362.0,2529394.5,269558.0,3930973550.414953,33291292306.09592,36723351157.13265,1732031523.3825498,48142257230.63322,3992945.5,-247879602.5,103215320294.5,1056394572.5,17292606269.5,3508077943.5,18907364941.0,3676536.5,72022.0,20896.70433658588,89866790.0,-42.54198890711663,1.5076363636363637,5.589430894308944,196.02823254259943,8.426829268292684,295.53929168058806,99000.0,1.0,0.0,0.0,0.0,0.0,0.0,0.0,0.0,1.0,0.0,0.0,0.0,0.0,0.0,0.0,1.0,0.0,0.0,0.0,1.0,0.0,0.0,0.0,0.0,1.0,0.0,0.0,0.0,1.0,0.0,0.0,0.0,0.0,1.0,0.0,0.0,0.0,0.0,0.0,0.0,0.0,0.0,0.0,0.0,0.0,0.0,0.0,0.0,0.0,0.0,0.0,0.0,0.0,0.0,0.0,0.0,0.0,0.0,0.0,0.0,0.0,0.0,0.0,0.0,0.0,0.0,0.0,0.0,0.0,0.0,0.0,0.0,0.0,0.0,0.0,0.0,0.0,0.0,0.0,0.0,0.0,0.0,0.0,0.0,0.0,0.0,0.0,0.0,0.0,0.0,0.0,0.0,0.0,0.0,0.0,0.0,0.0,0.0,0.0,0.0,0.0,0.0,1.0,0.0,0.0,0.0,0.0,0.0,0.0,0.0,0.0,0.0,0.0,0.0,0.0,0.0,0.0,0.0,0.0,0.0,0.0,0.0
105244,0,0.0,0.0,0.0,0.0,0.0,121500.0,945000.0,33943.5,945000.0,0.0060079999999999,53.594520547945216,,-10171.0,-2978.0,,2.0,2.0,2.0,17.0,,0.5822621692917371,0.4794489811780563,,,,,,,,,,,,,,,,,,,,,,,,,,,,,,,,,,,,,,,,,,,,,0.0,0.0,0.0,0.0,-919.0,0.0,0.0,0.0,0.0,1.0,1.0,1.0,0.0,0.0,1.0,0.0,0.0,0.0,0.0,0.0,0.0,0.0,0.0,0.0,1.0,0.0,0.0,0.0,0.0,0.0,0.0,0.0,0.0,0.0,0.0,0.0,0.0,0.0,0.0,0.0,0.0,0.0,0.0,9.0,0.0,0.0,66015.0,0.0,0.0,0.0,0.0,0.0,-969.0,-604.0,-597.0,-949.0,385.0,-21.0,1.0,14488.38,214420.5,214420.5,0.0,214420.5,16.0,-919.0,365243.0,-888.0,-438.0,-438.0,-432.0,17.0,0.0,0.0,1.0,17.0,16.0,8.0,-22.0,0.0,0.0,19.0,14488.38,14488.38,-619.0,-618.0,10.0,1.0,0.0,,,,,,,,,,,,,,,,,,,,,8357176444.5,184578319147.5,165744565659.0,52032389905.935,1863.0,1706.0,71127.0,70968.0,9141.0,506685.0,,,,,,,128570.0,663608.0,,,,13543587.950684523,,-922999438.0,-296870809.0,-1537028854.0416667,44081.0,30748.0,,,,,,,,158226.315635991,126259.06466659064,,,,,,,3718506.0,,,,,,,,,,,,,,,,437024.0,431816.0,,6432.412771002895,632714.0,626261.0,,,,,,,,,32.0,84000830.75999998,29375110.8,8623983049.064985,2857955104.8450003,99866503.30499998,805594.5899999997,169.0,19303.0,-28312469.0,12752842.0,-14684231.0,-15982516.0,-15.5,0.0,0.0,54873.0,0.0,0.0,0.0,0.0,0.0,-1540.0,-1234.0,-1234.0,-1234.0,303153152.5799998,4320364371.480003,4851624606.930002,70474435.78499994,4320364371.480003,312707.0,-21638850.0,5031082793.0,225128844.0,1133497063.0,489941931.0,1188661280.0,311026.0,4869.0,879.6846302185534,7173466.0,2574563.0,1585684.0,-5200001.0,1544153.0,103639.0,3410627593.050064,3450322468.080049,-207448635.0,-205721572.0,3633111.0,171931.0,,,,,,,,,,,,,,,,,,,,,1469211.0,14848178.0,3236276.0,8566292.0,11621665.0,1417637.0,1061168266.3095012,802228181.2874953,72189732403.86714,21698354062.237617,583477324.4969988,5792665.7475,689.5,94245.0,-277254355.0,22019978.5,-123925517.0,-218961607.0,-2024715.5,,,,,,,,,,,,,,,,,,,,,4278463.0,2482465.5,-9014685.0,921451.5,37582.5,3738488503.837457,3663166144.207457,-260949139.0,-257632980.0,2529404.5,269559.0,3930988038.794953,33291506726.59592,36723565577.63265,1732031523.3825498,48142471651.13322,3992961.5,-247880521.5,103215685537.5,1056393684.5,17292605831.5,3508077505.5,18907364509.0,3676553.5,72022.0,20896.70433658588,89866791.0,,7.777777777777778,3.5794776614079287,191.84038907523805,27.84038181095055,1492.0919150296293,60750.0,-0.9009688679024191,0.4338837391175582,0.0,0.0,0.0,0.0,0.0,0.0,1.0,0.0,0.0,1.0,0.0,0.0,0.0,0.0,0.0,0.0,0.0,0.0,1.0,1.0,0.0,0.0,0.0,0.0,0.0,1.0,0.0,0.0,0.0,0.0,0.0,0.0,0.0,0.0,0.0,0.0,0.0,0.0,0.0,0.0,0.0,0.0,0.0,0.0,0.0,0.0,0.0,0.0,0.0,0.0,0.0,0.0,0.0,0.0,0.0,0.0,0.0,0.0,0.0,0.0,0.0,0.0,0.0,0.0,0.0,0.0,0.0,0.0,0.0,0.0,0.0,0.0,0.0,0.0,0.0,0.0,0.0,0.0,0.0,0.0,0.0,0.0,0.0,0.0,0.0,0.0,0.0,0.0,0.0,0.0,0.0,0.0,0.0,0.0,0.0,0.0,0.0,0.0,0.0,0.0,0.0,0.0,0.0,0.0,0.0,1.0,0.0,0.0,0.0,0.0,0.0,0.0,0.0,0.0,0.0,0.0,0.0,0.0,0.0,0.0
105245,0,0.0,1.0,0.0,1.0,0.0,171000.0,332946.0,14796.0,238500.0,0.0105,33.52876712328767,-3108.0,-6374.0,-4353.0,,2.0,3.0,3.0,10.0,,0.4870154596797552,0.5744466170995097,0.0412,0.0368,0.9757,0.6668,0.0206,0.0,0.069,0.1667,0.2083,0.0454,0.0336,0.0235,0.0,0.0,0.042,0.0382,0.9757,0.6798,0.0207,0.0,0.069,0.1667,0.2083,0.0465,0.0367,0.0245,0.0,0.0,0.0416,0.0368,0.9757,0.6713,0.0207,0.0,0.069,0.1667,0.2083,0.0462,0.0342,0.024,0.0,0.0,0.0281,1.0,0.0,0.0,0.0,0.0,0.0,0.0,0.0,0.0,0.0,0.0,1.0,1.0,1.0,0.0,1.0,0.0,0.0,0.0,0.0,0.0,0.0,0.0,0.0,0.0,1.0,0.0,0.0,0.0,0.0,0.0,0.0,0.0,0.0,0.0,0.0,0.0,0.0,0.0,0.0,0.0,0.0,0.0,0.0,14.0,0.0,0.0,91488.15,0.0,0.0,0.0,0.0,0.0,-1238.5,-643.0,-918.0,-1144.0,604.0,-22.0,4.0,6069.69,51977.25,49401.0,3600.0,51977.25,11.0,-2013.0,365243.0,-1965.5,-1755.5,-1681.0,-1751.5,11.5,1.0,0.0896278908829057,62.5,48.0,10.0,5.5,-79.0,0.0,0.0,43.0,11451.375,11451.375,-2394.0,-2389.0,5.0,1.0,0.0,,,,,,,,,,,,,,,,,,,,,8357191240.5,184578652093.5,165744804159.0,52032560905.935,1863.0,1706.0,71127.0,70968.0,9141.0,506686.0,17829.04440000231,17891.330699999115,17342.368999998,11308.640700000096,11246.467300000097,11193.844600000066,128570.0,663610.0,4142.750900000115,4140.4311000000125,3950.997500000093,13543621.479451649,-602663926.0,-923003791.0,-296870809.0,-1537035228.0416667,44081.0,30748.0,11361.013999999192,11236.959999998986,10720.927299997287,22915.09590000981,22836.85650000977,22221.65580000833,,158226.80265145068,126259.63911320776,35042.96930002802,34983.076700028454,34428.51080002887,22978.920299995887,22951.983399995464,22598.622499995698,3718516.0,8305.424700000165,8410.090800000075,8133.51060000023,9828.022700000718,9943.064400002157,10303.280499999635,16486.861299999724,16672.3226999997,16268.983899999695,829.265600000177,814.4433000000461,760.3627000000133,3917.880600000123,3901.126800000162,3733.76230000016,437024.0,431816.0,,6432.423271002896,632717.0,626264.0,,16351.204999999794,154372.04489999078,154374.78699999035,154266.4978999872,77699.22839999638,78037.42920000659,78439.43030000661,41.0,84061547.00999998,29375110.8,8626109337.134985,2858620418.46,99866503.30499998,805594.5899999997,169.0,19303.0,-28330274.5,12745875.0,-14694402.5,-15993167.0,-20.0,0.0,0.0,91818.0,0.0,0.0,0.0,0.0,0.0,-1363.0,-1011.0,-918.0,-1144.0,303174072.6974998,4320581453.730003,4851881644.680002,70484056.78499994,4320581453.730003,312747.0,-21643154.5,5031995900.5,225124632.5,1133493436.5,489938844.5,1188657666.0,311054.0,4871.0,879.8756429028937,7173646.0,2575051.5,1585951.0,-5201651.5,1544183.0,103639.0,3411128950.380065,3450794867.19005,-207495337.0,-205768082.0,3633316.0,171963.0,,,,,,,,,,,,,,,,,,,,,1469225.0,14848782.0,3236276.0,8566340.0,11621708.0,1417641.0,1061168266.3095012,802228181.2874953,72189823892.01714,21698354062.237617,583477324.4969988,5792665.7475,689.5,94245.0,-277255593.5,22019335.5,-123926435.0,-218962751.0,-2024737.5,,,,,,,,,,,,,,,,,,,,,4278473.0,2482471.0,-9014764.0,921451.5,37582.5,3738499955.212457,3663177595.582457,-260951533.0,-257635369.0,2529409.5,269560.0,3930994108.484953,33291558703.84592,36723614978.63265,1732035123.3825498,48142523628.38322,3992972.5,-247882534.5,103216050780.5,1056391719.0,17292604076.0,3508075824.5,18907362757.5,3676565.0,72023.0,20896.793964476765,89866853.5,-92.69651903905869,1.947052631578948,11.557177615571776,387.4979168749792,22.50243309002433,754.4788387827882,85500.0,-0.9009688679024191,-0.433883739117558,0.0,0.0,0.0,0.0,0.0,0.0,1.0,0.0,1.0,0.0,0.0,0.0,0.0,0.0,0.0,0.0,0.0,0.0,1.0,1.0,0.0,0.0,0.0,0.0,0.0,1.0,0.0,0.0,0.0,0.0,0.0,0.0,0.0,0.0,0.0,0.0,0.0,0.0,0.0,0.0,0.0,0.0,0.0,0.0,0.0,0.0,0.0,0.0,0.0,0.0,0.0,0.0,0.0,0.0,0.0,0.0,0.0,0.0,0.0,0.0,0.0,0.0,0.0,0.0,0.0,0.0,0.0,0.0,0.0,0.0,0.0,0.0,0.0,0.0,0.0,0.0,0.0,0.0,0.0,1.0,0.0,0.0,0.0,0.0,0.0,0.0,0.0,0.0,0.0,0.0,0.0,0.0,0.0,0.0,0.0,0.0,0.0,0.0,0.0,0.0,0.0,0.0,0.0,0.0,0.0,0.0,0.0,0.0,0.0,0.0,1.0,0.0,0.0,0.0,0.0,0.0,0.0,0.0,1.0,0.0
105248,0,0.0,1.0,1.0,1.0,0.0,315000.0,1800000.0,56002.5,1800000.0,0.072508,35.81095890410959,-1969.0,-7208.0,-4857.0,12.0,2.0,1.0,1.0,17.0,0.4278491834527169,0.6209907738244201,0.324891229465852,0.7773,0.3927,0.9796,,,0.96,0.4138,0.625,,0.109,,0.9471,,0.2729,0.792,0.4075,0.9796,,,0.9667,0.4138,0.625,,0.1115,,0.9868,,0.289,0.7848,0.3927,0.9796,,,0.96,0.4138,0.625,,0.1109,,0.9641,,0.2787,0.8043,1.0,0.0,0.0,0.0,0.0,-379.0,0.0,0.0,0.0,0.0,0.0,3.0,1.0,1.0,0.0,1.0,1.0,1.0,0.0,0.0,0.0,0.0,0.0,0.0,0.0,1.0,0.0,0.0,0.0,0.0,0.0,0.0,0.0,0.0,0.0,0.0,0.0,0.0,0.0,0.0,0.0,0.0,0.0,0.0,5.0,19055.25,0.0,451336.5,454180.5,0.0,0.0,0.0,0.0,-1398.0,-2.0,-16.0,-1867.0,227.0,-30.0,1.0,49563.9,522000.0,522000.0,0.0,522000.0,12.0,-379.0,365243.0,-320.0,-20.0,10.0,-17.0,17.0,0.0,0.0,88.0,12.0,12.0,7.0,-6.5,0.0,0.0,11.0,49563.9,49563.9,-205.0,-170.0,6.0,1.0,0.0,,,,,,,,,,,,,,,,,,,,,8357247243.0,184580452093.5,165746604159.0,52032875905.935,1863.0,1706.0,71127.0,70968.0,9141.0,506689.0,17829.82170000231,17892.115499999116,17343.160999998006,11309.033400000097,11246.860000000095,11194.252100000063,128570.0,663612.0,,,,13543657.290410552,-602665895.0,-923008648.0,-296871188.0,-1537042436.0416667,44081.0,30748.0,11361.973999999193,11237.919999998989,10721.89399999729,22915.50970000981,22837.270300009764,22222.06960000833,67568.17549685568,158227.42364222454,126259.96400443722,35043.59430002802,34983.701700028454,34429.13580002887,,,,3718533.0,8305.533700000165,8410.201700000074,8133.62210000023,,,,16487.808399999725,16673.2867999997,16269.970699999698,,,,3918.153500000123,3901.405500000161,3734.051300000161,437024.0,431816.0,1264613.0,6432.495779002897,632718.0,626265.0,,16352.009299999794,154373.02449999074,154375.76659999034,154267.4774999872,,,,46.0,84123595.25999998,29375110.8,8630249607.494986,2860370625.375,99911143.30499998,805594.5899999997,169.0,19303.0,-28352701.0,12734393.0,-14703968.0,-16007085.0,-22.5,0.0,0.0,451336.5,454180.5,0.0,0.0,0.0,0.0,-2168.0,-24.0,-20.0,-1867.0,303248432.6099997,4321300092.480003,4852609818.930002,70486756.78499994,4321300092.480003,312809.0,-21649525.0,5034004737.0,225118589.0,1133853933.0,489934496.0,1189018188.0,311177.0,4872.0,879.9254564831235,7176281.0,2575675.0,1586298.0,-5204070.5,1544183.0,103639.0,3411808302.5100703,3451467081.0600557,-207563135.0,-205834646.0,3633614.0,172022.0,,,,,,,,,,,,,,,,,,,,,1469230.0,14849009.0,3236276.0,8566352.0,11621719.0,1417642.0,1061187321.5595012,802228181.2874953,72190275228.51714,21698808242.737617,583477324.4969988,5792665.7475,689.5,94245.0,-277256991.5,22019333.5,-123926451.0,-218964618.0,-2024767.5,,,,,,,,,,,,,,,,,,,,,4278485.0,2482478.0,-9014770.5,921451.5,37582.5,3738549519.112457,3663227159.482457,-260951738.0,-257635539.0,2529415.5,269561.0,3931043672.384953,33292080703.84592,36724136978.63265,1732035123.3825498,48143045628.38322,3992984.5,-247882913.5,103216416023.5,1056391399.0,17292604056.0,3508075834.5,18907362740.5,3676582.0,72023.0,20896.793964476765,89866941.5,-54.98316884706602,5.7142857142857135,5.624748895138611,201.42765152974457,32.141422257934906,1151.0151515985406,157500.0,-0.2225209339563143,0.9749279121818236,0.0,0.0,0.0,0.0,0.0,0.0,1.0,0.0,1.0,0.0,0.0,0.0,0.0,0.0,0.0,1.0,0.0,0.0,0.0,0.0,1.0,0.0,0.0,0.0,0.0,1.0,0.0,0.0,0.0,0.0,0.0,0.0,0.0,0.0,0.0,0.0,0.0,0.0,0.0,0.0,1.0,0.0,0.0,0.0,0.0,0.0,0.0,0.0,0.0,0.0,0.0,0.0,0.0,1.0,0.0,0.0,0.0,0.0,0.0,0.0,0.0,0.0,0.0,0.0,0.0,0.0,0.0,0.0,0.0,0.0,0.0,0.0,0.0,0.0,0.0,0.0,0.0,0.0,0.0,0.0,0.0,0.0,0.0,0.0,0.0,0.0,0.0,0.0,0.0,0.0,0.0,0.0,0.0,0.0,0.0,0.0,0.0,0.0,0.0,0.0,0.0,0.0,0.0,0.0,0.0,0.0,0.0,0.0,0.0,0.0,1.0,0.0,0.0,0.0,0.0,0.0,0.0,1.0,0.0,0.0
105249,0,0.0,1.0,1.0,1.0,1.0,157500.0,499221.0,25618.5,373500.0,0.009549,46.22739726027398,-221.0,-10102.0,-55.0,2.0,3.0,2.0,2.0,14.0,0.7651507652727956,0.6096974426080729,,0.0825,0.079,0.9767,,,,0.1379,0.1667,,0.0767,,0.0703,,,0.084,0.0819999999999999,0.9767,,,,0.1379,0.1667,,0.0785,,0.0733,,,0.0833,0.079,0.9767,,,,0.1379,0.1667,,0.0781,,0.0716,,,0.0588,1.0,1.0,0.0,1.0,0.0,-1273.0,0.0,0.0,0.0,0.0,0.0,4.0,1.0,1.0,0.0,1.0,0.0,0.0,0.0,0.0,0.0,0.0,0.0,0.0,0.0,0.0,0.0,0.0,0.0,0.0,1.0,0.0,0.0,0.0,0.0,0.0,0.0,0.0,0.0,0.0,0.0,0.0,0.0,0.0,1.0,,0.0,1472616.0,,,0.0,0.0,0.0,-776.0,1050.0,-499.0,-499.0,26.0,-12.5,2.0,10615.005,136566.0,160233.75,0.0,136566.0,18.0,-1167.5,365243.0,-1135.5,-865.5,-625.5,-860.5,12.5,0.5,0.0,1249.5,22.0,18.0,11.5,-29.5,0.0,0.0,20.0,9336.42,9336.42,-883.0,-867.0,6.5,1.0,0.0,,,,,,,,,,,,,,,,,,,,,8357272861.5,184580951314.5,165746977659.0,52033033405.935,1863.0,1706.0,71127.0,70968.0,9141.0,506693.0,17829.90420000231,17892.198799999114,17343.244999998,11309.112400000096,11246.939000000097,11194.334100000066,128571.0,663615.0,,,,13543703.517807811,-602666116.0,-923008703.0,-296872461.0,-1537052538.0416667,44081.0,30748.0,,,,22915.64760000981,22837.40820000977,22222.20750000833,67568.94064762097,158228.03333966713,,35043.76100002802,34983.868400028456,34429.30250002887,,,,3718547.0,8305.610400000165,8410.279800000075,8133.700600000231,,,,16487.878699999725,16673.3583999997,16270.043999999698,,,,,,,437025.0,431817.0,1264615.0,6432.505328002897,632720.0,626267.0,,16352.068099999797,154374.00119999074,154376.74329999034,154268.4541999872,,,,26.0,,29375110.8,8633693223.494986,,,805594.5899999997,169.0,19303.0,-28355138.0,12737049.0,-14704485.0,-16007584.0,-12.5,,0.0,1472616.0,,,0.0,0.0,0.0,-776.0,1050.0,-499.0,-499.0,303264994.4099997,4321516974.480003,4852860705.180002,70486756.78499994,4321516974.480003,312836.0,-21651329.0,5034552601.5,225116834.0,1133852493.0,489933506.0,1189016755.5,311197.5,4872.5,879.9254564831235,7178780.5,2575926.0,1586442.0,-5204457.5,1544183.0,103639.0,3412310201.280072,3451968979.830056,-207574246.5,-205845390.0,3633713.5,172038.5,,,,,,,,,,,,,,,,,,,,,1469231.0,14849035.0,3236276.0,8566374.0,11621739.0,1417644.0,,802228181.2874953,72191747844.51714,,,5792665.7475,689.5,94245.0,-277257767.5,22020383.5,-123926950.0,-218965117.0,-2024780.0,,,,,,,,,,,,,,,,,,,,,4278503.0,2482489.5,-9014800.0,921451.5,37582.5,3738558855.532457,3663236495.902457,-260952621.0,-257636406.0,2529422.0,269562.0,3931054287.389953,33292217269.84592,36724297212.38265,1732035123.3825498,48143182194.38322,3993002.5,-247884081.0,103216781266.5,1056390263.5,17292603190.5,3508075209.0,18907361880.0,3676594.5,72023.5,20896.793964476765,89868191.0,-4.780714751377942,3.1696571428571434,6.1479009309678565,284.20145865265926,19.48673809942034,900.8211834288204,52500.0,-0.2225209339563143,0.9749279121818236,0.0,0.0,0.0,0.0,0.0,0.0,1.0,0.0,1.0,0.0,0.0,0.0,0.0,0.0,0.0,0.0,0.0,0.0,1.0,0.0,1.0,0.0,0.0,0.0,0.0,1.0,0.0,0.0,0.0,0.0,0.0,0.0,0.0,0.0,0.0,0.0,0.0,0.0,1.0,0.0,0.0,0.0,0.0,0.0,0.0,0.0,0.0,0.0,0.0,0.0,0.0,0.0,0.0,1.0,0.0,0.0,0.0,0.0,0.0,0.0,0.0,0.0,0.0,0.0,0.0,0.0,0.0,0.0,0.0,0.0,0.0,0.0,0.0,0.0,0.0,0.0,0.0,0.0,0.0,0.0,0.0,0.0,0.0,0.0,0.0,0.0,0.0,0.0,0.0,0.0,0.0,0.0,0.0,0.0,0.0,0.0,0.0,0.0,0.0,0.0,0.0,0.0,0.0,0.0,0.0,0.0,0.0,0.0,0.0,0.0,1.0,0.0,0.0,1.0,0.0,0.0,0.0,0.0,0.0,0.0
105266,0,0.0,1.0,0.0,0.0,1.0,180000.0,218907.0,24885.0,198000.0,0.00702,34.07397260273972,-1966.0,-6554.0,-4354.0,,3.0,2.0,2.0,17.0,,0.326920262824033,,,,,,,,,,,,,,,,,,,,,,,,,,,,,,,,,,,,,,,,,,,,,,2.0,0.0,1.0,0.0,-673.0,,,,,,,1.0,1.0,0.0,1.0,0.0,0.0,0.0,0.0,0.0,0.0,1.0,1.0,0.0,1.0,0.0,0.0,0.0,0.0,0.0,0.0,0.0,0.0,0.0,0.0,0.0,0.0,0.0,0.0,0.0,0.0,0.0,0.0,0.0,,,,,,,,,,,,,0.0,,6.0,10181.88,70420.5,68080.5,3802.5,93960.0,12.0,-1190.0,365243.0,-1155.5,-825.5,-825.5,-819.5,12.5,0.0,0.0520216092779144,24.0,39.0,12.0,6.0,-50.0,0.0,0.0,82.0,9859.185,9534.892500000002,-453.0,-449.5,11.0,0.0,19.0,580068.45,720000.0,0.0,0.0,0.0,0.0,29171.61,15750.0,6750.0,571776.075,580068.45,580068.45,0.0,0.0,0.0,0.0,8.0,-10.0,0.0,0.0,8357297746.5,184581170221.5,165747175659.0,52033213405.935,,,,,,,,,,,,,128572.0,663618.0,,,,13543737.591780417,-602668082.0,-923013057.0,-296873134.0,-1537059092.0416667,44081.0,30748.0,,,,,,,,158228.36025992993,,,,,,,,3718564.0,,,,,,,,,,,,,,,,437027.0,431818.0,,6432.512348002897,632722.0,626269.0,,,,,,,,,,,,,,,,,,,,,,,,,,,,,,,,,,,303806322.3824998,4330004685.480003,4862223213.930002,70596574.78499994,4330028125.980003,313577.0,-21700812.5,5046600209.5,225441964.5,1136384122.5,491010395.5,1191915268.5,311807.0,4880.0,881.5219825224953,7183058.5,2584356.0,1591413.0,-5218184.0,1544241.0,103639.0,3419985988.215075,3460124394.8100586,-208181963.5,-206446463.5,3648431.5,172508.0,3131991817.559952,8534691000.0,263851221.375,407035775.1149997,12423191.535000002,130365433.39499988,177876507.14999914,446138846.6849964,412015059.9449991,3006964677.105012,3120499034.77494,3120659033.084939,13474.0,35953.0,173.0,22306.0,1028972.0,-1829321.0,813880.0,1739.0,1469231.0,14849035.0,3236295.0,8566413.0,11621821.0,1417650.0,,,,,,,,,,,,,,5928309952.357462,18747382500.0,198880482.825,448398171.0674977,1948107.735,257087113.1100008,309385214.2574986,637079396.6699978,459519634.3274993,5713295151.105035,5891559448.342499,5891802631.0875,13394.0,80970.0,44.0,70473.0,972319.5,-1700470.0,177364.0,6755.0,4278515.0,2482495.5,-9014850.0,921451.5,37582.5,3738568714.717457,3663246030.794957,-260953074.0,-257636855.5,2529433.0,269562.0,3931064469.269953,33292287690.34592,36724365292.88265,1732038925.8825498,48143276154.38322,3993014.5,-247885271.0,103217146509.5,1056389108.0,17292602365.0,3508074383.5,18907361060.5,3676607.0,72023.5,20896.84598608604,89868215.0,-57.6979979094637,1.21615,7.2332730560578655,246.46634794025115,8.796745027124773,299.74004904753644,60000.0,-0.9009688679024191,0.4338837391175582,0.0,0.0,0.0,0.0,0.0,0.0,1.0,0.0,1.0,0.0,0.0,0.0,0.0,0.0,0.0,0.0,0.0,0.0,1.0,0.0,1.0,0.0,0.0,0.0,0.0,1.0,0.0,0.0,0.0,0.0,0.0,0.0,1.0,0.0,0.0,0.0,0.0,0.0,0.0,0.0,0.0,0.0,0.0,0.0,0.0,0.0,0.0,0.0,0.0,0.0,0.0,0.0,0.0,1.0,0.0,0.0,0.0,0.0,0.0,0.0,0.0,0.0,0.0,0.0,0.0,0.0,0.0,0.0,0.0,0.0,0.0,0.0,0.0,0.0,0.0,0.0,0.0,0.0,0.0,0.0,0.0,0.0,0.0,0.0,0.0,0.0,0.0,0.0,0.0,0.0,0.0,0.0,0.0,0.0,0.0,0.0,0.0,0.0,0.0,0.0,0.0,0.0,0.0,0.0,0.0,0.0,0.0,0.0,0.0,0.0,0.0,0.0,0.0,0.0,0.0,0.0,0.0,0.0,0.0,0.0
105271,1,0.0,0.0,0.0,0.0,0.0,135000.0,225000.0,17775.0,225000.0,0.010147,31.64383561643836,-541.0,-806.0,-3292.0,,2.0,2.0,2.0,10.0,0.3254819255971718,0.0593417022990954,0.4206109640437848,,,,,,,,,,,,,,,,,,,,,,,,,,,,,,,,,,,,,,,,,,,,,7.0,0.0,7.0,0.0,-1747.0,0.0,0.0,0.0,0.0,0.0,8.0,1.0,1.0,0.0,1.0,1.0,0.0,0.0,0.0,0.0,0.0,0.0,0.0,0.0,1.0,0.0,0.0,0.0,0.0,0.0,0.0,0.0,0.0,0.0,0.0,0.0,0.0,0.0,0.0,0.0,0.0,0.0,0.0,2.0,,0.0,32600.025,0.0,0.0,0.0,0.0,0.0,-1635.5,-1436.5,-223.0,-583.0,109.0,-33.0,11.0,11748.3975,62991.0,116212.5,6300.0,112500.0,11.0,-727.0,365243.0,-1212.0,-927.0,-912.0,-922.0,12.0,0.0,0.1089246515736013,2.0,32.0,10.0,5.0,-50.5,0.0,0.0,50.0,7100.685,7100.685,-564.0,-562.0,6.5,1.0,10.0,160405.6275,202500.0,0.0,9127.0125,0.0,1837.5525,8275.4775,10080.0,9540.0,156892.05,160405.6275,160405.6275,0.0,2.0,0.0,1.5,4.5,-5.5,0.0,0.0,8357315521.5,184581395221.5,165747400659.0,52033348405.935,1863.0,1706.0,71127.0,70968.0,9141.0,506701.0,,,,,,,128572.0,663620.0,,,,13543769.235616036,-602668623.0,-923016349.0,-296874881.0,-1537059898.0416667,44081.0,30748.0,,,,,,,67569.26612954655,158228.41960163225,126260.38461540129,,,,,,,3718574.0,,,,,,,,,,,,,,,,437034.0,431825.0,,6432.522495002897,632724.0,626271.0,,,,,,,,,54.5,,29724090.435,8674184393.234983,2876744630.61,100280283.97499998,805594.5899999997,170.0,19303.0,-28492897.5,12827448.5,-14779692.5,-16079927.5,-26.75,,0.0,42218.55,0.0,0.0,0.0,0.0,0.0,-2656.0,-2442.0,-15.0,-735.0,304363403.99999964,4338038148.480003,4870880453.430002,70719671.83499993,4338094398.480003,313830.0,-21726533.0,5050251558.5,225796527.5,1138202028.5,492098829.5,1194099296.0,312243.0,4882.5,882.9505835078447,7197792.0,2586077.0,1592138.5,-5221935.5,1544296.0,103694.0,3423509940.375081,3463260267.892562,-208287222.0,-206550833.5,3650968.5,172635.5,3138204943.642452,8549466750.0,264976221.375,408290855.5349997,12423191.535000002,130495513.81499988,178154826.18749917,446881087.8899963,412598310.7499991,3012958195.537511,3126669441.952441,3126829440.26244,13524.0,36046.0,173.0,22349.0,1029174.5,-1829574.5,813880.0,1739.0,1469233.0,14849144.0,3236305.0,8566445.0,11621871.0,1417661.0,,802228181.2874953,72191780444.54213,21698808242.737617,583477324.4969988,5792665.7475,689.5,94245.0,-277259403.0,22018947.0,-123927173.0,-218965700.0,-2024813.0,5928470357.9849615,18747585000.0,198880482.825,448407298.07999766,1948107.735,257088950.66250083,309393489.73499864,637089476.6699978,459529174.3274993,5713452043.155035,5891719853.969997,5891963036.714999,13394.0,80972.0,44.0,70474.5,972324.0,-1700475.5,177364.0,6755.0,4278525.0,2482500.5,-9014900.5,921451.5,37582.5,3738575815.402457,3663253131.479957,-260953638.0,-257637417.5,2529439.5,269563.0,3931076217.667453,33292350681.34592,36724481505.38265,1732045225.8825498,48143388654.38322,3993025.5,-247885998.0,103217511752.5,1056387896.0,17292601438.0,3508073471.5,18907360138.5,3676619.0,72023.5,20896.95491073761,89868217.0,-17.096536796536796,1.6666666666666667,7.594936708860758,240.3329287324432,12.658227848101266,400.5548812207386,67500.0,-0.9009688679024191,0.4338837391175582,0.0,0.0,0.0,0.0,0.0,0.0,1.0,0.0,0.0,0.0,0.0,0.0,0.0,1.0,0.0,0.0,0.0,0.0,1.0,1.0,0.0,0.0,0.0,0.0,0.0,1.0,0.0,0.0,0.0,0.0,0.0,0.0,0.0,0.0,0.0,0.0,0.0,0.0,0.0,0.0,0.0,0.0,0.0,0.0,1.0,0.0,0.0,0.0,0.0,0.0,0.0,0.0,0.0,0.0,0.0,0.0,0.0,0.0,0.0,0.0,0.0,0.0,0.0,0.0,0.0,0.0,0.0,0.0,0.0,1.0,0.0,0.0,0.0,0.0,0.0,0.0,0.0,0.0,0.0,0.0,0.0,0.0,0.0,0.0,0.0,0.0,0.0,0.0,0.0,0.0,0.0,0.0,0.0,0.0,0.0,0.0,0.0,0.0,0.0,0.0,0.0,0.0,0.0,0.0,0.0,0.0,0.0,0.0,0.0,0.0,0.0,0.0,0.0,0.0,0.0,0.0,0.0,0.0,0.0,0.0
105276,0,0.0,1.0,0.0,1.0,0.0,189000.0,832500.0,64557.0,832500.0,0.030755,55.43835616438356,-386.0,-3827.0,-3770.0,,1.0,2.0,2.0,17.0,,0.6040369050918749,0.6925590674998008,,,,,,,,,,,,,,,,,,,,,,,,,,,,,,,,,,,,,,,,,,,,,1.0,1.0,1.0,1.0,-621.0,0.0,0.0,0.0,0.0,0.0,4.0,1.0,1.0,0.0,1.0,0.0,0.0,0.0,0.0,0.0,0.0,0.0,0.0,0.0,1.0,0.0,0.0,0.0,0.0,0.0,0.0,0.0,0.0,0.0,0.0,0.0,0.0,0.0,0.0,0.0,0.0,0.0,0.0,3.0,0.0,,45000.0,,,0.0,0.0,0.0,-1895.0,-1714.0,-1222.0,-1225.0,210.0,-34.5,8.0,15655.7025,75867.75,72310.5,4419.0,107804.25,6.0,-484.5,365243.0,-1175.0,-1010.0,-935.0,-1002.0,14.0,0.0,0.1050680098955961,-0.5,40.0,6.0,4.0,-51.5,0.0,0.0,37.0,16405.29,16405.29,-1573.0,-1570.0,4.0,1.0,11.0,0.0,405000.0,0.0,0.0,0.0,0.0,0.0,9900.0,0.0,0.0,0.0,0.0,0.0,0.0,0.0,0.0,0.0,-6.0,0.0,0.0,8357380078.5,184582227721.5,165748233159.0,52033537405.935,1863.0,1706.0,71127.0,70968.0,9141.0,506705.0,,,,,,,128572.0,663621.0,,,,13543824.6739722,-602669009.0,-923020119.0,-296875502.0,-1537063725.0416667,44082.0,30749.0,,,,,,,,158229.02363853736,126261.07717446877,,,,,,,3718591.0,,,,,,,,,,,,,,,,437035.0,431826.0,,6432.553250002897,632726.0,626273.0,,,,,,,,,63.0,84434191.10999998,,8691977858.984983,,,805594.5899999997,171.0,19303.0,-28531273.0,12958719.0,-14798076.0,-16101727.0,-31.0,0.0,,45000.0,,,0.0,0.0,0.0,-1895.0,-1714.0,-1222.0,-1225.0,305185038.2099996,4347615137.580004,4880910304.980002,70914580.33499993,4347615137.580004,314330.0,-21762196.0,5057008220.5,225956334.5,1139460581.0,492632860.5,1195174154.0,312642.5,4891.0,884.2555834694213,7206687.5,2588557.0,1593619.5,-5228556.0,1544326.0,103724.0,3431997799.4250765,3473171298.1350627,-208497344.0,-206759508.0,3652276.0,172833.0,3139113311.2799525,8553798000.0,265261971.375,408659604.0299997,12423191.535000002,130578512.30999988,178200675.98999918,447159827.7449963,412858423.4399991,3013826936.940011,3127558571.0999413,3127718569.40994,13539.0,36070.0,173.0,22358.0,1029211.0,-1829722.0,813880.0,1739.0,1469236.0,14849354.0,3236316.0,8566485.0,11621908.0,1417669.0,1061187321.5595012,,72191825444.54213,,,5792665.7475,689.5,94245.0,-277261298.0,22017233.0,-123928395.0,-218966925.0,-2024847.5,5928470357.9849615,18747990000.0,198880482.825,448407298.07999766,1948107.735,257088950.66250083,309393489.73499864,637099376.6699978,459529174.3274993,5713452043.155035,5891719853.969997,5891963036.714999,13394.0,80972.0,44.0,70474.5,972324.0,-1700481.5,177364.0,6755.0,4278531.0,2482504.5,-9014952.0,921451.5,37582.5,3738592220.692457,3663269536.769957,-260955211.0,-257638987.5,2529443.5,269564.0,3931091873.369953,33292426549.09592,36724553815.88265,1732049644.8825498,48143496458.63322,3993031.5,-247886482.5,103217876995.5,1056386721.0,17292600428.0,3508072536.5,18907359136.5,3676633.0,72023.5,20897.05997874751,89868216.5,-6.962688411168768,4.404761904761905,2.927645336679213,162.30384489781892,12.895580649658443,714.9097930022974,189000.0,1.0,0.0,0.0,0.0,0.0,0.0,0.0,0.0,1.0,0.0,1.0,0.0,0.0,0.0,0.0,0.0,0.0,0.0,0.0,0.0,1.0,0.0,0.0,1.0,0.0,0.0,0.0,1.0,0.0,0.0,0.0,0.0,0.0,0.0,0.0,0.0,0.0,0.0,0.0,0.0,1.0,0.0,0.0,0.0,0.0,0.0,0.0,0.0,0.0,0.0,0.0,0.0,0.0,0.0,0.0,0.0,0.0,1.0,0.0,0.0,0.0,0.0,0.0,0.0,0.0,0.0,0.0,0.0,0.0,0.0,0.0,0.0,0.0,0.0,0.0,0.0,0.0,0.0,0.0,0.0,0.0,0.0,0.0,0.0,0.0,0.0,0.0,0.0,0.0,0.0,0.0,0.0,0.0,0.0,0.0,0.0,0.0,0.0,0.0,0.0,0.0,0.0,0.0,0.0,0.0,0.0,0.0,0.0,0.0,0.0,0.0,0.0,0.0,0.0,0.0,0.0,0.0,0.0,0.0,0.0,0.0,0.0
105282,0,0.0,1.0,0.0,0.0,0.0,112500.0,900000.0,29034.0,900000.0,0.010276,49.08493150684932,-888.0,-2855.0,-1440.0,,2.0,2.0,2.0,8.0,0.5972041601159555,0.6200020910574289,0.7726311345553628,,,,,,,,,,,,,,,,,,,,,,,,,,,,,,,,,,,,,,,,,,,,,0.0,0.0,0.0,0.0,-713.0,0.0,0.0,0.0,0.0,2.0,1.0,1.0,1.0,0.0,1.0,0.0,0.0,0.0,0.0,0.0,0.0,0.0,0.0,0.0,1.0,0.0,0.0,0.0,0.0,0.0,0.0,0.0,0.0,0.0,0.0,0.0,0.0,0.0,0.0,0.0,0.0,0.0,0.0,1.0,0.0,,202500.0,0.0,0.0,0.0,0.0,0.0,-2853.0,-2487.0,-1306.0,-2484.0,94.0,-46.5,1.0,3670.92,31860.0,18000.0,13860.0,31860.0,6.0,-713.0,365243.0,-682.0,-562.0,-532.0,-554.0,18.0,0.0,0.4737853107344632,63.0,7.0,6.0,3.0,-21.0,0.0,0.0,5.0,3670.92,3670.92,-633.0,-622.0,3.0,1.0,0.0,,,,,,,,,,,,,,,,,,,,,8357409112.5,184583127721.5,165749133159.0,52033649905.935,1863.0,1706.0,71127.0,70970.0,9141.0,506706.0,,,,,,,128572.0,663623.0,,,,13543873.758903705,-602669897.0,-923021559.0,-296876215.0,-1537066580.0416667,44082.0,30749.0,,,,,,,67569.86333370669,158229.6436406284,126261.84980560331,,,,,,,3718599.0,,,,,,,,,,,,,,,,437035.0,431826.0,,6432.563526002897,632728.0,626275.0,,,,,,,,,94.0,84458941.10999998,,8696140725.284983,2881886942.61,100280283.97499998,805594.5899999997,171.0,19303.0,-28550076.0,12950556.0,-14809060.0,-16114503.0,-46.5,0.0,,202500.0,0.0,0.0,0.0,0.0,0.0,-2853.0,-2487.0,-1306.0,-2484.0,305314911.7649996,4349000168.730004,4882255867.980002,70962350.98499994,4349000168.730004,314437.0,-21779979.0,5061756079.0,226489475.0,1140727559.0,493534405.0,1196259766.0,312919.0,4893.0,885.4929516237512,7216319.0,2589476.0,1594116.0,-5232028.0,1544331.0,103726.0,3433042814.580072,3474220072.590059,-208592500.0,-206853431.0,3652939.0,172935.0,,,,,,,,,,,,,,,,,,,,,1469237.0,14849448.0,3236316.0,8566492.0,11621913.0,1417670.0,1061187321.5595012,,72192027944.54213,21698808242.737617,583477324.4969988,5792665.7475,689.5,94245.0,-277264151.0,22014746.0,-123929701.0,-218969409.0,-2024894.0,,,,,,,,,,,,,,,,,,,,,4278537.0,2482507.5,-9014973.0,921451.5,37582.5,3738595891.612457,3663273207.689957,-260955844.0,-257639609.5,2529446.5,269565.0,3931095544.289953,33292458409.09592,36724571815.88265,1732063504.8825498,48143528318.63322,3993037.5,-247887195.5,103218242238.5,1056386039.0,17292599866.0,3508072004.5,18907358582.5,3676651.0,72023.5,20897.533764058247,89868279.5,-18.091091761553923,8.0,3.874767513949163,190.19269802715945,30.998140111593305,1521.5415842172756,56250.0,-0.9009688679024191,-0.433883739117558,0.0,0.0,0.0,0.0,0.0,0.0,1.0,0.0,0.0,0.0,0.0,0.0,0.0,1.0,0.0,0.0,0.0,0.0,1.0,0.0,1.0,0.0,0.0,0.0,0.0,1.0,0.0,0.0,0.0,0.0,0.0,0.0,0.0,0.0,0.0,0.0,1.0,0.0,0.0,0.0,0.0,0.0,0.0,0.0,0.0,0.0,0.0,0.0,0.0,0.0,0.0,0.0,0.0,0.0,0.0,0.0,0.0,0.0,0.0,0.0,0.0,1.0,0.0,0.0,0.0,0.0,0.0,0.0,0.0,0.0,0.0,0.0,0.0,0.0,0.0,0.0,0.0,0.0,0.0,0.0,0.0,0.0,0.0,0.0,0.0,0.0,0.0,0.0,0.0,0.0,0.0,0.0,0.0,0.0,0.0,0.0,0.0,0.0,0.0,0.0,0.0,0.0,0.0,0.0,0.0,0.0,0.0,0.0,0.0,0.0,0.0,0.0,0.0,0.0,0.0,0.0,0.0,0.0,0.0,0.0
105292,0,0.0,0.0,0.0,1.0,0.0,315000.0,804420.0,33327.0,706500.0,0.0072739999999999,35.87945205479452,-812.0,-201.0,-742.0,,2.0,2.0,2.0,13.0,0.3250822774096784,0.4427855786081525,,0.0144,0.0461,0.9682,0.5648,0.0021,0.0,0.069,0.0417,0.0417,0.0011,0.0118,0.0149,0.0,0.0,0.0147,0.0479,0.9682,0.5818,0.0021,0.0,0.069,0.0417,0.0417,0.0012,0.0129,0.0155,0.0,0.0,0.0146,0.0461,0.9682,0.5706,0.0021,0.0,0.069,0.0417,0.0417,0.0012,0.012,0.0152,0.0,0.0,0.0129,1.0,0.0,0.0,0.0,0.0,-419.0,,,,,,,1.0,1.0,0.0,1.0,0.0,1.0,0.0,0.0,0.0,0.0,0.0,0.0,0.0,0.0,0.0,0.0,0.0,0.0,0.0,0.0,0.0,0.0,0.0,0.0,0.0,0.0,0.0,0.0,0.0,0.0,0.0,0.0,0.0,,,,,,,,,,,,,0.0,,0.0,,,,,,,,,,,,,,,,,0.0,,,,,,0.0,,,,,,,0.0,,,,,,,,,,,,,,,,,,,,,8357442439.5,184583932141.5,165749839659.0,52033964905.935,,,,,,,17829.91860000231,17892.213399999113,17343.259699998,11309.158500000096,11246.985100000094,11194.382000000063,128572.0,663625.0,4142.753000000114,4140.433200000013,3950.999600000094,13543909.638355762,-602670709.0,-923022301.0,-296876634.0,-1537066781.0416667,44082.0,30749.0,11361.973999999193,11237.919999998989,10721.89399999729,22915.71660000981,22837.47720000977,22222.27650000833,67570.18841598407,158230.08642620698,,35043.80270002802,34983.910100028465,34429.34420002887,22978.96199999589,22952.025099995462,22598.6641999957,3718612.0,8305.611500000165,8410.281000000074,8133.701800000231,9828.034500000718,9943.076400002155,10303.293399999637,16487.893599999723,16673.3735999997,16270.059499999696,829.265600000177,814.4433000000461,760.3627000000133,3918.153500000123,3901.405500000161,3734.051300000161,437035.0,431826.0,,6432.570800002895,632730.0,626277.0,,16352.080999999796,154374.96939999078,154377.71149999034,154269.4223999872,77699.79319999636,78037.9998000066,78440.01210000661,,,,,,,,,,,,,,,,,,,,,,,,,,,,,,,,,,,,,,,,,,,,,,,,,,,,,,,,,,,,,,,,,,,,,,,,,,1469237.0,14849448.0,3236316.0,8566492.0,11621913.0,1417670.0,,,,,,,,,,,,,,,,,,,,,,,,,,,,,,,,,,,,,,,,,,,,,,,,,,,,,,,,,,,,,-22.63133781307269,2.5537142857142863,9.45179584120983,339.1252557163943,24.137186065352417,866.0290101694666,157500.0,1.0,0.0,0.0,1.0,0.0,0.0,0.0,0.0,0.0,0.0,1.0,0.0,0.0,0.0,0.0,0.0,0.0,0.0,0.0,0.0,1.0,0.0,1.0,0.0,0.0,0.0,0.0,1.0,0.0,0.0,0.0,0.0,0.0,0.0,0.0,0.0,0.0,0.0,0.0,0.0,0.0,0.0,0.0,0.0,0.0,0.0,1.0,0.0,0.0,0.0,0.0,0.0,0.0,0.0,0.0,0.0,0.0,0.0,0.0,0.0,0.0,0.0,0.0,0.0,0.0,0.0,0.0,0.0,0.0,0.0,0.0,0.0,0.0,0.0,0.0,0.0,0.0,0.0,0.0,0.0,0.0,0.0,0.0,0.0,0.0,0.0,0.0,0.0,0.0,0.0,0.0,0.0,0.0,0.0,0.0,0.0,0.0,1.0,0.0,0.0,0.0,0.0,0.0,0.0,0.0,0.0,0.0,0.0,0.0,0.0,1.0,0.0,1.0,0.0,0.0,0.0,0.0,0.0,1.0,0.0,0.0,0.0
105297,0,0.0,0.0,1.0,1.0,0.0,67500.0,238500.0,13819.5,238500.0,0.0228,57.31780821917808,,-11478.0,-1140.0,3.0,2.0,2.0,2.0,8.0,0.6181373626694429,0.683068515517022,0.7826078370261895,0.132,0.1614,0.9776,,,0.0,0.2759,0.1667,,0.0839,,0.104,,0.0851,0.1345,0.1675,0.9777,,,0.0,0.2759,0.1667,,0.0858,,0.1083,,0.09,0.1332,0.1614,0.9776,,,0.0,0.2759,0.1667,,0.0853,,0.1059,,0.0868,0.1097,1.0,0.0,0.0,0.0,0.0,-1519.0,0.0,0.0,0.0,0.0,0.0,3.0,1.0,0.0,0.0,1.0,1.0,0.0,0.0,0.0,0.0,0.0,0.0,0.0,0.0,0.0,0.0,0.0,1.0,0.0,0.0,0.0,0.0,0.0,0.0,0.0,0.0,0.0,0.0,0.0,0.0,0.0,0.0,0.0,15.0,0.0,0.0,160974.0,0.0,0.0,0.0,0.0,0.0,-1893.0,-1528.0,-1486.0,-1727.5,926.0,-32.0,4.0,34635.825,597771.0,742500.0,0.0,1035000.0,24.0,-1002.5,365243.0,-972.5,-432.5,77.5,-427.5,13.0,0.0,0.0,-1.0,51.0,36.0,23.0,-26.0,0.0,0.0,53.0,46771.65,46771.65,-752.0,-745.0,8.0,1.0,24.0,0.0,225000.0,0.0,0.0,0.0,0.0,0.0,0.0,0.0,0.0,0.0,0.0,0.0,0.0,0.0,0.0,0.0,-13.5,0.0,0.0,8357456259.0,184584170641.5,165750078159.0,52034032405.935,1863.0,1706.0,71127.0,70970.0,9141.0,506709.0,17830.050600002312,17892.346599999113,17343.394199998,11309.319900000097,11247.146500000095,11194.549500000065,128572.0,663627.0,,,,13543966.95616398,,-923023441.0,-296878153.0,-1537078259.0416667,44082.0,30749.0,11361.973999999193,11237.919999998989,10721.89399999729,22915.99250000981,22837.75310000977,22222.55240000833,67570.80655334676,158230.76949472257,126262.63241344035,35043.969400028014,34984.07680002846,34429.510900028865,,,,3718620.0,8305.695400000164,8410.366300000076,8133.787600000231,,,,16487.997599999722,16673.4794999997,16270.167799999695,,,,3918.2386000001234,3901.492300000161,3734.141300000161,437035.0,431826.0,1264618.0,6432.593600002895,632732.0,626279.0,,16352.190699999795,154375.9469999908,154378.68909999036,154270.4000999872,,,,63.0,84619271.38499998,29770307.46,8712029163.824982,2885377455.7650003,100431033.97499998,805594.5899999997,171.0,19303.0,-28632089.0,12918981.0,-14853749.0,-16167806.5,-31.0,0.0,0.0,136350.0,0.0,0.0,0.0,0.0,0.0,-2062.0,-1821.0,-1592.0,-1821.0,306383431.4999999,4364521231.410005,4900970035.575003,71080467.56999993,4364521231.410005,315635.0,-21862731.5,5079648953.0,228075195.5,1144883697.5,496242745.5,1200600056.5,313977.5,4912.0,887.298290273005,7236485.5,2598546.0,1600117.0,-5251287.0,1545020.0,103726.0,3445306170.120084,3487493796.615069,-209286277.0,-207540325.0,3661395.0,173463.0,3152472739.8749533,8607928500.0,267007071.375,411078578.3549998,12423191.535000002,131232586.63499989,178965071.68499914,449179682.5799952,414865395.7649991,3026672451.900011,3140847156.869941,3141007155.179941,13602.0,36205.0,173.0,22430.0,1032010.0,-1835047.5,813880.0,1739.0,1469252.0,14850374.0,3236340.0,8566543.0,11621966.0,1417674.0,1061187321.5595012,802228181.2874953,72192188918.54213,21698808242.737617,583477324.4969988,5792665.7475,689.5,94245.0,-277266044.0,22013218.0,-123931187.0,-218971136.5,-2024926.0,5928470357.9849615,18748215000.0,198880482.825,448407298.07999766,1948107.735,257088950.66250083,309393489.73499864,637099376.6699978,459529174.3274993,5713452043.155035,5891719853.969997,5891963036.714999,13394.0,80972.0,44.0,70474.5,972324.0,-1700495.0,177364.0,6755.0,4278573.0,2482530.5,-9014999.0,921451.5,37582.5,3738642663.262457,3663319979.339957,-260956596.0,-257640354.5,2529454.5,269566.0,3931130180.114953,33293056180.09592,36725314315.88265,1732063504.8825498,48144563318.63322,3993061.5,-247888198.0,103218607481.5,1056385066.5,17292599433.5,3508072082.0,18907358155.0,3676664.0,72023.5,20897.533764058247,89868278.5,,3.533333333333333,4.884402474763919,279.9632443137972,17.258222077499187,989.2034632420836,33750.0,-0.9009688679024191,0.4338837391175582,0.0,0.0,0.0,0.0,0.0,1.0,0.0,0.0,0.0,1.0,0.0,0.0,0.0,0.0,0.0,0.0,0.0,0.0,1.0,0.0,1.0,0.0,0.0,0.0,0.0,1.0,0.0,0.0,0.0,0.0,0.0,0.0,0.0,0.0,0.0,0.0,0.0,0.0,0.0,0.0,0.0,0.0,0.0,0.0,0.0,0.0,0.0,0.0,0.0,0.0,0.0,0.0,0.0,0.0,0.0,0.0,0.0,0.0,0.0,0.0,0.0,0.0,0.0,0.0,0.0,0.0,0.0,0.0,0.0,0.0,0.0,0.0,0.0,0.0,0.0,0.0,0.0,0.0,0.0,0.0,0.0,0.0,0.0,0.0,0.0,0.0,0.0,0.0,0.0,0.0,0.0,0.0,0.0,0.0,0.0,0.0,0.0,0.0,0.0,0.0,0.0,0.0,0.0,0.0,0.0,1.0,0.0,0.0,0.0,0.0,1.0,0.0,0.0,0.0,0.0,0.0,0.0,0.0,1.0,0.0
105332,0,0.0,1.0,1.0,0.0,0.0,180000.0,379876.5,19422.0,317092.5,0.02461,55.512328767123286,-2319.0,-5279.0,-3520.0,11.0,2.0,2.0,2.0,6.0,0.4446586846323833,0.2734716029514844,0.7352209993926424,,,,,,,,,,,,,,,,,,,,,,,,,,,,,,,,,,,,,,,,,,,,,0.0,0.0,0.0,0.0,-2112.0,0.0,0.0,0.0,0.0,1.0,2.0,1.0,1.0,1.0,1.0,0.0,0.0,0.0,0.0,0.0,1.0,1.0,0.0,0.0,1.0,0.0,0.0,0.0,0.0,0.0,0.0,0.0,0.0,0.0,0.0,0.0,0.0,0.0,0.0,0.0,0.0,0.0,0.0,5.0,0.0,,427500.0,0.0,0.0,0.0,0.0,0.0,-1288.0,2.0,-140.0,-1213.0,263.0,-26.0,2.0,4040.685,27763.47,26804.25,2783.9700000000007,27763.47,9.0,-2229.5,365243.0,-2182.5,-1957.5,-1942.5,-1951.5,15.0,0.0,0.1024199275631107,103.0,19.0,10.0,5.0,-69.0,0.0,0.0,17.0,3148.785,3148.785,-2091.0,-2073.0,5.0,1.0,0.0,,,,,,,,,,,,,,,,,,,,,8357475681.0,184584550518.0,165750395251.5,52034212405.935,1863.0,1706.0,71127.0,70971.0,9141.0,506711.0,,,,,,,128572.0,663629.0,,,,13544022.468492744,-602673028.0,-923026961.0,-296880265.0,-1537083538.0416667,44082.0,30749.0,,,,,,,67571.25121203139,158231.04296632548,126263.36763443974,,,,,,,3718626.0,,,,,,,,,,,,,,,,437035.0,431826.0,1264629.0,6432.618210002896,632734.0,626281.0,,,,,,,,,43.0,84791200.05000001,,8755488597.374983,2896848597.6,101576440.44,807295.5899999997,172.0,23753.0,-28795771.0,12988195.0,-14939077.0,-16254660.0,-21.0,0.0,,427500.0,0.0,0.0,0.0,0.0,0.0,-1824.0,2.0,-140.0,-1213.0,308231809.1775001,4393415920.770004,4933036738.575003,71599221.17999993,4393415920.770004,317946.0,-22001202.5,5114523367.5,228150986.0,1153758487.0,498198152.0,1209293708.0,316001.0,4941.0,894.4451768660483,7282372.5,2623629.0,1615839.0,-5286232.0,1545226.0,103876.0,3470542411.365053,3514371605.23504,-210933383.0,-209171966.0,3705174.0,175121.0,,,,,,,,,,,,,,,,,,,,,1469257.0,14850637.0,3236340.0,8566562.0,11621983.0,1417676.0,1061187321.5595012,,72192616418.54213,21698808242.737617,583477324.4969988,5792665.7475,689.5,94245.0,-277267332.0,22013220.0,-123931327.0,-218972349.5,-2024952.0,,,,,,,,,,,,,,,,,,,,,4278583.0,2482535.5,-9015068.0,921451.5,37582.5,3738645812.047457,3663323128.124957,-260958687.0,-257642427.5,2529459.5,269567.0,3931134220.799953,33293083943.56592,36725341120.13265,1732066288.8525498,48144591082.10322,3993070.5,-247890427.5,103218972724.5,1056382884.0,17292597476.0,3508070139.5,18907356203.5,3676679.0,72023.5,20897.63618398581,89868381.5,-41.77450399763104,2.110425,9.267840593141797,514.4794139677784,19.55908248378128,1085.7702172229483,90000.0,-0.2225209339563146,-0.9749279121818236,0.0,0.0,0.0,0.0,0.0,0.0,1.0,0.0,1.0,0.0,0.0,0.0,0.0,0.0,0.0,0.0,0.0,0.0,1.0,0.0,1.0,0.0,0.0,0.0,0.0,1.0,0.0,0.0,0.0,0.0,0.0,0.0,0.0,0.0,1.0,0.0,0.0,0.0,0.0,0.0,0.0,0.0,0.0,0.0,0.0,0.0,0.0,0.0,0.0,0.0,0.0,0.0,0.0,1.0,0.0,0.0,0.0,0.0,0.0,0.0,0.0,0.0,0.0,0.0,0.0,0.0,0.0,0.0,0.0,0.0,0.0,0.0,0.0,0.0,0.0,0.0,0.0,0.0,0.0,0.0,0.0,0.0,0.0,0.0,0.0,0.0,0.0,0.0,0.0,0.0,0.0,0.0,0.0,0.0,0.0,0.0,0.0,0.0,0.0,0.0,0.0,0.0,0.0,0.0,0.0,0.0,0.0,0.0,0.0,0.0,0.0,0.0,0.0,0.0,0.0,0.0,0.0,0.0,0.0,0.0
105333,0,0.0,0.0,1.0,1.0,1.0,103500.0,67500.0,7218.0,67500.0,0.031329,34.115068493150694,-771.0,-5988.0,-4637.0,7.0,3.0,2.0,2.0,11.0,,0.6193578812160198,0.5028782772082183,0.0247,,0.9732,0.6328,0.0029,0.0,0.0345,0.0417,0.0833,0.0353,0.0202,0.0086,0.0,0.0,0.0252,,0.9732,0.6472,0.0029,0.0,0.0345,0.0417,0.0833,0.0361,0.022,0.009,0.0,0.0,0.025,,0.9732,0.6377,0.0029,0.0,0.0345,0.0417,0.0833,0.036,0.0205,0.0088,0.0,0.0,0.0101,1.0,0.0,0.0,0.0,0.0,-2001.0,0.0,0.0,0.0,0.0,1.0,2.0,1.0,1.0,1.0,1.0,1.0,0.0,0.0,0.0,0.0,0.0,0.0,0.0,0.0,0.0,0.0,0.0,0.0,0.0,1.0,0.0,0.0,0.0,0.0,0.0,0.0,0.0,0.0,0.0,0.0,0.0,0.0,0.0,7.0,0.0,0.0,135000.0,42780.0825,0.0,0.0,0.0,0.0,-1231.0,-190.5,-346.0,-972.0,239.0,-21.0,4.0,4725.0,22340.25,43785.0,4500.0,23625.0,4.0,-1048.0,181264.0,-2311.0,-2129.0,181715.0,181720.0,11.0,0.0,0.1994671994671994,86.0,8.0,6.0,2.5,-62.5,0.0,0.0,103.0,68.31,68.31,-1563.0,-1563.0,45.0,0.0,89.0,0.0,0.0,0.0,0.0,0.0,0.0,0.0,68.31,0.0,0.0,0.0,0.0,0.0,0.0,0.0,0.0,8.0,-45.0,0.0,0.0,8357482899.0,184584618018.0,165750462751.5,52034315905.935,1863.0,1706.0,71127.0,70972.0,9141.0,506713.0,17830.075300002314,17892.371599999115,17343.419399998,,,,128573.0,663632.0,4142.755900000115,4140.4361000000135,3951.002500000093,13544056.58356124,-602673799.0,-923031598.0,-296882266.0,-1537089526.0416667,44082.0,30749.0,11361.973999999193,11237.919999998989,10721.89399999729,22916.02700000981,22837.78760000977,22222.58690000833,,158231.6623242067,126263.87051271697,35044.011100028016,34984.11850002846,34429.552600028874,22979.045299995887,22952.108399995464,22598.747499995698,3718637.0,8305.730700000164,8410.402300000076,8133.823700000231,9828.05470000072,9943.096900002156,10303.315399999636,16488.006199999723,16673.4882999997,16270.176799999696,829.265600000177,814.4433000000461,760.3627000000133,3918.2386000001234,3901.492300000161,3734.141300000161,437035.0,431826.0,1264636.0,6432.649539002897,632736.0,626283.0,,16352.200799999797,154376.9201999908,154379.66229999036,154271.3732999872,77700.42599999638,78038.6375000066,78440.65930000662,41.0,84820618.80000001,29876419.935,8758199006.054983,2897828062.515,101576440.44,807295.5899999997,172.0,23753.0,-28802396.0,12987171.5,-14941592.0,-16258480.0,-20.0,0.0,0.0,135000.0,0.0,0.0,0.0,0.0,0.0,-1283.0,-500.0,-656.0,-1214.0,308267793.3150002,4393618801.740004,4933180153.575003,71664314.39999993,4393618801.740004,317961.0,-22004479.0,5115069874.5,228146547.5,1153754440.5,498377949.5,1209473517.5,316034.5,4941.0,895.0735312873762,7282578.5,2623746.0,1615905.0,-5287170.0,1545226.0,103876.0,3470606209.3950505,3514435403.265037,-211030682.0,-209268913.0,3707399.0,175135.0,3171236771.924954,8650692000.0,269352021.375,413870590.3949997,12445484.535000002,131642254.61999989,179984500.15499926,452072693.7899961,417725286.974999,3044567017.845012,3159709659.1349416,3159870602.444941,13705.0,36434.0,175.0,22554.0,1040414.0,-1848210.0,813899.0,1758.0,1469264.0,14850876.0,3236429.0,8566570.0,11622086.0,1417680.0,1061187321.5595012,802228181.2874953,72192751418.54213,21698851022.82012,583477324.4969988,5792665.7475,689.5,94245.0,-277268563.0,22013029.5,-123931673.0,-218973321.5,-2024973.0,5928470357.9849615,18748215000.0,198880482.825,448407298.07999766,1948107.735,257088950.66250083,309393489.73499864,637099444.9799979,459529174.3274993,5713452043.155035,5891719853.969997,5891963036.714999,13394.0,80972.0,44.0,70474.5,972332.0,-1700540.0,177364.0,6755.0,4278589.0,2482538.0,-9015130.5,921451.5,37582.5,3738645880.357457,3663323196.434957,-260960250.0,-257643990.5,2529504.5,269567.0,3931138945.799953,33293106283.81592,36725384905.13265,1732070788.8525498,48144614707.10322,3993074.5,-247891475.5,103219153988.5,1056380573.0,17292595347.0,3508251854.5,18907537923.5,3676690.0,72023.5,20897.83565118528,89868467.5,-22.59998393832316,0.6521739130434783,14.33915211970075,489.1811566972978,9.351620947630924,319.0311891504117,34500.0,-0.9009688679024191,0.4338837391175582,0.0,0.0,0.0,0.0,0.0,0.0,1.0,0.0,0.0,0.0,0.0,0.0,0.0,1.0,0.0,0.0,0.0,0.0,1.0,0.0,1.0,0.0,0.0,0.0,0.0,1.0,0.0,0.0,0.0,0.0,0.0,0.0,0.0,0.0,0.0,0.0,0.0,0.0,1.0,0.0,0.0,0.0,0.0,0.0,0.0,0.0,0.0,0.0,0.0,0.0,0.0,0.0,0.0,0.0,0.0,0.0,0.0,0.0,0.0,0.0,0.0,0.0,0.0,0.0,0.0,0.0,0.0,0.0,0.0,0.0,0.0,0.0,0.0,0.0,1.0,0.0,0.0,0.0,0.0,0.0,0.0,0.0,0.0,0.0,0.0,0.0,0.0,0.0,0.0,0.0,0.0,0.0,0.0,0.0,0.0,0.0,0.0,0.0,0.0,0.0,0.0,0.0,0.0,0.0,0.0,0.0,0.0,0.0,1.0,0.0,0.0,1.0,0.0,0.0,0.0,0.0,0.0,0.0,1.0,0.0
105343,0,0.0,0.0,0.0,1.0,0.0,135000.0,272520.0,21658.5,225000.0,0.00712,65.78356164383561,,-8523.0,-4237.0,,2.0,2.0,2.0,12.0,,0.2173213069000465,0.807273923277881,0.0186,0.0344,0.9881,0.8368,0.0022,0.0,0.069,0.0833,0.0417,,0.0151,0.0175,0.0,0.0,0.0189,0.0357,0.9881,0.8432,0.0022,0.0,0.069,0.0833,0.0417,,0.0165,0.0182,0.0,0.0,0.0187,0.0344,0.9881,0.8390000000000001,0.0022,0.0,0.069,0.0833,0.0417,,0.0154,0.0178,0.0,0.0,0.0137,1.0,0.0,0.0,0.0,0.0,-929.0,0.0,0.0,0.0,0.0,0.0,5.0,1.0,0.0,0.0,1.0,0.0,0.0,0.0,0.0,0.0,0.0,0.0,0.0,0.0,0.0,0.0,0.0,1.0,0.0,0.0,0.0,0.0,0.0,0.0,0.0,0.0,0.0,0.0,0.0,0.0,0.0,0.0,0.0,1.0,,,225000.0,,,0.0,0.0,0.0,-1415.0,-684.0,-1135.0,-1139.0,47.0,-23.0,11.0,12572.6175,45000.0,47970.0,0.0,143455.5,24.0,-517.0,365243.0,-1110.0,-420.0,-420.0,-418.0,10.0,1.0,0.0,-1.0,99.0,24.0,10.0,-25.0,0.0,0.0,123.0,12466.035,12458.115,-692.0,-674.0,10.0,1.0,0.0,,,,,,,,,,,,,,,,,,,,,8357504557.5,184584890538.0,165750687751.5,52034450905.935,1863.0,1706.0,71127.0,70972.0,9141.0,506718.0,17830.093900002314,17892.390299999115,17343.438299998004,11309.354300000095,11247.180900000096,11194.585200000063,128573.0,663634.0,4142.758100000115,4140.4383000000125,3951.004700000093,13544122.367122885,,-923035835.0,-296883195.0,-1537098049.0416667,44082.0,30749.0,11361.973999999193,11237.919999998989,10721.89399999729,22916.09600000981,22837.85660000977,22222.65590000833,,158231.8796455136,126264.67778664026,35044.094400028014,34984.20180002846,34429.635900028865,22979.08699999589,22952.150099995462,22598.7891999957,3718649.0,,,,9828.06980000072,9943.112300002156,10303.331899999635,16488.023699999725,16673.5060999997,16270.194999999698,829.265600000177,814.4433000000461,760.3627000000133,3918.2386000001234,3901.492300000161,3734.141300000161,437035.0,431826.0,,6432.656659002897,632738.0,626285.0,,16352.214499999794,154377.90829999078,154380.65039999035,154272.36139998722,77701.26279999637,78039.47650000661,78441.50250000662,47.0,,,8780497830.584982,,,807894.0899999997,172.0,23774.0,-28886279.0,13042276.0,-14990241.0,-16308968.0,-23.0,,,225000.0,,,0.0,0.0,0.0,-1415.0,-684.0,-1135.0,-1139.0,308743848.9675002,4399200939.240004,4940300989.575003,71716181.39999993,4399245939.240004,318405.0,-22045073.0,5124196000.0,228483707.0,1157021533.0,500375391.0,1213293569.0,316604.0,4953.0,896.0713927962793,7289119.0,2628348.0,1618622.0,-5299077.0,1593258.0,103969.0,3477586887.5400376,3522080838.645029,-211516175.0,-209753572.0,3718252.0,175405.0,,,,,,,,,,,,,,,,,,,,,1469265.0,14850923.0,3236429.0,8566669.0,11622209.0,1417691.0,,,72192976418.54213,,,5792665.7475,689.5,94245.0,-277269978.0,22012345.5,-123932808.0,-218974460.5,-2024996.0,,,,,,,,,,,,,,,,,,,,,4278613.0,2482548.0,-9015155.5,921451.5,37582.5,3738658346.392457,3663335654.549957,-260960942.0,-257644664.5,2529514.5,269568.0,3931151518.417453,33293151283.81592,36725432875.13265,1732070788.8525498,48144758162.60322,3993098.5,-247891992.5,103219519231.5,1056379463.0,17292594927.0,3508251434.5,18907537505.5,3676700.0,72024.5,20897.83565118528,89868466.5,,2.018666666666667,6.233118637024725,410.0367440920567,12.582588821940575,827.7275074071649,67500.0,-0.9009688679024191,-0.433883739117558,0.0,0.0,0.0,0.0,0.0,0.0,1.0,0.0,0.0,1.0,0.0,0.0,0.0,0.0,0.0,0.0,0.0,0.0,1.0,0.0,1.0,0.0,0.0,0.0,0.0,1.0,0.0,0.0,0.0,0.0,0.0,0.0,0.0,0.0,0.0,0.0,0.0,0.0,0.0,0.0,0.0,0.0,0.0,0.0,0.0,0.0,0.0,0.0,0.0,0.0,0.0,0.0,0.0,0.0,0.0,0.0,0.0,0.0,0.0,0.0,0.0,0.0,0.0,0.0,0.0,0.0,0.0,0.0,0.0,0.0,0.0,0.0,0.0,0.0,0.0,0.0,0.0,0.0,0.0,0.0,0.0,0.0,0.0,0.0,0.0,0.0,0.0,0.0,0.0,0.0,0.0,0.0,0.0,0.0,0.0,0.0,0.0,0.0,0.0,0.0,0.0,0.0,0.0,0.0,0.0,1.0,0.0,0.0,1.0,0.0,1.0,0.0,0.0,0.0,0.0,0.0,0.0,0.0,1.0,0.0
105344,0,0.0,0.0,1.0,1.0,1.0,1350000.0,1885536.0,103455.0,1800000.0,0.072508,47.26575342465753,-1915.0,-9549.0,-779.0,7.0,3.0,1.0,1.0,11.0,0.7907535856232879,0.7253131810216837,0.2020866016820394,0.0866,0.0381,0.9762,0.6736,0.0,0.08,0.0345,0.4583,0.0417,0.0563,0.0706,0.076,0.0,0.0,0.0882,0.0396,0.9762,0.6864,0.0,0.0806,0.0345,0.4583,0.0417,0.0576,0.0771,0.0792,0.0,0.0,0.0874,0.0381,0.9762,0.6779999999999999,0.0,0.08,0.0345,0.4583,0.0417,0.0573,0.0718,0.0774,0.0,0.0,0.0571,1.0,0.0,0.0,0.0,0.0,0.0,0.0,0.0,0.0,0.0,0.0,2.0,1.0,1.0,0.0,1.0,0.0,0.0,0.0,0.0,0.0,0.0,0.0,0.0,0.0,0.0,0.0,0.0,0.0,0.0,1.0,0.0,0.0,0.0,0.0,0.0,0.0,0.0,0.0,0.0,0.0,0.0,0.0,0.0,5.0,0.0,,1557000.0,0.0,0.0,0.0,0.0,0.0,-2649.0,-1188.0,-1185.0,-2020.0,324.0,-36.5,0.0,,,,,,,,,,,,,,,,,0.0,,,,,,105.0,2311.965,2311.965,-1609.0,-1609.0,62.0,0.0,96.0,0.0,0.0,0.0,0.0,0.0,0.0,0.0,2311.965,0.0,0.0,0.0,0.0,0.0,0.0,0.0,0.0,14.0,-48.5,0.0,0.0,8357608012.5,184586776074.0,165752487751.5,52035800905.935,1863.0,1706.0,71127.0,70972.0,9141.0,506720.0,17830.180500002312,17892.477699999115,17343.526499998003,11309.392400000095,11247.219000000096,11194.624800000063,128574.0,663637.0,4142.758100000115,4140.4383000000125,3951.004700000093,13544169.632876309,-602675714.0,-923036614.0,-296883195.0,-1537107598.0416667,44082.0,30749.0,11362.053999999192,11237.999999998989,10721.97459999729,22916.13050000981,22837.891100009765,22222.69040000833,67572.04196561701,158232.60495869466,126264.87987324194,35044.55270002802,34984.660100028465,34430.09420002887,22979.12869999589,22952.191799995468,22598.830899995697,3718660.0,8305.787000000164,8410.459600000077,8133.881300000231,9828.14040000072,9943.184100002156,10303.408999999636,16488.099699999726,16673.5834999997,16270.274199999698,829.265600000177,814.4433000000461,760.3627000000133,3918.2386000001234,3901.492300000161,3734.141300000161,437035.0,431826.0,1264643.0,6432.729167002897,632739.0,626286.0,,16352.271599999794,154378.8844999908,154381.62659999036,154273.3375999872,77701.93639999638,78040.15450000661,78442.18890000661,88.0,85271560.78500001,,8788804830.584982,2911526384.265,101576440.44,807894.0899999997,172.0,23774.0,-28890532.0,13040256.0,-14992420.0,-16313636.0,-43.5,0.0,,1518745.5,0.0,0.0,0.0,0.0,0.0,-2751.0,-1392.0,-1876.0,-2020.0,,,,,,,,,,,,,,,,,,,,,,3478649517.9450502,3522864739.365039,-211642864.0,-209879966.0,3722144.0,175494.0,3188042160.704953,8677500750.0,270532371.375,415437223.9499998,12445484.535000002,132028538.17499988,180862185.55499923,453552467.0174938,418421769.02999896,3060908579.835013,3176426033.594939,3176593591.9049377,13807.0,36555.0,175.0,22573.0,1042902.0,-1856398.5,813903.0,1762.0,1469270.0,14851247.0,3236525.0,8566669.0,11622314.0,1417691.0,1061187321.5595012,,72194533418.54213,21698851022.82012,583477324.4969988,5792665.7475,689.5,94245.0,-277272627.0,22011157.5,-123933993.0,-218976480.5,-2025032.5,5928470357.9849615,18748215000.0,198880482.825,448407298.07999766,1948107.735,257088950.66250083,309393489.73499864,637101756.9449979,459529174.3274993,5713452043.155035,5891719853.969997,5891963036.714999,13394.0,80972.0,44.0,70474.5,972346.0,-1700588.5,177364.0,6755.0,,,,,,3738660658.357457,3663337966.514957,-260962551.0,-257646273.5,2529576.5,269568.0,,,,,,,,,,,,,,,,,-40.51559239508463,1.3966933333333331,13.049151805132665,616.7779916223253,18.225663331883432,861.4497090456242,450000.0,-0.9009688679024191,-0.433883739117558,0.0,0.0,0.0,0.0,0.0,0.0,1.0,0.0,1.0,0.0,0.0,0.0,0.0,0.0,0.0,1.0,0.0,0.0,0.0,1.0,0.0,0.0,0.0,0.0,0.0,1.0,0.0,0.0,0.0,0.0,0.0,0.0,0.0,0.0,0.0,0.0,0.0,0.0,0.0,0.0,0.0,0.0,0.0,0.0,0.0,0.0,0.0,0.0,1.0,0.0,0.0,0.0,0.0,0.0,0.0,0.0,0.0,0.0,0.0,0.0,0.0,0.0,0.0,0.0,0.0,0.0,0.0,0.0,0.0,0.0,0.0,0.0,0.0,0.0,0.0,0.0,0.0,0.0,0.0,0.0,0.0,0.0,0.0,0.0,0.0,0.0,0.0,0.0,0.0,0.0,0.0,0.0,0.0,0.0,0.0,0.0,0.0,0.0,0.0,0.0,0.0,0.0,0.0,0.0,0.0,0.0,1.0,0.0,0.0,0.0,1.0,0.0,0.0,0.0,0.0,0.0,0.0,1.0,0.0,0.0
105345,0,0.0,1.0,1.0,1.0,0.0,153000.0,254700.0,18531.0,225000.0,0.025164,33.08767123287672,-849.0,-1377.0,-2043.0,16.0,2.0,2.0,2.0,11.0,0.4051573748210037,0.4782464464265391,0.3312508645909018,0.0928,0.0936,0.9896,0.8572,,0.0,0.2069,0.1667,,0.0217,,0.0947,,0.0,0.0945,0.0971,0.9896,0.8628,,0.0,0.2069,0.1667,,0.0222,,0.0987,,0.0,0.0937,0.0936,0.9896,0.8591,,0.0,0.2069,0.1667,,0.022,,0.0964,,0.0,0.0921,1.0,3.0,0.0,3.0,0.0,-3036.0,0.0,0.0,0.0,0.0,0.0,0.0,1.0,1.0,1.0,1.0,0.0,0.0,0.0,0.0,0.0,0.0,1.0,1.0,0.0,1.0,0.0,0.0,0.0,0.0,0.0,0.0,0.0,0.0,0.0,0.0,0.0,0.0,0.0,0.0,0.0,0.0,0.0,0.0,7.0,11408.2425,0.0,157500.0,0.0,0.0,0.0,0.0,0.0,-1397.0,-117.0,-266.0,-1286.5,330.0,-32.0,5.0,10629.72,90000.0,104733.0,0.0,90000.0,12.0,-1636.0,365243.0,-2544.0,-2424.0,-2214.0,-2415.0,15.0,1.0,0.0,0.0,10.0,5.0,2.0,-83.5,0.0,0.0,8.0,4207.5,4207.5,-2541.5,-2529.0,4.0,1.0,0.0,,,,,,,,,,,,,,,,,,,,,8357626543.5,184587030774.0,165752712751.5,52035953905.935,1863.0,1706.0,71127.0,70972.0,9141.0,506720.0,17830.27330000231,17892.571399999117,17343.620999998002,11309.486000000095,11247.312600000096,11194.721900000066,128574.0,663639.0,,,,13544202.72054754,-602676563.0,-923038657.0,-296886231.0,-1537108975.0416667,44082.0,30749.0,11362.053999999192,11237.999999998989,10721.97459999729,22916.33740000981,22838.09800000977,22222.89730000833,67572.44712299183,158233.08320514107,126265.21112410651,35044.719400028014,34984.82680002846,34430.260900028865,,,,3718671.0,8305.808700000163,8410.481600000077,8133.90350000023,,,,16488.194399999727,16673.679899999694,16270.372899999697,,,,3918.2386000001234,3901.492300000161,3734.141300000161,437038.0,431829.0,1264659.0,6432.754331002897,632741.0,626288.0,,16352.363699999794,154379.8740999908,154382.61619999036,154274.3271999872,77702.79359999638,78041.01360000661,78443.05170000662,46.0,85286877.2775,29893569.345,8797680770.084982,2913920149.725,101576440.44,807894.0899999997,172.0,23774.0,-28900510.0,13036443.0,-14997955.0,-16318771.5,-22.5,0.0,0.0,157500.0,0.0,0.0,0.0,0.0,0.0,-2430.0,-2065.0,-2018.0,-2063.0,308803434.1650003,4399911034.740004,4941116821.575003,71716181.39999993,4399911034.740004,318501.0,-22055255.0,5125291729.0,228479336.0,1157017822.0,500372010.0,1213289905.0,316703.0,4956.0,896.0713927962793,7289414.0,2629259.5,1619086.5,-5300703.0,1593292.0,104003.0,3478845583.7775564,3523056313.657545,-211736495.0,-209973518.0,3725393.5,175499.0,,,,,,,,,,,,,,,,,,,,,1469277.0,14851577.0,3236525.0,8566679.0,11622322.0,1417696.0,1061198729.8020012,802228181.2874953,72194690918.54213,21698851022.82012,583477324.4969988,5792665.7475,689.5,94245.0,-277274024.0,22011040.5,-123934259.0,-218977767.0,-2025064.5,,,,,,,,,,,,,,,,,,,,,4278618.0,2482550.0,-9015239.0,921451.5,37582.5,3738664865.857457,3663342174.014957,-260965092.5,-257648802.5,2529580.5,269569.0,3931162148.137453,33293241283.81592,36725537608.13265,1732070788.8525498,48144848162.60322,3993110.5,-247893628.5,103219884474.5,1056376919.0,17292592503.0,3508249220.5,18907535090.5,3676715.0,72025.5,20897.83565118528,89868466.5,-25.659104082139606,1.6647058823529413,8.25643516270034,273.18621221899184,13.74453618261292,454.7746944586746,76500.0,0.6234898018587334,-0.7818314824680299,0.0,0.0,0.0,0.0,0.0,0.0,1.0,0.0,0.0,0.0,0.0,0.0,0.0,1.0,0.0,0.0,0.0,0.0,1.0,0.0,1.0,0.0,0.0,0.0,0.0,1.0,0.0,0.0,0.0,0.0,0.0,0.0,0.0,0.0,0.0,0.0,0.0,0.0,1.0,0.0,0.0,0.0,0.0,0.0,0.0,0.0,0.0,0.0,0.0,0.0,0.0,0.0,0.0,1.0,0.0,0.0,0.0,0.0,0.0,0.0,0.0,0.0,0.0,0.0,0.0,0.0,0.0,0.0,0.0,0.0,0.0,0.0,0.0,0.0,0.0,0.0,0.0,0.0,0.0,0.0,0.0,0.0,0.0,0.0,0.0,0.0,0.0,0.0,0.0,0.0,0.0,0.0,0.0,0.0,0.0,0.0,0.0,0.0,0.0,0.0,0.0,0.0,0.0,0.0,0.0,0.0,0.0,0.0,1.0,0.0,1.0,0.0,0.0,0.0,0.0,0.0,0.0,1.0,0.0,0.0
105357,0,0.0,1.0,1.0,0.0,0.0,81000.0,431280.0,22018.5,360000.0,0.025164,36.44657534246576,-1174.0,-2786.0,-4875.0,13.0,2.0,2.0,2.0,16.0,0.6248868316600524,0.5637630973619067,0.6769925032909132,0.0804,0.0588,0.9757,0.6668,0.0069999999999999,0.0,0.1379,0.1667,0.2083,0.0165,0.063,0.0611,0.0116,0.0118,0.0819,0.061,0.9757,0.6798,0.0071,0.0,0.1379,0.1667,0.2083,0.0168,0.0689,0.0637,0.0117,0.0124,0.0812,0.0588,0.9757,0.6713,0.0069999999999999,0.0,0.1379,0.1667,0.2083,0.0167,0.0641,0.0622,0.0116,0.012,0.0544,1.0,2.0,0.0,2.0,0.0,-784.0,0.0,0.0,0.0,0.0,0.0,1.0,1.0,1.0,1.0,1.0,0.0,0.0,0.0,0.0,0.0,0.0,0.0,0.0,0.0,1.0,0.0,0.0,0.0,0.0,0.0,0.0,0.0,0.0,0.0,0.0,0.0,0.0,0.0,0.0,0.0,0.0,0.0,0.0,3.0,12584.25,0.0,405000.0,0.0,0.0,0.0,0.0,0.0,-345.0,-161.0,-221.0,-888.0,120.0,-35.5,1.0,1531.8,16771.5,15093.0,1678.5,16771.5,12.0,-784.0,365243.0,-736.0,-736.0,-406.0,-733.0,17.0,0.0,0.1089967558601848,42.0,3.0,6.5,6.0,-25.0,0.0,0.0,1.0,15243.435,15243.435,-752.0,-736.0,1.0,2.0,0.0,,,,,,,,,,,,,,,,,,,,,8357648562.0,184587462054.0,165753072751.5,52036034905.935,1863.0,1706.0,71127.0,70972.0,9141.0,506721.0,17830.35370000231,17892.652599999117,17343.702899998003,11309.544800000096,11247.371400000096,11194.782900000066,128574.0,663641.0,4142.765100000114,4140.445300000013,3951.011800000093,13544239.167122882,-602677737.0,-923043532.0,-296887015.0,-1537111761.0416667,44082.0,30749.0,11362.053999999192,11237.999999998989,10721.97459999729,22916.47530000981,22838.23590000977,22223.035200008337,67573.07200982349,158233.64696823846,126265.8881166098,35044.886100028016,34984.99350002846,34430.427600028874,22979.33699999589,22952.400099995462,22599.0391999957,3718687.0,8305.825200000163,8410.498300000078,8133.920300000232,9828.20340000072,9943.248200002155,10303.477899999636,16488.255499999726,16673.742099999698,16270.4365999997,829.277200000177,814.4549000000461,760.3744000000132,3918.250400000123,3901.504300000162,3734.153700000161,437040.0,431831.0,1264672.0,6432.7794950028965,632743.0,626290.0,,16352.418099999795,154380.8497999908,154383.59189999037,154275.3028999872,77703.46039999637,78041.68490000661,78443.73150000662,12.0,85922633.79000002,29939815.845,8822175466.589981,2923957501.02,101576440.44,807894.0899999997,172.0,23774.0,-28975809.0,13007584.0,-15036343.0,-16361840.5,-5.5,0.0,0.0,405000.0,0.0,0.0,0.0,0.0,0.0,-2895.0,-1068.0,-1545.0,-1555.0,309215806.15500027,4403805504.660004,4945196304.675003,71846793.71999994,4403805504.660004,318823.0,-22095764.0,5133692318.0,228449536.0,1157358560.0,500349740.0,1213630795.0,317144.0,4961.0,898.4042654417842,7291246.0,2632180.5,1620697.0,-5311167.0,1593292.0,104003.0,3482544357.2250547,3526845186.870043,-212019619.0,-210253085.0,3726715.0,175735.0,,,,,,,,,,,,,,,,,,,,,1469280.0,14851697.0,3236525.0,8566682.0,11622323.0,1417697.0,1061211314.0520012,802228181.2874953,72195095918.54213,21698851022.82012,583477324.4969988,5792665.7475,689.5,94245.0,-277274369.0,22010879.5,-123934480.0,-218978655.0,-2025100.0,,,,,,,,,,,,,,,,,,,,,4278624.5,2482556.0,-9015264.0,921451.5,37582.5,3738680109.292457,3663357417.449957,-260965844.5,-257649538.5,2529581.5,269571.0,3931163679.937453,33293258055.31592,36725552701.13265,1732072467.3525498,48144864934.10322,3993122.5,-247894412.5,103220249717.5,1056376183.0,17292591767.0,3508248814.5,18907534357.5,3676732.0,72025.5,20897.94464794114,89868508.5,-32.211531233556336,5.3244444444444445,3.6787247087676263,134.07691726228973,19.5871653382383,713.885097245436,40500.0,-0.9009688679024191,0.4338837391175582,0.0,0.0,0.0,0.0,0.0,0.0,1.0,0.0,0.0,0.0,0.0,0.0,0.0,1.0,0.0,0.0,0.0,0.0,1.0,0.0,1.0,0.0,0.0,0.0,0.0,1.0,0.0,0.0,0.0,0.0,0.0,0.0,0.0,0.0,1.0,0.0,0.0,0.0,0.0,0.0,0.0,0.0,0.0,0.0,0.0,0.0,0.0,0.0,0.0,0.0,0.0,0.0,0.0,0.0,0.0,0.0,0.0,0.0,0.0,1.0,0.0,0.0,0.0,0.0,0.0,0.0,0.0,0.0,0.0,0.0,0.0,0.0,0.0,0.0,0.0,0.0,0.0,0.0,0.0,0.0,0.0,0.0,0.0,0.0,0.0,0.0,0.0,0.0,0.0,0.0,0.0,0.0,0.0,0.0,0.0,0.0,0.0,0.0,0.0,0.0,0.0,0.0,0.0,0.0,0.0,0.0,0.0,0.0,1.0,0.0,1.0,0.0,0.0,0.0,0.0,0.0,0.0,0.0,1.0,0.0
105359,0,0.0,1.0,1.0,1.0,1.0,135000.0,539100.0,29376.0,450000.0,0.010643,32.8027397260274,-4773.0,-3443.0,-4388.0,7.0,3.0,2.0,2.0,9.0,,0.608671820491319,0.5620604831738043,0.0124,0.0318,0.9886,,,,0.069,,,0.024,,0.0072,,0.0185,0.0126,0.033,0.9886,,,,0.069,,,0.0246,,0.0075,,0.0196,0.0125,0.0318,0.9886,,,,0.069,,,0.0244,,0.0073,,0.0189,0.0097,1.0,1.0,1.0,1.0,1.0,-2148.0,0.0,0.0,0.0,0.0,1.0,1.0,1.0,1.0,1.0,1.0,1.0,0.0,0.0,0.0,0.0,0.0,0.0,0.0,0.0,1.0,0.0,0.0,0.0,0.0,0.0,0.0,0.0,0.0,0.0,0.0,0.0,0.0,0.0,0.0,0.0,0.0,0.0,0.0,6.0,0.0,0.0,150045.75,197086.5,0.0,0.0,0.0,0.0,-1296.5,-26.5,-337.0,-671.5,232.0,-21.0,5.0,15570.044999999998,26406.0,26055.0,2317.5,238203.0,9.0,-895.0,365243.0,-1276.5,-952.5,-676.5,-871.5,10.0,0.0,0.1032580422767045,-1.0,44.0,29.5,14.0,-27.5,0.0,0.0,66.0,22561.515,3727.08,-510.5,-510.5,9.0,1.0,16.0,0.0,0.0,0.0,0.0,0.0,0.0,0.0,0.09,0.09,0.0,0.0,0.0,0.0,0.0,0.0,0.0,6.0,-10.5,0.0,0.0,8357677938.0,184588001154.0,165753522751.5,52036169905.935,1863.0,1706.0,71127.0,70973.0,9141.0,506722.0,17830.36610000231,17892.665099999118,17343.715499998,11309.576600000097,11247.403200000095,11194.815900000063,128575.0,663644.0,,,,13544271.969862608,-602682510.0,-923047920.0,-296889163.0,-1537115204.0416667,44083.0,30750.0,,,,22916.54430000981,22838.30490000977,22223.104200008336,,158234.25564005892,126266.45017709296,,,,,,,3718696.0,8305.849200000162,8410.522700000078,8133.9449000002305,,,,16488.262699999726,16673.7493999997,16270.4440999997,,,,3918.2689000001233,3901.5232000001615,3734.173300000161,437041.0,431832.0,1264679.0,6432.790138002895,632745.0,626292.0,,16352.427799999796,154381.8383999908,154384.58049999038,154276.29149998722,,,,43.0,85977878.04000002,29939815.845,8823944529.089981,2924154587.52,101576440.44,807894.0899999997,172.0,23774.0,-28979982.5,13008429.5,-15037513.5,-16363709.5,-21.0,0.0,0.0,139500.0,197086.5,0.0,0.0,0.0,0.0,-1327.0,-378.0,-343.0,-959.0,309294905.0625003,4405105365.660004,4946586602.175003,71862152.21999994,4405092162.660004,318887.0,-22101175.0,5134970106.5,228446337.5,1157722023.5,500714025.0,1213994425.0,317233.0,4963.0,898.743586419965,7291439.0,2633148.0,1621323.0,-5311769.5,1593292.0,104003.0,3484045656.945057,3528181712.0700445,-212039768.0,-210272816.5,3727186.5,175771.5,3188399134.184953,8679852000.0,270779871.375,415717962.1874998,12475904.535000002,132031356.41249987,180867947.71499923,453668990.71499246,418430769.38999885,3061255794.547513,3176778970.5749397,3176946528.8849387,13809.0,36558.5,176.0,22573.5,1043610.0,-1858858.0,813903.0,1762.0,1469286.0,14851929.0,3236541.0,8566726.0,11622389.0,1417702.0,1061211314.0520012,802228181.2874953,72195245964.29213,21699048109.32012,583477324.4969988,5792665.7475,689.5,94245.0,-277275665.5,22010853.0,-123934817.0,-218979326.5,-2025121.0,5928470357.9849615,18748215000.0,198880482.825,448407298.07999766,1948107.735,257088950.66250083,309393489.73499864,637101757.0349978,459529174.4174992,5713452043.155035,5891719853.969997,5891963036.714999,13394.0,80972.0,44.0,70474.5,972352.0,-1700599.0,177364.0,6755.0,4278654.0,2482570.0,-9015291.5,921451.5,37582.5,3738702670.807457,3663361144.529957,-260966355.0,-257650049.0,2529590.5,269572.0,3931179249.982453,33293284461.31592,36725578756.13265,1732074784.8525498,48145103137.10322,3993131.5,-247895307.5,103220614960.5,1056374906.5,17292590814.5,3508248138.0,18907533486.0,3676742.0,72025.5,20898.04790598341,89868507.5,-145.50613881232775,3.993333333333333,4.595588235294118,150.7478847703465,18.351715686274517,601.9865531829171,45000.0,0.6234898018587336,0.7818314824680298,0.0,0.0,0.0,0.0,0.0,0.0,1.0,0.0,0.0,0.0,0.0,0.0,0.0,1.0,0.0,0.0,0.0,1.0,0.0,0.0,1.0,0.0,0.0,0.0,0.0,1.0,0.0,0.0,0.0,0.0,0.0,0.0,0.0,0.0,0.0,0.0,0.0,0.0,1.0,0.0,0.0,0.0,0.0,0.0,0.0,0.0,0.0,0.0,0.0,0.0,0.0,0.0,1.0,0.0,0.0,0.0,0.0,0.0,0.0,0.0,0.0,0.0,0.0,0.0,0.0,0.0,0.0,0.0,0.0,0.0,0.0,0.0,0.0,0.0,0.0,0.0,0.0,0.0,0.0,0.0,0.0,0.0,0.0,0.0,0.0,0.0,0.0,0.0,0.0,0.0,0.0,0.0,0.0,0.0,0.0,0.0,0.0,0.0,0.0,0.0,0.0,0.0,0.0,0.0,0.0,0.0,0.0,0.0,0.0,0.0,1.0,0.0,0.0,0.0,0.0,0.0,0.0,1.0,0.0,0.0
105366,0,0.0,1.0,0.0,1.0,0.0,220500.0,729792.0,37390.5,630000.0,0.0060079999999999,37.254794520547954,-6033.0,-7635.0,-4493.0,,2.0,2.0,2.0,9.0,,0.4966288600363729,0.6263042766749393,0.3722,0.2519,0.9851,0.7959999999999999,0.1469,0.4,0.3448,0.3333,0.375,0.2438,0.3018,0.3906,0.0077,0.0074,0.3792,0.2614,0.9851,0.804,0.1482,0.4028,0.3448,0.3333,0.375,0.2494,0.3297,0.407,0.0078,0.0078,0.3758,0.2519,0.9851,0.7987,0.1478,0.4,0.3448,0.3333,0.375,0.248,0.307,0.3976,0.0078,0.0075,0.3892,1.0,0.0,0.0,0.0,0.0,-634.0,0.0,0.0,0.0,0.0,0.0,4.0,1.0,1.0,0.0,1.0,0.0,0.0,0.0,0.0,0.0,0.0,0.0,0.0,0.0,1.0,0.0,0.0,0.0,0.0,0.0,0.0,0.0,0.0,0.0,0.0,0.0,0.0,0.0,0.0,0.0,0.0,0.0,0.0,3.0,7123.5,,382410.0,0.0,0.0,0.0,0.0,0.0,-1628.0,-532.0,-618.0,-1795.5,180.0,-29.5,8.0,30536.955,483750.0,530230.5,4500.45,540000.0,30.0,-634.0,365243.0,-768.0,-318.0,102.0,-316.0,10.0,1.0,0.1772769758017107,-1.0,35.0,24.0,18.0,-19.0,0.0,0.0,35.0,28438.56,28438.56,-562.0,-558.0,6.0,1.0,0.0,,,,,,,,,,,,,,,,,,,,,8357715328.5,184588730946.0,165754152751.5,52036390405.935,1863.0,1706.0,71127.0,70973.0,9141.0,506726.0,17830.73830000231,17893.04089999912,17344.094699998,11309.828500000096,11247.655100000096,11195.077300000064,128575.0,663646.0,4142.912000000114,4140.593100000013,3951.1600000000935,13544309.22465713,-602688543.0,-923052413.0,-296889797.0,-1537122839.0416667,44083.0,30750.0,11362.453999999192,11238.399999998986,10722.377399997293,22916.88910000981,22838.64970000977,22223.44900000833,,158234.75226891894,126267.07648136964,35045.219400028014,34985.32680002846,34430.760900028865,22979.71199999589,22952.775099995462,22599.4141999957,3718705.0,8306.093000000164,8410.770700000077,8134.194300000231,9828.505200000718,9943.555200002156,10303.807599999636,16488.653299999725,16674.1469999997,16270.851099999698,829.284900000177,814.4627000000461,760.3822000000133,3918.2763000001232,3901.5307000001617,3734.181100000161,437041.0,431832.0,,6432.796146002896,632747.0,626294.0,,16352.816999999795,154382.8234999908,154385.56559999034,154277.2765999872,77704.25639999637,78042.48360000661,78444.53550000662,54.0,86032168.87500001,,8829298363.544981,2926601697.555,101576440.44,807894.0899999997,172.0,23774.0,-29021792.0,12988334.0,-15061704.0,-16389996.0,-26.5,0.0,,382410.0,0.0,0.0,0.0,0.0,0.0,-1628.0,-532.0,-618.0,-1995.0,309543121.57500035,4409135602.560003,4950964962.675003,71934940.61999995,4408795852.560003,319229.0,-22127389.0,5140631373.0,228796573.0,1159170952.0,501070020.0,1215443429.0,317637.5,4967.0,900.1704239819636,7295517.5,2635100.0,1622657.0,-5316295.0,1593292.0,104003.0,3486452296.9950624,3530138524.24505,-212172257.0,-210402567.0,3728003.0,175909.0,,,,,,,,,,,,,,,,,,,,,1469289.0,14852109.0,3236541.0,8566761.0,11622424.0,1417710.0,1061218437.5520012,,72195628374.29213,21699048109.32012,583477324.4969988,5792665.7475,689.5,94245.0,-277277293.5,22010321.0,-123935435.0,-218981122.0,-2025150.5,,,,,,,,,,,,,,,,,,,,,4278678.0,2482588.0,-9015310.5,921451.5,37582.5,3738731109.367456,3663389583.089957,-260966917.0,-257650607.0,2529596.5,269573.0,3931209786.937453,33293768211.31592,36726108986.63265,1732079285.3025498,48145643137.10322,3993161.5,-247895941.5,103220980203.5,1056374138.5,17292590496.5,3508248240.0,18907533170.0,3676752.0,72026.5,20898.22518295922,89868506.5,-161.9388880717753,3.3097142857142856,5.8972198820556025,219.69971494847144,19.518112889637734,727.1432851323124,110250.0,1.0,0.0,0.0,0.0,0.0,0.0,0.0,0.0,1.0,0.0,0.0,0.0,1.0,0.0,0.0,0.0,0.0,0.0,0.0,0.0,1.0,0.0,1.0,0.0,0.0,0.0,0.0,1.0,0.0,0.0,0.0,0.0,0.0,0.0,0.0,1.0,0.0,0.0,0.0,0.0,0.0,0.0,0.0,0.0,0.0,0.0,0.0,0.0,0.0,0.0,0.0,0.0,0.0,0.0,0.0,0.0,0.0,0.0,0.0,0.0,0.0,0.0,0.0,0.0,0.0,0.0,0.0,0.0,0.0,0.0,0.0,0.0,0.0,0.0,0.0,0.0,0.0,0.0,0.0,0.0,0.0,0.0,0.0,0.0,1.0,0.0,0.0,0.0,0.0,0.0,0.0,0.0,0.0,0.0,0.0,0.0,0.0,0.0,0.0,0.0,0.0,0.0,0.0,0.0,0.0,0.0,0.0,0.0,0.0,0.0,1.0,0.0,1.0,0.0,0.0,0.0,0.0,0.0,0.0,1.0,0.0,0.0
105367,0,0.0,1.0,1.0,0.0,0.0,180000.0,156384.0,16969.5,135000.0,0.025164,38.2958904109589,-1588.0,-9299.0,-4256.0,1.0,2.0,2.0,2.0,10.0,0.2678317960516546,0.66581507642223,0.3312508645909018,0.0928,0.1008,0.9762,0.6736,0.0132,0.0,0.2069,0.1667,,0.0199,,0.0821,,0.0169,0.0945,0.1046,0.9762,0.6864,0.0119,0.0,0.2069,0.1667,,0.0203,,0.0757,,0.0,0.0937,0.1008,0.9762,0.6779999999999999,0.014,0.0,0.2069,0.1667,,0.0202,,0.0883,,0.0,0.0682,1.0,3.0,0.0,3.0,0.0,-2187.0,0.0,0.0,0.0,0.0,1.0,2.0,1.0,1.0,0.0,1.0,0.0,0.0,0.0,0.0,0.0,0.0,0.0,0.0,0.0,1.0,0.0,0.0,0.0,0.0,0.0,0.0,0.0,0.0,0.0,0.0,0.0,0.0,0.0,0.0,0.0,0.0,0.0,0.0,9.0,0.0,0.0,74317.5,0.0,0.0,0.0,0.0,0.0,-1156.0,-852.0,-850.0,-1223.0,432.0,-30.5,6.0,35743.23,249750.0,297204.75,1233.0,249750.0,12.0,-936.5,365243.0,-618.5,-386.0,-288.5,-372.0,13.0,1.0,0.0528816071399803,-1.0,28.0,12.0,4.0,-23.5,0.0,0.0,30.0,25822.98,25822.98,-556.0,-549.0,4.0,1.0,12.0,0.0,765000.0,0.0,0.0,0.0,0.0,0.0,0.0,0.0,0.0,0.0,0.0,0.0,0.0,0.0,0.0,3.0,-8.5,0.0,0.0,8357732298.0,184588887330.0,165754287751.5,52036570405.935,1863.0,1706.0,71127.0,70974.0,9141.0,506728.0,17830.83110000231,17893.134599999117,17344.189199998,11309.929300000094,11247.755900000097,11195.181900000063,128575.0,663648.0,4142.925200000114,4140.607100000013,3951.1719000000935,13544347.52054754,-602690131.0,-923056669.0,-296891984.0,-1537132138.0416667,44083.0,30750.0,11362.453999999192,11238.399999998986,10722.377399997293,22917.09600000981,22838.85660000977,22223.655900008336,67573.33984161954,158235.41808399538,126267.40773223426,35045.386100028016,34985.49350002846,34430.927600028874,,,,3718715.0,8306.112900000162,8410.790900000078,8134.21460000023,,,,16488.735399999725,16674.2352999997,16270.926799999696,,,,3918.2932000001233,3901.5307000001617,3734.181100000161,437044.0,431835.0,1264680.0,6432.821310002895,632749.0,626296.0,,16352.885199999797,154383.7996999908,154386.54179999034,154278.2527999872,77704.92999999638,78043.16160000661,78445.22190000664,39.0,86039292.37500001,29963350.845,8830961322.07498,2926943504.055,101576440.44,807894.0899999997,172.0,23774.0,-29031902.0,12981929.0,-15065204.0,-16398407.0,-19.0,0.0,0.0,65173.05,0.0,0.0,0.0,0.0,0.0,-2381.0,-1774.0,-925.0,-1801.0,309759618.51000035,4411932352.560003,4954101390.675003,71938423.61999995,4411932352.560003,319373.0,-22132058.5,5141726924.5,228794403.5,1159169743.0,501250708.0,1215442275.0,317718.5,4970.0,900.3178611464131,7295515.5,2635750.0,1623084.5,-5316980.0,1593292.5,104003.5,3487904768.880062,3531590996.130049,-212192509.0,-210422597.5,3728236.0,175943.5,3189867683.984953,8689234500.0,271004871.375,415976200.42499983,12506324.535000002,132034174.64999989,180969523.19999924,454513672.03499246,419273200.7099989,3062680152.9300127,3178233494.4149394,3178401052.724939,13814.0,36565.0,177.0,22574.0,1043653.5,-1859045.5,813903.0,1762.0,1469298.0,14852541.0,3236553.0,8566789.0,11622454.0,1417716.0,1061218437.5520012,802228181.2874953,72195702691.79213,21699048109.32012,583477324.4969988,5792665.7475,689.5,94245.0,-277278449.5,22009469.0,-123936285.0,-218982345.0,-2025181.0,5928470357.9849615,18748980000.0,198880482.825,448407298.07999766,1948107.735,257088950.66250083,309393489.73499864,637101757.0349978,459529174.4174992,5713452043.155035,5891719853.969997,5891963036.714999,13394.0,80972.0,44.0,70474.5,972355.0,-1700607.5,177364.0,6755.0,4278690.0,2482592.0,-9015334.0,921451.5,37582.5,3738756932.347457,3663415406.069957,-260967473.0,-257651156.0,2529600.5,269574.0,3931245530.167453,33294017961.31592,36726406191.38265,1732080518.3025498,48145892887.10322,3993173.5,-247896878.0,103221345446.5,1056373520.0,17292590110.5,3508247951.5,18907532798.0,3676765.0,72027.5,20898.27806456636,89868505.5,-41.46659035627415,0.8688,10.60726597719438,406.2146954225289,9.215592680986475,352.91932738309305,90000.0,1.0,0.0,0.0,1.0,0.0,0.0,0.0,0.0,0.0,0.0,0.0,0.0,0.0,0.0,0.0,1.0,0.0,0.0,0.0,0.0,1.0,0.0,1.0,0.0,0.0,0.0,0.0,1.0,0.0,0.0,0.0,0.0,0.0,0.0,0.0,0.0,0.0,0.0,0.0,0.0,1.0,0.0,0.0,0.0,0.0,0.0,0.0,0.0,0.0,0.0,0.0,0.0,0.0,0.0,0.0,1.0,0.0,0.0,0.0,0.0,0.0,0.0,0.0,0.0,0.0,0.0,0.0,0.0,0.0,0.0,0.0,0.0,0.0,0.0,0.0,0.0,0.0,0.0,0.0,0.0,0.0,0.0,0.0,0.0,0.0,0.0,0.0,0.0,0.0,0.0,0.0,0.0,0.0,0.0,0.0,0.0,0.0,0.0,0.0,0.0,0.0,0.0,0.0,0.0,0.0,0.0,0.0,0.0,0.0,0.0,1.0,0.0,1.0,0.0,0.0,0.0,0.0,0.0,0.0,1.0,0.0,0.0
105370,0,0.0,0.0,0.0,1.0,0.0,157500.0,1928304.0,79708.5,1800000.0,0.04622,40.03287671232877,-1112.0,-3759.0,-5224.0,,2.0,1.0,1.0,18.0,0.7988064562287104,0.7678885036408941,0.5298898341969072,0.0371,0.0695,0.993,0.9048,0.0294,0.0,0.1034,0.0833,0.0417,0.0157,0.0303,0.0398,0.0,0.0,0.0378,0.0721,0.993,0.9085,0.0297,0.0,0.1034,0.0833,0.0417,0.016,0.0331,0.0415,0.0,0.0,0.0375,0.0695,0.993,0.9061,0.0296,0.0,0.1034,0.0833,0.0417,0.016,0.0308,0.0406,0.0,0.0,0.0474,1.0,7.0,0.0,7.0,0.0,-788.0,0.0,0.0,0.0,0.0,0.0,2.0,1.0,1.0,0.0,1.0,1.0,1.0,0.0,0.0,0.0,0.0,0.0,0.0,0.0,1.0,0.0,0.0,0.0,0.0,0.0,0.0,0.0,0.0,0.0,0.0,0.0,0.0,0.0,0.0,0.0,0.0,0.0,0.0,5.0,0.0,0.0,472500.0,0.0,0.0,0.0,0.0,0.0,-1262.0,-213.0,-7.0,-454.0,203.0,-20.0,1.0,31694.625,703543.5,703543.5,0.0,703543.5,24.0,-788.0,365243.0,-757.0,-67.0,-67.0,-60.0,15.0,0.0,0.0,135.0,25.0,24.0,12.0,-14.0,0.0,0.0,24.0,31694.625,31694.625,-420.0,-412.0,12.5,1.0,0.0,,,,,,,,,,,,,,,,,,,,,8357812006.5,184590815634.0,165756087751.5,52036727905.935,1863.0,1706.0,71127.0,70974.0,9141.0,506730.0,17830.86820000231,17893.17209999912,17344.226999997998,11309.998800000096,11247.825400000096,11195.254000000064,128575.0,663650.0,4142.954600000115,4140.636700000013,3951.2016000000935,13544387.553424256,-602691243.0,-923061893.0,-296892772.0,-1537135897.0416667,44083.0,30750.0,11362.453999999192,11238.399999998986,10722.377399997293,22917.19940000981,22838.96000000977,22223.759300008336,67574.13864807576,158236.18597249902,126267.93762206844,35045.469400028014,34985.57680002846,34431.010900028865,22979.75369999589,22952.816799995468,22599.455899995697,3718733.0,8306.128600000162,8410.806900000078,8134.230600000231,9828.535500000718,9943.586000002157,10303.840699999637,16488.775199999724,16674.2758999997,16270.968299999697,829.284900000177,814.4627000000461,760.3822000000133,3918.2932000001233,3901.5307000001617,3734.181100000161,437051.0,431842.0,,6432.867530002895,632750.0,626297.0,,16352.932599999796,154384.7926999908,154387.53479999036,154279.2457999872,77705.83479999637,78044.0677000066,78446.13040000664,42.0,86194060.87500001,29963350.845,8850330321.25498,2932402794.705,101855842.29,807894.0899999997,172.0,23774.0,-29049321.0,12979944.0,-15072549.0,-16407027.0,-20.5,0.0,0.0,472500.0,0.0,0.0,0.0,0.0,0.0,-1262.0,-213.0,-7.0,-454.0,309923686.3050004,4414769601.885003,4957089003.675003,71989839.94499995,4414769601.885003,319539.0,-22152763.0,5145379177.0,229146064.0,1159889291.0,501790861.0,1216161903.0,317952.0,4974.0,901.0581470621888,7299553.0,2637415.0,1624209.0,-5321827.0,1593302.0,104004.0,3489370274.137557,3533024146.342545,-212321229.5,-210550279.5,3728840.0,176034.5,,,,,,,,,,,,,,,,,,,,,1469303.0,14852744.0,3236553.0,8566814.0,11622478.0,1417717.0,1061218437.5520012,802228181.2874953,72196175191.79213,21699048109.32012,583477324.4969988,5792665.7475,689.5,94245.0,-277279711.5,22009256.0,-123936292.0,-218982799.0,-2025201.0,,,,,,,,,,,,,,,,,,,,,4278714.0,2482604.0,-9015348.0,921451.5,37582.5,3738788626.972457,3663447100.694957,-260967893.0,-257651568.0,2529613.0,269575.0,3931277224.792453,33294721504.81592,36727109734.88265,1732080518.3025498,48146596430.60322,3993197.5,-247897666.0,103221710689.5,1056372763.0,17292590043.5,3508247884.5,18907532738.0,3676780.0,72027.5,20898.27806456636,89868640.5,-27.77716944976732,12.2432,1.9759498673290803,79.10295742852745,24.1919494156834,968.4733283889472,78750.0,-0.9009688679024191,0.4338837391175582,0.0,0.0,0.0,0.0,0.0,1.0,0.0,0.0,0.0,0.0,1.0,0.0,0.0,0.0,0.0,1.0,0.0,0.0,0.0,0.0,1.0,0.0,0.0,0.0,0.0,1.0,0.0,0.0,0.0,0.0,0.0,0.0,0.0,1.0,0.0,0.0,0.0,0.0,0.0,0.0,0.0,0.0,0.0,0.0,0.0,0.0,0.0,0.0,0.0,0.0,0.0,0.0,0.0,0.0,0.0,0.0,0.0,0.0,0.0,1.0,0.0,0.0,0.0,0.0,0.0,0.0,0.0,0.0,0.0,0.0,0.0,0.0,0.0,0.0,0.0,0.0,0.0,0.0,0.0,0.0,0.0,0.0,0.0,0.0,0.0,0.0,0.0,0.0,0.0,0.0,0.0,0.0,0.0,0.0,0.0,0.0,0.0,0.0,0.0,0.0,0.0,0.0,0.0,0.0,0.0,0.0,0.0,0.0,0.0,1.0,1.0,0.0,0.0,0.0,0.0,0.0,0.0,1.0,0.0,0.0
105377,0,0.0,0.0,0.0,1.0,2.0,108000.0,119893.5,12717.0,103500.0,0.0196889999999999,35.049315068493144,-1542.0,-2775.0,-1633.0,,4.0,2.0,2.0,11.0,0.2389971037948251,0.5575094657746016,0.5971924268337128,,,,,,,,,,,,,,,,,,,,,,,,,,,,,,,,,,,,,,,,,,,,1.0,8.0,0.0,8.0,0.0,-1140.0,0.0,0.0,0.0,0.0,1.0,1.0,1.0,1.0,0.0,1.0,0.0,0.0,0.0,0.0,0.0,0.0,1.0,1.0,0.0,1.0,0.0,0.0,0.0,0.0,0.0,0.0,0.0,0.0,0.0,0.0,0.0,0.0,0.0,0.0,0.0,0.0,0.0,0.0,5.0,0.0,,162000.0,9207.0,0.0,0.0,0.0,0.0,-367.0,935.0,-105.0,-920.0,82.0,-8.0,1.0,8501.13,242820.0,218538.0,24282.0,242820.0,36.0,-1140.0,365243.0,-1106.0,-596.0,-56.0,-592.0,13.0,0.0,0.1089090909090909,131.0,19.0,36.0,27.0,-28.0,0.0,0.0,23.0,8501.13,8501.13,-833.0,-836.0,10.0,1.0,0.0,,,,,,,,,,,,,,,,,,,,,8357824723.5,184590935527.5,165756191251.5,52036835905.935,1863.0,1706.0,71127.0,70975.0,9141.0,506731.0,,,,,,,128577.0,663654.0,,,,13544422.602739325,-602692785.0,-923063526.0,-296893912.0,-1537138672.0416667,44083.0,30750.0,,,,,,,67574.37764517956,158236.7434819648,126268.53481449527,,,,,,,3718744.0,,,,,,,,,,,,,,,,437059.0,431850.0,,6432.887219002895,632752.0,626299.0,,,,,,,,,13.0,86406094.71000001,,8864520303.689978,2939893811.775,102219461.37,807894.0899999997,173.0,23774.0,-29084772.0,12978662.0,-15089504.0,-16426730.0,-6.0,0.0,,175113.0,0.0,0.0,0.0,0.0,0.0,-372.0,741.0,-237.0,-920.0,310393039.8150004,4424013159.885003,4967178525.675003,72079034.44499995,4424013159.885003,320169.0,-22175150.0,5150491307.0,229131957.0,1161707181.0,502518709.0,1217980033.0,318336.0,4978.0,902.007892604222,7301721.0,2642268.0,1627432.0,-5326049.0,1593309.0,104008.0,3495087579.5550594,3538801039.635046,-212482049.0,-210708760.0,3732518.0,176245.0,,,,,,,,,,,,,,,,,,,,,1469308.0,14852826.0,3236553.0,8566833.0,11622501.0,1417718.0,1061218437.5520012,,72196337191.79213,21699057316.32012,583477324.4969988,5792665.7475,689.5,94245.0,-277280078.5,22010191.0,-123936397.0,-218983719.0,-2025209.0,,,,,,,,,,,,,,,,,,,,,4278750.0,2482631.0,-9015376.0,921451.5,37582.5,3738797128.102457,3663455601.824957,-260968726.0,-257652404.0,2529623.0,269576.0,3931285725.922453,33294964324.81592,36727328272.88265,1732104800.3025498,48146839250.60322,3993233.5,-247898806.0,103222075932.5,1056371657.0,17292589447.5,3508247828.5,18907532146.0,3676793.0,72027.5,20898.386973657267,89868771.5,-43.99515359962479,1.110125,8.492569002123142,297.6587266963325,9.427813163481954,330.4383939737661,27000.0,-0.9009688679024191,0.4338837391175582,0.0,0.0,0.0,0.0,0.0,0.0,1.0,0.0,0.0,0.0,1.0,0.0,0.0,0.0,0.0,0.0,0.0,0.0,1.0,0.0,1.0,0.0,0.0,0.0,0.0,1.0,0.0,0.0,0.0,0.0,0.0,1.0,0.0,0.0,0.0,0.0,0.0,0.0,0.0,0.0,0.0,0.0,0.0,0.0,0.0,0.0,0.0,0.0,0.0,0.0,0.0,0.0,0.0,1.0,0.0,0.0,0.0,0.0,0.0,0.0,0.0,0.0,0.0,0.0,0.0,0.0,0.0,0.0,0.0,0.0,0.0,0.0,0.0,0.0,0.0,0.0,0.0,0.0,0.0,0.0,0.0,0.0,0.0,0.0,0.0,0.0,0.0,0.0,0.0,0.0,0.0,0.0,0.0,0.0,0.0,0.0,0.0,0.0,0.0,0.0,0.0,0.0,0.0,0.0,0.0,0.0,0.0,0.0,0.0,0.0,0.0,0.0,0.0,0.0,0.0,0.0,0.0,0.0,0.0,0.0
105390,0,0.0,1.0,1.0,0.0,2.0,432000.0,305640.0,32094.0,270000.0,0.015221,29.936986301369863,-2185.0,-549.0,-3293.0,1.0,4.0,2.0,2.0,11.0,,0.2554913493998412,0.7180328113294772,,,,,,,,,,,,,,,,,,,,,,,,,,,,,,,,,,,,,,,,,,,,,2.0,0.0,2.0,0.0,-546.0,0.0,0.0,0.0,0.0,0.0,2.0,1.0,1.0,1.0,1.0,0.0,0.0,0.0,0.0,0.0,0.0,0.0,0.0,0.0,1.0,0.0,0.0,0.0,0.0,0.0,0.0,0.0,0.0,0.0,0.0,0.0,0.0,0.0,0.0,0.0,0.0,0.0,0.0,6.0,0.0,0.0,122512.5,0.0,0.0,0.0,0.0,0.0,-813.0,-34.0,-319.0,-341.0,171.0,-14.0,3.0,20891.745,112635.0,120811.5,0.0,112635.0,6.0,-546.0,365243.0,-122.0,365243.0,28.0,365243.0,10.0,0.0,0.0,5.0,18.0,12.0,5.0,-9.5,0.0,0.0,16.0,20891.745,20891.745,-299.0,-290.0,4.5,1.0,18.0,0.0,135000.0,,0.0,,,0.0,,0.0,0.0,0.0,0.0,,0.0,,,0.0,-9.5,0.0,0.0,8357856817.5,184591241167.5,165756461251.5,52037267905.935,1863.0,1706.0,71127.0,70975.0,9141.0,506733.0,,,,,,,128579.0,663658.0,,,,13544452.539725626,-602694970.0,-923066819.0,-296894458.0,-1537139221.0416667,44083.0,30750.0,,,,,,,,158236.99897331418,126269.25284730662,,,,,,,3718755.0,,,,,,,,,,,,,,,,437061.0,431852.0,1264681.0,6432.902440002896,632754.0,626301.0,,,,,,,,,27.0,86694837.21000001,30040477.65,8892997565.039976,2949038238.3750005,102220205.175,807894.0899999997,174.0,23774.0,-29159426.0,13001758.5,-15124293.0,-16462682.5,-13.0,0.0,0.0,152550.0,0.0,0.0,0.0,0.0,0.0,-1046.0,248.0,-323.0,-359.0,310820750.59500027,4429286637.885003,4972820958.675003,72225761.44499995,4429286637.885003,320514.0,-22208589.0,5159987293.0,229836939.0,1163879086.0,503597746.0,1220152119.0,318952.0,4987.0,904.1342995834708,7310162.0,2646195.0,1629762.0,-5336183.0,1593344.0,104015.0,3500181036.8775635,3543583327.447545,-212780233.0,-211003754.5,3734250.0,176548.5,3195533096.864953,8710272000.0,,417271350.7349998,,,181258219.7099992,,420331449.1949987,3068131905.900014,3183853364.234939,3184020922.544938,,36645.0,,,1044176.0,-1859927.5,813903.0,1762.0,1469314.0,14852997.0,3236571.0,8566851.0,11622517.0,1417721.0,1061218437.5520012,802228181.2874953,72196459704.29213,21699057316.32012,583477324.4969988,5792665.7475,689.5,94245.0,-277280891.5,22010157.0,-123936716.0,-218984060.0,-2025223.0,5928470357.9849615,18749115000.0,,448407298.07999766,,,309393489.73499864,,459529174.4174992,5713452043.155035,5891719853.969997,5891963036.714999,,80972.0,,,972355.0,-1700617.0,177364.0,6755.0,4278762.0,2482636.0,-9015385.5,921451.5,37582.5,3738818019.847457,3663476493.569957,-260969025.0,-257652694.0,2529627.5,269577.0,3931306617.667453,33295076959.81592,36727449084.38265,1732104800.3025498,48146951885.60322,3993239.5,-247899352.0,103222441175.5,1056371535.0,17292954690.5,3508247856.5,18907897389.0,3676803.0,72027.5,20898.386973657267,89868776.5,-72.986638601629,0.7075,13.460459899046551,402.965603607895,9.523275378575434,285.0981645525857,108000.0,-0.9009688679024191,0.4338837391175582,0.0,0.0,0.0,0.0,0.0,0.0,1.0,0.0,0.0,0.0,1.0,0.0,0.0,0.0,0.0,1.0,0.0,0.0,0.0,0.0,1.0,0.0,0.0,0.0,0.0,1.0,0.0,0.0,0.0,0.0,0.0,0.0,0.0,0.0,0.0,0.0,0.0,0.0,0.0,0.0,1.0,0.0,0.0,0.0,0.0,0.0,0.0,0.0,0.0,0.0,0.0,0.0,0.0,0.0,0.0,0.0,0.0,0.0,0.0,0.0,0.0,0.0,0.0,0.0,0.0,0.0,0.0,0.0,0.0,0.0,0.0,0.0,0.0,0.0,0.0,0.0,0.0,0.0,0.0,0.0,0.0,0.0,0.0,0.0,0.0,0.0,0.0,0.0,0.0,1.0,0.0,0.0,0.0,0.0,0.0,0.0,0.0,0.0,0.0,0.0,0.0,0.0,0.0,0.0,0.0,0.0,0.0,0.0,0.0,0.0,0.0,0.0,0.0,0.0,0.0,0.0,0.0,0.0,0.0,0.0
105399,0,0.0,1.0,0.0,1.0,1.0,202500.0,285264.0,29952.0,252000.0,0.005313,36.49589041095891,-5654.0,-5715.0,-4329.0,,3.0,2.0,2.0,9.0,0.5779539269931445,0.6241713738080847,0.6626377922738201,0.2969,0.2009,0.9846,0.7892,,0.32,0.2759,0.3333,0.375,0.3216,0.2421,0.1717,0.0,0.0,0.3025,0.2085,0.9846,0.7975,,0.3222,0.2759,0.3333,0.375,0.3289,0.2645,0.1789,0.0,0.0,0.2998,0.2009,0.9846,0.792,,0.32,0.2759,0.3333,0.375,0.3272,0.2463,0.1748,0.0,0.0,0.2757,1.0,0.0,0.0,0.0,0.0,-1357.0,0.0,0.0,0.0,0.0,1.0,1.0,1.0,1.0,0.0,1.0,0.0,0.0,0.0,0.0,0.0,0.0,0.0,0.0,0.0,1.0,0.0,0.0,0.0,0.0,0.0,0.0,0.0,0.0,0.0,0.0,0.0,0.0,0.0,0.0,0.0,0.0,0.0,0.0,4.0,0.0,0.0,103118.76,0.0,0.0,0.0,0.0,0.0,-951.0,-797.5,-659.0,-1210.0,125.0,-15.0,6.0,5258.79,29223.0,27321.75,3802.5,38016.0,9.0,-850.5,365243.0,-819.0,-789.0,-624.0,-781.0,15.0,0.0,0.1089348743112947,24.5,18.0,6.0,3.0,-31.5,0.0,0.0,13.0,6035.94,6035.94,-977.0,-959.0,2.0,1.0,0.0,,,,,,,,,,,,,,,,,,,,,8357886769.5,184591526431.5,165756713251.5,52037470405.935,1863.0,1706.0,71127.0,70976.0,9141.0,506734.0,17831.165100002312,17893.47189999912,17344.529499998,11310.199700000096,11248.026300000096,11195.462500000063,128580.0,663661.0,,,,13544489.035616037,-602700624.0,-923071148.0,-296895815.0,-1537144936.0416667,44083.0,30750.0,11362.773999999192,11238.719999998986,10722.69959999729,22917.47530000981,22839.23590000977,22224.035200008337,67574.95559910653,158237.62314468806,126269.9154850989,35045.80270002802,34985.910100028465,34431.34420002887,22980.12869999589,22953.191799995468,22599.830899995697,3718764.0,8306.450200000161,8411.134100000078,8134.55950000023,9828.777600000718,9943.832300002156,10304.105199999636,16488.946899999723,16674.4506999997,16271.147199999696,829.284900000177,814.4627000000461,760.3822000000133,3918.2932000001233,3901.5307000001617,3734.181100000161,437061.0,431852.0,,6432.907753002895,632756.0,626303.0,,16353.208299999797,154385.7772999908,154388.51939999036,154280.2303999872,77706.62399999637,78044.85970000661,78446.92790000665,32.0,86694837.21000001,30040477.65,8904669852.104977,2955200441.3550005,102222455.175,807894.0899999997,174.0,23774.0,-29192516.5,13024056.5,-15139921.0,-16475999.0,-15.5,0.0,0.0,21737.52,0.0,0.0,0.0,0.0,0.0,-1356.0,-1231.0,-962.0,-1210.0,311390692.53750026,4438449743.535003,4983377011.425003,72268219.84499995,4438458453.285003,321344.0,-22239577.0,5166378352.5,229817626.5,1164960848.5,503951825.5,1221599620.5,319437.5,4989.0,905.0668285964928,7319535.0,2650655.0,1632093.0,-5346736.0,1593386.0,104025.0,3503966811.7050643,3547200672.180047,-213188857.0,-211411001.0,3741139.0,176753.0,,,,,,,,,,,,,,,,,,,,,1469318.0,14853122.0,3236571.0,8566869.0,11622530.0,1417727.0,1061218437.5520012,802228181.2874953,72196562823.05212,21699057316.32012,583477324.4969988,5792665.7475,689.5,94245.0,-277281842.5,22009359.5,-123937375.0,-218985270.0,-2025238.0,,,,,,,,,,,,,,,,,,,,,4278768.0,2482639.0,-9015417.0,921451.5,37582.5,3738824055.787457,3663482529.509957,-260970002.0,-257653653.0,2529629.5,269578.0,3931311876.457453,33295106182.81592,36727476406.13265,1732108602.8025498,48146989901.60322,3993248.5,-247900202.5,103222806418.5,1056370716.0,17292953901.5,3508247232.5,18907896608.0,3676818.0,72027.5,20898.495908531582,89868801.0,-154.92155243600328,1.4087111111111108,6.760817307692308,246.7420475500527,9.524038461538463,347.5882639620653,67500.0,1.0,0.0,0.0,0.0,0.0,0.0,0.0,0.0,1.0,0.0,0.0,0.0,1.0,0.0,0.0,0.0,0.0,1.0,0.0,0.0,0.0,0.0,1.0,0.0,0.0,0.0,0.0,1.0,0.0,0.0,0.0,0.0,0.0,0.0,0.0,0.0,1.0,0.0,0.0,0.0,0.0,0.0,0.0,0.0,0.0,0.0,0.0,0.0,0.0,0.0,0.0,0.0,0.0,0.0,0.0,0.0,0.0,0.0,0.0,0.0,0.0,0.0,0.0,0.0,0.0,0.0,0.0,0.0,0.0,0.0,0.0,0.0,0.0,0.0,0.0,0.0,0.0,0.0,0.0,0.0,0.0,1.0,0.0,0.0,0.0,0.0,0.0,0.0,0.0,0.0,0.0,0.0,0.0,0.0,0.0,0.0,0.0,0.0,0.0,0.0,0.0,0.0,0.0,0.0,0.0,0.0,0.0,0.0,0.0,0.0,1.0,0.0,1.0,0.0,0.0,0.0,0.0,0.0,0.0,1.0,0.0,0.0
105403,0,0.0,0.0,0.0,1.0,0.0,90000.0,179865.0,14341.5,148500.0,0.035792,56.27671232876714,,-9452.0,-3671.0,,2.0,2.0,2.0,14.0,0.7332770819551621,0.5641932882935721,0.25533177083329,,,,,,,,,,,,,,,,,,,,,,,,,,,,,,,,,,,,,,,,,,,,,0.0,0.0,0.0,0.0,-739.0,0.0,0.0,0.0,0.0,2.0,3.0,1.0,0.0,0.0,1.0,0.0,0.0,0.0,0.0,0.0,0.0,0.0,0.0,0.0,1.0,0.0,0.0,0.0,0.0,0.0,0.0,0.0,0.0,0.0,0.0,0.0,0.0,0.0,0.0,0.0,0.0,0.0,0.0,2.0,17208.0,,378947.25,487053.0,0.0,0.0,0.0,0.0,-779.5,666.5,-92.0,-168.0,52.0,-15.5,14.0,12074.31,112500.0,121410.0,8532.0,225000.0,24.0,-420.0,365243.0,-483.5,182423.0,680.5,182426.5,16.0,0.5,0.0994996561285771,-1.0,33.0,24.0,21.0,-14.0,0.0,0.0,56.0,10206.36,10206.36,-280.5,-277.0,7.0,1.0,13.0,86523.3,90000.0,0.0,0.0,0.0,0.0,4271.985,4500.0,4500.0,82675.125,85886.73,85886.73,0.0,0.0,0.0,0.0,4.0,-8.0,0.0,0.0,8357901111.0,184591706296.5,165756861751.5,52037560405.935,1863.0,1706.0,71127.0,70978.0,9141.0,506737.0,,,,,,,128580.0,663663.0,,,,13544545.312328365,,-923074819.0,-296896554.0,-1537154388.0416667,44083.0,30750.0,,,,,,,67575.68887618849,158238.18733797633,126270.17081686977,,,,,,,3718778.0,,,,,,,,,,,,,,,,437061.0,431852.0,,6432.943545002896,632758.0,626305.0,,,,,,,,,26.0,86909149.71000001,,8918165269.709978,2962286521.6050005,102222455.175,807894.0899999997,174.0,23774.0,-29209458.0,13037889.0,-15148579.0,-16486059.0,-12.5,17208.0,,225000.0,487053.0,0.0,0.0,0.0,0.0,-1262.0,-168.0,-168.0,-168.0,311806974.3750003,4442571331.785003,4987767560.175003,72312751.84499995,4442803081.785003,321577.0,-22262428.0,5172587288.5,230165299.5,1165677244.5,504305648.5,1222316105.0,319832.5,4994.5,905.7244772857488,7325960.5,2652563.0,1633361.0,-5351602.0,1593386.0,104025.0,3507440699.67757,3550619514.3525515,-213324496.5,-211544975.5,3741870.5,176902.5,3199237095.194955,8722786500.0,272446671.375,417919079.4299998,12506324.535000002,132532098.65999988,181541081.2049992,456554928.5099912,421182096.47999865,3071669056.920016,3187549600.739939,3187717159.0499377,13857.0,36742.0,177.0,22708.0,1046727.0,-1864955.0,813907.0,1763.0,1469320.0,14853174.0,3236584.0,8566902.0,11622586.0,1417741.0,1061235645.5520012,,72196941770.30212,21699544369.32012,583477324.4969988,5792665.7475,689.5,94245.0,-277282622.0,22010026.0,-123937467.0,-218985438.0,-2025253.5,5928556881.284962,18749205000.0,198880482.825,448407298.07999766,1948107.735,257088950.66250083,309397761.71999866,637106257.0349978,459533674.4174992,5713534718.280035,5891805740.699998,5892048923.445,13394.0,80972.0,44.0,70474.5,972359.0,-1700625.0,177364.0,6755.0,4278792.0,2482660.0,-9015431.0,921451.5,37582.5,3738834262.147457,3663492735.869957,-260970282.5,-257653930.0,2529636.5,269579.0,3931323950.767453,33295218682.81592,36727597816.13265,1732117134.8025498,48147214901.60322,3993272.5,-247900622.5,103223171661.5,1056370232.5,17293136324.5,3508247913.0,18908079034.5,3676834.0,72028.0,20898.595408187703,89868800.0,,1.9985,6.2754941951678695,353.1641815423102,12.541575149042988,705.7986168123068,45000.0,-0.9009688679024191,-0.433883739117558,0.0,0.0,0.0,0.0,0.0,0.0,1.0,0.0,0.0,1.0,0.0,0.0,0.0,0.0,0.0,0.0,0.0,0.0,1.0,0.0,1.0,0.0,0.0,0.0,0.0,1.0,0.0,0.0,0.0,0.0,0.0,0.0,0.0,0.0,0.0,0.0,0.0,0.0,0.0,0.0,0.0,0.0,0.0,0.0,0.0,0.0,0.0,0.0,0.0,0.0,0.0,0.0,0.0,0.0,0.0,0.0,0.0,0.0,0.0,0.0,0.0,0.0,0.0,0.0,0.0,0.0,0.0,0.0,0.0,0.0,0.0,0.0,0.0,0.0,0.0,0.0,0.0,0.0,0.0,0.0,0.0,0.0,0.0,0.0,0.0,0.0,0.0,0.0,0.0,0.0,0.0,0.0,0.0,0.0,0.0,0.0,0.0,0.0,0.0,0.0,0.0,0.0,0.0,0.0,0.0,1.0,0.0,0.0,0.0,0.0,0.0,0.0,0.0,0.0,0.0,0.0,0.0,0.0,0.0,0.0
105404,0,0.0,0.0,0.0,1.0,1.0,171000.0,900000.0,46084.5,900000.0,0.026392,29.389041095890413,-1041.0,-2928.0,-2004.0,,3.0,2.0,2.0,10.0,,0.7197147309842942,,,,,,,,,,,,,,,,,,,,,,,,,,,,,,,,,,,,,,,,,,,,,,6.0,0.0,6.0,0.0,-908.0,,,,,,,1.0,1.0,0.0,1.0,1.0,0.0,0.0,0.0,0.0,1.0,1.0,0.0,0.0,1.0,0.0,0.0,0.0,0.0,0.0,0.0,0.0,0.0,0.0,0.0,0.0,0.0,0.0,0.0,0.0,0.0,0.0,0.0,0.0,,,,,,,,,,,,,0.0,,2.0,16442.7525,152439.75,150693.75,1746.0,152439.75,11.0,-785.0,365243.0,-873.0,-723.0,-603.0,-719.0,16.0,0.0,0.0545177748325729,29.0,17.0,10.0,6.0,-78.0,0.0,0.0,6.0,29700.0,29700.0,-813.5,-798.0,3.5,1.0,0.0,,,,,,,,,,,,,,,,,,,,,8357947195.5,184592606296.5,165757761751.5,52037731405.935,,,,,,,,,,,,,128581.0,663666.0,,,,13544574.70136946,-602701665.0,-923076823.0,-296897462.0,-1537157316.0416667,44083.0,30750.0,,,,,,,,158238.9070527073,,,,,,,,3718788.0,,,,,,,,,,,,,,,,437067.0,431858.0,,6432.969937002896,632760.0,626307.0,,,,,,,,,,,,,,,,,,,,,,,,,,,,,,,,,,,311875952.1750003,4443647961.285003,4988978654.175003,72316243.84499995,4443647961.285003,321678.0,-22266709.0,5173134958.0,230163726.0,1166041560.0,504670279.0,1222680427.0,319960.5,4995.0,905.833512835414,7326221.5,2653155.0,1633818.0,-5352587.0,1593386.0,104025.0,3507866283.105069,3551045097.7800508,-213334061.5,-211554442.5,3742190.5,176911.5,,,,,,,,,,,,,,,,,,,,,1469320.0,14853174.0,3236584.0,8566919.0,11622592.0,1417743.0,,,,,,,,,,,,,,,,,,,,,,,,,,,,,,,,,,4278802.0,2482666.0,-9015509.0,921451.5,37582.5,3738863962.147457,3663522435.869957,-260971096.0,-257654728.0,2529640.0,269580.0,3931340393.519953,33295371122.56592,36727748509.88265,1732118880.8025498,48147367341.35322,3993283.5,-247901407.5,103223536904.5,1056369359.5,17293135601.5,3508247310.0,18908078315.5,3676850.0,72028.0,20898.649925962534,89868829.0,-35.421366644914706,5.2631578947368425,3.710575139146568,109.05024525376776,19.52934283761352,573.9486592303566,57000.0,-0.9009688679024191,-0.433883739117558,0.0,1.0,0.0,0.0,0.0,0.0,0.0,0.0,0.0,0.0,1.0,0.0,0.0,0.0,0.0,0.0,0.0,0.0,1.0,0.0,1.0,0.0,0.0,0.0,0.0,1.0,0.0,0.0,0.0,0.0,0.0,0.0,0.0,0.0,0.0,0.0,0.0,0.0,0.0,0.0,0.0,1.0,0.0,0.0,0.0,0.0,0.0,0.0,0.0,0.0,0.0,0.0,0.0,0.0,0.0,0.0,0.0,0.0,0.0,0.0,0.0,0.0,0.0,0.0,0.0,0.0,0.0,0.0,0.0,0.0,0.0,0.0,0.0,0.0,0.0,0.0,0.0,0.0,1.0,0.0,0.0,0.0,0.0,0.0,0.0,0.0,0.0,0.0,0.0,0.0,0.0,0.0,0.0,0.0,0.0,0.0,0.0,0.0,0.0,0.0,0.0,0.0,0.0,0.0,0.0,0.0,0.0,0.0,0.0,0.0,0.0,0.0,0.0,0.0,0.0,0.0,0.0,0.0,0.0,0.0
105414,0,0.0,0.0,0.0,1.0,0.0,382500.0,1347750.0,43605.0,1125000.0,0.020713,51.86849315068493,-6851.0,-3841.0,-2448.0,,2.0,3.0,1.0,14.0,0.6692518455749622,0.5564626649672475,0.4507472818545589,0.1258,0.1348,0.9881,,,0.16,0.1379,0.3333,,0.0575,,0.1764,,0.0265,0.1282,0.1399,0.9881,,,0.1611,0.1379,0.3333,,0.0588,,0.1838,,0.0281,0.127,0.1348,0.9881,,,0.16,0.1379,0.3333,,0.0585,,0.1795,,0.0271,0.1445,1.0,0.0,0.0,0.0,0.0,-883.0,0.0,0.0,0.0,0.0,3.0,1.0,1.0,1.0,0.0,1.0,1.0,0.0,0.0,0.0,0.0,0.0,0.0,0.0,0.0,1.0,0.0,0.0,0.0,0.0,0.0,0.0,0.0,0.0,0.0,0.0,0.0,0.0,0.0,0.0,0.0,0.0,0.0,0.0,7.0,10804.5,0.0,1350000.0,279864.0,0.0,0.0,0.0,0.0,-1288.0,205.0,-667.0,-999.0,284.0,-20.0,4.0,21010.275,154784.25,112686.75,22765.5,227637.0,6.0,-632.0,365243.0,-724.0,-551.0,-521.0,-548.0,11.0,0.0,0.1039867106467358,91.0,21.0,11.0,5.0,-21.0,0.0,0.0,18.0,21010.275,21010.275,-685.0,-626.0,4.5,1.0,0.0,,,,,,,,,,,,,,,,,,,,,8357990800.5,184593954046.5,165758886751.5,52038113905.935,1863.0,1706.0,71127.0,70981.0,9141.0,506738.0,17831.290900002314,17893.598899999117,17344.657699998,11310.334500000095,11248.161100000096,11195.602400000063,128581.0,663668.0,,,,13544626.56986261,-602708516.0,-923079271.0,-296898345.0,-1537161157.0416667,44083.0,30750.0,11362.933999999192,11238.879999998986,10722.860699997287,22917.613200009808,22839.373800009776,22224.17310000834,67576.35812803407,158239.46351537228,126270.6215641516,35046.13600002802,34986.243400028456,34431.67750002887,,,,3718802.0,8306.507700000162,8411.192600000077,8134.618300000231,,,,16489.123299999723,16674.630199999698,16271.330999999696,,,,3918.3197000001232,3901.557800000162,3734.209200000161,437067.0,431858.0,,6432.990650002896,632763.0,626308.0,,16353.352799999797,154386.76539999078,154389.50749999034,154281.21849998718,,,,43.0,87296010.21000001,30056263.110000007,8934297899.759977,2963789056.0350003,103012042.275,807894.0899999997,174.0,23774.0,-29275827.0,13047315.0,-15185949.0,-16523672.0,-21.0,21609.0,0.0,1350000.0,279864.0,0.0,0.0,0.0,0.0,-1401.0,205.0,-667.0,-999.0,312355084.1850003,4449478271.535003,4994881522.425003,72561822.34499995,4449437305.785003,322078.0,-22310335.5,5181534903.0,230499120.0,1167478820.0,505743671.0,1224117862.0,320465.0,5004.0,907.6025508263566,7342565.0,2656352.0,1635488.0,-5364264.0,1593540.0,104065.0,3512314565.257589,3555429273.877568,-213848720.0,-212066948.5,3748810.0,177158.5,,,,,,,,,,,,,,,,,,,,,1469327.0,14853458.0,3236584.0,8566940.0,11622610.0,1417747.0,1061246450.0520012,802228181.2874953,72198291770.30212,21699824233.32012,583477324.4969988,5792665.7475,689.5,94245.0,-277283910.0,22010231.0,-123938134.0,-218986437.0,-2025273.5,,,,,,,,,,,,,,,,,,,,,4278813.0,2482671.0,-9015530.0,921451.5,37582.5,3738884972.422457,3663543446.144957,-260971781.0,-257655354.0,2529644.5,269581.0,3931361403.794953,33295525906.81592,36727861196.63265,1732141646.3025498,48147594978.35322,3993289.5,-247902039.5,103223902147.5,1056368635.5,17293135050.5,3508246789.0,18908077767.5,3676861.0,72028.0,20898.753912673183,89868920.0,-132.08403760828227,3.523529411764706,8.771929824561402,454.9867820235521,30.908152734778124,1603.1593084241626,191250.0,0.6234898018587336,0.7818314824680298,0.0,1.0,0.0,0.0,0.0,0.0,0.0,0.0,0.0,0.0,0.0,0.0,0.0,1.0,0.0,0.0,0.0,0.0,1.0,0.0,1.0,0.0,0.0,0.0,0.0,1.0,0.0,0.0,0.0,0.0,0.0,0.0,0.0,0.0,0.0,0.0,1.0,0.0,0.0,0.0,0.0,0.0,0.0,0.0,0.0,0.0,0.0,0.0,0.0,0.0,0.0,0.0,0.0,0.0,0.0,0.0,0.0,0.0,0.0,1.0,0.0,0.0,0.0,0.0,0.0,0.0,0.0,0.0,0.0,0.0,0.0,0.0,0.0,0.0,0.0,0.0,0.0,0.0,0.0,0.0,0.0,0.0,0.0,0.0,0.0,0.0,0.0,0.0,0.0,0.0,0.0,0.0,0.0,0.0,0.0,0.0,0.0,0.0,0.0,0.0,0.0,0.0,0.0,0.0,0.0,0.0,0.0,0.0,0.0,0.0,1.0,0.0,0.0,0.0,0.0,0.0,0.0,1.0,0.0,0.0
105417,0,0.0,0.0,0.0,1.0,1.0,157500.0,420588.0,38574.0,360000.0,0.022625,40.42739726027396,-2828.0,-142.0,-4266.0,,2.0,2.0,2.0,13.0,0.5240189502168362,0.555976864847712,0.5262949398096192,0.0619,0.0512,0.9767,0.6804,0.022,0.0,0.1034,0.1667,0.2083,0.0396,0.0504,0.051,0.0,0.0,0.063,0.0531,0.9767,0.6929,0.0222,0.0,0.1034,0.1667,0.2083,0.0405,0.0551,0.0532,0.0,0.0,0.0625,0.0512,0.9767,0.6847,0.0221,0.0,0.1034,0.1667,0.2083,0.0403,0.0513,0.0519,0.0,0.0,0.0522,1.0,1.0,0.0,1.0,0.0,0.0,0.0,0.0,0.0,0.0,0.0,2.0,1.0,1.0,0.0,1.0,0.0,1.0,0.0,0.0,0.0,0.0,0.0,0.0,0.0,0.0,0.0,0.0,0.0,0.0,1.0,0.0,0.0,0.0,0.0,0.0,0.0,0.0,0.0,0.0,0.0,0.0,0.0,0.0,3.0,2920.5,0.0,85608.0,0.0,0.0,0.0,0.0,0.0,-1048.0,-773.0,-769.0,-927.0,109.0,-18.0,4.0,10491.525,108956.25,115409.25,0.0,108956.25,12.0,-382.5,365243.0,-352.5,-228.0,110.0,-137.5,13.0,0.0,0.0,20.0,16.0,12.0,10.0,-7.5,0.0,0.0,71.0,3252.6,3252.6,-488.0,-490.0,25.0,0.0,34.0,47135.79,67500.0,0.0,0.0,0.0,0.0,2436.3,4374.405,4374.405,45546.12,47135.79,47135.79,0.0,0.0,0.0,0.0,17.0,-17.5,0.0,0.0,8358029374.5,184594374634.5,165759246751.5,52038271405.935,1863.0,1706.0,71127.0,70981.0,9141.0,506740.0,17831.352800002314,17893.661399999117,17344.720699997997,11310.385700000095,11248.212300000096,11195.655500000064,128582.0,663670.0,4142.976600000115,4140.658800000013,3951.223800000093,13544666.99725987,-602711344.0,-923083537.0,-296898345.0,-1537161299.0416667,44083.0,30750.0,11362.933999999192,11238.879999998986,10722.860699997287,22917.71660000981,22839.477200009776,22224.27650000834,67576.8821469843,158240.01949223713,126271.1478590914,35046.30270002802,34986.410100028465,34431.84420002887,22980.33699999589,22953.400099995462,22600.0391999957,3718815.0,8306.547300000162,8411.232900000077,8134.658800000231,9828.828000000718,9943.883600002157,10304.160299999636,16489.174299999722,16674.682099999696,16271.384199999697,829.284900000177,814.4627000000461,760.3822000000133,3918.3197000001232,3901.557800000162,3734.209200000161,437068.0,431859.0,,6433.013275002894,632765.0,626310.0,,16353.404999999795,154387.74209999078,154390.48419999034,154282.19519998718,77707.30439999637,78045.5444000066,78447.62080000664,35.0,87521732.10000002,30056263.110000007,8947490050.259977,2968125145.65,103042367.505,807894.0899999997,174.0,23774.0,-29294443.0,13108087.0,-15192678.0,-16530429.5,-17.0,0.0,0.0,85608.0,0.0,0.0,0.0,0.0,0.0,-1048.0,-773.0,-769.0,-1081.0,312630342.2775003,4454309847.285003,5000197754.925003,72619516.84499995,4454309847.285003,322384.0,-22320914.0,5184273172.5,230492096.0,1167838947.0,506105246.5,1224843541.0,320713.5,5008.0,908.0841779611766,7343016.0,2657004.0,1635863.0,-5365842.0,1593540.0,104065.0,3513469141.305093,3556582859.070071,-213907640.0,-212124707.0,3750250.0,177212.0,3216949837.784953,8750801250.0,273764271.375,419284019.4299998,12513007.035000002,132572756.15999988,182466102.5549992,457619007.0374916,422235595.0574984,3088915319.4300146,3205216280.519936,3205387603.6199346,13899.0,36788.0,178.0,22711.0,1049061.0,-1870398.5,813909.0,1765.0,1469330.0,14853567.0,3236618.0,8566956.0,11622681.0,1417751.0,1061249370.5520012,802228181.2874953,72198377378.30212,21699824233.32012,583477324.4969988,5792665.7475,689.5,94245.0,-277284958.0,22009458.0,-123938903.0,-218987364.0,-2025291.5,5928604017.074962,18749272500.0,198880482.825,448407298.07999766,1948107.735,257088950.66250083,309400198.01999867,637110631.4399978,459538048.8224992,5713580264.400035,5891852876.489998,5892096059.235,13394.0,80972.0,44.0,70474.5,972376.0,-1700642.5,177364.0,6755.0,4278825.0,2482681.0,-9015537.5,921451.5,37582.5,3738888225.022457,3663546698.744957,-260972269.0,-257655844.0,2529669.5,269581.0,3931371895.319953,33295634863.06592,36727976605.88265,1732141646.3025498,48147703934.60322,3993301.5,-247902422.0,103224267390.5,1056368283.0,17293134822.5,3508246899.0,18908077630.0,3676874.0,72028.0,20898.753912673183,89868940.0,-69.95256166982922,2.6704,4.0830611292580485,165.06753431049802,10.903406439570697,440.79634362275385,78750.0,1.0,0.0,0.0,0.0,0.0,0.0,0.0,0.0,1.0,0.0,0.0,0.0,0.0,0.0,0.0,1.0,0.0,0.0,0.0,0.0,1.0,0.0,0.0,0.0,1.0,0.0,0.0,1.0,0.0,0.0,0.0,0.0,0.0,0.0,0.0,0.0,0.0,0.0,0.0,0.0,0.0,0.0,0.0,0.0,0.0,0.0,0.0,0.0,0.0,0.0,0.0,0.0,0.0,0.0,0.0,1.0,0.0,0.0,0.0,0.0,0.0,0.0,0.0,0.0,0.0,0.0,0.0,0.0,0.0,0.0,0.0,0.0,0.0,0.0,0.0,0.0,0.0,0.0,0.0,0.0,0.0,0.0,0.0,0.0,0.0,0.0,0.0,0.0,0.0,0.0,0.0,0.0,0.0,0.0,0.0,0.0,0.0,0.0,0.0,0.0,0.0,0.0,0.0,0.0,0.0,0.0,0.0,0.0,0.0,0.0,0.0,0.0,1.0,0.0,0.0,0.0,0.0,0.0,0.0,1.0,0.0,0.0
105425,0,0.0,1.0,1.0,1.0,1.0,180000.0,315000.0,16213.5,315000.0,0.020713,41.62191780821918,-767.0,-3320.0,-4125.0,12.0,3.0,3.0,3.0,8.0,,0.3339109900215245,0.4794489811780563,,,,,,,,,,,,,,,,,,,,,,,,,,,,,,,,,,,,,,,,,,,,,3.0,0.0,3.0,0.0,-730.0,0.0,0.0,0.0,0.0,1.0,0.0,1.0,1.0,1.0,1.0,0.0,0.0,0.0,0.0,0.0,0.0,0.0,0.0,0.0,1.0,0.0,0.0,0.0,0.0,0.0,0.0,0.0,0.0,0.0,0.0,0.0,0.0,0.0,0.0,0.0,0.0,0.0,0.0,14.0,0.0,0.0,382500.0,130943.25,0.0,0.0,0.0,0.0,-721.0,701.0,-538.5,-717.0,371.0,-16.0,2.0,3337.065,11450.25,9159.75,4581.0,22900.5,6.0,-405.5,365243.0,-685.0,-535.0,-535.0,-530.0,7.0,0.0,0.2178609835831292,22.0,7.0,6.0,3.0,-21.0,0.0,0.0,6.0,3337.065,3337.065,-626.5,-610.0,3.5,1.0,0.0,,,,,,,,,,,,,,,,,,,,,8358045588.0,184594689634.5,165759561751.5,52038451405.935,1863.0,1706.0,71127.0,70982.0,9141.0,506740.0,,,,,,,128583.0,663673.0,,,,13544708.61917768,-602712111.0,-923087662.0,-296899075.0,-1537164619.0416667,44083.0,30750.0,,,,,,,,158240.35340322714,126271.62730807258,,,,,,,3718823.0,,,,,,,,,,,,,,,,437071.0,431862.0,1264693.0,6433.033988002894,632768.0,626313.0,,,,,,,,,24.0,87759480.60000002,30086362.980000004,8955551614.949978,2969533688.4,103059100.26,807894.0899999997,174.0,23774.0,-29331937.5,13127717.5,-15219066.5,-16554371.0,-11.5,0.0,0.0,563017.5,0.0,0.0,0.0,0.0,0.0,-1177.0,-323.0,-1087.0,-717.0,312911016.30000025,4457227883.445004,5004341768.925003,72704310.25499995,4457239333.695004,322724.0,-22349126.0,5189927409.0,230469460.0,1169284464.0,507191510.0,1227388058.0,321075.0,5014.0,909.4375032360556,7351418.5,2658843.0,1636959.0,-5370926.0,1593543.0,104068.0,3517076833.672605,3560226136.492583,-214495688.5,-212710010.5,3768178.5,177401.5,,,,,,,,,,,,,,,,,,,,,1469344.0,14853938.0,3236618.0,8566963.0,11622687.0,1417753.0,1061249370.5520012,802228181.2874953,72198759878.30212,21699955176.57012,583477324.4969988,5792665.7475,689.5,94245.0,-277285679.0,22010159.0,-123939441.5,-218988081.0,-2025307.5,,,,,,,,,,,,,,,,,,,,,4278831.0,2482684.0,-9015558.5,921451.5,37582.5,3738891562.087457,3663550035.809957,-260972895.5,-257656454.0,2529673.0,269582.0,3931375232.384953,33295646313.31592,36727985765.63265,1732146227.3025498,48147726835.10322,3993307.5,-247902827.5,103224632633.5,1056367598.0,17293134287.5,3508246364.0,18908077100.0,3676881.0,72028.0,20898.97177365677,89868962.0,-18.42779094260137,1.75,11.101859561476548,462.0806861861692,19.42825423258396,808.6412008257959,60000.0,-0.9009688679024191,-0.433883739117558,0.0,0.0,0.0,0.0,0.0,0.0,1.0,0.0,0.0,0.0,0.0,0.0,0.0,1.0,0.0,0.0,0.0,0.0,1.0,0.0,1.0,0.0,0.0,0.0,0.0,1.0,0.0,0.0,0.0,0.0,0.0,0.0,0.0,0.0,0.0,0.0,0.0,0.0,1.0,0.0,0.0,0.0,0.0,0.0,0.0,0.0,0.0,0.0,0.0,0.0,0.0,0.0,0.0,1.0,0.0,0.0,0.0,0.0,0.0,0.0,0.0,0.0,0.0,0.0,0.0,0.0,0.0,0.0,0.0,0.0,0.0,0.0,0.0,0.0,0.0,0.0,0.0,0.0,0.0,0.0,0.0,0.0,0.0,0.0,0.0,0.0,0.0,0.0,0.0,0.0,0.0,0.0,0.0,0.0,0.0,0.0,0.0,0.0,0.0,0.0,0.0,0.0,0.0,0.0,0.0,0.0,0.0,0.0,0.0,0.0,0.0,0.0,0.0,0.0,0.0,0.0,0.0,0.0,0.0,0.0
105452,0,0.0,0.0,1.0,0.0,0.0,202500.0,540000.0,34510.5,540000.0,0.020246,47.09041095890412,-5779.0,-5490.0,-747.0,11.0,2.0,3.0,3.0,4.0,0.6365575788980506,0.4961751312296687,0.0005272652387098,0.1186,0.1264,0.9925,0.898,0.0165,0.0,0.2069,0.1667,0.2083,0.0784,0.0967,0.124,0.0,0.0,0.1208,0.1312,0.9926,0.902,0.0166,0.0,0.2069,0.1667,0.2083,0.0802,0.1056,0.1292,0.0,0.0,0.1197,0.1264,0.9925,0.8994,0.0166,0.0,0.2069,0.1667,0.2083,0.0797,0.0983,0.1263,0.0,0.0,0.1066,1.0,2.0,0.0,2.0,0.0,-298.0,0.0,0.0,0.0,0.0,0.0,4.0,1.0,1.0,1.0,1.0,0.0,0.0,0.0,0.0,0.0,0.0,0.0,0.0,0.0,1.0,0.0,0.0,0.0,0.0,0.0,0.0,0.0,0.0,0.0,0.0,0.0,0.0,0.0,0.0,0.0,0.0,0.0,0.0,16.0,0.0,0.0,99513.0,0.0,0.0,0.0,0.0,0.0,-1138.5,-589.5,-662.0,-800.5,583.0,-19.0,5.0,5784.255,0.0,0.0,9000.0,57213.0,12.0,-298.0,365243.0,-2207.0,-1877.0,-1877.0,-1869.0,14.0,0.0,0.1581257218280811,-1.0,13.0,12.0,6.0,-67.0,0.0,0.0,15.0,5784.255,5784.255,-2007.0,-2027.0,7.0,1.0,0.0,,,,,,,,,,,,,,,,,,,,,8358080098.5,184595229634.5,165760101751.5,52038653905.935,1863.0,1706.0,71127.0,70982.0,9141.0,506744.0,17831.471400002316,17893.78109999912,17344.841499997998,11310.512100000096,11248.338700000097,11195.786700000064,128583.0,663675.0,4142.993100000114,4140.675400000013,3951.240400000093,13544755.709588638,-602717890.0,-923088409.0,-296899373.0,-1537170109.0416667,44083.0,30750.0,11362.933999999192,11238.879999998986,10722.860699997287,22917.923500009816,22839.68410000977,22224.48340000834,67577.51870456319,158240.84957835838,126271.6278353378,35046.469400028014,34986.57680002846,34432.010900028865,22980.545299995887,22953.608399995464,22600.247499995698,3718827.0,8306.625700000162,8411.312600000078,8134.73900000023,9828.924700000718,9943.981900002156,10304.265899999637,16489.298299999722,16674.808399999696,16271.513399999698,829.284900000177,814.4627000000461,760.3822000000133,3918.3197000001232,3901.557800000162,3734.209200000161,437073.0,431864.0,1264704.0,6433.054234002894,632771.0,626316.0,,16353.511599999794,154388.73459999074,154391.47669999037,154283.18779998718,77708.20239999637,78046.4438000066,78448.52280000664,37.5,88331059.935,30341834.32500001,9024879809.114977,2983226611.1400003,103448929.77,808638.7949999997,176.0,24483.0,-29496940.5,13242687.5,-15307082.5,-16648117.5,-18.25,0.0,0.0,100026.0,0.0,0.0,0.0,0.0,0.0,-1334.0,-811.0,-805.0,-1000.0,313945607.65500027,4471272433.935003,5019591803.175003,73074834.49499995,4471329646.935003,323824.0,-22418713.0,5212933753.0,232603520.0,1178007945.0,510812234.0,1237209504.0,322441.0,5031.0,914.2535856830737,7418561.0,2667759.0,1642759.0,-5387766.0,1593655.0,104180.0,3526913185.3801045,3570215103.1800904,-215253022.0,-213460160.0,3780848.0,178024.0,,,,,,,,,,,,,,,,,,,,,1469360.0,14854521.0,3236618.0,8566976.0,11622702.0,1417758.0,1061249370.5520012,802228181.2874953,72198859391.30212,21699955176.57012,583477324.4969988,5792665.7475,689.5,94245.0,-277286817.5,22009569.5,-123940103.5,-218988881.5,-2025326.5,,,,,,,,,,,,,,,,,,,,,4278843.0,2482690.0,-9015625.5,921451.5,37582.5,3738897346.342457,3663555820.064957,-260974902.5,-257658481.0,2529680.0,269583.0,3931381016.639953,33295646313.31592,36727985765.63265,1732155227.3025498,48147784048.10322,3993319.5,-247903125.5,103224997876.5,1056365391.0,17293132410.5,3508244487.0,18908075231.0,3676895.0,72028.0,20899.1298993786,89868961.0,-122.72137537817082,2.6666666666666665,5.867779371495633,276.31614201990936,15.647411657321683,736.8430453864248,101250.0,-0.9009688679024191,-0.433883739117558,0.0,0.0,0.0,0.0,0.0,0.0,1.0,0.0,0.0,0.0,1.0,0.0,0.0,0.0,0.0,1.0,0.0,0.0,0.0,0.0,1.0,0.0,0.0,0.0,0.0,1.0,0.0,0.0,0.0,0.0,0.0,0.0,0.0,1.0,0.0,0.0,0.0,0.0,0.0,0.0,0.0,0.0,0.0,0.0,0.0,0.0,0.0,0.0,0.0,0.0,0.0,0.0,0.0,0.0,0.0,0.0,0.0,0.0,0.0,0.0,0.0,0.0,0.0,0.0,0.0,0.0,0.0,0.0,0.0,0.0,0.0,0.0,0.0,0.0,0.0,0.0,0.0,0.0,0.0,0.0,0.0,0.0,0.0,0.0,0.0,0.0,0.0,1.0,0.0,0.0,0.0,0.0,0.0,0.0,0.0,0.0,0.0,0.0,0.0,0.0,0.0,0.0,0.0,0.0,0.0,0.0,0.0,0.0,1.0,0.0,1.0,0.0,0.0,0.0,0.0,0.0,0.0,0.0,1.0,0.0
105454,0,0.0,1.0,0.0,1.0,1.0,450000.0,790830.0,62613.0,675000.0,0.04622,38.11780821917807,-3201.0,-7940.0,-4723.0,,3.0,1.0,1.0,11.0,,0.5593643873663872,0.3589512285783967,,,,,,,,,,,,,,,,,,,,,,,,,,,,,,,,,,,,,,,,,,,,,0.0,0.0,0.0,0.0,-380.0,0.0,0.0,0.0,0.0,0.0,2.0,1.0,1.0,0.0,1.0,1.0,0.0,0.0,1.0,1.0,0.0,0.0,0.0,0.0,1.0,0.0,0.0,0.0,0.0,0.0,0.0,0.0,0.0,0.0,0.0,0.0,0.0,0.0,0.0,0.0,0.0,0.0,0.0,1.0,158648.94,0.0,6261043.5,5639025.78,0.0,0.0,0.0,0.0,-297.0,1529.0,-22.0,,10.0,-4.5,1.0,3375.0,0.0,67500.0,,,0.0,-2901.0,-2900.0,-2837.0,365243.0,365243.0,365243.0,12.0,0.0,,535.0,0.0,,,,,,164.0,3375.0,3375.0,-1385.0,-1380.5,82.5,0.0,96.0,64831.7025,67500.0,0.0,0.0,0.0,0.0,3375.0,4275.0,4275.0,62564.715,64831.7025,64831.7025,0.0,0.0,0.0,0.0,47.5,-48.5,0.0,0.0,8358142711.5,184596020464.5,165760776751.5,52039103905.935,1863.0,1706.0,71127.0,70982.0,9141.0,506746.0,,,,,,,128584.0,663678.0,,,,13544793.827396857,-602721091.0,-923093132.0,-296899753.0,-1537178049.0416667,44083.0,30750.0,,,,,,,,158241.40894274574,126271.9867865664,,,,,,,3718838.0,,,,,,,,,,,,,,,,437073.0,431864.0,,6433.100454002894,632772.0,626317.0,,,,,,,,,10.0,88492107.375,30467275.83000001,9034767363.419975,2989648771.920001,103448929.77,808638.7949999997,176.0,24483.0,-29513014.0,13236869.0,-15317457.0,,-4.5,158648.94,0.0,6261043.5,5639025.78,0.0,0.0,0.0,0.0,-297.0,1529.0,-22.0,,314180721.85500026,4472814174.435003,5021368443.675003,,,323900.0,-22437162.0,5215851584.0,232588037.0,1178362837.0,511533283.0,1238295539.0,322583.0,5032.0,,7422425.0,,,,,,3531672393.165105,3574237116.780092,-215542526.0,-213748281.5,3790455.0,178118.0,3245113942.717453,8831504250.0,276275721.375,423436587.9299998,12747272.040000005,133966288.57499982,184392746.4599992,462914664.2549873,427073253.4799982,3115904630.7150164,3233280400.087434,3233455503.187433,14093.0,37240.0,189.0,22958.0,1065337.5,-1892040.5,813982.0,1806.0,1469361.0,14854531.0,3236714.0,8566976.0,11622866.0,1417759.0,1061408019.4920012,802228181.2874953,72205120434.80212,21705594202.35012,583477324.4969988,5792665.7475,689.5,94245.0,-277287114.5,22011098.5,-123940125.5,,-2025331.0,5928668848.777462,18749340000.0,198880482.825,448407298.07999766,1948107.735,257088950.66250083,309403573.01999867,637114906.4399978,459542323.8224992,5713642829.115035,5891917708.192497,5892160890.937499,13394.0,80972.0,44.0,70474.5,972423.5,-1700691.0,177364.0,6755.0,,,,,,3738900721.342457,3663559195.064957,-260976287.5,-257659861.5,2529762.5,269583.0,3931384391.639953,33295646313.31592,36728053265.63265,,,3993319.5,-247906026.5,103224994976.5,1056362554.0,17293497653.5,3508609730.0,18908440474.0,3676907.0,72028.0,,89869496.0,-83.97649680155251,1.7574,7.187005893344831,273.952912312621,12.630444156964211,481.44484809820017,150000.0,-0.9009688679024191,0.4338837391175582,0.0,0.0,0.0,0.0,0.0,0.0,1.0,0.0,0.0,0.0,1.0,0.0,0.0,0.0,0.0,0.0,0.0,0.0,1.0,0.0,1.0,0.0,0.0,0.0,0.0,0.0,1.0,0.0,0.0,0.0,0.0,0.0,0.0,0.0,0.0,0.0,0.0,0.0,1.0,0.0,0.0,0.0,0.0,0.0,0.0,0.0,0.0,0.0,0.0,0.0,0.0,0.0,0.0,0.0,0.0,0.0,0.0,0.0,0.0,0.0,0.0,0.0,0.0,0.0,0.0,0.0,0.0,0.0,0.0,0.0,0.0,0.0,0.0,0.0,0.0,0.0,0.0,0.0,0.0,1.0,0.0,0.0,0.0,0.0,0.0,0.0,0.0,0.0,0.0,0.0,0.0,0.0,0.0,0.0,0.0,0.0,0.0,0.0,0.0,0.0,0.0,0.0,0.0,0.0,0.0,0.0,0.0,0.0,0.0,0.0,0.0,0.0,0.0,0.0,0.0,0.0,0.0,0.0,0.0,0.0
105456,0,0.0,0.0,1.0,0.0,0.0,112500.0,450000.0,35554.5,450000.0,0.030755,24.10958904109589,-1435.0,-3075.0,-1435.0,7.0,1.0,2.0,2.0,18.0,0.2990240255897536,0.5820972736987673,0.4650692149562261,,,,,,,,,,,,,,,,,,,,,,,,,,,,,,,,,,,,,,,,,,,,,0.0,0.0,0.0,0.0,-707.0,0.0,0.0,0.0,0.0,2.0,2.0,1.0,1.0,1.0,1.0,0.0,0.0,0.0,0.0,0.0,0.0,1.0,1.0,0.0,1.0,0.0,0.0,0.0,0.0,0.0,0.0,0.0,0.0,0.0,0.0,0.0,0.0,0.0,0.0,0.0,0.0,0.0,0.0,2.0,,16577.865,114300.0,0.0,0.0,0.0,0.0,0.0,-854.5,29.5,-348.0,-593.0,57.0,-14.0,6.0,2250.0,35935.695,33248.25,1984.5,45000.0,12.0,-332.5,365243.0,-346.5,-241.5,-24.0,-237.5,11.5,0.0,0.1089214930147572,117.0,36.0,12.0,7.0,-11.0,0.0,0.0,30.0,9011.97,9011.97,-332.5,-316.5,4.0,1.0,0.0,,,,,,,,,,,,,,,,,,,,,8358178266.0,184596470464.5,165761226751.5,52039216405.935,1863.0,1706.0,71127.0,70984.0,9141.0,506748.0,,,,,,,128584.0,663679.0,,,,13544817.936985897,-602722526.0,-923094567.0,-296900460.0,-1537181124.0416667,44083.0,30750.0,,,,,,,67577.81772858878,158241.99104001946,126272.45185578134,,,,,,,3718856.0,,,,,,,,,,,,,,,,437073.0,431864.0,1264711.0,6433.131209002894,632774.0,626319.0,,,,,,,,,28.5,,30483853.69500001,9041969703.419975,2992266021.420001,103448929.77,808638.7949999997,176.0,24483.0,-29525489.5,13235872.0,-15325273.0,-16667098.0,-14.25,,16577.865,161100.0,0.0,0.0,0.0,0.0,0.0,-1125.0,-758.0,-590.0,-593.0,314456611.3650004,4481256439.935003,5029943425.425003,73181763.49499995,4481296012.935003,324182.0,-22445353.5,5217860420.5,232581597.0,1178722985.0,511529555.5,1238655718.5,322715.0,5035.0,915.5942988073016,7426832.0,2669339.0,1643776.0,-5393003.5,1593719.0,104244.0,3534118387.852605,3576626470.7325907,-215706943.0,-213911689.0,3797806.0,178165.5,,,,,,,,,,,,,,,,,,,,,1469363.0,14854588.0,3236714.0,8567012.0,11622896.0,1417765.0,,802244759.1524953,72205234734.80212,21705594202.35012,583477324.4969988,5792665.7475,689.5,94245.0,-277287969.0,22011128.0,-123940473.5,-218989474.5,-2025345.0,,,,,,,,,,,,,,,,,,,,,4278855.0,2482697.0,-9015636.5,921451.5,37582.5,3738909733.312457,3663568207.034957,-260976620.0,-257660178.0,2529766.5,269584.0,3931386641.639953,33295682249.01092,36728086513.88265,1732157211.8025498,48147829048.10322,3993331.5,-247906359.0,103225360219.5,1056362207.5,17293497412.0,3508609706.0,18908440236.5,3676918.5,72028.0,20899.238820871607,89869613.0,-59.51988636363636,4.0,3.1641564358941907,76.28651133114761,12.656625743576765,305.14604532459043,112500.0,0.6234898018587336,0.7818314824680298,0.0,0.0,0.0,0.0,0.0,0.0,1.0,0.0,0.0,0.0,0.0,0.0,0.0,1.0,0.0,0.0,1.0,0.0,0.0,0.0,0.0,0.0,1.0,0.0,0.0,0.0,0.0,0.0,0.0,1.0,0.0,0.0,0.0,0.0,0.0,0.0,0.0,0.0,0.0,0.0,0.0,0.0,0.0,0.0,0.0,0.0,0.0,0.0,0.0,0.0,0.0,0.0,0.0,1.0,0.0,0.0,0.0,0.0,0.0,0.0,0.0,0.0,0.0,0.0,0.0,0.0,0.0,0.0,0.0,0.0,0.0,0.0,0.0,0.0,0.0,0.0,0.0,0.0,0.0,0.0,0.0,0.0,0.0,0.0,0.0,0.0,0.0,0.0,0.0,0.0,0.0,0.0,0.0,0.0,0.0,0.0,0.0,0.0,0.0,0.0,0.0,0.0,0.0,0.0,0.0,0.0,0.0,0.0,0.0,0.0,0.0,0.0,0.0,0.0,0.0,0.0,0.0,0.0,0.0,0.0
105470,0,0.0,1.0,1.0,1.0,0.0,135000.0,360000.0,23026.5,360000.0,0.028663,54.02465753424657,-1181.0,-6909.0,-3250.0,2.0,2.0,2.0,2.0,13.0,0.6882408177337995,0.5963075751209981,0.5954562029091491,0.0722,0.0842,0.9791,0.7144,0.0171,0.0,0.1379,0.1667,0.2083,0.047,0.0588,0.0659,0.0,0.0,0.0735,0.0874,0.9791,0.7256,0.0173,0.0,0.1379,0.1667,0.2083,0.0481,0.0643,0.0686,0.0,0.0,0.0729,0.0842,0.9791,0.7182,0.0172,0.0,0.1379,0.1667,0.2083,0.0478,0.0599,0.0671,0.0,0.0,0.0518,1.0,0.0,0.0,0.0,0.0,-2320.0,0.0,0.0,0.0,0.0,1.0,3.0,1.0,1.0,1.0,1.0,1.0,0.0,0.0,0.0,0.0,0.0,0.0,0.0,0.0,1.0,0.0,0.0,0.0,0.0,0.0,0.0,0.0,0.0,0.0,0.0,0.0,0.0,0.0,0.0,0.0,0.0,0.0,0.0,2.0,45186.75,,1391420.25,485941.5,,0.0,0.0,0.0,-788.0,-88.5,-332.5,-646.0,53.0,-13.0,3.0,13111.74,75060.0,67554.0,12595.5,81787.5,6.5,-1209.0,365243.0,-1733.0,-1568.0,-1568.0,-1562.5,12.0,0.0,0.1577943318451792,773.0,14.0,8.0,3.5,-69.5,0.0,0.0,13.0,11922.3,11922.3,-2110.0,-2109.0,4.0,1.0,0.0,,,,,,,,,,,,,,,,,,,,,8358201292.5,184596830464.5,165761586751.5,52039351405.935,1863.0,1706.0,71127.0,70985.0,9141.0,506751.0,17831.54360000232,17893.85399999912,17344.914999997996,11310.596300000096,11248.422900000096,11195.874100000065,128584.0,663681.0,4143.010200000114,4140.692600000013,3951.257700000093,13544871.961643431,-602723707.0,-923097817.0,-296902780.0,-1537188033.0416667,44083.0,30750.0,11362.933999999192,11238.879999998986,10722.860699997287,22918.06140000981,22839.82200000978,22224.62130000834,67578.50596940651,158242.58734759456,126273.04731198426,35046.636100028016,34986.74350002846,34432.177600028874,22980.753599995885,22953.816699995463,22600.4557999957,3718869.0,8306.672700000163,8411.360400000078,8134.78710000023,9828.98350000072,9944.041800002156,10304.330199999637,16489.364199999723,16674.875499999696,16271.581999999697,829.284900000177,814.4627000000461,760.3822000000133,3918.3197000001232,3901.557800000162,3734.209200000161,437073.0,431864.0,1264713.0,6433.159872002894,632776.0,626321.0,,16353.563399999795,154389.71369999074,154392.45579999033,154284.16689998718,77708.91679999638,78047.1620000066,78449.24840000665,26.5,88808615.14499998,,9057214330.109978,2997748389.645,,813116.2499999997,179.0,24504.0,-29575336.0,13395733.0,-15349775.5,-16688016.0,-12.75,0.0,,119745.0,485941.5,,0.0,0.0,0.0,-976.0,-673.0,-640.0,-646.0,315046073.20500016,4487489111.205004,5036343153.525003,73441020.91499995,4487533368.705004,324759.0,-22490518.0,5232469081.5,232539355.5,1181613526.5,512234157.5,1241546455.5,323351.0,5047.0,918.217225015148,7444456.0,2676246.0,1647387.5,-5409705.5,1734636.0,245161.0,3541978941.9301023,3584902374.7650905,-216320610.0,-214519533.0,3812914.0,178634.0,,,,,,,,,,,,,,,,,,,,,1469365.0,14854641.0,3236714.0,8567026.0,11622909.0,1417768.0,1061453206.2420012,,72206626155.05212,21706080143.85012,,5792665.7475,689.5,94245.0,-277288757.0,22011039.5,-123940806.0,-218990120.5,-2025358.0,,,,,,,,,,,,,,,,,,,,,4278863.0,2482700.5,-9015706.0,921451.5,37582.5,3738921655.612457,3663580129.334957,-260978730.0,-257662287.0,2529770.5,269585.0,3931399753.379953,33295757309.01092,36728154067.88265,1732169807.3025498,48147910835.60322,3993338.0,-247907568.0,103225725462.5,1056360474.5,17293495844.0,3508608138.0,18908438674.0,3676930.5,72028.0,20899.39661520345,89870386.0,-21.860388457832556,2.6666666666666665,5.86281024037522,316.73631542454507,15.634160641000586,844.6301744654535,67500.0,-0.9009688679024191,-0.433883739117558,0.0,1.0,0.0,0.0,0.0,0.0,0.0,0.0,0.0,0.0,0.0,0.0,0.0,1.0,0.0,0.0,0.0,0.0,1.0,1.0,0.0,0.0,0.0,0.0,0.0,1.0,0.0,0.0,0.0,0.0,0.0,0.0,0.0,0.0,0.0,0.0,0.0,0.0,1.0,0.0,0.0,0.0,0.0,0.0,0.0,0.0,0.0,0.0,0.0,0.0,0.0,0.0,0.0,0.0,0.0,0.0,0.0,0.0,0.0,0.0,0.0,0.0,0.0,0.0,0.0,0.0,0.0,0.0,0.0,0.0,0.0,0.0,0.0,0.0,0.0,0.0,0.0,0.0,0.0,0.0,0.0,0.0,0.0,0.0,0.0,0.0,0.0,0.0,0.0,0.0,1.0,0.0,0.0,0.0,0.0,0.0,0.0,0.0,0.0,0.0,0.0,0.0,0.0,0.0,0.0,0.0,0.0,0.0,1.0,0.0,1.0,0.0,0.0,0.0,0.0,0.0,0.0,0.0,1.0,0.0
105471,0,0.0,0.0,0.0,1.0,0.0,153000.0,149256.0,15421.5,135000.0,0.010006,64.07945205479452,,-6989.0,-4811.0,,2.0,2.0,2.0,8.0,,0.5145888857131166,0.5262949398096192,0.0309,0.029,0.9901,0.8640000000000001,0.0052,0.0,0.069,0.1667,0.2083,0.0067,0.0252,0.0292,0.0,0.0,0.0315,0.0301,0.9901,0.8693,0.0052,0.0,0.069,0.1667,0.2083,0.0068,0.0275,0.0304,0.0,0.0,0.0312,0.029,0.9901,0.8658,0.0052,0.0,0.069,0.1667,0.2083,0.0068,0.0257,0.0297,0.0,0.0,0.0258,1.0,9.0,0.0,8.0,0.0,-975.0,0.0,0.0,0.0,0.0,0.0,3.0,1.0,0.0,0.0,1.0,1.0,0.0,0.0,0.0,0.0,0.0,0.0,0.0,0.0,0.0,0.0,0.0,1.0,0.0,0.0,0.0,0.0,0.0,0.0,0.0,0.0,0.0,0.0,0.0,0.0,0.0,0.0,0.0,9.0,15129.0,0.0,243675.0,16299.0,0.0,0.0,0.0,0.0,-684.0,129.0,-104.0,-685.5,255.0,-17.0,4.0,26217.54,413527.5,477641.25,15205.5,675000.0,36.0,-557.5,365243.0,-761.0,-656.0,289.0,-649.0,9.0,1.0,0.1023256084367195,1.5,28.0,36.0,33.0,-22.5,0.0,0.0,24.0,26217.54,26217.54,-693.5,-678.5,4.5,1.0,0.0,,,,,,,,,,,,,,,,,,,,,8358216714.0,184596979720.5,165761721751.5,52039504405.935,1863.0,1706.0,71127.0,70985.0,9141.0,506754.0,17831.574500002316,17893.88519999912,17344.946499997997,11310.625300000096,11248.451900000096,11195.904200000065,128584.0,663683.0,4143.015400000114,4140.697800000013,3951.262900000093,13544936.041095486,,-923102628.0,-296903755.0,-1537195022.0416667,44083.0,30750.0,11362.933999999192,11238.879999998986,10722.860699997287,22918.130400009813,22839.89100000978,22224.69030000834,,158243.10193648026,126273.57360692408,35046.802800028025,34986.91020002846,34432.344300028875,22980.961899995884,22954.024999995458,22600.66409999569,3718877.0,8306.679400000163,8411.367200000077,8134.793900000232,9829.00870000072,9944.067500002157,10304.357699999637,16489.393399999724,16674.905199999695,16271.612399999698,829.284900000177,814.4627000000461,760.3822000000133,3918.3197000001232,3901.557800000162,3734.209200000161,437082.0,431872.0,,6433.169878002896,632778.0,626323.0,,16353.589199999791,154390.70379999073,154393.44589999033,154285.15699998714,77709.78079999637,78048.0278000066,78450.11770000665,23.0,88902019.39499998,30558565.12500001,9060015523.859978,2998135754.145,104006493.585,813116.2499999997,179.0,24504.0,-29581889.0,13394785.5,-15353173.0,-16691141.0,-11.0,23850.0,0.0,243675.0,0.0,0.0,0.0,0.0,0.0,-1382.0,-72.0,-591.0,-2188.0,315111387.6900002,4488832181.205004,5037813380.025003,73465068.91499995,4488494681.205004,324809.0,-22494766.0,5233382189.0,232536524.0,1181611816.0,512233407.0,1241544754.0,323385.0,5048.0,918.4228904099753,7446699.5,2676530.0,1647593.0,-5410545.0,1734636.0,245161.0,3543155464.3651023,3586078897.2000904,-216343590.5,-214542202.0,3812998.5,178653.5,,,,,,,,,,,,,,,,,,,,,1469374.0,14854896.0,3236714.0,8567054.0,11622933.0,1417772.0,1061468335.2420012,802244759.1524953,72206869830.05212,21706096442.85012,583477324.4969988,5792665.7475,689.5,94245.0,-277289441.0,22011168.5,-123940910.0,-218990806.0,-2025375.0,,,,,,,,,,,,,,,,,,,,,4278899.0,2482733.5,-9015728.5,921451.5,37582.5,3738947873.152457,3663606346.874957,-260979423.5,-257662965.5,2529775.0,269586.0,3931425970.919953,33296170836.51092,36728631709.13265,1732185012.8025498,48148585835.60322,3993374.0,-247908125.5,103226090705.5,1056359713.5,17293495188.0,3508608427.0,18908438025.0,3676939.5,72029.0,20899.498940811893,89870387.5,,0.975529411764706,9.921213889699445,635.7459497703571,9.67843594981033,620.1888724112707,76500.0,-0.9009688679024191,-0.433883739117558,0.0,0.0,0.0,0.0,0.0,0.0,1.0,0.0,0.0,1.0,0.0,0.0,0.0,0.0,0.0,0.0,0.0,0.0,1.0,0.0,1.0,0.0,0.0,0.0,0.0,1.0,0.0,0.0,0.0,0.0,0.0,0.0,0.0,0.0,0.0,0.0,0.0,0.0,0.0,0.0,0.0,0.0,0.0,0.0,0.0,0.0,0.0,0.0,0.0,0.0,0.0,0.0,0.0,0.0,0.0,0.0,0.0,0.0,0.0,0.0,0.0,0.0,0.0,0.0,0.0,0.0,0.0,0.0,0.0,0.0,0.0,0.0,0.0,0.0,0.0,0.0,0.0,0.0,0.0,0.0,0.0,0.0,0.0,0.0,0.0,0.0,0.0,0.0,0.0,0.0,0.0,0.0,0.0,0.0,0.0,0.0,0.0,0.0,0.0,0.0,0.0,0.0,0.0,0.0,0.0,1.0,0.0,0.0,1.0,0.0,1.0,0.0,0.0,0.0,0.0,0.0,0.0,1.0,0.0,0.0
105483,0,0.0,1.0,0.0,1.0,0.0,180000.0,361998.0,14935.5,292500.0,0.072508,21.31232876712329,-564.0,-3640.0,-459.0,,2.0,1.0,1.0,17.0,0.0378966214256091,0.6038956808069772,,0.1959,0.0864,0.9856,0.8028,0.0,0.2,0.1034,0.6042,0.6458,0.0,0.1597,0.1935,0.0,0.011,0.1502,0.0844,0.9762,0.6864,0.0,0.1611,0.069,0.3333,0.375,0.0,0.1313,0.148,0.0,0.0006,0.1978,0.0864,0.9856,0.8054,0.0,0.2,0.1034,0.6042,0.6458,0.0,0.1625,0.197,0.0,0.0112,0.1974,1.0,0.0,0.0,0.0,0.0,-110.0,,,,,,,1.0,1.0,1.0,1.0,1.0,0.0,0.0,0.0,0.0,0.0,0.0,0.0,0.0,0.0,0.0,0.0,0.0,0.0,0.0,0.0,0.0,0.0,0.0,0.0,0.0,0.0,0.0,0.0,0.0,0.0,0.0,0.0,0.0,,,,,,,,,,,,,0.0,,0.0,,,,,,,,,,,,,,,,,0.0,,,,,,0.0,,,,,,,0.0,,,,,,,,,,,,,,,,,,,,,8358231649.5,184597341718.5,165762014251.5,52039684405.935,,,,,,,17831.77040000232,17894.082999999122,17345.096699997997,11310.711700000094,11248.538300000097,11195.988600000064,128584.0,663685.0,4143.015400000114,4140.697800000013,3951.262900000093,13544957.353424251,-602724271.0,-923103087.0,-296903865.0,-1537198662.0416667,44083.0,30750.0,11363.133999999192,11239.079999998989,10723.021799997288,22918.233800009813,22839.99440000978,22224.75930000834,67578.54386602793,158243.70583216107,,35047.40700002802,34987.51440002846,34432.677600028874,22981.60769999588,22954.67079999546,22601.03909999569,3718894.0,8306.679400000163,8411.367200000077,8134.793900000232,9829.16840000072,9944.230000002157,10304.488999999636,16489.586899999726,16675.102199999696,16271.760399999695,829.284900000177,814.4627000000461,760.3822000000133,3918.330700000123,3901.569000000162,3734.209800000161,437082.0,431872.0,,6433.242386002896,632779.0,626324.0,,16353.786599999792,154391.68939999078,154394.43149999034,154286.13319998718,77710.58359999637,78048.8332000066,78450.80410000666,,,,,,,,,,,,,,,,,,,,,,,,,,,,,,,,,,,,,,,,,,,,,,,,,,,,,,,,,,,,,,,,,,,,,,,,,,1469374.0,14854896.0,3236714.0,8567054.0,11622933.0,1417772.0,,,,,,,,,,,,,,,,,,,,,,,,,,,,,,,,,,,,,,,,,,,,,,,,,,,,,,,,,,,,,-26.4635557269572,2.0111,12.05182283820428,256.85241057093447,24.237420909912625,516.5558828992063,90000.0,0.6234898018587336,0.7818314824680298,0.0,0.0,0.0,0.0,0.0,0.0,1.0,0.0,1.0,0.0,0.0,0.0,0.0,0.0,0.0,0.0,1.0,0.0,0.0,1.0,0.0,0.0,0.0,0.0,0.0,1.0,0.0,0.0,0.0,0.0,0.0,0.0,0.0,0.0,0.0,0.0,0.0,0.0,1.0,0.0,0.0,0.0,0.0,0.0,0.0,0.0,0.0,0.0,0.0,0.0,0.0,1.0,0.0,0.0,0.0,0.0,0.0,0.0,0.0,0.0,0.0,0.0,0.0,0.0,0.0,0.0,0.0,0.0,0.0,0.0,0.0,0.0,0.0,0.0,0.0,0.0,0.0,0.0,0.0,0.0,0.0,0.0,0.0,0.0,0.0,0.0,0.0,0.0,0.0,0.0,0.0,0.0,0.0,0.0,0.0,0.0,0.0,0.0,0.0,0.0,0.0,0.0,0.0,0.0,0.0,0.0,0.0,0.0,1.0,0.0,1.0,0.0,0.0,0.0,0.0,0.0,0.0,1.0,0.0,0.0
105493,0,0.0,1.0,1.0,0.0,0.0,157500.0,1107900.0,35739.0,900000.0,0.025164,58.30684931506849,-1603.0,-5648.0,-4841.0,21.0,2.0,2.0,2.0,11.0,,0.5432026311634254,0.3572932680336494,,,,,,,,,,,,,,,,,,,,,,,,,,,,,,,,,,,,,,,,,,,,,14.0,0.0,13.0,0.0,-2825.0,0.0,0.0,0.0,0.0,0.0,0.0,1.0,1.0,1.0,1.0,0.0,0.0,0.0,0.0,0.0,0.0,0.0,0.0,0.0,1.0,0.0,0.0,0.0,0.0,0.0,0.0,0.0,0.0,0.0,0.0,0.0,0.0,0.0,0.0,0.0,0.0,0.0,0.0,0.0,,,,,,,,,,,,,0.0,,12.0,17980.3125,225000.0,225000.0,0.0,405000.0,24.0,-1010.5,365243.0,-1227.0,-852.0,-294.0,-845.0,8.0,0.5,0.0,-1.0,108.0,24.0,21.5,-35.5,0.0,0.0,128.0,18911.565,18911.565,-1357.0,-1354.0,9.0,1.0,0.0,,,,,,,,,,,,,,,,,,,,,8358267388.5,184598449618.5,165762914251.5,52039841905.935,1863.0,1706.0,71127.0,70985.0,9141.0,506754.0,,,,,,,128584.0,663687.0,,,,13545015.660273569,-602725874.0,-923107928.0,-296906690.0,-1537204310.0416667,44083.0,30750.0,,,,,,,,158244.24903479224,126273.93090019214,,,,,,,3718905.0,,,,,,,,,,,,,,,,437096.0,431885.0,1264734.0,6433.267550002895,632781.0,626326.0,,,,,,,,,,,,,,,,,,,,,,,,,,,,,,,,,,,316502550.0450003,4511615585.805005,5062146881.085004,73581052.45499994,4511849698.305005,326321.0,-22575718.0,5251821186.5,232849427.0,1187052299.5,513306382.5,1247353363.5,324555.0,5063.0,920.6774825199536,7472405.5,2686883.0,1654321.0,-5428112.0,1735625.0,245314.0,3557646080.482581,3600899900.5275726,-217173228.5,-215366214.0,3830310.0,179355.5,,,,,,,,,,,,,,,,,,,,,1469374.0,14854896.0,3236714.0,8567162.0,11623061.0,1417784.0,,,,,,,,,,,,,,,,,,,,,,,,,,,,,,,,,,4278923.0,2482755.0,-9015764.0,921451.5,37582.5,3738966784.717457,3663625258.439957,-260980780.5,-257664319.5,2529784.0,269587.0,3931443951.232453,33296395836.51092,36728856709.13265,1732185012.8025498,48148990835.60322,3993398.0,-247909136.0,103226455948.5,1056358486.5,17293494336.0,3508608133.0,18908437180.0,3676947.5,72029.5,20899.498940811893,89870386.5,-27.492481909594964,7.034285714285715,4.406950390329891,256.95539234794734,30.99974817426341,1807.497645601847,78750.0,0.6234898018587336,0.7818314824680298,0.0,0.0,0.0,0.0,0.0,0.0,1.0,0.0,0.0,0.0,0.0,0.0,0.0,1.0,0.0,0.0,0.0,0.0,1.0,0.0,1.0,0.0,0.0,0.0,0.0,1.0,0.0,0.0,0.0,0.0,0.0,0.0,0.0,0.0,0.0,0.0,1.0,0.0,0.0,0.0,0.0,0.0,0.0,0.0,0.0,0.0,0.0,0.0,0.0,0.0,0.0,0.0,0.0,0.0,0.0,0.0,0.0,0.0,0.0,1.0,0.0,0.0,0.0,0.0,0.0,0.0,0.0,0.0,0.0,0.0,0.0,0.0,0.0,0.0,0.0,0.0,0.0,0.0,0.0,0.0,0.0,0.0,0.0,0.0,0.0,0.0,0.0,0.0,0.0,0.0,0.0,0.0,0.0,0.0,0.0,0.0,0.0,0.0,0.0,0.0,0.0,0.0,0.0,0.0,0.0,0.0,0.0,0.0,0.0,0.0,0.0,0.0,0.0,0.0,0.0,0.0,0.0,0.0,0.0,0.0
105508,0,0.0,1.0,0.0,1.0,0.0,135000.0,495000.0,38304.0,495000.0,0.025164,41.8,-3876.0,-1063.0,-3835.0,,2.0,2.0,2.0,8.0,,0.2059760860925113,0.7338145369642702,,,,,,,,,,,,,,,,,,,,,,,,,,,,,,,,,,,,,,,,,,,,,0.0,0.0,0.0,0.0,0.0,0.0,0.0,0.0,0.0,1.0,5.0,1.0,1.0,0.0,1.0,0.0,0.0,0.0,0.0,0.0,0.0,0.0,0.0,0.0,1.0,0.0,0.0,0.0,0.0,0.0,0.0,0.0,0.0,0.0,0.0,0.0,0.0,0.0,0.0,0.0,0.0,0.0,0.0,1.0,0.0,,126810.0,0.0,0.0,0.0,0.0,0.0,-1366.0,-1000.0,-985.0,-1000.0,45.0,-22.0,8.0,14663.0025,101250.0,121783.5,1523.25,101250.0,9.5,-939.5,365243.0,-1014.0,-684.0,-684.0,-675.0,9.0,1.0,0.051763166628373,23.0,79.0,12.0,5.0,-23.0,0.0,0.0,75.0,15944.58,15944.58,-663.0,-650.0,6.0,1.0,0.0,,,,,,,,,,,,,,,,,,,,,8358305692.5,184598944618.5,165763409251.5,52039976905.935,1863.0,1706.0,71127.0,70986.0,9141.0,506759.0,,,,,,,128584.0,663689.0,,,,13545057.46027357,-602729750.0,-923111763.0,-296906690.0,-1537205373.0416667,44083.0,30750.0,,,,,,,,158244.45501087833,126274.66471472908,,,,,,,3718913.0,,,,,,,,,,,,,,,,437096.0,431885.0,,6433.292714002894,632783.0,626328.0,,,,,,,,,45.0,89292267.04499999,,9181936383.119978,3027957737.669998,106644278.79,813116.2499999997,180.0,24504.0,-29791076.0,13524915.0,-15455460.0,-16809620.0,-22.0,0.0,,126810.0,0.0,0.0,0.0,0.0,0.0,-1366.0,-1000.0,-985.0,-1000.0,317524078.9575004,4528955872.5300045,5081247178.335004,73748592.17999993,4528955872.5300045,327357.0,-22625176.0,5263689994.0,233179359.0,1189218834.0,515113300.0,1249520521.0,325405.0,5074.0,922.8650638014904,7486620.0,2693890.0,1659048.0,-5438860.0,1735644.0,245333.0,3571494443.820085,3615180188.580077,-217514266.0,-215703980.0,3834138.0,179735.0,,,,,,,,,,,,,,,,,,,,,1469375.0,14854941.0,3236714.0,8567241.0,11623136.0,1417792.0,1061468335.2420012,,72206996640.05212,21706096442.85012,583477324.4969988,5792665.7475,689.5,94245.0,-277290807.0,22010168.5,-123941895.0,-218991806.0,-2025397.0,,,,,,,,,,,,,,,,,,,,,4278935.0,2482760.0,-9015787.0,921451.5,37582.5,3738982729.297457,3663641203.019957,-260981443.5,-257664969.5,2529790.0,269588.0,3931458614.234953,33296497086.51092,36728978492.63265,1732186536.0525498,48149092085.60322,3993407.5,-247910075.5,103226821191.5,1056357472.5,17293493652.0,3508607449.0,18908436505.0,3676956.5,72030.5,20899.550703978523,89870409.5,-92.72727272727272,3.6666666666666665,3.524436090225564,147.32142857142856,12.92293233082707,540.1785714285714,67500.0,-0.2225209339563143,0.9749279121818236,0.0,0.0,0.0,0.0,0.0,0.0,1.0,0.0,0.0,0.0,0.0,0.0,0.0,1.0,0.0,0.0,0.0,0.0,1.0,0.0,1.0,0.0,0.0,0.0,0.0,1.0,0.0,0.0,0.0,0.0,0.0,0.0,0.0,0.0,0.0,0.0,0.0,0.0,1.0,0.0,0.0,0.0,0.0,0.0,0.0,0.0,0.0,0.0,0.0,0.0,0.0,0.0,0.0,0.0,0.0,0.0,0.0,0.0,0.0,0.0,0.0,0.0,0.0,0.0,0.0,0.0,0.0,0.0,1.0,0.0,0.0,0.0,0.0,0.0,0.0,0.0,0.0,0.0,0.0,0.0,0.0,0.0,0.0,0.0,0.0,0.0,0.0,0.0,0.0,0.0,0.0,0.0,0.0,0.0,0.0,0.0,0.0,0.0,0.0,0.0,0.0,0.0,0.0,0.0,0.0,0.0,0.0,0.0,0.0,0.0,0.0,0.0,0.0,0.0,0.0,0.0,0.0,0.0,0.0,0.0
105514,0,0.0,0.0,0.0,1.0,0.0,225000.0,154066.5,7996.5,117000.0,0.00702,54.53972602739726,-2245.0,-4014.0,-1623.0,,1.0,2.0,2.0,12.0,,0.6295267417470465,0.5154953751603267,,,,,,,,,,,,,,,,,,,,,,,,,,,,,,,,,,,,,,,,,,,,,1.0,0.0,1.0,0.0,-720.0,0.0,0.0,0.0,0.0,0.0,2.0,1.0,1.0,0.0,1.0,0.0,1.0,0.0,0.0,0.0,0.0,1.0,1.0,0.0,1.0,0.0,0.0,0.0,0.0,0.0,0.0,0.0,0.0,0.0,0.0,0.0,0.0,0.0,0.0,0.0,0.0,0.0,0.0,5.0,9335.25,,474300.0,307341.0,0.0,0.0,0.0,0.0,-434.0,144.5,-37.0,-651.0,105.0,-10.0,3.0,3275.82,35095.5,35095.5,0.0,35095.5,12.0,-720.0,365243.0,-685.0,-625.0,-355.0,-598.0,11.0,0.0,0.0,149.0,5.0,12.0,10.0,-21.0,0.0,0.0,3.0,15220.08,15220.08,-672.0,-655.0,2.0,1.0,0.0,,,,,,,,,,,,,,,,,,,,,8358313689.0,184599098685.0,165763526251.5,52040201905.935,1863.0,1706.0,71127.0,70986.0,9141.0,506761.0,,,,,,,128584.0,663690.0,,,,13545111.999999598,-602731995.0,-923113386.0,-296907410.0,-1537209387.0416667,44083.0,30750.0,,,,,,,,158245.08453762007,126275.18021010426,,,,,,,3718925.0,,,,,,,,,,,,,,,,437097.0,431886.0,,6433.299734002894,632785.0,626330.0,,,,,,,,,15.0,89360723.29499999,,9184780000.619978,3028876471.169998,106644278.79,813116.2499999997,180.0,24504.0,-29800294.0,13524102.5,-15461420.0,-16815229.0,-7.0,0.0,,225000.0,49446.0,0.0,0.0,0.0,0.0,-634.0,-651.0,-188.0,-651.0,317737024.78500026,4531925008.5300045,5084408250.585004,73774512.17999993,4531925008.5300045,327589.0,-22644896.0,5269168192.0,233528431.0,1190667620.0,515833202.0,1250969483.0,325684.0,5079.0,923.4163138074256,7490231.0,2696522.0,1660634.0,-5444195.0,1735644.0,245333.0,3574309055.2650905,3617969588.730083,-217675648.0,-215863310.0,3835537.0,179898.0,,,,,,,,,,,,,,,,,,,,,1469380.0,14855046.0,3236714.0,8567246.0,11623139.0,1417795.0,1061477670.4920012,,72207470940.05212,21706403783.85012,583477324.4969988,5792665.7475,689.5,94245.0,-277291241.0,22010313.0,-123941932.0,-218992457.0,-2025407.0,,,,,,,,,,,,,,,,,,,,,4278947.0,2482770.0,-9015808.0,921451.5,37582.5,3738997949.377457,3663656423.099957,-260982115.5,-257665624.5,2529792.0,269589.0,3931461890.054953,33296532182.01092,36729013588.13265,1732186536.0525498,48149127181.10322,3993419.5,-247910795.5,103227186434.5,1056356787.5,17293493027.0,3508607094.0,18908435907.0,3676967.5,72030.5,20899.550703978523,89870558.5,-41.162656352036976,0.68474,28.13731007315701,1534.6011825379082,19.266741699493533,1050.8028137310073,225000.0,1.0,0.0,0.0,1.0,0.0,0.0,0.0,0.0,0.0,0.0,1.0,0.0,0.0,0.0,0.0,0.0,0.0,0.0,0.0,0.0,1.0,0.0,0.0,0.0,1.0,0.0,0.0,1.0,0.0,0.0,0.0,0.0,0.0,0.0,0.0,0.0,0.0,0.0,0.0,0.0,0.0,0.0,0.0,0.0,0.0,1.0,0.0,0.0,0.0,0.0,0.0,0.0,0.0,0.0,0.0,0.0,0.0,0.0,0.0,0.0,0.0,0.0,0.0,0.0,0.0,0.0,0.0,0.0,0.0,0.0,0.0,0.0,0.0,0.0,0.0,0.0,0.0,0.0,0.0,0.0,0.0,0.0,0.0,0.0,0.0,0.0,0.0,0.0,0.0,0.0,0.0,0.0,1.0,0.0,0.0,0.0,0.0,0.0,0.0,0.0,0.0,0.0,0.0,0.0,0.0,0.0,0.0,0.0,0.0,0.0,0.0,0.0,0.0,0.0,0.0,0.0,0.0,0.0,0.0,0.0,0.0,0.0
105515,0,0.0,0.0,0.0,1.0,0.0,157500.0,670401.0,24210.0,553500.0,0.009175,58.60821917808219,,-10308.0,-4756.0,,1.0,2.0,2.0,14.0,0.7537335702337459,0.7071670732407437,0.6075573001388961,0.0423,0.0542,0.9856,,,0.0,0.069,0.1667,,,,0.0437,,0.0,0.0431,0.0562,0.9856,,,0.0,0.069,0.1667,,,,0.0455,,0.0,0.0427,0.0542,0.9856,,,0.0,0.069,0.1667,,,,0.0445,,0.0,0.0344,1.0,1.0,0.0,1.0,0.0,-962.0,0.0,0.0,0.0,0.0,1.0,3.0,1.0,0.0,0.0,1.0,1.0,0.0,0.0,0.0,0.0,0.0,0.0,0.0,0.0,0.0,0.0,0.0,1.0,0.0,0.0,0.0,0.0,0.0,0.0,0.0,0.0,0.0,0.0,0.0,0.0,0.0,0.0,0.0,2.0,35352.0,,596250.0,307298.25,0.0,0.0,0.0,0.0,-443.5,119.5,-64.0,,31.0,-7.0,10.0,18875.52,0.0,15772.5,4500.0,270000.0,18.0,-482.0,365243.0,-1126.0,-616.0,-136.0,-607.5,15.5,0.5,0.1359664056293269,-1.0,26.0,18.0,12.5,-26.5,0.0,0.0,100.0,6558.817499999999,6231.285,-795.5,-791.5,27.5,0.0,43.0,147137.085,270000.0,0.0,0.0,0.0,0.0,7077.532499999998,13500.0,13500.0,140216.04,147137.085,147137.085,0.0,0.0,0.0,0.0,21.5,-23.0,0.0,0.0,8358337899.0,184599769086.0,165764079751.5,52040359405.935,1863.0,1706.0,71127.0,70987.0,9141.0,506764.0,17831.812700002316,17894.125699999124,17345.139799997996,11310.765900000097,11248.592500000095,11196.044800000063,128584.0,663691.0,,,,13545170.608218774,,-923118142.0,-296908372.0,-1537219695.0416667,44083.0,30750.0,11363.133999999192,11239.079999998989,10723.021799997288,22918.302800009813,22840.06340000977,22224.82830000834,67579.29759959817,158245.7917046933,126275.78776740436,35047.573700028035,34987.681100028465,34432.844300028875,,,,3718939.0,,,,,,,16489.630599999724,16675.146699999696,16271.805899999696,,,,3918.330700000123,3901.569000000162,3734.209800000161,437098.0,431887.0,,6433.308909002894,632787.0,626332.0,,16353.820999999793,154392.6749999908,154395.41709999036,154287.11879998722,,,,15.5,89408079.04499999,,9186850000.619978,3030270402.419998,106644278.79,813116.2499999997,180.0,24504.0,-29801854.0,13525725.0,-15461581.0,,-7.25,35352.0,,1125000.0,614596.5,0.0,0.0,0.0,0.0,-516.0,580.0,-28.0,,317778694.47000027,4532259754.5300045,5085036810.585004,73779012.17999993,4532394754.5300045,327631.0,-22650890.0,5269898005.5,233525112.0,1190665133.0,516014215.5,1251149955.0,325770.5,5080.0,923.5522802130548,7490565.5,2696702.0,1660752.5,-5444817.0,1735644.0,245333.0,3575539548.8100905,3619200012.210083,-217724525.0,-215911937.0,3836811.5,179916.0,3285649953.944951,8903335500.0,278795271.375,426683095.1549999,12793172.040000005,134647324.7399998,186460431.45749903,467005444.199988,430657128.9899976,3154867695.270018,3273662510.729935,3273837613.8299336,14283.0,37724.0,190.0,23251.0,1077569.0,-1909809.0,814051.0,1816.0,1469382.0,14855077.0,3236757.0,8567272.0,11623239.0,1417805.0,1061513022.4920012,,72208067190.05212,21706711082.10012,583477324.4969988,5792665.7475,689.5,94245.0,-277291684.5,22010432.5,-123941996.0,,-2025414.0,5928815985.862462,18749610000.0,198880482.825,448407298.07999766,1948107.735,257088950.66250083,309410650.5524987,637128406.4399978,459555823.8224992,5713783045.155035,5892064845.277497,5892308028.022499,13394.0,80972.0,44.0,70474.5,972445.0,-1700714.0,177364.0,6755.0,4278965.0,2482782.5,-9015834.5,921451.5,37582.5,3739004508.194957,3663662654.384957,-260982911.0,-257666416.0,2529819.5,269589.0,3931480765.574953,33296532182.01092,36729029360.63265,1732191036.0525498,48149397181.10322,3993437.5,-247911277.5,103227551677.5,1056355661.5,17293492411.0,3508606958.0,18908435299.5,3676983.0,72031.0,20899.68667038415,89870557.5,,4.256514285714286,6.505576208178439,381.2802362886388,27.6910780669145,1622.9247726231094,157500.0,0.6234898018587336,0.7818314824680298,0.0,0.0,0.0,0.0,0.0,0.0,1.0,0.0,0.0,1.0,0.0,0.0,0.0,0.0,0.0,0.0,0.0,0.0,1.0,0.0,0.0,0.0,0.0,1.0,0.0,1.0,0.0,0.0,0.0,0.0,0.0,0.0,0.0,0.0,0.0,0.0,0.0,0.0,0.0,0.0,0.0,0.0,0.0,0.0,0.0,0.0,0.0,0.0,0.0,0.0,0.0,0.0,0.0,0.0,0.0,0.0,0.0,0.0,0.0,0.0,0.0,0.0,0.0,0.0,0.0,0.0,0.0,0.0,0.0,0.0,0.0,0.0,0.0,0.0,0.0,0.0,0.0,0.0,0.0,0.0,0.0,0.0,0.0,0.0,0.0,0.0,0.0,0.0,0.0,0.0,0.0,0.0,0.0,0.0,0.0,0.0,0.0,0.0,0.0,0.0,0.0,0.0,0.0,0.0,0.0,1.0,0.0,0.0,0.0,0.0,1.0,0.0,0.0,0.0,0.0,0.0,0.0,1.0,0.0,0.0
105528,0,0.0,0.0,0.0,1.0,2.0,90000.0,296280.0,23539.5,225000.0,0.0031219999999999,29.45205479452055,-832.0,-418.0,-2947.0,,4.0,3.0,3.0,14.0,0.3743003643211958,0.1365636445931505,,,,,,,,,,,,,,,,,,,,,,,,,,,,,,,,,,,,,,,,,,,,,,2.0,0.0,2.0,0.0,-8.0,,,,,,,1.0,1.0,0.0,1.0,0.0,0.0,0.0,0.0,0.0,0.0,0.0,0.0,0.0,1.0,0.0,0.0,0.0,0.0,0.0,0.0,0.0,0.0,0.0,0.0,0.0,0.0,0.0,0.0,0.0,0.0,0.0,0.0,0.0,,,,,,,,,,,,,0.0,,2.0,6268.8825,67495.5,72247.5,0.0,67495.5,6.0,-432.0,365243.0,182422.5,365243.0,182587.5,365243.0,15.0,0.0,0.0,984.0,11.0,12.0,7.0,-9.0,0.0,0.0,11.0,10287.765,10287.765,-262.0,-248.0,6.0,1.0,11.0,0.0,135000.0,,0.0,,,0.0,,0.0,0.0,0.0,0.0,,0.0,,,0.0,-9.0,0.0,0.0,8358361438.5,184600065366.0,165764304751.5,52040449405.935,,,,,,,,,,,,,128586.0,663695.0,,,,13545200.060273573,-602732827.0,-923121089.0,-296908380.0,-1537220113.0416667,44083.0,30750.0,,,,,,,67579.67189996249,158245.92826833788,,,,,,,,3718953.0,,,,,,,,,,,,,,,,437100.0,431889.0,,6433.312031002894,632790.0,626335.0,,,,,,,,,,,,,,,,,,,,,,,,,,,,,,,,,,,318673934.7075,4541946679.5300045,5096313288.585004,74013507.17999993,4541946679.5300045,328423.0,-22729264.0,5286145537.5,234205862.0,1194461687.5,517264682.0,1255864188.5,326717.5,5092.0,926.5997733015644,7517952.0,2702022.0,1663817.0,-5460954.0,1798604.0,245349.0,3585672926.595095,3629000387.340092,-218328653.0,-216512554.0,3848783.0,180298.0,3301568899.1549487,8933103000.0,,428060737.5299999,,,187335615.869999,,432413012.83499753,3170144669.625017,3289565073.3299327,3289740176.429932,,37794.0,,,1083442.0,-1922251.0,814063.0,1828.0,1469382.0,14855077.0,3236768.0,8567283.0,11623250.0,1417807.0,,,,,,,,,,,,,,5928815985.862462,18749745000.0,,448407298.07999766,,,309410650.5524987,,459555823.8224992,5713783045.155035,5892064845.277497,5892308028.022499,,80972.0,,,972445.0,-1700723.0,177364.0,6755.0,4278977.0,2482789.5,-9015843.5,921451.5,37582.5,3739014795.959957,3663672942.149957,-260983173.0,-257666664.0,2529825.5,269590.0,3931487034.457453,33296599677.51092,36729101608.13265,1732191036.0525498,48149464676.60322,3993443.5,-247911709.5,103227916920.5,1056538084.0,17293857654.0,3508789545.5,18908800542.5,3676998.0,72031.0,20899.68667038415,89871541.5,-28.249302325581397,3.292,3.823360734085261,112.60582983949742,12.58650353660868,370.6983918316256,22500.0,-0.9009688679024191,0.4338837391175582,0.0,0.0,0.0,0.0,0.0,0.0,1.0,0.0,0.0,0.0,0.0,0.0,0.0,1.0,0.0,0.0,0.0,0.0,1.0,1.0,0.0,0.0,0.0,0.0,0.0,1.0,0.0,0.0,0.0,0.0,0.0,0.0,0.0,0.0,0.0,0.0,0.0,0.0,1.0,0.0,0.0,0.0,0.0,0.0,0.0,0.0,0.0,0.0,0.0,0.0,0.0,0.0,0.0,0.0,0.0,0.0,0.0,0.0,0.0,0.0,0.0,0.0,0.0,0.0,1.0,0.0,0.0,0.0,0.0,0.0,0.0,0.0,0.0,0.0,0.0,0.0,0.0,0.0,0.0,0.0,0.0,0.0,0.0,0.0,0.0,0.0,0.0,0.0,0.0,0.0,0.0,0.0,0.0,0.0,0.0,0.0,0.0,0.0,0.0,0.0,0.0,0.0,0.0,0.0,0.0,0.0,0.0,0.0,0.0,0.0,0.0,0.0,0.0,0.0,0.0,0.0,0.0,0.0,0.0,0.0
105529,0,0.0,0.0,0.0,1.0,0.0,81000.0,248760.0,25618.5,225000.0,0.019101,68.02465753424657,,-1457.0,-4489.0,,2.0,2.0,2.0,9.0,,0.5451228118800251,0.6092756673894402,,,,,,,,,,,,,,,,,,,,,,,,,,,,,,,,,,,,,,,,,,,,,0.0,0.0,0.0,0.0,0.0,0.0,0.0,0.0,0.0,1.0,2.0,1.0,0.0,0.0,1.0,0.0,0.0,0.0,0.0,0.0,0.0,0.0,0.0,0.0,0.0,0.0,0.0,1.0,0.0,0.0,0.0,0.0,0.0,0.0,0.0,0.0,0.0,0.0,0.0,0.0,0.0,0.0,0.0,1.0,0.0,,175500.0,0.0,0.0,0.0,0.0,0.0,-205.0,-23.0,-21.0,-23.0,7.0,-3.0,4.0,4805.3475,62390.25,68978.25,0.0,62390.25,12.0,-729.0,365243.0,-698.0,-293.0,-188.0,-287.5,14.0,0.0,0.0,80.0,47.0,12.0,9.0,-20.0,0.0,0.0,44.0,3680.55,3680.55,-564.0,-548.0,7.0,1.0,0.0,,,,,,,,,,,,,,,,,,,,,8358387057.0,184600314126.0,165764529751.5,52040530405.935,1863.0,1706.0,71127.0,70988.0,9141.0,506766.0,,,,,,,128586.0,663697.0,,,,13545268.084931104,,-923125578.0,-296908380.0,-1537221570.0416667,44083.0,30750.0,,,,,,,,158246.4733911498,126276.39704307176,,,,,,,3718962.0,,,,,,,,,,,,,,,,437100.0,431889.0,,6433.331132002894,632792.0,626337.0,,,,,,,,,7.0,89465071.54499999,,9206768162.47498,3038782248.5849986,106644278.79,813116.2499999997,180.0,24504.0,-29859636.0,13576769.0,-15491053.0,-16845319.0,-3.0,0.0,,175500.0,0.0,0.0,0.0,0.0,0.0,-205.0,-23.0,-21.0,-23.0,318696263.6625,4542165485.2800045,5096546998.335004,74013507.17999993,4542165485.2800045,328467.0,-22730661.0,5287241266.5,234204558.5,1195009159.5,517264603.0,1256411669.0,326759.5,5093.0,926.5997733015644,7518594.0,2702567.0,1664163.0,-5461344.0,1798604.0,245349.0,3585848661.1575937,3629199705.142591,-218339058.0,-216522237.5,3849004.0,180329.5,,,,,,,,,,,,,,,,,,,,,1469383.0,14855084.0,3236768.0,8567330.0,11623294.0,1417811.0,1061513022.4920012,,72208242690.05212,21706711082.10012,583477324.4969988,5792665.7475,689.5,94245.0,-277291889.5,22010409.5,-123942017.0,-218992480.0,-2025417.0,,,,,,,,,,,,,,,,,,,,,4278989.0,2482798.5,-9015863.5,921451.5,37582.5,3739018476.509957,3663676622.699957,-260983737.0,-257667212.0,2529832.5,269591.0,3931491839.804953,33296662067.76092,36729170586.38265,1732191036.0525498,48149527066.85322,3993455.5,-247912438.5,103228282163.5,1056537386.0,17293857361.0,3508789357.5,18908800255.0,3677012.0,72031.0,20899.68667038415,89871621.5,,3.071111111111111,3.161777621640612,215.0788399115472,9.710170384682945,660.5310150172406,40500.0,-0.9009688679024191,0.4338837391175582,0.0,0.0,0.0,0.0,0.0,0.0,1.0,0.0,0.0,1.0,0.0,0.0,0.0,0.0,0.0,0.0,0.0,0.0,1.0,0.0,1.0,0.0,0.0,0.0,0.0,1.0,0.0,0.0,0.0,0.0,0.0,0.0,0.0,0.0,0.0,0.0,0.0,0.0,0.0,0.0,0.0,0.0,0.0,0.0,0.0,0.0,0.0,0.0,0.0,0.0,0.0,0.0,0.0,0.0,0.0,0.0,0.0,0.0,0.0,0.0,0.0,0.0,0.0,0.0,0.0,0.0,0.0,0.0,0.0,0.0,0.0,0.0,0.0,0.0,0.0,0.0,0.0,0.0,0.0,0.0,0.0,0.0,0.0,0.0,0.0,0.0,0.0,0.0,0.0,0.0,0.0,0.0,0.0,0.0,0.0,0.0,0.0,0.0,0.0,0.0,0.0,0.0,0.0,0.0,0.0,1.0,0.0,0.0,0.0,0.0,0.0,0.0,0.0,0.0,0.0,0.0,0.0,0.0,0.0,0.0
105531,0,0.0,0.0,0.0,0.0,0.0,112500.0,383760.0,41328.0,360000.0,0.008068,61.68493150684932,,-11558.0,-4656.0,,2.0,3.0,3.0,7.0,,0.6108728508068004,0.2985949897873972,0.0928,0.0877,0.9841,,,0.0,0.2069,0.1667,,0.0688,,0.0851,,0.0,0.0945,0.091,0.9841,,,0.0,0.2069,0.1667,,0.0704,,0.0886,,0.0,0.0937,0.0877,0.9841,,,0.0,0.2069,0.1667,,0.07,,0.0866,,0.0,0.0694,1.0,1.0,0.0,1.0,0.0,0.0,0.0,0.0,0.0,0.0,1.0,1.0,1.0,0.0,0.0,1.0,1.0,0.0,0.0,0.0,0.0,0.0,0.0,0.0,0.0,1.0,0.0,0.0,0.0,0.0,0.0,0.0,0.0,0.0,0.0,0.0,0.0,0.0,0.0,0.0,0.0,0.0,0.0,0.0,6.0,41769.0,0.0,270506.25,0.0,0.0,0.0,0.0,0.0,-1035.0,-304.0,-669.5,-1195.0,252.0,-22.5,2.0,24511.41,133852.5,129690.0,26770.5,267705.0,12.0,-954.5,365243.0,-1446.0,-1116.0,-1116.0,-1112.0,9.5,0.0,0.1018887200330531,1464.0,13.0,12.0,6.0,-42.0,0.0,0.0,12.0,24511.41,24511.41,-1295.0,-1281.0,6.5,1.0,0.0,,,,,,,,,,,,,,,,,,,,,8358428385.0,184600697886.0,165764889751.5,52040642905.935,1863.0,1706.0,71127.0,70989.0,9141.0,506767.0,17831.905500002318,17894.219399999125,17345.234299997996,11310.853600000097,11248.680200000095,11196.135800000066,128586.0,663699.0,,,,13545329.769862613,,-923130234.0,-296908380.0,-1537233128.0416667,44083.0,30750.0,11363.133999999192,11239.079999998989,10723.021799997288,22918.50970000981,22840.27030000978,22225.03520000834,,158247.08426400062,126276.69563806154,35047.74040002803,34987.84780002847,34433.011000028884,,,,3718969.0,8306.748200000162,8411.437200000077,8134.86430000023,,,,16489.715699999724,16675.233299999694,16271.894499999697,,,,3918.330700000123,3901.569000000162,3734.209800000161,437101.0,431890.0,,6433.339200002894,632795.0,626340.0,,16353.890399999793,154393.6590999908,154396.40119999036,154288.10289998722,,,,34.5,89534303.59499998,30824743.725000016,9208006602.97498,3038971554.5849986,106644278.79,813116.2499999997,180.0,24504.0,-29864154.5,13575821.5,-15492642.0,-16848485.0,-16.75,57010.5,0.0,167512.5,0.0,0.0,0.0,0.0,0.0,-2067.0,-1702.0,-886.0,-1702.0,318734959.725,4542483903.0300045,5096880333.585004,74044215.17999993,4542617755.5300045,328521.0,-22734493.5,5288519617.0,234200542.0,1195371658.0,517262107.0,1256774178.0,326811.0,5093.0,926.8016572519704,7520308.5,2703304.0,1664617.0,-5462681.0,1798604.0,245349.0,3586242243.6000977,3629585748.555094,-218375268.5,-216557734.0,3849336.5,180375.5,,,,,,,,,,,,,,,,,,,,,1469389.0,14855336.0,3236768.0,8567343.0,11623306.0,1417813.0,1061554791.4920012,802244759.1524953,72208513196.30212,21706711082.10012,583477324.4969988,5792665.7475,689.5,94245.0,-277292924.5,22010105.5,-123942686.5,-218993675.0,-2025439.5,,,,,,,,,,,,,,,,,,,,,4279001.0,2482804.5,-9015905.5,921451.5,37582.5,3739042987.919957,3663701134.109957,-260985032.0,-257668493.0,2529839.0,269592.0,3931516351.214953,33296795920.26092,36729300276.38265,1732217806.5525498,48149794771.85322,3993467.5,-247913393.0,103228647406.5,1056535940.0,17293856245.0,3508788241.5,18908799143.0,3677021.5,72031.0,20899.788559104185,89873085.5,,3.4112,2.722125435540069,167.91412104434156,9.285714285714286,572.7886497064579,56250.0,-0.2225209339563146,-0.9749279121818236,0.0,0.0,0.0,0.0,0.0,0.0,1.0,0.0,0.0,1.0,0.0,0.0,0.0,0.0,0.0,0.0,0.0,0.0,1.0,0.0,1.0,0.0,0.0,0.0,0.0,1.0,0.0,0.0,0.0,0.0,0.0,0.0,0.0,0.0,0.0,0.0,0.0,0.0,0.0,0.0,0.0,0.0,0.0,0.0,0.0,0.0,0.0,0.0,0.0,0.0,0.0,0.0,0.0,0.0,0.0,0.0,0.0,0.0,0.0,0.0,0.0,0.0,0.0,0.0,0.0,0.0,0.0,0.0,0.0,0.0,0.0,0.0,0.0,0.0,0.0,0.0,0.0,0.0,0.0,0.0,0.0,0.0,0.0,0.0,0.0,0.0,0.0,0.0,0.0,0.0,0.0,0.0,0.0,0.0,0.0,0.0,0.0,0.0,0.0,0.0,0.0,0.0,0.0,0.0,0.0,1.0,0.0,0.0,0.0,0.0,1.0,0.0,0.0,0.0,0.0,0.0,0.0,1.0,0.0,0.0
105532,0,0.0,0.0,0.0,1.0,0.0,135000.0,274500.0,14143.5,274500.0,0.020713,56.386301369863006,-5043.0,-8431.0,-3515.0,,1.0,3.0,3.0,12.0,0.5640688205427808,0.4633846781722674,0.2955826421513093,0.0918,0.0977,0.9871,0.8232,0.0149,0.0,0.2069,0.1667,0.2083,0.0967,0.0748,0.0882,0.0039,0.0049,0.0935,0.1014,0.9871,0.8301,0.015,0.0,0.2069,0.1667,0.2083,0.0989,0.0817,0.0919,0.0039,0.0051,0.0926,0.0977,0.9871,0.8256,0.015,0.0,0.2069,0.1667,0.2083,0.0984,0.0761,0.0898,0.0039,0.005,0.0694,1.0,0.0,0.0,0.0,0.0,-1443.0,0.0,0.0,0.0,0.0,0.0,4.0,1.0,1.0,1.0,1.0,1.0,0.0,0.0,0.0,0.0,0.0,0.0,0.0,0.0,0.0,0.0,0.0,1.0,0.0,0.0,0.0,0.0,0.0,0.0,0.0,0.0,0.0,0.0,0.0,0.0,0.0,0.0,0.0,9.0,0.0,0.0,122310.0,0.0,0.0,0.0,0.0,0.0,-1495.0,-487.0,-326.0,-1978.0,496.0,-31.5,10.0,12326.58,69795.0,51149.25,9000.0,229500.0,6.0,-663.0,365243.0,-665.0,-145.0,-145.0,-139.0,10.0,0.0,0.1812131296324307,-1.0,37.0,30.0,12.0,-12.0,0.0,0.0,40.0,13403.16,12404.835,-301.5,-300.0,7.0,1.0,0.0,,,,,,,,,,,,,,,,,,,,,8358442528.5,184600972386.0,165765164251.5,52040777905.935,1863.0,1706.0,71127.0,70989.0,9141.0,506771.0,17831.997300002313,17894.311999999125,17345.327799997995,11310.951300000095,11248.777900000096,11196.237200000063,128586.0,663700.0,4143.030300000114,4140.712800000013,3951.277900000093,13545386.156163985,-602737870.0,-923133749.0,-296909823.0,-1537241559.0416667,44083.0,30750.0,11363.133999999192,11239.079999998989,10723.021799997288,22918.71660000982,22840.47720000978,22225.24210000834,67580.23596878303,158247.5476486788,126276.99122070373,35047.90710002803,34988.01450002847,34433.17770002888,22981.81599999588,22954.87909999545,22601.247399995693,3718981.0,8306.844900000162,8411.535600000077,8134.963200000231,9829.24320000072,9944.306100002155,10304.570699999636,16489.803899999722,16675.323099999696,16271.986399999694,829.288800000177,814.4666000000461,760.3861000000132,3918.335600000123,3901.574000000162,3734.214900000161,437101.0,431890.0,,6433.359913002894,632798.0,626343.0,,16353.959799999791,154394.6461999908,154397.38829999036,154289.08999998722,77711.40679999637,78049.6588000066,78451.63420000668,50.0,89576072.59499998,30824743.725000016,9209148221.47498,3038971554.5849986,106644278.79,813116.2499999997,180.0,24504.0,-29876065.0,13568855.0,-15497951.0,-16856269.0,-24.5,0.0,0.0,122310.0,0.0,0.0,0.0,0.0,0.0,-2552.0,-2010.0,-1141.0,-2427.0,318782621.2275,4543594300.5300045,5097871908.585004,74053215.17999993,4543621345.5300045,328548.0,-22739027.5,5289250103.0,234198465.0,1195735494.0,517260905.0,1257138024.0,326870.0,5094.0,926.9828703816028,7521789.0,2703778.0,1664888.0,-5463371.0,1798604.0,245349.0,3586621907.790094,3629938423.5900903,-218395262.0,-216577561.5,3849570.5,180401.5,,,,,,,,,,,,,,,,,,,,,1469398.0,14855832.0,3236768.0,8567380.0,11623346.0,1417823.0,1061554791.4920012,802244759.1524953,72208635506.30212,21706711082.10012,583477324.4969988,5792665.7475,689.5,94245.0,-277294419.5,22009618.5,-123943012.5,-218995653.0,-2025471.0,,,,,,,,,,,,,,,,,,,,,4279031.0,2482816.5,-9015917.5,921451.5,37582.5,3739056391.079957,3663713538.944957,-260985333.5,-257668793.0,2529846.0,269593.0,3931528677.794953,33296865715.26092,36729351425.63265,1732226806.5525498,48150024271.85322,3993473.5,-247914056.0,103229012649.5,1056535275.0,17293856100.0,3508788096.5,18908799004.0,3677031.5,72031.0,20899.969772233817,89873084.5,-89.43661629658425,2.033333333333333,9.545020680878142,538.20841269357,19.40820871778556,1094.3571058102589,135000.0,-0.2225209339563146,-0.9749279121818236,0.0,0.0,0.0,0.0,0.0,0.0,1.0,0.0,0.0,0.0,0.0,0.0,0.0,1.0,0.0,1.0,0.0,0.0,0.0,0.0,0.0,0.0,1.0,0.0,0.0,1.0,0.0,0.0,0.0,0.0,0.0,0.0,0.0,1.0,0.0,0.0,0.0,0.0,0.0,0.0,0.0,0.0,0.0,0.0,0.0,0.0,0.0,0.0,0.0,0.0,0.0,0.0,0.0,0.0,0.0,0.0,0.0,0.0,0.0,0.0,0.0,0.0,0.0,0.0,0.0,0.0,0.0,0.0,0.0,0.0,0.0,0.0,0.0,0.0,0.0,0.0,0.0,0.0,0.0,0.0,0.0,0.0,0.0,1.0,0.0,0.0,0.0,0.0,0.0,0.0,0.0,0.0,0.0,0.0,0.0,0.0,0.0,0.0,0.0,0.0,0.0,0.0,0.0,0.0,0.0,0.0,0.0,0.0,0.0,1.0,1.0,0.0,0.0,0.0,0.0,0.0,0.0,1.0,0.0,0.0
105558,0,0.0,0.0,0.0,1.0,0.0,292500.0,500490.0,48888.0,450000.0,0.072508,57.27945205479452,,-9967.0,-4421.0,,1.0,1.0,1.0,12.0,,0.7620384193131836,0.6545292802242897,0.0639,0.0611,0.9727,0.626,0.0447,0.0,0.1034,0.1667,0.2083,0.0,0.0504,0.0486,0.0077,0.0057,0.0651,0.0634,0.9727,0.6406,0.0452,0.0,0.1034,0.1667,0.2083,0.0,0.0551,0.0506,0.0078,0.006,0.0645,0.0611,0.9727,0.631,0.045,0.0,0.1034,0.1667,0.2083,0.0,0.0513,0.0495,0.0078,0.0058,0.0395,1.0,0.0,0.0,0.0,0.0,-3291.0,0.0,0.0,0.0,0.0,0.0,1.0,1.0,0.0,0.0,1.0,1.0,0.0,0.0,0.0,0.0,0.0,0.0,0.0,0.0,0.0,0.0,0.0,1.0,0.0,0.0,0.0,0.0,0.0,0.0,0.0,0.0,0.0,0.0,0.0,0.0,0.0,0.0,0.0,2.0,0.0,,1026000.0,346659.75,0.0,0.0,0.0,0.0,-1747.0,-220.0,-280.0,-1186.0,116.0,-28.5,0.0,,,,,,,,,,,,,,,,,0.0,,,,,,96.0,132.165,132.165,-1469.5,-1469.5,64.5,0.0,96.0,0.0,0.0,0.0,0.0,0.0,0.0,0.0,132.165,0.0,0.0,0.0,0.0,0.0,0.0,0.0,0.0,7.0,-48.5,0.0,0.0,8358491416.5,184601472876.0,165765614251.5,52041070405.935,1863.0,1706.0,71127.0,70989.0,9141.0,506772.0,17832.061200002314,17894.37649999912,17345.392899997994,11311.012400000096,11248.839000000096,11196.300600000064,128586.0,663701.0,4143.075000000114,4140.757800000013,3951.323100000093,13545443.43561604,,-923138170.0,-296913114.0,-1537251526.0416667,44083.0,30750.0,11363.133999999192,11239.079999998989,10723.021799997288,22918.82000000982,22840.58060000978,22225.34550000834,,158248.3096870981,126277.64574998392,35048.07380002803,34988.18120002847,34433.34440002888,22982.02429999588,22955.087399995453,22601.455699995688,3718993.0,8306.844900000162,8411.535600000077,8134.963200000231,9829.29360000072,9944.357400002156,10304.625799999636,16489.85249999972,16675.372599999693,16272.036999999696,829.296500000177,814.4744000000461,760.3939000000133,3918.3413000001233,3901.579800000162,3734.22090000016,437101.0,431890.0,,6433.432421002894,632799.0,626344.0,,16353.999299999796,154395.6188999908,154398.36099999034,154290.0626999872,77712.03279999638,78050.28980000659,78452.27480000666,58.0,89923216.32,,9249809368.27498,3051373997.9249988,106974383.625,813242.2499999997,180.0,24520.0,-30077001.0,13593841.0,-15594629.0,-16970876.0,-28.5,0.0,,1350000.0,0.0,0.0,0.0,0.0,0.0,-1818.0,-842.0,-538.0,-1186.0,,,,,,,,,,,,,,,,,,,,,,3603387000.172587,3645995399.707588,-219416685.0,-217590597.0,3867431.5,181198.0,3326938379.4599504,8982666000.0,281593821.375,430246514.4749999,13067168.040000005,135138198.05999982,188817659.369999,471321542.9024898,434198943.9899975,3194679404.9250174,3314954596.3649325,3315129699.4649315,14410.0,38000.0,192.0,23398.0,1088810.5,-1931525.5,814063.0,1828.0,1469400.0,14855948.0,3236864.0,8567380.0,11623442.0,1417823.0,1061554791.4920012,,72209661506.30212,21707057741.85012,583477324.4969988,5792665.7475,689.5,94245.0,-277296166.5,22009398.5,-123943292.5,-218996839.0,-2025499.5,5928815985.862462,18749745000.0,198880482.825,448407298.07999766,1948107.735,257088950.66250083,309410650.5524987,637128538.6049979,459555823.8224992,5713783045.155035,5892064845.277497,5892308028.022499,13394.0,80972.0,44.0,70474.5,972452.0,-1700771.5,177364.0,6755.0,,,,,,3739056523.244957,3663713671.109957,-260986803.0,-257670262.5,2529910.5,269593.0,,,,,,,,,,,,,,,,,,1.7110769230769232,5.983063328424152,342.7065890612706,10.237481590574372,586.3973359291464,292500.0,1.0,0.0,0.0,0.0,0.0,0.0,0.0,0.0,1.0,0.0,0.0,1.0,0.0,0.0,0.0,0.0,0.0,0.0,0.0,0.0,1.0,0.0,0.0,0.0,1.0,0.0,0.0,1.0,0.0,0.0,0.0,0.0,0.0,0.0,0.0,0.0,0.0,0.0,0.0,0.0,0.0,0.0,0.0,0.0,0.0,0.0,0.0,0.0,0.0,0.0,0.0,0.0,0.0,0.0,0.0,0.0,0.0,0.0,0.0,0.0,0.0,0.0,0.0,0.0,0.0,0.0,0.0,0.0,0.0,0.0,0.0,0.0,0.0,0.0,0.0,0.0,0.0,0.0,0.0,0.0,0.0,0.0,0.0,0.0,0.0,0.0,0.0,0.0,0.0,0.0,0.0,0.0,0.0,0.0,0.0,0.0,0.0,0.0,0.0,0.0,0.0,0.0,0.0,0.0,0.0,0.0,0.0,1.0,0.0,0.0,1.0,0.0,1.0,0.0,0.0,0.0,0.0,0.0,0.0,0.0,1.0,0.0
105574,0,0.0,0.0,0.0,0.0,0.0,112500.0,418500.0,24156.0,418500.0,0.015221,59.35890410958904,-4157.0,-5132.0,-5143.0,,2.0,2.0,2.0,9.0,0.8875675666828465,0.5710949188664827,0.5937175866150576,,,,,,,,,,,,,,,,,,,,,,,,,,,,,,,,,,,,,,,,,,,,,1.0,1.0,1.0,0.0,-553.0,0.0,0.0,0.0,0.0,0.0,2.0,1.0,1.0,0.0,1.0,1.0,0.0,0.0,0.0,0.0,0.0,1.0,1.0,0.0,1.0,0.0,0.0,0.0,0.0,0.0,0.0,0.0,0.0,0.0,0.0,0.0,0.0,0.0,0.0,0.0,0.0,0.0,0.0,1.0,,0.0,84510.0,0.0,0.0,0.0,0.0,0.0,-317.0,-225.0,-223.0,-225.0,11.0,-5.0,6.0,17112.69,33750.0,33750.0,2.25,92004.75,6.0,-247.0,365243.0,-369.5,182435.5,50.5,182436.5,14.0,0.5,2.529769132170935e-05,-1.0,15.0,24.0,17.0,-8.0,0.0,0.0,17.0,17112.69,22982.4,-191.0,-187.0,4.0,3.0,0.0,,,,,,,,,,,,,,,,,,,,,8358515572.5,184601891376.0,165766032751.5,52041182905.935,1863.0,1706.0,71127.0,70989.0,9141.0,506774.0,,,,,,,128586.0,663703.0,,,,13545502.794520147,-602742027.0,-923143313.0,-296913667.0,-1537256658.0416667,44084.0,30750.0,,,,,,,67581.12353634971,158248.880782017,126278.23946757054,,,,,,,3719002.0,,,,,,,,,,,,,,,,437102.0,431891.0,,6433.447642002894,632801.0,626346.0,,,,,,,,,11.0,,31027314.82500001,9273850332.479984,3062229308.5049987,107285778.99,813242.2499999997,180.0,24520.0,-30149026.0,13626033.0,-15631584.0,-17013196.0,-5.0,,0.0,84510.0,0.0,0.0,0.0,0.0,0.0,-317.0,-225.0,-223.0,-225.0,321127390.84499985,4580557920.900003,5138043770.790004,74492146.84499995,4580591670.900003,331103.0,-22893439.5,5327412321.5,235548654.5,1203873571.5,520118109.5,1266740505.5,329275.0,5121.5,933.1933615428024,7567373.5,2723545.0,1676534.0,-5501352.0,1830964.0,245452.0,3607738871.265083,3650478825.01508,-219786841.0,-217956453.0,3872222.0,181561.0,,,,,,,,,,,,,,,,,,,,,1469401.0,14855959.0,3236864.0,8567395.0,11623459.0,1417829.0,,802244759.1524953,72209746016.30212,21707057741.85012,583477324.4969988,5792665.7475,689.5,94245.0,-277296483.5,22009173.5,-123943515.5,-218997064.0,-2025504.5,,,,,,,,,,,,,,,,,,,,,4279055.0,2482833.5,-9015925.5,921451.5,37582.5,3739073635.934957,3663736653.509957,-260986994.0,-257670449.5,2529914.5,269596.0,3931545790.484953,33296899465.26092,36729385175.63265,1732226808.8025498,48150116276.60322,3993479.5,-247914303.0,103229377892.5,1056534905.5,17294038535.5,3508788147.0,18908981440.5,3677045.5,72031.5,20899.96979753151,89873083.5,-70.03161635742639,3.72,4.657228017883756,276.44795133005334,17.32488822652757,1028.3863789477982,56250.0,-0.2225209339563146,-0.9749279121818236,0.0,1.0,0.0,0.0,0.0,0.0,0.0,0.0,0.0,0.0,0.0,0.0,0.0,1.0,0.0,0.0,0.0,0.0,1.0,0.0,1.0,0.0,0.0,0.0,0.0,1.0,0.0,0.0,0.0,0.0,0.0,0.0,0.0,1.0,0.0,0.0,0.0,0.0,0.0,0.0,0.0,0.0,0.0,0.0,0.0,0.0,0.0,0.0,0.0,0.0,0.0,0.0,0.0,1.0,0.0,0.0,0.0,0.0,0.0,0.0,0.0,0.0,0.0,0.0,0.0,0.0,0.0,0.0,0.0,0.0,0.0,0.0,0.0,0.0,0.0,0.0,0.0,0.0,0.0,0.0,0.0,0.0,0.0,0.0,0.0,0.0,0.0,0.0,0.0,0.0,0.0,0.0,0.0,0.0,0.0,0.0,0.0,0.0,0.0,0.0,0.0,0.0,0.0,0.0,0.0,0.0,0.0,0.0,0.0,0.0,0.0,0.0,0.0,0.0,0.0,0.0,0.0,0.0,0.0,0.0
105578,0,0.0,0.0,1.0,1.0,0.0,101250.0,296280.0,18256.5,225000.0,0.010006,59.361643835616434,,-3540.0,-3551.0,10.0,2.0,2.0,2.0,8.0,0.7360358134067536,0.551443098786123,0.8357765157975799,,,,,,,,,,,,,,,,,,,,,,,,,,,,,,,,,,,,,,,,,,,,,4.0,0.0,4.0,0.0,-2624.0,0.0,0.0,0.0,0.0,1.0,1.0,1.0,0.0,0.0,1.0,1.0,0.0,0.0,0.0,0.0,0.0,0.0,0.0,0.0,1.0,0.0,0.0,0.0,0.0,0.0,0.0,0.0,0.0,0.0,0.0,0.0,0.0,0.0,0.0,0.0,0.0,0.0,0.0,1.0,0.0,,1080450.0,0.0,0.0,0.0,0.0,0.0,-2910.0,-1084.0,-934.0,-1570.0,96.0,-47.5,3.0,12576.825,145080.0,170356.5,0.0,145080.0,10.0,-1556.0,365243.0,-1525.0,-835.0,-835.0,-826.0,9.0,0.0,0.0,120.0,46.0,24.0,7.0,-38.5,0.0,0.0,46.0,7683.075,7683.075,-1227.5,-1210.0,8.0,1.0,0.0,,,,,,,,,,,,,,,,,,,,,8358533829.0,184602187656.0,165766257751.5,52041284155.935,1863.0,1706.0,71127.0,70990.0,9141.0,506775.0,,,,,,,128586.0,663705.0,,,,13545562.156163985,,-923146864.0,-296916291.0,-1537260198.0416667,44084.0,30750.0,,,,,,,67581.85957216311,158249.43222511574,126279.07524408634,,,,,,,3719010.0,,,,,,,,,,,,,,,,437106.0,431895.0,1264744.0,6433.457648002895,632803.0,626348.0,,,,,,,,,96.0,89951179.32,,9275401456.379984,3062229308.5049987,107285778.99,813242.2499999997,180.0,24520.0,-30158044.0,13619907.0,-15637639.0,-17019895.0,-47.5,0.0,,1080450.0,0.0,0.0,0.0,0.0,0.0,-2910.0,-1084.0,-934.0,-1570.0,321378332.30999994,4584157848.900003,5142351364.290004,74527885.84499995,4584157848.900003,331383.0,-22910397.0,5332707263.0,236264492.0,1206238475.0,521207905.0,1269105461.0,329539.0,5127.0,933.6104758827298,7574118.0,2727487.0,1679214.0,-5505499.5,1830967.0,245455.0,3611608500.712582,3654702689.782578,-219971242.0,-218138455.5,3877681.5,181760.5,,,,,,,,,,,,,,,,,,,,,1469402.0,14856055.0,3236864.0,8567441.0,11623505.0,1417832.0,1061554791.4920012,,72210826466.30212,21707057741.85012,583477324.4969988,5792665.7475,689.5,94245.0,-277299393.5,22008089.5,-123944449.5,-218998634.0,-2025552.0,,,,,,,,,,,,,,,,,,,,,4279079.0,2482840.5,-9015964.0,921451.5,37582.5,3739081319.009957,3663744336.584957,-260988221.5,-257671659.5,2529922.5,269597.0,3931558367.309953,33297044545.26092,36729555532.13265,1732226808.8025498,48150261356.60322,3993489.5,-247915859.0,103229743135.5,1056533380.5,17294037700.5,3508787312.0,18908980614.5,3677054.5,72031.5,20899.96979753151,89873203.5,,2.9262222222222216,5.54596992851861,329.21789161976085,16.228740448607347,963.3647104108916,50625.0,0.6234898018587334,-0.7818314824680299,0.0,0.0,0.0,0.0,0.0,0.0,1.0,0.0,0.0,1.0,0.0,0.0,0.0,0.0,0.0,0.0,0.0,0.0,1.0,0.0,1.0,0.0,0.0,0.0,0.0,1.0,0.0,0.0,0.0,0.0,0.0,0.0,0.0,0.0,0.0,0.0,0.0,0.0,0.0,0.0,0.0,0.0,0.0,0.0,0.0,0.0,0.0,0.0,0.0,0.0,0.0,0.0,0.0,0.0,0.0,0.0,0.0,0.0,0.0,0.0,0.0,0.0,0.0,0.0,0.0,0.0,0.0,0.0,0.0,0.0,0.0,0.0,0.0,0.0,0.0,0.0,0.0,0.0,0.0,0.0,0.0,0.0,0.0,0.0,0.0,0.0,0.0,0.0,0.0,0.0,0.0,0.0,0.0,0.0,0.0,0.0,0.0,0.0,0.0,0.0,0.0,0.0,0.0,0.0,0.0,1.0,0.0,0.0,0.0,0.0,0.0,0.0,0.0,0.0,0.0,0.0,0.0,0.0,0.0,0.0
105584,0,0.0,1.0,1.0,1.0,1.0,180000.0,431280.0,22149.0,360000.0,0.020713,37.73698630136986,-1384.0,-2449.0,-4943.0,16.0,3.0,3.0,2.0,10.0,0.4232508621469009,0.2602410228800565,0.2707073872651806,,,,,,,,,,,,,,,,,,,,,,,,,,,,,,,,,,,,,,,,,,,,,1.0,1.0,1.0,1.0,-646.0,0.0,0.0,0.0,0.0,0.0,2.0,1.0,1.0,0.0,1.0,0.0,0.0,0.0,0.0,0.0,0.0,0.0,0.0,0.0,1.0,0.0,0.0,0.0,0.0,0.0,0.0,0.0,0.0,0.0,0.0,0.0,0.0,0.0,0.0,0.0,0.0,0.0,0.0,3.0,16420.5,0.0,189000.0,162279.9,20577.06,0.0,0.0,0.0,-1206.0,-861.0,-883.0,-900.0,138.0,-29.5,13.0,35817.435,77625.0,69862.5,3881.25,625500.0,36.0,-195.0,365243.0,-464.0,365243.0,75.0,365243.0,12.0,0.0,0.0544545454545454,-1.0,33.0,24.0,9.5,-11.0,0.0,0.0,39.0,5109.705,5109.705,-305.0,-255.0,7.0,1.0,6.0,103126.9725,180000.0,42750.0,37909.7325,0.0,0.0,2973.375,7200.0,5625.0,96155.4375,98661.69,98661.69,2.0,2.5,0.0,0.0,1.5,-3.5,0.0,0.0,8358555978.0,184602618936.0,165766617751.5,52041464155.935,1863.0,1706.0,71127.0,70990.0,9141.0,506777.0,,,,,,,128587.0,663708.0,,,,13545599.893150289,-602743411.0,-923151807.0,-296916937.0,-1537262647.0416667,44085.0,30751.0,,,,,,,67582.28282302526,158249.69246613866,126279.3459514736,,,,,,,3719020.0,,,,,,,,,,,,,,,,437107.0,431896.0,1264760.0,6433.478361002894,632806.0,626350.0,,,,,,,,,40.0,89978845.32,31063410.58500002,9278884035.449984,3062688718.0049987,107306356.05,813242.2499999997,180.0,24520.0,-30209865.0,13609495.0,-15676937.0,-17054680.0,-19.5,22491.0,0.0,814882.5,275436.0,20577.06,0.0,0.0,0.0,-2688.0,-861.0,-1287.0,-900.0,321694614.18,4586889497.400003,5146190035.290004,74584583.59499995,4587519497.400003,331693.0,-22930680.0,5339281637.0,236978235.0,1208417183.0,522292040.0,1271284250.0,329868.0,5133.0,934.0621794612408,7580246.0,2730391.0,1680856.5,-5512485.0,1830984.0,245472.0,3613562395.605076,3656581340.895075,-220169134.0,-218333757.0,3879061.0,181972.0,3334392870.2549515,9023463000.0,281773821.375,431441298.98999983,13067168.040000005,136152982.57499984,189165567.41999903,472256842.4999908,435119640.74999744,3201887225.0700183,3322393825.1399345,3322568928.239933,14417.0,38108.0,192.0,23499.0,1089743.0,-1936183.0,814063.0,1828.0,1469405.0,14856193.0,3236870.0,8567474.0,11623544.0,1417845.0,1061571211.9920012,802244759.1524953,72211015466.30212,21707220021.75012,583497901.5569987,5792665.7475,689.5,94245.0,-277300599.5,22007228.5,-123945332.5,-218999534.0,-2025581.5,5928919112.834962,18749925000.0,198923232.825,448445207.8124977,1948107.735,257088950.66250083,309413623.9274987,637135738.6049979,459561448.8224992,5713879200.592535,5892163506.967498,5892406689.7125,13396.0,80974.5,44.0,70474.5,972453.5,-1700775.0,177364.0,6755.0,4279103.0,2482850.0,-9015975.0,921451.5,37582.5,3739086428.714956,3663749446.289957,-260988526.5,-257671914.5,2529929.5,269598.0,3931594184.744953,33297122170.26092,36729625394.63265,1732230690.0525498,48150886856.60322,3993525.5,-247916054.0,103230108378.5,1056532916.5,17294402943.5,3508787387.0,18909345857.5,3677066.5,72031.5,20900.02425207696,89873202.5,-36.67489472919994,2.396,8.126777732629012,306.68009997049865,19.471759447379117,734.8055195293148,60000.0,0.6234898018587336,0.7818314824680298,0.0,0.0,0.0,0.0,0.0,0.0,1.0,0.0,0.0,0.0,0.0,0.0,0.0,1.0,0.0,0.0,0.0,0.0,1.0,1.0,0.0,0.0,0.0,0.0,0.0,1.0,0.0,0.0,0.0,0.0,0.0,0.0,0.0,0.0,0.0,0.0,0.0,0.0,0.0,0.0,0.0,0.0,0.0,0.0,0.0,0.0,0.0,0.0,0.0,0.0,0.0,0.0,0.0,0.0,0.0,0.0,0.0,0.0,0.0,0.0,0.0,0.0,0.0,0.0,0.0,0.0,0.0,0.0,0.0,0.0,0.0,0.0,0.0,0.0,0.0,0.0,0.0,0.0,0.0,0.0,0.0,0.0,0.0,0.0,0.0,0.0,0.0,0.0,0.0,0.0,1.0,0.0,0.0,0.0,0.0,0.0,0.0,0.0,0.0,0.0,0.0,0.0,0.0,0.0,0.0,0.0,0.0,0.0,0.0,0.0,0.0,0.0,0.0,0.0,0.0,0.0,0.0,0.0,0.0,0.0
105595,0,0.0,1.0,0.0,1.0,0.0,202500.0,156384.0,18688.5,135000.0,0.0116569999999999,40.41095890410959,-430.0,-3636.0,-177.0,,1.0,1.0,1.0,12.0,0.4025737655422282,0.5352322082025062,0.6144143775673561,0.0515,0.1251,0.9871,0.8232,0.0177,0.0,0.1379,0.2083,0.2083,0.0,0.0403,0.0701,0.0077,0.0536,0.0525,0.1298,0.9871,0.8301,0.0179,0.0,0.1379,0.2083,0.2083,0.0,0.0441,0.073,0.0078,0.0567,0.052,0.1251,0.9871,0.8256,0.0178,0.0,0.1379,0.2083,0.2083,0.0,0.041,0.0713,0.0078,0.0547,0.0765,1.0,2.0,0.0,2.0,0.0,-301.0,0.0,0.0,0.0,0.0,1.0,0.0,1.0,1.0,0.0,1.0,0.0,1.0,0.0,0.0,0.0,0.0,0.0,0.0,0.0,1.0,0.0,0.0,0.0,0.0,0.0,0.0,0.0,0.0,0.0,0.0,0.0,0.0,0.0,0.0,0.0,0.0,0.0,0.0,1.0,0.0,,90000.0,0.0,0.0,0.0,0.0,0.0,-2837.0,-2471.0,-2530.0,-2531.0,94.0,-46.5,2.0,14364.2025,147291.75,100732.5,46559.25,147291.75,9.0,-222.0,365243.0,-188.5,182516.0,51.5,182517.5,18.0,0.0,0.3267369704573436,53.0,8.0,6.0,5.5,-6.0,0.0,0.0,7.0,18619.02,18619.02,-127.0,-106.0,2.0,1.0,0.0,,,,,,,,,,,,,,,,,,,,,8358574666.5,184602775320.0,165766752751.5,52041666655.935,1863.0,1706.0,71127.0,70991.0,9141.0,506777.0,17832.112700002315,17894.428499999125,17345.445399997996,11311.137500000095,11248.964100000096,11196.430400000065,128587.0,663709.0,4143.092700000115,4140.775600000013,3951.3410000000927,13545640.304109192,-602743841.0,-923151984.0,-296917238.0,-1537266283.0416667,44085.0,30751.0,11363.133999999192,11239.079999998989,10723.021799997288,22918.95790000982,22840.71850000978,22225.483400008347,67582.68539679081,158250.22769834686,126279.96036585118,35048.28210002803,34988.38950002847,34433.55270002888,22982.23259999588,22955.29569999545,22601.66399999569,3719032.0,8306.844900000162,8411.535600000077,8134.963200000231,9829.33390000072,9944.398400002156,10304.669899999635,16489.922599999718,16675.443899999696,16272.109999999697,829.304200000177,814.4822000000461,760.4017000000133,3918.394900000124,3901.6345000001616,3734.27760000016,437109.0,431898.0,,6433.490018002894,632807.0,626351.0,,16354.075799999791,154396.6059999908,154399.34809999034,154291.0497999872,77712.85599999638,78051.11540000659,78453.10490000669,94.0,89984020.32,,9287691858.179983,3063678701.3099995,107433533.295,813242.2499999997,180.0,24520.0,-30270555.0,13603150.0,-15707877.0,-17096651.0,-46.5,0.0,,90000.0,0.0,0.0,0.0,0.0,0.0,-2837.0,-2471.0,-2530.0,-2531.0,322202017.1924999,4592086215.525003,5152190553.540004,74990610.71999995,4592086215.525003,332182.0,-23007024.5,5349686976.5,237305905.5,1210580511.5,523726891.5,1273447926.0,330568.0,5141.0,939.4150529363473,7589363.0,2733212.5,1682319.0,-5522857.5,1832399.0,245472.0,3617591562.85507,3660473181.330071,-220559042.0,-218720523.0,3886323.0,182213.0,,,,,,,,,,,,,,,,,,,,,1469406.0,14856287.0,3236870.0,8567482.0,11623551.0,1417847.0,1061571211.9920012,,72211105466.30212,21707220021.75012,583497901.5569987,5792665.7475,689.5,94245.0,-277303436.5,22004757.5,-123947862.5,-219002065.0,-2025628.0,,,,,,,,,,,,,,,,,,,,,4279109.0,2482855.5,-9015981.0,921451.5,37582.5,3739105047.734956,3663768065.309957,-260988653.5,-257672020.5,2529931.5,269599.0,3931608548.947453,33297269462.01092,36729726127.13265,1732277249.3025498,48151034148.35322,3993534.5,-247916276.0,103230473621.5,1056532728.0,17294585459.5,3508787438.5,18909528375.0,3677084.5,72031.5,20900.35098904742,89873255.5,-10.640677966101697,0.7722666666666667,10.835540573079696,437.8745848025359,8.367926799903682,338.15594602350507,202500.0,-0.9009688679024191,-0.433883739117558,0.0,0.0,0.0,0.0,0.0,0.0,1.0,0.0,0.0,0.0,0.0,0.0,0.0,1.0,0.0,0.0,0.0,0.0,1.0,0.0,0.0,0.0,1.0,0.0,0.0,1.0,0.0,0.0,0.0,0.0,0.0,0.0,0.0,0.0,0.0,0.0,0.0,0.0,1.0,0.0,0.0,0.0,0.0,0.0,0.0,0.0,0.0,0.0,0.0,0.0,0.0,0.0,0.0,1.0,0.0,0.0,0.0,0.0,0.0,0.0,0.0,0.0,0.0,0.0,0.0,0.0,0.0,0.0,0.0,0.0,0.0,0.0,0.0,0.0,0.0,0.0,0.0,0.0,0.0,0.0,0.0,0.0,0.0,0.0,0.0,0.0,0.0,0.0,0.0,0.0,0.0,0.0,0.0,0.0,0.0,0.0,0.0,0.0,0.0,0.0,0.0,0.0,0.0,0.0,0.0,0.0,0.0,0.0,1.0,0.0,1.0,0.0,0.0,0.0,0.0,0.0,0.0,1.0,0.0,0.0
105617,0,0.0,1.0,0.0,1.0,0.0,54000.0,225000.0,20637.0,225000.0,0.009175,55.05479452054794,,-5186.0,-3627.0,,2.0,2.0,2.0,9.0,,0.5832936775204198,,,,,,,,,,,,,,,,,,,,,,,,,,,,,,,,,,,,,,,,,,,,,,7.0,2.0,7.0,2.0,0.0,0.0,0.0,0.0,0.0,0.0,0.0,1.0,0.0,0.0,1.0,0.0,0.0,0.0,0.0,0.0,0.0,0.0,0.0,0.0,1.0,0.0,0.0,0.0,0.0,0.0,0.0,0.0,0.0,0.0,0.0,0.0,0.0,0.0,0.0,0.0,0.0,0.0,0.0,2.0,0.0,,20025.0,6817.5,,0.0,0.0,0.0,-259.5,-274.0,-5.0,-334.0,18.0,-8.5,1.0,2219.175,20353.5,17163.0,4500.0,20353.5,10.0,-2467.0,365243.0,-2434.0,-2164.0,-2164.0,-2161.0,17.0,1.0,0.2262340899648751,15.0,10.0,10.0,5.5,-76.5,0.0,0.0,10.0,2219.175,2219.175,-2303.5,-2299.0,5.5,1.0,0.0,,,,,,,,,,,,,,,,,,,,,8358595303.5,184603000320.0,165766977751.5,52041720655.935,1863.0,1706.0,71127.0,70991.0,9141.0,506777.0,,,,,,,128587.0,663711.0,,,,13545695.358903712,,-923155611.0,-296917238.0,-1537271469.0416667,44087.0,30753.0,,,,,,,,158250.81099202434,,,,,,,,3719041.0,,,,,,,,,,,,,,,,437116.0,431905.0,,6433.499193002896,632809.0,626353.0,,,,,,,,,9.0,90436059.855,,9344643446.339989,3075229542.914999,,813242.2499999997,181.0,24520.0,-30450478.0,13667411.0,-15799633.0,-17207523.0,-8.5,,,26550.0,0.0,,0.0,0.0,0.0,-517.0,-274.0,-8.0,-334.0,322775967.195,4598309758.275003,5158949546.790004,75220668.71999995,4598309758.275003,332746.0,-23063716.0,5364113459.0,237995246.0,1212008973.0,525158014.0,1274876995.0,331428.0,5148.0,942.7985506977712,7611608.0,2737293.0,1684463.5,-5535990.0,1835136.0,245475.0,3622745385.472576,3665632599.607576,-220912823.0,-219069665.0,3888946.5,182575.5,,,,,,,,,,,,,,,,,,,,,1469408.0,14856305.0,3236870.0,8567492.0,11623561.0,1417848.0,1061571211.9920012,,72211125491.30212,21707226839.25012,,5792665.7475,689.5,94245.0,-277303696.0,22004483.5,-123947867.5,-219002399.0,-2025636.5,,,,,,,,,,,,,,,,,,,,,4279119.0,2482861.0,-9016057.5,921451.5,37582.5,3739107266.909957,3663770284.484957,-260990957.0,-257674319.5,2529937.0,269600.0,3931610768.122453,33297289815.51092,36729743290.13265,1732281749.3025498,48151054501.85322,3993544.5,-247918743.0,103230838864.5,1056530294.0,17294583295.5,3508785274.5,18909526214.0,3677101.5,72032.5,20900.57722313738,89873270.5,,4.166666666666667,2.6166593981683386,144.05964549641854,10.902747492368077,600.2485229017439,27000.0,-0.9009688679024191,-0.433883739117558,0.0,1.0,0.0,0.0,0.0,0.0,0.0,0.0,0.0,1.0,0.0,0.0,0.0,0.0,0.0,0.0,0.0,0.0,1.0,1.0,0.0,0.0,0.0,0.0,0.0,1.0,0.0,0.0,0.0,0.0,0.0,0.0,0.0,0.0,0.0,0.0,0.0,0.0,0.0,0.0,0.0,0.0,0.0,0.0,0.0,0.0,0.0,0.0,0.0,0.0,0.0,0.0,0.0,0.0,0.0,0.0,0.0,0.0,0.0,0.0,0.0,0.0,0.0,0.0,0.0,0.0,0.0,0.0,0.0,0.0,0.0,0.0,0.0,0.0,0.0,0.0,0.0,0.0,0.0,0.0,0.0,0.0,0.0,0.0,0.0,0.0,0.0,0.0,0.0,0.0,0.0,0.0,0.0,0.0,0.0,0.0,0.0,0.0,0.0,0.0,0.0,0.0,0.0,0.0,0.0,1.0,0.0,0.0,0.0,0.0,0.0,0.0,0.0,0.0,0.0,0.0,0.0,0.0,0.0,0.0
105618,0,0.0,1.0,1.0,1.0,0.0,157500.0,675000.0,34596.0,675000.0,0.0145199999999999,64.5095890410959,,-8162.0,-5447.0,4.0,2.0,2.0,2.0,7.0,,0.6786638806943144,0.511891801533151,,,,,,,,,,,,,,,,,,,,,,,,,,,,,,,,,,,,,,,,,,,,,7.0,0.0,7.0,0.0,-2156.0,0.0,0.0,0.0,0.0,0.0,8.0,1.0,0.0,0.0,1.0,0.0,0.0,0.0,0.0,0.0,0.0,0.0,0.0,0.0,1.0,0.0,0.0,0.0,0.0,0.0,0.0,0.0,0.0,0.0,0.0,0.0,0.0,0.0,0.0,0.0,0.0,0.0,0.0,3.0,25461.0,21820.5,675000.0,146916.0,0.0,0.0,0.0,0.0,-694.0,163.0,-20.0,,73.0,-14.0,20.0,28161.495,66690.0,72776.25,0.0,450000.0,24.0,-344.0,365243.0,-1492.5,-862.5,-802.5,-857.0,6.5,1.0,0.0,-1.0,105.0,24.0,11.0,-36.0,0.0,0.0,102.0,17767.89,17767.89,-1097.5,-1104.0,9.0,1.0,0.0,,,,,,,,,,,,,,,,,,,,,8358629899.5,184603675320.0,165767652751.5,52041878155.935,1863.0,1706.0,71127.0,70991.0,9141.0,506785.0,,,,,,,128587.0,663713.0,,,,13545759.868492752,,-923161058.0,-296919394.0,-1537279631.0416667,44087.0,30753.0,,,,,,,,158251.48965590505,126280.47225765271,,,,,,,3719048.0,,,,,,,,,,,,,,,,437123.0,431912.0,1264764.0,6433.513713002894,632811.0,626355.0,,,,,,,,,23.0,90484560.855,31193382.555000026,9346292426.339989,3075383276.414999,107508532.095,813242.2499999997,181.0,24520.0,-30451406.0,13668342.0,-15799676.0,,-11.0,25461.0,0.0,675000.0,146916.0,0.0,0.0,0.0,0.0,-1260.0,19.0,-13.0,,322930817.775,4600539238.275003,5161252534.290004,75220668.71999995,4600989238.275003,332902.0,-23071104.0,5365391809.5,237990165.5,1212006007.5,525155168.5,1274874055.0,331505.0,5151.5,942.7985506977712,7615063.5,2738492.0,1685064.0,-5538179.0,1835136.0,245475.0,3623985788.76008,3666873002.895081,-220977892.0,-219133802.0,3889561.0,182632.5,,,,,,,,,,,,,,,,,,,,,1469411.0,14856378.0,3236870.0,8567597.0,11623663.0,1417868.0,1061596672.9920012,802266579.6524953,72211800491.30212,21707373755.25012,583497901.5569987,5792665.7475,689.5,94245.0,-277304390.0,22004646.5,-123947887.5,,-2025650.5,,,,,,,,,,,,,,,,,,,,,4279143.0,2482872.0,-9016093.5,921451.5,37582.5,3739125034.799956,3663788052.374957,-260992054.5,-257675423.5,2529946.0,269601.0,3931638929.617453,33297356505.51092,36729816066.38265,1732281749.3025498,48151504501.85322,3993568.5,-247919087.0,103231204107.5,1056528801.5,17294582433.0,3508784472.0,18909525357.0,3677108.0,72033.5,20900.57722313738,89873269.5,,4.285714285714286,4.5525494276795015,293.6830926688809,19.51092611862643,1258.6418257237751,78750.0,-0.2225209339563143,0.9749279121818236,0.0,0.0,0.0,0.0,0.0,0.0,1.0,0.0,0.0,1.0,0.0,0.0,0.0,0.0,0.0,0.0,0.0,0.0,1.0,0.0,1.0,0.0,0.0,0.0,0.0,1.0,0.0,0.0,0.0,0.0,0.0,0.0,0.0,0.0,0.0,0.0,0.0,0.0,0.0,0.0,0.0,0.0,0.0,0.0,0.0,0.0,0.0,0.0,0.0,0.0,0.0,0.0,0.0,0.0,0.0,0.0,0.0,0.0,0.0,0.0,0.0,0.0,0.0,0.0,0.0,0.0,0.0,0.0,0.0,0.0,0.0,0.0,0.0,0.0,0.0,0.0,0.0,0.0,0.0,0.0,0.0,0.0,0.0,0.0,0.0,0.0,0.0,0.0,0.0,0.0,0.0,0.0,0.0,0.0,0.0,0.0,0.0,0.0,0.0,0.0,0.0,0.0,0.0,0.0,0.0,1.0,0.0,0.0,0.0,0.0,0.0,0.0,0.0,0.0,0.0,0.0,0.0,0.0,0.0,0.0
105621,0,0.0,0.0,0.0,0.0,1.0,162000.0,582804.0,25803.0,463500.0,0.025164,45.97534246575343,-4541.0,-11531.0,-337.0,,2.0,2.0,2.0,11.0,0.6892868075310792,0.5375976893542143,0.5334816299804352,0.3247,0.204,0.9791,0.7144,0.0,0.24,0.2069,0.3333,0.375,0.0,0.2614,0.2927,0.0154,0.0428,0.3309,0.2117,0.9791,0.7256,0.0,0.2417,0.2069,0.3333,0.375,0.0,0.2856,0.305,0.0156,0.0453,0.3279,0.204,0.9791,0.7182,0.0,0.24,0.2069,0.3333,0.375,0.0,0.2659,0.298,0.0155,0.0437,0.2391,1.0,0.0,0.0,0.0,0.0,-1.0,0.0,0.0,0.0,0.0,0.0,3.0,1.0,1.0,0.0,1.0,0.0,0.0,0.0,0.0,0.0,0.0,0.0,0.0,0.0,1.0,0.0,0.0,0.0,0.0,0.0,0.0,0.0,0.0,0.0,0.0,0.0,0.0,0.0,0.0,0.0,0.0,0.0,0.0,8.0,0.0,0.0,78750.0,0.0,0.0,0.0,0.0,0.0,-909.0,-932.0,-591.5,-1224.0,346.0,-23.5,0.0,,,,,,,,,,,,,,,,,93.0,6.0,0.0,-50.0,0.0,0.0,0.0,,,,,,,0.0,,,,,,,,,,,,,,,,,,,,,8358655702.5,184604258124.0,165768116251.5,52042040155.935,1863.0,1706.0,71127.0,70991.0,9141.0,506788.0,17832.437400002316,17894.756399999125,17345.776299997997,11311.341500000097,11249.168100000095,11196.642100000065,128588.0,663715.0,4143.092700000115,4140.775600000013,3951.3410000000927,13545805.843835218,-602748382.0,-923161395.0,-296919395.0,-1537291162.0416667,44087.0,30753.0,11363.373999999192,11239.319999998988,10723.263499997289,22919.164800009818,22840.925400009783,22225.690300008344,67583.37468359835,158252.0272535944,126281.0057392827,35048.61540002803,34988.72280002847,34433.886000028884,22982.60759999588,22955.67069999545,22602.03899999569,3719059.0,8306.844900000162,8411.535600000077,8134.963200000231,9829.59530000072,9944.664300002156,10304.955499999634,16490.215299999723,16675.741899999695,16272.414999999695,829.319600000177,814.4977000000459,760.4173000000131,3918.437700000124,3901.6782000001617,3734.322900000161,437123.0,431912.0,,6433.538877002894,632813.0,626357.0,,16354.314899999796,154397.5850999908,154400.32719999034,154292.0288999872,77713.57039999637,78051.83360000659,78453.83050000668,30.5,90537584.355,31193382.555000026,9350052982.694988,3077637825.599999,107508532.095,813242.2499999997,181.0,24520.0,-30460902.5,13668378.0,-15804464.0,-17212636.0,-14.75,0.0,0.0,90000.0,0.0,0.0,0.0,0.0,0.0,-2605.0,-1649.0,-1645.0,-1648.0,,,,,,,,,,,,,,,,,2740212.0,1685926.0,-5544055.0,1835136.0,245475.0,,,,,,,,,,,,,,,,,,,,,,,,,,,1469419.0,14856724.0,3236870.0,8567690.0,11623663.0,1417868.0,1061596672.9920012,802266579.6524953,72211879241.30212,21707373755.25012,583497901.5569987,5792665.7475,689.5,94245.0,-277305299.0,22003714.5,-123948479.0,-219003623.0,-2025674.0,,,,,,,,,,,,,,,,,,,,,4279149.0,2482872.0,-9016143.5,921451.5,37582.5,,,,,,,,,,,,,,,,,,,,,,,-98.77033549848042,3.597555555555556,6.278339727938612,288.64881910832287,22.586675967910708,1038.4301627876976,81000.0,-0.9009688679024191,0.4338837391175582,0.0,0.0,0.0,0.0,0.0,0.0,1.0,0.0,1.0,0.0,0.0,0.0,0.0,0.0,0.0,0.0,0.0,0.0,1.0,0.0,0.0,0.0,1.0,0.0,0.0,1.0,0.0,0.0,0.0,0.0,0.0,0.0,0.0,0.0,0.0,0.0,1.0,0.0,0.0,0.0,0.0,0.0,0.0,0.0,0.0,0.0,0.0,0.0,0.0,0.0,0.0,0.0,0.0,0.0,0.0,0.0,0.0,0.0,0.0,0.0,0.0,0.0,0.0,0.0,1.0,0.0,0.0,0.0,0.0,0.0,0.0,0.0,0.0,0.0,0.0,0.0,0.0,0.0,0.0,0.0,0.0,0.0,0.0,0.0,0.0,0.0,0.0,0.0,0.0,0.0,0.0,0.0,0.0,0.0,0.0,0.0,0.0,0.0,0.0,0.0,0.0,0.0,0.0,0.0,0.0,0.0,0.0,0.0,1.0,0.0,1.0,0.0,0.0,0.0,0.0,0.0,0.0,1.0,0.0,0.0
105625,0,0.0,0.0,1.0,1.0,1.0,135000.0,398160.0,29101.5,315000.0,0.005084,46.73150684931507,-1421.0,-1213.0,-611.0,10.0,3.0,2.0,2.0,17.0,,0.3219596758273838,0.6863823354047934,0.0247,,0.9826,,,0.08,0.1034,0.1667,,,,0.0217,,0.0,0.0252,,0.9826,,,0.0806,0.1034,0.1667,,,,0.0226,,0.0,0.025,,0.9826,,,0.08,0.1034,0.1667,,,,0.0221,,0.0,0.0171,1.0,2.0,0.0,2.0,0.0,-389.0,0.0,0.0,0.0,0.0,1.0,4.0,1.0,1.0,0.0,1.0,0.0,0.0,0.0,0.0,0.0,0.0,0.0,0.0,0.0,1.0,0.0,0.0,0.0,0.0,0.0,0.0,0.0,0.0,0.0,0.0,0.0,0.0,0.0,0.0,0.0,0.0,0.0,0.0,2.0,17829.0,,547848.0,159610.5,,0.0,0.0,0.0,-891.0,200.0,-2.5,,60.0,-14.5,5.0,19695.51,90000.0,434875.5,2115.0,240354.0,18.0,-961.0,365243.0,-1061.0,-611.0,-371.0,-602.5,14.0,0.5,0.1043360634473556,-1.0,39.0,30.0,14.0,-28.0,0.0,0.0,61.0,10732.545,11314.98,-544.0,-541.0,9.0,1.0,25.0,0.0,765000.0,0.0,0.0,0.0,0.0,0.0,11250.0,0.0,0.0,0.0,0.0,0.0,0.0,0.0,0.0,0.0,-13.0,0.0,0.0,8358684804.0,184604656284.0,165768431251.5,52042175155.935,1863.0,1706.0,71127.0,70992.0,9141.0,506792.0,17832.462100002318,17894.781399999127,17345.801499997997,,,,128589.0,663718.0,,,,13545852.575342068,-602749803.0,-923162006.0,-296919784.0,-1537292375.0416667,44087.0,30753.0,11363.453999999192,11239.399999998986,10723.344099997288,22919.268200009818,22841.028800009783,22225.793700008344,,158252.3492132702,126281.6921216181,35048.78210002803,34988.88950002847,34434.05270002888,,,,3719076.0,,,,,,,16490.236999999725,16675.763999999694,16272.437599999696,,,,3918.437700000124,3901.6782000001617,3734.322900000161,437125.0,431914.0,1264774.0,6433.543961002894,632815.0,626359.0,,16354.331999999791,154398.5676999908,154401.30979999035,154293.01149998722,,,,30.0,90579537.855,,9355197580.694988,3080836979.954999,,813242.2499999997,181.0,24520.0,-30473508.0,13694500.5,-15812324.5,,-14.5,17829.0,,697500.0,159610.5,,0.0,0.0,0.0,-1284.0,177.0,-4.0,,323378975.69999987,4607789053.275003,5170158056.790004,75313998.71999995,4607799671.025003,333408.0,-23114366.0,5373061604.5,238329431.5,1213447581.5,525868548.5,1276315762.5,331954.0,5164.5,944.15000770241,7622145.0,2743467.0,1687468.0,-5552385.0,1867659.0,245475.0,3627696942.315085,3670659284.715085,-221248855.0,-219402068.0,3891659.0,182975.0,3355219204.694953,9074614500.0,283120671.375,433144512.1349999,13207388.040000005,136301399.77499986,190228254.20999905,474071741.999991,436867009.6499977,3221915234.895019,3343086472.409935,3343261575.509934,14480.5,38271.0,194.0,23596.0,1093117.0,-1941452.0,814072.0,1837.0,1469421.0,14856784.0,3236895.0,8567729.0,11623724.0,1417873.0,1061614501.9920012,,72212427089.30212,21707533365.75012,,5792665.7475,689.5,94245.0,-277306190.0,22003914.5,-123948481.5,,-2025688.5,5928919112.834962,18750690000.0,198923232.825,448445207.8124977,1948107.735,257088950.66250083,309413623.9274987,637146988.6049979,459561448.8224992,5713879200.592535,5892163506.967498,5892406689.7125,13396.0,80974.5,44.0,70474.5,972453.5,-1700788.0,177364.0,6755.0,4279179.0,2482886.0,-9016171.5,921451.5,37582.5,3739135767.344957,3663799367.354957,-260992598.5,-257675964.5,2529955.0,269602.0,3931658625.127453,33297446505.51092,36730250941.88265,1732283864.3025498,48151744855.85322,3993586.5,-247920048.0,103231569350.5,1056527740.5,17294581822.0,3508784101.0,18909524754.5,3677122.0,72034.0,20900.68155920083,89873268.5,-30.407750483672395,2.949333333333333,4.63893613731251,216.78447587435477,13.681768980980364,639.3696808454303,45000.0,-0.9009688679024191,-0.433883739117558,0.0,1.0,0.0,0.0,0.0,0.0,0.0,0.0,1.0,0.0,0.0,0.0,0.0,0.0,0.0,0.0,0.0,0.0,1.0,0.0,1.0,0.0,0.0,0.0,0.0,1.0,0.0,0.0,0.0,0.0,0.0,0.0,0.0,0.0,0.0,0.0,0.0,0.0,1.0,0.0,0.0,0.0,0.0,0.0,0.0,0.0,0.0,0.0,0.0,0.0,0.0,0.0,0.0,1.0,0.0,0.0,0.0,0.0,0.0,0.0,0.0,0.0,0.0,0.0,0.0,0.0,0.0,0.0,0.0,0.0,0.0,0.0,0.0,0.0,0.0,0.0,0.0,0.0,0.0,0.0,0.0,0.0,0.0,0.0,0.0,0.0,0.0,0.0,0.0,0.0,0.0,0.0,0.0,0.0,0.0,0.0,0.0,0.0,0.0,0.0,0.0,0.0,0.0,0.0,0.0,0.0,0.0,0.0,0.0,0.0,1.0,0.0,0.0,0.0,0.0,0.0,0.0,0.0,1.0,0.0
105629,0,0.0,0.0,0.0,1.0,1.0,121500.0,112500.0,11943.0,112500.0,0.020246,37.580821917808215,-389.0,-5995.0,-296.0,,2.0,3.0,3.0,9.0,0.5788053782976899,0.328934775501427,0.4812493411434029,0.1237,0.1205,0.9757,0.6668,0.0133,0.0,0.2069,0.1667,0.2083,0.1509,0.1,0.1017,0.0039,0.003,0.1261,0.125,0.9757,0.6798,0.0134,0.0,0.2069,0.1667,0.2083,0.1543,0.1093,0.106,0.0039,0.0031,0.1249,0.1205,0.9757,0.6713,0.0134,0.0,0.2069,0.1667,0.2083,0.1535,0.1018,0.1035,0.0039,0.003,0.0879,1.0,0.0,0.0,0.0,0.0,-359.0,0.0,0.0,0.0,0.0,2.0,1.0,1.0,1.0,0.0,1.0,0.0,0.0,0.0,0.0,0.0,0.0,0.0,0.0,0.0,1.0,0.0,0.0,0.0,0.0,0.0,0.0,0.0,0.0,0.0,0.0,0.0,0.0,0.0,0.0,0.0,0.0,0.0,0.0,2.0,10012.5,,270000.0,109829.25,0.0,0.0,0.0,0.0,-761.5,-31.0,-226.5,-456.0,51.0,-12.0,1.0,5642.19,53185.5,61609.5,0.0,53185.5,12.0,-359.0,365243.0,-329.0,365243.0,1.0,365243.0,13.0,1.0,0.0,2106.0,11.0,12.0,7.0,-7.0,0.0,0.0,11.0,5642.19,5642.19,-188.0,-179.0,6.0,1.0,0.0,,,,,,,,,,,,,,,,,,,,,8358696747.0,184604768784.0,165768543751.5,52042296655.935,1863.0,1706.0,71127.0,70994.0,9141.0,506793.0,17832.585800002318,17894.906299999126,17345.927599998002,11311.462000000096,11249.288600000094,11196.767100000065,128590.0,663720.0,4143.106000000114,4140.7890000000125,3951.354400000093,13545890.156163985,-602750192.0,-923162302.0,-296920143.0,-1537298370.0416667,44087.0,30753.0,11363.453999999192,11239.399999998986,10723.344099997288,22919.475100009822,22841.235700009784,22226.000600008345,67583.95348897665,158252.6781480457,126282.17337095924,35048.94880002803,34989.05620002847,34434.21940002888,22982.81589999588,22955.878999995453,22602.247299995688,3719085.0,8306.995800000162,8411.689100000078,8135.11750000023,9829.69530000072,9944.766100002156,10305.064799999634,16490.338699999724,16675.867499999695,16272.543599999695,829.3235000001772,814.5016000000461,760.4212000000133,3918.440700000124,3901.681200000162,3734.326000000161,437125.0,431914.0,,6433.564207002894,632818.0,626362.0,,16354.419899999792,154399.5433999908,154402.28549999036,154293.9871999872,77714.23719999638,78052.50490000659,78454.51030000667,25.5,90589550.355,,9357034604.714989,3081578546.204999,107762719.905,813242.2499999997,181.0,24520.0,-30478822.5,13693475.0,-15814847.0,-17216822.0,-12.25,0.0,,135000.0,0.0,0.0,0.0,0.0,0.0,-1138.0,-408.0,-437.0,-456.0,323611199.72999984,4610653384.275003,5173208296.290004,75345575.21999995,4610653384.275003,333722.0,-23135612.0,5379088114.0,238681249.0,1215264622.0,526225871.0,1278132869.0,332304.0,5170.0,944.573626412634,7629375.0,2746449.0,1689192.0,-5556525.0,1867659.0,245475.0,3630315930.930087,3673615044.465088,-221375043.0,-219524173.0,3893112.0,183257.0,,,,,,,,,,,,,,,,,,,,,1469423.0,14856835.0,3236895.0,8567740.0,11623735.0,1417874.0,1061624514.4920012,,72212697089.30212,21707643195.00012,583497901.5569987,5792665.7475,689.5,94245.0,-277306951.5,22003883.5,-123948708.0,-219004079.0,-2025700.5,,,,,,,,,,,,,,,,,,,,,4279191.0,2482893.0,-9016178.5,921451.5,37582.5,3739141409.534957,3663805009.544957,-260992786.5,-257676143.5,2529961.0,269603.0,3931664267.317453,33297499691.01092,36730312551.38265,1732283864.3025498,48151798041.35322,3993598.5,-247920407.0,103231934593.5,1056527411.5,17294947065.0,3508784102.0,18909889997.5,3677135.0,72035.0,20900.68155920083,89875374.5,-10.351024276445283,0.925925925925926,10.173323285606632,382.3218507086745,9.419743782969103,354.001713619143,60750.0,1.0,0.0,0.0,0.0,0.0,0.0,0.0,0.0,1.0,0.0,0.0,0.0,0.0,0.0,0.0,1.0,0.0,1.0,0.0,0.0,0.0,0.0,0.0,1.0,0.0,0.0,0.0,1.0,0.0,0.0,0.0,0.0,0.0,0.0,0.0,1.0,0.0,0.0,0.0,0.0,0.0,0.0,0.0,0.0,0.0,0.0,0.0,0.0,0.0,0.0,0.0,0.0,0.0,0.0,0.0,0.0,0.0,0.0,0.0,0.0,0.0,0.0,0.0,0.0,0.0,0.0,0.0,0.0,0.0,0.0,0.0,0.0,0.0,0.0,0.0,0.0,0.0,0.0,0.0,0.0,0.0,0.0,0.0,0.0,0.0,0.0,0.0,0.0,0.0,0.0,0.0,0.0,1.0,0.0,0.0,0.0,0.0,0.0,0.0,0.0,0.0,0.0,0.0,0.0,0.0,0.0,0.0,0.0,0.0,0.0,1.0,0.0,1.0,0.0,0.0,0.0,0.0,0.0,0.0,1.0,0.0,0.0
105630,0,0.0,0.0,1.0,1.0,0.0,261000.0,1676520.0,52168.5,1498500.0,0.019101,58.68219178082192,-1728.0,-5151.0,-4269.0,3.0,2.0,2.0,2.0,10.0,0.8263938589625603,0.5733110129701509,0.6347055309763198,,,,,,,,,,,,,,,,,,,,,,,,,,,,,,,,,,,,,,,,,,,,,0.0,0.0,0.0,0.0,-164.0,0.0,0.0,0.0,0.0,0.0,2.0,1.0,1.0,0.0,1.0,0.0,0.0,0.0,0.0,0.0,0.0,0.0,0.0,0.0,1.0,0.0,0.0,0.0,0.0,0.0,0.0,0.0,0.0,0.0,0.0,0.0,0.0,0.0,0.0,0.0,0.0,0.0,0.0,7.0,0.0,,157500.0,0.0,0.0,0.0,0.0,0.0,-1028.0,-477.0,-551.0,-1346.5,368.0,-31.0,9.0,19570.5675,83781.0,95944.5,4945.5,247045.5,10.0,-179.0,365243.0,-688.5,182127.5,-448.5,-524.0,12.0,0.0,0.1039784976341798,-1.0,24.0,8.0,5.0,-35.5,0.0,0.0,22.0,8917.11,8917.11,-1071.5,-1063.0,4.0,1.0,8.0,0.0,382500.0,,0.0,,,0.0,,0.0,0.0,0.0,0.0,,0.0,,,0.0,-5.5,0.0,0.0,8358748915.5,184606445304.0,165770042251.5,52042557655.935,1863.0,1706.0,71127.0,70994.0,9141.0,506795.0,,,,,,,128590.0,663722.0,,,,13545948.838355768,-602751920.0,-923166571.0,-296920307.0,-1537303521.0416667,44087.0,30753.0,,,,,,,67584.77988283563,158253.2514590587,126282.80807649026,,,,,,,3719095.0,,,,,,,,,,,,,,,,437125.0,431914.0,1264777.0,6433.583308002894,632820.0,626364.0,,,,,,,,,34.0,90599562.855,,9357643141.694988,3081688375.454999,107762719.905,813242.2499999997,181.0,24520.0,-30486116.0,13688879.0,-15817348.0,-17222297.5,-16.5,0.0,,157500.0,0.0,0.0,0.0,0.0,0.0,-2731.0,-1866.0,-754.5,-1975.0,323679430.19249994,4612435339.275003,5175145685.790004,75350520.71999995,4612097839.275003,333784.0,-23139131.0,5380001221.5,239042956.0,1215809474.5,526588147.5,1278312451.5,332364.0,5170.5,944.6825355035428,7631433.0,2746623.0,1689295.5,-5557356.0,1867659.0,245475.0,3630431809.080089,3673730922.61509,-221397326.0,-219546318.5,3893200.5,183273.5,3355451775.809953,9088384500.0,,433144512.1349999,,,190242024.29999903,,436876390.1249977,3222143876.2050195,3343319043.5249352,3343494146.6249337,,38271.0,,,1093120.0,-1941848.0,814072.0,1837.0,1469430.0,14857203.0,3236903.0,8567764.0,11623757.0,1417883.0,1061624514.4920012,,72212854589.30212,21707643195.00012,583497901.5569987,5792665.7475,689.5,94245.0,-277307979.5,22003406.5,-123949259.0,-219005425.5,-2025731.5,5928919112.834962,18751072500.0,,448445207.8124977,,,309413623.9274987,,459561448.8224992,5713879200.592535,5892163506.967498,5892406689.7125,,80974.5,,,972453.5,-1700793.5,177364.0,6755.0,4279199.0,2482898.0,-9016214.0,921451.5,37582.5,3739150326.644957,3663813926.654957,-260993858.0,-257677206.5,2529965.0,269604.0,3931683837.884953,33297583472.01092,36730408495.88265,1732288809.8025498,48152045086.85322,3993608.5,-247920586.0,103232299836.5,1056526723.0,17295129192.5,3508783653.5,18909889473.5,3677147.0,72035.0,20900.785537698463,89875373.5,-29.44675288295439,6.423448275862068,5.00301906322781,293.5881241514424,32.136634175795734,1885.8481298941613,130500.0,0.6234898018587336,0.7818314824680298,0.0,0.0,0.0,0.0,0.0,0.0,1.0,0.0,1.0,0.0,0.0,0.0,0.0,0.0,0.0,1.0,0.0,0.0,0.0,0.0,1.0,0.0,0.0,0.0,0.0,1.0,0.0,0.0,0.0,0.0,0.0,0.0,0.0,0.0,0.0,0.0,0.0,0.0,0.0,0.0,0.0,0.0,0.0,0.0,0.0,0.0,0.0,0.0,0.0,0.0,0.0,0.0,0.0,1.0,0.0,0.0,0.0,0.0,0.0,0.0,0.0,0.0,0.0,0.0,0.0,0.0,0.0,0.0,0.0,0.0,0.0,0.0,0.0,0.0,0.0,0.0,0.0,0.0,0.0,0.0,0.0,0.0,0.0,0.0,0.0,0.0,0.0,0.0,0.0,0.0,0.0,0.0,0.0,0.0,0.0,0.0,0.0,0.0,0.0,0.0,0.0,0.0,0.0,0.0,0.0,0.0,0.0,0.0,0.0,0.0,0.0,0.0,0.0,0.0,0.0,0.0,0.0,0.0,0.0,0.0
105634,0,0.0,0.0,0.0,1.0,0.0,180000.0,667237.5,28399.5,576000.0,0.009549,54.01917808219178,,-5573.0,-3148.0,,1.0,2.0,2.0,11.0,0.6955650170934651,0.3911546883038161,0.7544061731797895,,,,,,,,,,,,,,,,,,,,,,,,,,,,,,,,,,,,,,,,,,,,,0.0,0.0,0.0,0.0,-1937.0,0.0,0.0,0.0,0.0,0.0,4.0,1.0,0.0,0.0,1.0,0.0,0.0,0.0,0.0,0.0,0.0,0.0,0.0,0.0,0.0,0.0,0.0,1.0,0.0,0.0,0.0,0.0,0.0,0.0,0.0,0.0,0.0,0.0,0.0,0.0,0.0,0.0,0.0,6.0,0.0,,414171.0,0.0,0.0,0.0,0.0,0.0,-923.0,60.5,-334.0,-636.0,203.0,-16.0,6.0,3633.615,32145.75,49810.5,0.0,51291.0,12.0,-1231.5,365243.0,-352.5,182562.0,157.5,182564.0,13.5,0.0,0.0,28.0,41.0,18.0,12.0,-16.0,0.0,0.0,39.0,6939.72,6939.72,-469.0,-466.0,8.0,1.0,91.0,0.0,0.0,,0.0,,,0.0,,0.0,0.0,0.0,0.0,,0.0,,,0.0,-46.0,0.0,0.0,8358777315.0,184607112541.5,165770618251.5,52042737655.935,1863.0,1706.0,71127.0,70994.0,9141.0,506799.0,,,,,,,128590.0,663723.0,,,,13546002.857533848,,-923169719.0,-296922244.0,-1537309094.0416667,44087.0,30753.0,,,,,,,67585.47544785272,158253.64261374698,126283.5624826634,,,,,,,3719106.0,,,,,,,,,,,,,,,,437125.0,431914.0,,6433.592857002896,632822.0,626366.0,,,,,,,,,30.5,90669785.355,,9367963364.114988,3088389523.454999,107762719.905,813242.2499999997,181.0,24520.0,-30503093.5,13687746.0,-15826524.0,-17232641.0,-14.75,0.0,,190692.0,0.0,0.0,0.0,0.0,0.0,-1435.0,-339.0,-334.0,-636.0,323779684.41,4613220767.025003,5176020011.040004,75391884.71999995,4613220767.025003,333890.0,-23150662.5,5382922916.5,239403738.0,1217084336.5,527316382.5,1279952654.5,332522.0,5173.0,945.2105175959674,7641881.5,2747519.0,1689861.0,-5558586.0,1867659.0,245475.0,3631151703.78009,3674484280.530091,-221432239.0,-219580693.0,3893674.0,183338.0,3355492336.9199524,9091399500.0,,433171441.9349998,,,190249286.08499905,,436907591.0099976,3222183367.440019,3343359542.8499346,3343534645.9499326,,38288.0,,,1093145.0,-1944046.0,814072.0,1837.0,1469436.0,14857406.0,3236994.0,8567805.0,11623796.0,1417889.0,1061624514.4920012,,72213268760.30212,21707643195.00012,583497901.5569987,5792665.7475,689.5,94245.0,-277308902.5,22003467.0,-123949593.0,-219006061.5,-2025747.5,5928919112.834962,18751072500.0,,448445207.8124977,,,309413623.9274987,,459561448.8224992,5713879200.592535,5892163506.967498,5892406689.7125,,80974.5,,,972453.5,-1700839.5,177364.0,6755.0,4279217.0,2482910.0,-9016230.0,921451.5,37582.5,3739157266.364957,3663820866.374957,-260994327.0,-257677672.5,2529973.0,269605.0,3931687471.499953,33297615617.76092,36730458306.38265,1732288809.8025498,48152096377.85322,3993620.5,-247921817.5,103232665079.5,1056526370.5,17295311754.5,3508783811.0,18910072037.5,3677160.5,72035.0,20900.785537698463,89875401.5,,3.706875,6.33813975598162,342.3811001881906,23.494691807954364,1269.1639407600992,180000.0,-0.2225209339563143,0.9749279121818236,0.0,0.0,0.0,0.0,0.0,0.0,1.0,0.0,0.0,1.0,0.0,0.0,0.0,0.0,0.0,1.0,0.0,0.0,0.0,0.0,0.0,0.0,1.0,0.0,0.0,1.0,0.0,0.0,0.0,0.0,0.0,0.0,0.0,0.0,0.0,0.0,0.0,0.0,0.0,0.0,0.0,0.0,0.0,0.0,0.0,0.0,0.0,0.0,0.0,0.0,0.0,0.0,0.0,0.0,0.0,0.0,0.0,0.0,0.0,0.0,0.0,0.0,0.0,0.0,0.0,0.0,0.0,0.0,0.0,0.0,0.0,0.0,0.0,0.0,0.0,0.0,0.0,0.0,0.0,0.0,0.0,0.0,0.0,0.0,0.0,0.0,0.0,0.0,0.0,0.0,0.0,0.0,0.0,0.0,0.0,0.0,0.0,0.0,0.0,0.0,0.0,0.0,0.0,0.0,0.0,1.0,0.0,0.0,0.0,0.0,0.0,0.0,0.0,0.0,0.0,0.0,0.0,0.0,0.0,0.0
105635,0,0.0,0.0,0.0,1.0,0.0,135000.0,781920.0,34573.5,675000.0,0.030755,47.00821917808219,-3625.0,-5039.0,-708.0,,1.0,2.0,2.0,14.0,0.5860737129718858,0.6762317166988221,0.8050196619153701,,,,,,,,,,,,,,,,,,,,,,,,,,,,,,,,,,,,,,,,,,,,,0.0,0.0,0.0,0.0,-1983.0,0.0,0.0,0.0,0.0,0.0,1.0,1.0,1.0,0.0,1.0,0.0,0.0,0.0,0.0,0.0,0.0,1.0,1.0,0.0,1.0,0.0,0.0,0.0,0.0,0.0,0.0,0.0,0.0,0.0,0.0,0.0,0.0,0.0,0.0,0.0,0.0,0.0,0.0,10.0,0.0,0.0,124584.75,0.0,0.0,0.0,0.0,0.0,-1465.0,-1099.0,-1019.0,-1100.5,527.0,-26.0,4.0,7345.7325,50825.25,51837.75,2448.0,50825.25,6.0,-1152.0,365243.0,-1111.0,-991.0,-931.0,-984.0,14.0,0.0,0.1043072983354673,175.5,20.0,6.0,4.0,-63.5,0.0,0.0,18.0,6816.465,6816.465,-1899.5,-1856.0,3.0,1.0,9.0,0.0,157500.0,,0.0,,,0.0,,0.0,0.0,0.0,0.0,,0.0,,,0.0,-7.0,0.0,0.0,8358811888.5,184607894461.5,165771293251.5,52042872655.935,1863.0,1706.0,71127.0,70994.0,9141.0,506800.0,,,,,,,128590.0,663724.0,,,,13546049.865753029,-602755545.0,-923170427.0,-296924227.0,-1537314133.0416667,44087.0,30753.0,,,,,,,67586.06152156569,158254.31884546368,126284.36750232532,,,,,,,3719120.0,,,,,,,,,,,,,,,,437125.0,431914.0,,6433.623612002894,632824.0,626368.0,,,,,,,,,49.0,90691484.355,31193382.555000026,9369774551.114988,3088890602.954999,107762719.905,813242.2499999997,181.0,24520.0,-30514197.0,13682221.5,-15832481.0,-17240155.5,-24.0,0.0,0.0,103635.0,0.0,0.0,0.0,0.0,0.0,-1465.0,-1099.0,-1019.0,-1101.0,323806913.8425,4613494184.775003,5176295053.290004,75398832.71999995,4613494184.775003,333929.0,-23155786.0,5384383888.5,239763610.5,1217445641.5,527677281.5,1280313976.5,332591.5,5173.0,945.4440325000796,7643310.5,2747898.0,1690057.0,-5560115.0,1867664.0,245480.0,3631351079.4975863,3674683656.247589,-221476391.5,-219624433.0,3893867.0,183368.5,3355492336.9199524,9092727000.0,,433171441.9349998,,,190249286.08499905,,436907591.0099976,3222183367.440019,3343359542.8499346,3343534645.9499326,,38288.0,,,1093145.0,-1946176.0,814072.0,1837.0,1469446.0,14857933.0,3237003.0,8567825.0,11623814.0,1417893.0,1061624514.4920012,802266579.6524953,72213393345.05212,21707643195.00012,583497901.5569987,5792665.7475,689.5,94245.0,-277310367.5,22002368.0,-123950612.0,-219007162.0,-2025773.5,5928919112.834962,18751230000.0,,448445207.8124977,,,309413623.9274987,,459561448.8224992,5713879200.592535,5892163506.967498,5892406689.7125,,80974.5,,,972453.5,-1700846.5,177364.0,6755.0,4279223.0,2482914.0,-9016293.5,921451.5,37582.5,3739164082.829957,3663827682.839957,-260996226.5,-257679528.5,2529976.0,269606.0,3931694817.232453,33297666443.01092,36730510144.13265,1732291257.8025498,48152147203.10322,3993626.5,-247922969.5,103233030322.5,1056525259.5,17295310763.5,3508782880.0,18910071053.5,3677174.5,72035.0,20900.8898449968,89875577.0,-77.11417414617087,5.792000000000001,3.904724716907458,183.5541553224608,22.616165560328003,1063.1456676276923,135000.0,-0.9009688679024191,0.4338837391175582,0.0,1.0,0.0,0.0,0.0,0.0,0.0,0.0,0.0,0.0,0.0,0.0,0.0,1.0,0.0,0.0,0.0,0.0,1.0,0.0,0.0,0.0,0.0,1.0,0.0,1.0,0.0,0.0,0.0,0.0,0.0,0.0,0.0,0.0,0.0,0.0,0.0,0.0,0.0,0.0,0.0,0.0,0.0,0.0,1.0,0.0,0.0,0.0,0.0,0.0,0.0,0.0,0.0,1.0,0.0,0.0,0.0,0.0,0.0,0.0,0.0,0.0,0.0,0.0,0.0,0.0,0.0,0.0,0.0,0.0,0.0,0.0,0.0,0.0,0.0,0.0,0.0,0.0,0.0,0.0,0.0,0.0,0.0,0.0,0.0,0.0,0.0,0.0,0.0,0.0,0.0,0.0,0.0,0.0,0.0,0.0,0.0,0.0,0.0,0.0,0.0,0.0,0.0,0.0,0.0,0.0,0.0,0.0,0.0,0.0,0.0,0.0,0.0,0.0,0.0,0.0,0.0,0.0,0.0,0.0
105641,0,0.0,1.0,1.0,1.0,1.0,157500.0,135000.0,10665.0,135000.0,0.031329,35.55068493150685,-1974.0,-1221.0,-4956.0,4.0,3.0,2.0,2.0,16.0,0.2003886124597001,0.5486666956366542,0.3344541255096772,0.2227,0.1577,0.9866,0.8164,0.0415,0.24,0.2069,0.3333,0.375,0.1139,0.1816,0.2312,0.0,0.0056,0.2269,0.1637,0.9866,0.8236,0.0418,0.2417,0.2069,0.3333,0.375,0.1165,0.1983,0.2409,0.0,0.006,0.2248,0.1577,0.9866,0.8189,0.0417,0.24,0.2069,0.3333,0.375,0.1159,0.1847,0.2354,0.0,0.0058,0.1831,1.0,4.0,0.0,3.0,0.0,-457.0,0.0,0.0,0.0,0.0,0.0,0.0,1.0,1.0,1.0,1.0,1.0,0.0,0.0,0.0,0.0,0.0,0.0,0.0,0.0,1.0,0.0,0.0,0.0,0.0,0.0,0.0,0.0,0.0,0.0,0.0,0.0,0.0,0.0,0.0,0.0,0.0,0.0,0.0,7.0,3213.0,1687.7475,67131.0,62777.1825,0.0,0.0,0.0,0.0,-1429.0,-1027.0,-908.0,-1201.0,360.0,-29.0,2.0,11651.085,67500.0,74182.5,,135000.0,18.0,-272.5,365243.0,-427.0,-67.0,83.0,-61.0,13.5,1.0,,9.5,13.0,18.0,12.0,-9.0,0.0,0.0,17.0,11651.085,11651.085,-216.0,-217.0,8.0,1.0,0.0,,,,,,,,,,,,,,,,,,,,,8358822553.5,184608029461.5,165771428251.5,52043030155.935,1863.0,1706.0,71127.0,70994.0,9141.0,506800.0,17832.808500002317,17895.131099999126,17346.154499998,11311.619700000096,11249.446300000096,11196.930800000064,128591.0,663727.0,4143.147500000115,4140.830700000012,3951.396200000093,13546085.416437956,-602757519.0,-923175383.0,-296924684.0,-1537315354.0416667,44087.0,30753.0,11363.693999999192,11239.639999998986,10723.585799997289,22919.682000009823,22841.442600009785,22226.207500008342,67586.26191017816,158254.86751215928,126284.70195645082,35049.28210002803,34989.38950002847,34434.55270002888,22983.19089999588,22956.253999995453,22602.622299995688,3719136.0,8307.109700000163,8411.805000000079,8135.2340000002305,9829.87690000072,9944.950800002156,10305.263099999636,16490.569899999722,16676.102899999696,16272.784499999698,829.3235000001772,814.5016000000461,760.4212000000133,3918.446300000124,3901.687000000162,3734.33200000016,437129.0,431917.0,1264781.0,6433.654941002896,632826.0,626370.0,,16354.602999999795,154400.5299999908,154403.27209999034,154294.9737999872,77715.05359999638,78053.32380000659,78455.33390000668,47.0,90694697.355,31330867.635000024,9377132509.304989,3092016516.997499,107762719.905,813242.2499999997,181.0,24520.0,-30557016.0,13660700.5,-15854764.0,-17268375.0,-23.0,0.0,3375.495,67131.0,0.0,0.0,0.0,0.0,0.0,-2074.0,-2214.0,-908.0,-2042.0,323993880.18,4616643195.675004,5179526611.290004,,4616643195.675004,334270.0,-23173634.0,5389679586.0,239749646.0,1218896562.0,528036351.0,1281764960.0,332911.5,5177.0,,7649072.5,2751191.0,1692554.0,-5565377.0,1867679.0,245495.0,3633363718.920085,3676671205.110085,-221632910.0,-219778181.0,3895035.0,183539.0,,,,,,,,,,,,,,,,,,,,,1469453.0,14858293.0,3237003.0,8567838.0,11623831.0,1417895.0,1061627727.4920012,802268267.3999952,72213460476.05212,21707705972.182617,583497901.5569987,5792665.7475,689.5,94245.0,-277311796.5,22001341.0,-123951520.0,-219008363.0,-2025802.5,,,,,,,,,,,,,,,,,,,,,4279241.0,2482926.0,-9016302.5,921451.5,37582.5,3739175733.914957,3663839333.924957,-260996442.5,-257679745.5,2529984.0,269607.0,3931706468.317453,33297733943.01092,36730584326.63265,,48152282203.10322,3993644.5,-247923242.0,103233395565.5,1056524832.5,17295310696.5,3508782963.0,18910070992.5,3677188.0,72036.0,,89875586.5,-55.52635635018496,0.8571428571428571,14.767932489451477,525.0101150222531,12.658227848101266,450.008670019074,52500.0,-0.9009688679024191,-0.433883739117558,0.0,0.0,0.0,0.0,0.0,0.0,1.0,0.0,0.0,0.0,0.0,0.0,0.0,1.0,0.0,0.0,0.0,0.0,1.0,0.0,1.0,0.0,0.0,0.0,0.0,1.0,0.0,0.0,0.0,0.0,0.0,0.0,0.0,0.0,0.0,0.0,0.0,0.0,1.0,0.0,0.0,0.0,0.0,0.0,0.0,0.0,0.0,0.0,0.0,0.0,0.0,0.0,0.0,1.0,0.0,0.0,0.0,0.0,0.0,0.0,0.0,0.0,0.0,0.0,0.0,0.0,0.0,0.0,0.0,0.0,0.0,0.0,0.0,0.0,0.0,0.0,0.0,0.0,0.0,0.0,0.0,0.0,0.0,0.0,0.0,0.0,0.0,0.0,0.0,0.0,0.0,0.0,0.0,0.0,0.0,0.0,0.0,0.0,0.0,0.0,0.0,0.0,0.0,0.0,0.0,0.0,0.0,0.0,1.0,0.0,1.0,0.0,0.0,0.0,0.0,0.0,0.0,1.0,0.0,0.0
105647,0,0.0,1.0,1.0,1.0,2.0,157500.0,703728.0,36058.5,607500.0,0.00712,36.8027397260274,-5779.0,-3440.0,-4565.0,13.0,4.0,2.0,2.0,9.0,0.2574047450783756,0.4490961821829921,0.4614823912998385,,,,,,,,,,,,,,,,,,,,,,,,,,,,,,,,,,,,,,,,,,,,,2.0,1.0,2.0,0.0,-2248.0,0.0,0.0,0.0,0.0,0.0,1.0,1.0,1.0,0.0,1.0,0.0,0.0,0.0,0.0,0.0,0.0,0.0,0.0,0.0,1.0,0.0,0.0,0.0,0.0,0.0,0.0,0.0,0.0,0.0,0.0,0.0,0.0,0.0,0.0,0.0,0.0,0.0,0.0,34.0,3237.1425,0.0,106114.905,0.0,0.0,0.0,0.0,0.0,-1352.5,-808.0,-680.5,-1055.0,1465.0,-24.0,3.0,9524.7675,131175.0,131175.0,0.0,131175.0,10.0,-2248.0,365243.0,-1180.0,-955.0,-901.5,-949.0,12.0,0.0,0.0,1995.0,18.0,16.0,6.5,-64.5,0.0,0.0,17.0,13497.84,13497.84,-1983.0,-1977.0,8.0,1.0,0.0,,,,,,,,,,,,,,,,,,,,,8358858612.0,184608733189.5,165772035751.5,52043187655.935,1863.0,1706.0,71127.0,70994.0,9141.0,506801.0,,,,,,,128593.0,663731.0,,,,13546122.219177686,-602763298.0,-923179948.0,-296926932.0,-1537318794.0416667,44088.0,30753.0,,,,,,,67586.51931492322,158255.3166083415,126285.16343884212,,,,,,,3719145.0,,,,,,,,,,,,,,,,437131.0,431919.0,1264794.0,6433.662061002896,632828.0,626372.0,,,,,,,,,45.0,90906170.355,31408923.285000023,9387091951.64999,3094850398.679999,107885529.855,830531.2499999997,181.0,24529.0,-30615183.5,13634131.0,-15887215.5,-17307593.5,-22.0,0.0,0.0,105111.0,0.0,0.0,0.0,0.0,0.0,-1777.0,-1347.0,-996.0,-1352.0,324365095.035,4622000067.675004,5185178957.790004,75545727.11999996,4622000067.675004,334610.0,-23204206.0,5396436266.5,240459819.5,1220341821.5,529120320.5,1282844976.5,333373.0,5187.0,947.7900954380032,7655759.0,2755897.0,1695681.5,-5571470.5,1867684.0,245495.0,3637592666.730073,3680862611.535072,-221807393.0,-219950640.0,3896861.0,183721.0,,,,,,,,,,,,,,,,,,,,,1469487.0,14859758.0,3237003.0,8567856.0,11623848.0,1417898.0,1061630964.6345012,802268267.3999952,72213566590.95712,21707705972.182617,583497901.5569987,5792665.7475,689.5,94245.0,-277313149.0,22000533.0,-123952200.5,-219009418.0,-2025826.5,,,,,,,,,,,,,,,,,,,,,4279257.0,2482932.5,-9016367.0,921451.5,37582.5,3739189231.754957,3663852831.764957,-260998425.5,-257681722.5,2529992.0,269608.0,3931715993.084953,33297865118.01092,36730715501.63265,1732291257.8025498,48152413378.10322,3993654.5,-247925490.0,103233760808.5,1056523652.5,17295309741.5,3508782061.5,18910070043.5,3677200.0,72036.0,20900.8898449968,89877581.5,-157.026353011241,4.468114285714286,4.367902158991639,160.7507663061224,19.516286035192813,718.2527953719043,39375.0,-0.9009688679024191,0.4338837391175582,0.0,0.0,0.0,0.0,0.0,0.0,1.0,0.0,0.0,0.0,1.0,0.0,0.0,0.0,0.0,0.0,0.0,0.0,1.0,0.0,1.0,0.0,0.0,0.0,0.0,1.0,0.0,0.0,0.0,0.0,0.0,0.0,0.0,0.0,0.0,0.0,0.0,0.0,1.0,0.0,0.0,0.0,0.0,0.0,0.0,0.0,0.0,0.0,0.0,0.0,0.0,0.0,0.0,0.0,0.0,0.0,0.0,0.0,0.0,0.0,0.0,0.0,0.0,0.0,0.0,0.0,0.0,0.0,0.0,0.0,0.0,0.0,0.0,0.0,0.0,0.0,0.0,0.0,0.0,0.0,0.0,0.0,0.0,0.0,0.0,0.0,0.0,0.0,0.0,0.0,0.0,0.0,0.0,0.0,0.0,0.0,0.0,0.0,0.0,0.0,0.0,1.0,0.0,0.0,0.0,0.0,0.0,0.0,0.0,0.0,0.0,0.0,0.0,0.0,0.0,0.0,0.0,0.0,0.0,0.0
105648,0,0.0,0.0,1.0,1.0,0.0,247500.0,552555.0,30105.0,477000.0,0.02461,27.61369863013699,-3479.0,-4550.0,-2729.0,1.0,2.0,2.0,2.0,11.0,0.207894611508563,0.5967391542563081,0.3539876078507373,0.1969,0.1686,0.9861,0.8096,0.1541,0.24,0.2069,0.3333,0.375,0.1123,0.1614,0.2163,0.0154,0.0459,0.2006,0.175,0.9861,0.8171,0.1555,0.2417,0.2069,0.3333,0.375,0.1149,0.1763,0.2254,0.0156,0.0486,0.1988,0.1686,0.9861,0.8121,0.1551,0.24,0.2069,0.3333,0.375,0.1143,0.1642,0.2202,0.0155,0.0469,0.2624,1.0,3.0,0.0,3.0,0.0,-1664.0,0.0,0.0,0.0,0.0,1.0,2.0,1.0,1.0,0.0,1.0,1.0,1.0,0.0,0.0,0.0,0.0,0.0,0.0,0.0,1.0,0.0,0.0,0.0,0.0,0.0,0.0,0.0,0.0,0.0,0.0,0.0,0.0,0.0,0.0,0.0,0.0,0.0,0.0,6.0,6876.0,,273870.0,33819.75,0.0,0.0,0.0,0.0,-331.5,263.0,-199.0,-353.0,151.0,-19.0,5.0,10943.37,95395.5,105471.0,4500.0,95395.5,12.0,-1247.0,365243.0,-1216.0,-916.0,-886.0,-906.0,17.0,0.0,0.0789103869778147,40.0,59.0,12.0,6.0,-35.0,0.0,0.0,55.0,13857.525,13857.525,-1100.0,-1066.0,6.0,1.0,0.0,,,,,,,,,,,,,,,,,,,,,8358888717.0,184609285744.5,165772512751.5,52043435155.935,1863.0,1706.0,71127.0,70995.0,9141.0,506803.0,17833.005400002316,17895.329899999124,17346.355099998,11311.788300000097,11249.614900000097,11197.105800000065,128593.0,663733.0,4143.301600000114,4140.985800000012,3951.5517000000928,13546149.832876312,-602766777.0,-923182677.0,-296928596.0,-1537323344.0416667,44088.0,30753.0,11363.933999999192,11239.879999998986,10723.827499997293,22919.888900009824,22841.649500009786,22226.41440000835,67586.72720953473,158255.91334749575,126285.51742644998,35049.61540002803,34989.72280002847,34434.886000028884,22983.56589999588,22956.628999995453,22602.997299995688,3719156.0,8307.222000000163,8411.919300000078,8135.348900000231,9830.03830000072,9945.115000002155,10305.439399999634,16490.786199999722,16676.323099999696,16273.009899999695,829.3389000001772,814.5171000000461,760.4368000000131,3918.492200000124,3901.7339000001616,3734.380600000161,437134.0,431922.0,1264795.0,6433.686671002895,632830.0,626374.0,,16354.865399999791,154401.5160999908,154404.25819999038,154295.9598999872,77715.86319999638,78054.13590000659,78456.15100000668,11.0,91050852.24,,9394651159.46999,3095005151.429999,107885529.855,865181.2499999997,181.0,24537.0,-30635472.5,13629037.5,-15900271.0,-17320829.0,-5.0,6876.0,,68800.5,0.0,0.0,0.0,0.0,0.0,-2439.0,-2135.0,-2133.0,-2135.0,324405068.85,4622379944.175004,5185604959.290004,75554727.11999996,4622379944.175004,334650.0,-23210544.0,5397714617.0,240454720.0,1220337757.0,529116316.0,1282840927.0,333432.0,5188.0,947.961668433469,7657823.0,2756359.0,1695915.0,-5573132.0,1867684.0,245495.0,3638052993.1950736,3681322938.0000734,-221855472.0,-219998336.0,3897083.0,183758.0,,,,,,,,,,,,,,,,,,,,,1469493.0,14859909.0,3237003.0,8567915.0,11623903.0,1417903.0,1061637840.6345012,,72213840460.95712,21707739791.932617,583497901.5569987,5792665.7475,689.5,94245.0,-277313480.5,22000796.0,-123952399.5,-219009771.0,-2025845.5,,,,,,,,,,,,,,,,,,,,,4279269.0,2482938.5,-9016402.0,921451.5,37582.5,3739203089.279957,3663866689.289957,-260999525.5,-257682788.5,2529998.0,269609.0,3931726936.454953,33297960513.51092,36730820972.63265,1732295757.8025498,48152508773.60322,3993666.5,-247926737.0,103234126051.5,1056522436.5,17295308825.5,3508781175.5,18910069137.5,3677217.0,72036.0,20900.968755383783,89877621.5,-125.98819327314214,2.2325454545454546,8.221225710014947,227.01844912668676,18.3542600896861,506.82900669574303,123750.0,-0.9009688679024191,0.4338837391175582,0.0,0.0,0.0,0.0,0.0,0.0,1.0,0.0,0.0,0.0,0.0,0.0,0.0,1.0,0.0,0.0,1.0,0.0,0.0,1.0,0.0,0.0,0.0,0.0,0.0,1.0,0.0,0.0,0.0,0.0,0.0,0.0,0.0,0.0,0.0,0.0,0.0,0.0,1.0,0.0,0.0,0.0,0.0,0.0,0.0,0.0,0.0,0.0,0.0,0.0,0.0,0.0,0.0,1.0,0.0,0.0,0.0,0.0,0.0,0.0,0.0,0.0,0.0,0.0,0.0,0.0,0.0,0.0,0.0,0.0,0.0,0.0,0.0,0.0,0.0,0.0,0.0,0.0,0.0,0.0,0.0,0.0,0.0,0.0,0.0,0.0,0.0,0.0,0.0,0.0,0.0,0.0,0.0,0.0,0.0,0.0,0.0,0.0,0.0,0.0,0.0,0.0,0.0,0.0,0.0,0.0,0.0,0.0,1.0,0.0,1.0,0.0,0.0,0.0,0.0,0.0,0.0,0.0,1.0,0.0
105655,0,0.0,0.0,0.0,1.0,0.0,180000.0,790830.0,45531.0,675000.0,0.035792,61.95890410958904,,-553.0,-5258.0,,1.0,2.0,2.0,12.0,0.4888403699421386,0.7371051810363436,0.4956658291397297,,,,,,,,,,,,,,,,,,,,,,,,,,,,,,,,,,,,,,,,,,,,1.0,3.0,0.0,3.0,0.0,-460.0,0.0,0.0,0.0,0.0,0.0,1.0,1.0,0.0,0.0,1.0,0.0,0.0,0.0,0.0,0.0,0.0,0.0,0.0,0.0,0.0,0.0,0.0,1.0,0.0,0.0,0.0,0.0,0.0,0.0,0.0,0.0,0.0,0.0,0.0,0.0,0.0,0.0,0.0,4.0,0.0,8338.05,135000.0,0.0,0.0,0.0,0.0,0.0,-618.5,-454.0,-107.5,-457.0,87.0,-13.0,2.0,26274.105,113202.0,119427.75,0.0,226404.0,10.0,-335.0,365243.0,-421.0,-331.0,-151.0,-324.0,15.5,0.0,0.0,7.5,6.0,10.0,8.0,-13.5,0.0,0.0,4.0,26274.105,26274.105,-398.5,-376.0,2.5,1.0,0.0,,,,,,,,,,,,,,,,,,,,,8358934248.0,184610076574.5,165773187751.5,52043615155.935,1863.0,1706.0,71127.0,70995.0,9141.0,506804.0,,,,,,,128593.0,663734.0,,,,13546211.791780423,,-923187935.0,-296929056.0,-1537323897.0416667,44088.0,30753.0,,,,,,,67587.21604990467,158256.65045267678,126286.01309227911,,,,,,,3719168.0,,,,,,,,,,,,,,,,437137.0,431925.0,,6433.722463002896,632832.0,626376.0,,,,,,,,,21.0,91146360.24,31475493.99000002,9411699954.959991,3102096817.619999,107885529.855,865455.8399999995,181.0,24544.0,-30685607.0,13653440.5,-15926112.5,-17349041.5,-10.0,0.0,8338.05,0.0,0.0,0.0,0.0,0.0,0.0,-973.0,-823.0,-130.0,-829.0,324679623.03000003,4625275155.435004,5188791215.790004,75591425.87999997,4625275155.435004,334818.0,-23231087.0,5402460661.0,240804195.0,1221057215.0,529837238.0,1283926408.0,333694.0,5191.0,948.6912473572936,7664437.0,2758357.0,1696999.0,-5577666.0,1867685.0,245496.0,3641436220.5675774,3684302943.952577,-222060367.0,-220201331.5,3900913.5,183895.5,,,,,,,,,,,,,,,,,,,,,1469497.0,14859996.0,3237003.0,8567921.0,11623907.0,1417905.0,1061637840.6345012,802276605.4499952,72213975460.95712,21707739791.932617,583497901.5569987,5792665.7475,689.5,94245.0,-277314099.0,22000342.0,-123952507.0,-219010228.0,-2025858.5,,,,,,,,,,,,,,,,,,,,,4279279.0,2482946.5,-9016415.5,921451.5,37582.5,3739229363.384957,3663892963.394957,-260999924.0,-257683164.5,2530000.5,269610.0,3931753210.559953,33298073715.51092,36730940400.38265,1732295757.8025498,48152735177.60322,3993676.5,-247927072.0,103234491294.5,1056522015.5,17295308494.5,3508781024.5,18910068813.5,3677232.5,72036.0,20900.968755383783,89877629.0,,4.3935,3.95335046451868,244.94526234271217,17.36904526586282,1076.167010102706,180000.0,0.6234898018587336,0.7818314824680298,0.0,1.0,0.0,0.0,0.0,0.0,0.0,0.0,0.0,1.0,0.0,0.0,0.0,0.0,0.0,0.0,1.0,0.0,0.0,0.0,0.0,0.0,1.0,0.0,0.0,1.0,0.0,0.0,0.0,0.0,0.0,0.0,0.0,0.0,0.0,0.0,0.0,0.0,0.0,0.0,0.0,0.0,0.0,0.0,0.0,0.0,0.0,0.0,0.0,0.0,0.0,0.0,0.0,0.0,0.0,0.0,0.0,0.0,0.0,0.0,0.0,0.0,0.0,0.0,0.0,0.0,0.0,0.0,0.0,0.0,0.0,0.0,0.0,0.0,0.0,0.0,0.0,0.0,0.0,0.0,0.0,0.0,0.0,0.0,0.0,0.0,0.0,0.0,0.0,0.0,0.0,0.0,0.0,0.0,0.0,0.0,0.0,0.0,0.0,0.0,0.0,0.0,0.0,0.0,0.0,1.0,0.0,0.0,0.0,0.0,0.0,0.0,0.0,0.0,0.0,0.0,0.0,0.0,0.0,0.0
105657,0,0.0,1.0,0.0,1.0,0.0,135000.0,1057266.0,44923.5,945000.0,0.025164,63.45753424657535,,-5079.0,-5103.0,,2.0,2.0,2.0,8.0,,0.5938574040023079,0.7801436381572275,0.1247,0.1159,0.9742,0.6464,0.0129,0.0,0.2069,0.1667,0.2083,0.0713,0.1009,0.1039,0.0039,0.0047,0.1271,0.1203,0.9742,0.6602,0.013,0.0,0.2069,0.1667,0.2083,0.0729,0.1102,0.1082,0.0039,0.0049,0.126,0.1159,0.9742,0.6511,0.0129,0.0,0.2069,0.1667,0.2083,0.0725,0.1026,0.1057,0.0039,0.0048,0.0897,1.0,5.0,0.0,5.0,0.0,-734.0,0.0,0.0,0.0,0.0,1.0,1.0,1.0,0.0,0.0,1.0,0.0,1.0,0.0,0.0,0.0,0.0,0.0,0.0,0.0,0.0,0.0,0.0,1.0,0.0,0.0,0.0,0.0,0.0,0.0,0.0,0.0,0.0,0.0,0.0,0.0,0.0,0.0,0.0,5.0,0.0,0.0,270000.0,0.0,0.0,0.0,0.0,0.0,-1115.0,-809.0,-826.0,-827.0,197.0,-22.0,1.0,9369.18,90787.5,100377.0,0.0,90787.5,12.0,-734.0,365243.0,-703.0,-613.0,-373.0,-588.0,11.0,0.0,0.0,2390.0,6.0,12.0,9.5,-21.5,0.0,0.0,4.0,9369.18,9369.18,-671.0,-658.0,2.5,1.0,0.0,,,,,,,,,,,,,,,,,,,,,8358979171.5,184611133840.5,165774132751.5,52043750155.935,1863.0,1706.0,71127.0,70996.0,9141.0,506805.0,17833.130100002316,17895.455899999124,17346.482199998,11311.904200000095,11249.730800000098,11197.226100000064,128593.0,663736.0,4143.314500000114,4140.998700000012,3951.5647000000927,13546275.24931467,,-923193038.0,-296929790.0,-1537328976.0416667,44088.0,30753.0,11363.933999999192,11239.879999998986,10723.827499997293,22920.095800009825,22841.85640000979,22226.621300008348,,158257.24431008074,126286.79323591728,35049.78210002803,34989.88950002847,34435.05270002888,22983.774199995874,22956.837299995448,22603.20559999569,3719176.0,8307.293300000163,8411.991800000078,8135.421800000231,9830.13920000072,9945.217600002155,10305.549599999633,16490.89009999972,16676.428799999696,16273.118099999698,829.3428000001771,814.5210000000461,760.4407000000133,3918.496900000124,3901.7387000001618,3734.38550000016,437142.0,431930.0,,6433.747627002896,632834.0,626378.0,,16354.955099999795,154402.4902999908,154405.23239999035,154296.9340999872,77716.50959999638,78054.78700000659,78456.81120000668,37.0,91162605.24,31475493.99000002,9417096329.129992,3102808119.2999988,107885529.855,865455.8399999995,181.0,24544.0,-30700546.0,13664969.0,-15935435.0,-17359808.0,-18.0,0.0,0.0,270000.0,0.0,0.0,0.0,0.0,0.0,-1731.0,-1366.0,-1366.0,-1366.0,324808689.91500014,4627355611.815004,5191013401.290004,75635902.25999996,4627355611.815004,334936.0,-23239856.0,5405017362.0,240797299.0,1221417142.0,529832952.0,1284286381.0,333827.0,5191.0,949.3085423502772,7667725.0,2759634.0,1697896.5,-5579425.5,1867685.0,245496.0,3643240002.570078,3685964891.265077,-222112706.5,-220253285.5,3901370.5,183963.5,,,,,,,,,,,,,,,,,,,,,1469502.0,14860193.0,3237003.0,8567927.0,11623911.0,1417906.0,1061637840.6345012,802276605.4499952,72214245460.95712,21707739791.932617,583497901.5569987,5792665.7475,689.5,94245.0,-277315214.0,21999533.0,-123953333.0,-219011055.0,-2025880.5,,,,,,,,,,,,,,,,,,,,,4279291.0,2482956.0,-9016437.0,921451.5,37582.5,3739238732.564957,3663902332.574957,-261000595.0,-257683822.5,2530003.0,269611.0,3931762579.739953,33298164503.01092,36731040777.38265,1732295757.8025498,48152825965.10322,3993688.5,-247927806.0,103234856537.5,1056521312.5,17295307881.5,3508780651.5,18910068225.5,3677243.5,72036.0,20900.968755383783,89880019.0,,7.8316,3.005108684764098,190.69678727809884,23.53480917559852,1493.4609592471586,67500.0,-0.9009688679024191,-0.433883739117558,0.0,0.0,0.0,0.0,0.0,0.0,1.0,0.0,0.0,1.0,0.0,0.0,0.0,0.0,0.0,0.0,0.0,0.0,1.0,0.0,1.0,0.0,0.0,0.0,0.0,1.0,0.0,0.0,0.0,0.0,0.0,0.0,0.0,0.0,0.0,0.0,0.0,0.0,0.0,0.0,0.0,0.0,0.0,0.0,0.0,0.0,0.0,0.0,0.0,0.0,0.0,0.0,0.0,0.0,0.0,0.0,0.0,0.0,0.0,0.0,0.0,0.0,0.0,0.0,0.0,0.0,0.0,0.0,0.0,0.0,0.0,0.0,0.0,0.0,0.0,0.0,0.0,0.0,0.0,0.0,0.0,0.0,0.0,0.0,0.0,0.0,0.0,0.0,0.0,0.0,0.0,0.0,0.0,0.0,0.0,0.0,0.0,0.0,0.0,0.0,0.0,0.0,0.0,0.0,0.0,1.0,0.0,0.0,1.0,0.0,1.0,0.0,0.0,0.0,0.0,0.0,0.0,1.0,0.0,0.0
105672,0,0.0,1.0,0.0,0.0,0.0,126000.0,481176.0,24696.0,360000.0,0.035792,37.68493150684933,-775.0,-2271.0,-2741.0,,2.0,2.0,2.0,11.0,0.3456832049878209,0.6995662692890879,,,,,,,,,,,,,,,,,,,,,,,,,,,,,,,,,,,,,,,,,,,,,,0.0,0.0,0.0,0.0,0.0,,,,,,,1.0,1.0,1.0,1.0,0.0,0.0,0.0,0.0,0.0,0.0,0.0,0.0,0.0,1.0,0.0,0.0,0.0,0.0,0.0,0.0,0.0,0.0,0.0,0.0,0.0,0.0,0.0,0.0,0.0,0.0,0.0,0.0,0.0,,,,,,,,,,,,,0.0,,0.0,,,,,,,,,,,,,,,,,0.0,,,,,,0.0,,,,,,,0.0,,,,,,,,,,,,,,,,,,,,,8359003867.5,184611615016.5,165774492751.5,52043876155.935,,,,,,,,,,,,,128593.0,663738.0,,,,13546312.934246177,-602767552.0,-923195779.0,-296929790.0,-1537331247.0416667,44088.0,30753.0,,,,,,,67587.56173310966,158257.94387635007,,,,,,,,3719187.0,,,,,,,,,,,,,,,,437142.0,431930.0,,6433.783419002894,632836.0,626380.0,,,,,,,,,,,,,,,,,,,,,,,,,,,,,,,,,,,,,,,,,,,,,,,,,,,,,,,,,,,,,,,,,,,,,,,,,,,,,,,,,,1469502.0,14860193.0,3237003.0,8567927.0,11623911.0,1417906.0,,,,,,,,,,,,,,,,,,,,,,,,,,,,,,,,,,,,,,,,,,,,,,,,,,,,,,,,,,,,,-20.565249000363504,3.818857142857144,5.1020408163265305,192.2700587084149,19.48396501457725,734.2518870561923,63000.0,1.0,0.0,0.0,0.0,0.0,0.0,0.0,0.0,0.0,0.0,1.0,0.0,0.0,0.0,0.0,0.0,0.0,0.0,0.0,0.0,1.0,0.0,1.0,0.0,0.0,0.0,0.0,1.0,0.0,0.0,0.0,0.0,0.0,0.0,0.0,0.0,0.0,0.0,0.0,0.0,0.0,0.0,0.0,0.0,0.0,0.0,1.0,0.0,0.0,0.0,0.0,0.0,0.0,0.0,0.0,0.0,0.0,0.0,0.0,0.0,0.0,0.0,0.0,0.0,0.0,0.0,0.0,0.0,0.0,0.0,0.0,0.0,0.0,0.0,0.0,0.0,0.0,0.0,0.0,0.0,0.0,0.0,0.0,0.0,0.0,0.0,0.0,0.0,0.0,0.0,0.0,0.0,0.0,0.0,0.0,0.0,0.0,0.0,0.0,0.0,0.0,1.0,0.0,0.0,0.0,0.0,0.0,0.0,0.0,0.0,0.0,0.0,0.0,0.0,0.0,0.0,0.0,0.0,0.0,0.0,0.0,0.0
105678,0,0.0,0.0,0.0,1.0,0.0,112500.0,900616.5,32476.5,670500.0,0.020713,51.91232876712328,-663.0,-12692.0,-2495.0,,2.0,3.0,2.0,6.0,,0.3757654765562168,0.2940831009471255,0.0474,0.0662,0.9776,0.6940000000000001,0.0134,0.0,0.1034,0.1667,0.2083,0.0247,0.037,0.0534,0.0077,0.0659,0.0483,0.0687,0.9777,0.706,0.0136,0.0,0.1034,0.1667,0.2083,0.0252,0.0404,0.0556,0.0078,0.0698,0.0479,0.0662,0.9776,0.6981,0.0135,0.0,0.1034,0.1667,0.2083,0.0251,0.0376,0.0544,0.0078,0.0673,0.0563,1.0,1.0,1.0,1.0,1.0,-3336.0,0.0,0.0,0.0,0.0,0.0,1.0,1.0,1.0,0.0,1.0,0.0,0.0,0.0,0.0,0.0,0.0,0.0,0.0,0.0,1.0,0.0,0.0,0.0,0.0,0.0,0.0,0.0,0.0,0.0,0.0,0.0,0.0,0.0,0.0,0.0,0.0,0.0,0.0,5.0,6375.015,0.0,148.5,0.0,0.0,0.0,0.0,0.0,-1814.0,-391.0,-389.0,-697.0,234.0,-28.0,0.0,,,,,,,,,,,,,,,,,0.0,,,,,,105.0,2387.79,2387.79,-1606.0,-1606.0,75.0,0.0,96.0,0.0,0.0,0.0,0.0,0.0,0.0,0.0,2387.79,0.0,0.0,0.0,0.0,0.0,0.0,0.0,0.0,20.0,-48.5,0.0,0.0,8359036344.0,184612515633.0,165775163251.5,52043988655.935,1863.0,1706.0,71127.0,70996.0,9141.0,506806.0,17833.177500002315,17895.503799999122,17346.530499998,11311.970400000097,11249.797000000097,11197.294800000063,128593.0,663740.0,4143.327900000114,4141.012200000012,3951.578300000093,13546364.846574944,-602768215.0,-923198274.0,-296933126.0,-1537343939.0416667,44089.0,30754.0,11363.933999999192,11239.879999998986,10723.827499997293,22920.199200009825,22841.95980000979,22226.724700008348,,158258.31964182662,126287.08731901822,35049.94880002803,34990.05620002847,34435.21940002888,22983.982499995876,22957.04559999545,22603.413899995685,3719193.0,8307.318000000163,8412.016900000079,8135.447000000231,9830.17620000072,9945.255200002155,10305.589999999633,16490.943499999717,16676.483199999693,16273.173699999696,829.3505000001771,814.5288000000461,760.4485000000133,3918.562800000124,3901.806000000162,3734.455300000161,437143.0,431931.0,,6433.804132002894,632839.0,626382.0,,16355.011399999796,154403.46789999082,154406.2099999904,154297.9117999872,77717.20359999637,78055.48510000657,78457.51720000668,60.0,91307985.255,31521309.97500002,9440428780.754992,3115738174.679999,108509295.915,865455.8399999995,182.0,24544.0,-30788189.0,13744101.0,-15975244.0,-17404318.0,-29.5,6375.015,0.0,0.0,0.0,0.0,0.0,0.0,0.0,-1814.0,-695.0,-389.0,-697.0,,,,,,,,,,,,,,,,,,,,,,3656757886.335072,3699891308.2950735,-223272106.0,-221407714.0,3927492.0,184558.0,3371087143.1699557,9128772000.0,284818746.375,434950247.42999977,13207388.040000005,136476560.0699999,191088236.51999903,476385537.3749936,438796716.2999976,3237022340.640022,3358853937.2249365,3359029040.3249354,14600.0,38537.0,194.0,23743.0,1102224.0,-1964285.0,814085.0,1850.0,1469507.0,14860427.0,3237099.0,8567927.0,11624016.0,1417906.0,1061644215.6495012,802276605.4499952,72214245609.45712,21707739791.932617,583497901.5569987,5792665.7475,689.5,94245.0,-277317028.0,21999142.0,-123953722.0,-219011752.0,-2025908.5,5928919112.834962,18751230000.0,198923232.825,448445207.8124977,1948107.735,257088950.66250083,309413623.9274987,637149376.3949977,459561448.8224992,5713879200.592535,5892163506.967498,5892406689.7125,13396.0,80974.5,44.0,70474.5,972473.5,-1700895.0,177364.0,6755.0,,,,,,3739241120.354957,3663904720.364957,-261002201.0,-257685428.5,2530078.0,269611.0,,,,,,,,,,,,,,,,,-12.77153261557948,8.00548,3.4640432312595264,179.8265510846726,27.731328806983512,1439.5978581773247,56250.0,0.6234898018587336,0.7818314824680298,0.0,0.0,0.0,0.0,0.0,0.0,1.0,0.0,0.0,0.0,0.0,0.0,0.0,1.0,0.0,1.0,0.0,0.0,0.0,1.0,0.0,0.0,0.0,0.0,0.0,1.0,0.0,0.0,0.0,0.0,0.0,0.0,0.0,0.0,0.0,0.0,0.0,0.0,0.0,0.0,0.0,0.0,0.0,0.0,0.0,0.0,0.0,0.0,0.0,0.0,0.0,0.0,0.0,0.0,0.0,0.0,0.0,0.0,0.0,0.0,0.0,0.0,0.0,0.0,0.0,0.0,0.0,0.0,0.0,0.0,0.0,0.0,0.0,0.0,0.0,0.0,0.0,0.0,1.0,0.0,0.0,0.0,0.0,0.0,0.0,0.0,0.0,0.0,0.0,0.0,0.0,0.0,0.0,0.0,0.0,0.0,0.0,0.0,0.0,0.0,0.0,0.0,0.0,0.0,0.0,0.0,0.0,0.0,1.0,0.0,1.0,0.0,0.0,0.0,0.0,0.0,0.0,0.0,1.0,0.0
105682,0,0.0,0.0,0.0,1.0,0.0,225000.0,573408.0,29407.5,495000.0,0.00733,27.621917808219177,-560.0,-927.0,-189.0,,2.0,2.0,2.0,13.0,0.2044356557520855,0.5592835383220897,,0.1567,0.0936,0.9826,,,0.0,0.069,0.1667,,0.0679,,0.0644,,0.1369999999999999,0.1597,0.0972,0.9826,,,0.0,0.069,0.1667,,0.0694,,0.0671,,0.145,0.1582,0.0936,0.9826,,,0.0,0.069,0.1667,,0.069,,0.0656,,0.1399,0.0805,1.0,0.0,0.0,0.0,0.0,-2045.0,,,,,,,1.0,1.0,0.0,1.0,0.0,1.0,0.0,0.0,0.0,0.0,0.0,0.0,0.0,1.0,0.0,0.0,0.0,0.0,0.0,0.0,0.0,0.0,0.0,0.0,0.0,0.0,0.0,0.0,0.0,0.0,0.0,0.0,0.0,,,,,,,,,,,,,0.0,,6.0,5426.055,32487.75,34512.75,0.0,33520.5,10.0,-1448.5,365243.0,-821.0,-701.0,-671.0,-698.0,13.5,0.0,0.0,50.5,31.0,10.0,4.0,-27.0,0.0,0.0,27.0,5621.49,5621.49,-794.0,-791.0,5.0,1.0,0.0,,,,,,,,,,,,,,,,,,,,,8359065751.5,184613089041.0,165775658251.5,52044213655.935,,,,,,,17833.33420000232,17895.661999999127,17346.690199998,11312.064000000097,11249.890600000095,11197.392000000063,128593.0,663742.0,,,,13546392.468492752,-602768775.0,-923198463.0,-296935171.0,-1537344866.0416667,44089.0,30754.0,11363.933999999192,11239.879999998986,10723.827499997293,22920.268200009825,22842.028800009783,22226.79370000835,67587.7661687654,158258.87892536493,,35050.115500028034,34990.222900028464,34435.38610002888,,,,3719206.0,8307.385900000163,8412.085900000078,8135.5164000002305,,,,16491.00789999972,16676.5487999997,16273.240799999698,,,,3918.699800000124,3901.9459000001616,3734.600300000161,437143.0,431931.0,,6433.811462002896,632841.0,626384.0,,16355.091899999796,154404.4504999908,154407.19259999038,154298.89439998716,,,,,,,,,,,,,,,,,,,,,,,,,,,,,,326196604.08000016,4645156846.545004,5210158075.290004,76142322.98999996,4645172574.045004,336086.0,-23320364.5,5425464372.0,241101706.0,1224659242.0,531626949.0,1288629787.0,335163.5,5210.0,953.7960466833538,7679968.5,2769858.0,1704209.0,-5599130.0,1867905.0,245508.0,3658358969.0550704,3701492391.015072,-223413467.0,-221547096.0,3932156.0,184649.0,,,,,,,,,,,,,,,,,,,,,1469507.0,14860427.0,3237099.0,8567958.0,11624043.0,1417912.0,,,,,,,,,,,,,,,,,,,,,,,,,,,,,,,,,,4279301.0,2482960.0,-9016464.0,921451.5,37582.5,3739246741.844957,3663910341.854957,-261002995.0,-257686219.5,2530083.0,269612.0,3931768005.794952,33298196990.76092,36731075290.13265,1732295757.8025498,48152859485.60322,3993698.5,-247929254.5,103235221780.5,1056520491.5,17295307180.5,3508779980.5,18910067527.5,3677257.0,72036.0,20900.968755383783,89880069.5,-20.27375520730014,2.54848,7.651109410864575,211.33831528859355,19.498699311400152,538.5914697466749,112500.0,-0.9009688679024191,-0.433883739117558,0.0,0.0,0.0,0.0,0.0,0.0,1.0,0.0,1.0,0.0,0.0,0.0,0.0,0.0,0.0,1.0,0.0,0.0,0.0,0.0,1.0,0.0,0.0,0.0,0.0,1.0,0.0,0.0,0.0,0.0,0.0,0.0,0.0,0.0,0.0,0.0,0.0,0.0,0.0,0.0,0.0,0.0,0.0,0.0,0.0,0.0,0.0,0.0,0.0,0.0,0.0,0.0,0.0,1.0,0.0,0.0,0.0,0.0,0.0,0.0,0.0,0.0,0.0,0.0,0.0,0.0,0.0,0.0,0.0,0.0,0.0,0.0,0.0,0.0,0.0,0.0,0.0,0.0,0.0,0.0,0.0,0.0,0.0,0.0,0.0,0.0,0.0,0.0,0.0,0.0,0.0,0.0,0.0,0.0,0.0,0.0,0.0,0.0,0.0,0.0,0.0,0.0,0.0,0.0,0.0,0.0,0.0,0.0,0.0,0.0,0.0,1.0,0.0,0.0,0.0,0.0,0.0,0.0,1.0,0.0
105691,0,0.0,0.0,0.0,0.0,0.0,76500.0,270000.0,12987.0,270000.0,0.025164,50.2986301369863,-5416.0,-3706.0,-1895.0,,2.0,2.0,2.0,14.0,,0.5882282677383227,0.4650692149562261,,,,,,,,,,,,,,,,,,,,,,,,,,,,,,,,,,,,,,,,,,,,,0.0,0.0,0.0,0.0,-730.0,0.0,0.0,0.0,0.0,0.0,6.0,1.0,1.0,1.0,1.0,0.0,0.0,0.0,0.0,0.0,0.0,1.0,1.0,0.0,1.0,0.0,0.0,0.0,0.0,0.0,0.0,0.0,0.0,0.0,0.0,0.0,0.0,0.0,0.0,0.0,0.0,0.0,0.0,1.0,,,67500.0,27670.5,0.0,0.0,0.0,0.0,-705.0,700.0,-137.0,,24.0,-11.5,3.0,8430.48,48150.0,112752.0,0.0,69075.0,10.0,-730.0,365243.0,-700.0,-190.0,-190.0,-182.0,8.0,1.0,0.0,10.0,30.0,18.0,7.0,-20.5,0.0,0.0,31.0,8430.48,8430.48,-650.0,-610.0,7.0,1.0,21.0,0.0,450000.0,,0.0,,,0.0,,0.0,0.0,0.0,0.0,,0.0,,,0.0,-13.0,0.0,0.0,8359078738.5,184613359041.0,165775928251.5,52044290155.935,1863.0,1706.0,71127.0,70996.0,9141.0,506812.0,,,,,,,128593.0,663744.0,,,,13546442.767122887,-602774191.0,-923200358.0,-296935901.0,-1537348572.0416667,44089.0,30754.0,,,,,,,,158259.46715363266,126287.5523882332,,,,,,,3719220.0,,,,,,,,,,,,,,,,437143.0,431931.0,,6433.836626002894,632843.0,626386.0,,,,,,,,,24.0,,,9482910001.244991,3141539306.0999985,108729795.915,865455.8399999995,182.0,24544.0,-30832892.0,13795038.0,-15998503.0,,-11.5,,,67500.0,27670.5,0.0,0.0,0.0,0.0,-705.0,700.0,-137.0,,326706414.4800002,4651361797.950004,5218064755.695004,76233461.48999996,4651385872.950004,336596.0,-23367836.0,5433129467.0,241437493.0,1225366409.0,533069971.0,1290070878.0,335672.0,5217.0,955.604082618752,7686334.0,2772623.0,1705784.5,-5606523.5,1867979.0,245541.0,3662807463.540085,3705795549.585085,-223890153.0,-222021623.0,3942631.0,184881.0,3375337103.504956,9162747000.0,,436287580.2449997,,,191385191.87999892,,440254423.8449975,3241107299.475023,3363043325.084937,3363218428.184936,,38584.0,,,1105957.0,-1972803.0,814090.0,1855.0,1469508.0,14860451.0,3237120.0,8567988.0,11624074.0,1417915.0,,,72214313109.45712,21707767462.432617,583497901.5569987,5792665.7475,689.5,94245.0,-277317733.0,21999842.0,-123953859.0,,-2025920.0,5928919112.834962,18751680000.0,,448445207.8124977,,,309413623.9274987,,459561448.8224992,5713879200.592535,5892163506.967498,5892406689.7125,,80974.5,,,972473.5,-1700908.0,177364.0,6755.0,4279319.0,2482967.0,-9016484.5,921451.5,37582.5,3739255172.324957,3663918772.334957,-261003645.0,-257686829.5,2530090.0,269613.0,3931776436.274952,33298245140.76092,36731188042.13265,1732295757.8025498,48152928560.60322,3993708.5,-247929984.5,103235587023.5,1056519791.5,17295306990.5,3508779790.5,18910067345.5,3677265.0,72037.0,20900.968755383783,89880079.5,-107.67688871942914,3.5294117647058822,5.8905058905058905,296.28437710629487,20.79002079002079,1045.7095662575116,38250.0,1.0,0.0,0.0,0.0,0.0,0.0,0.0,0.0,1.0,0.0,0.0,0.0,1.0,0.0,0.0,0.0,0.0,0.0,0.0,0.0,1.0,0.0,1.0,0.0,0.0,0.0,0.0,1.0,0.0,0.0,0.0,0.0,0.0,0.0,0.0,0.0,0.0,0.0,0.0,0.0,0.0,0.0,0.0,1.0,0.0,0.0,0.0,0.0,0.0,0.0,0.0,0.0,0.0,0.0,0.0,0.0,0.0,0.0,0.0,0.0,0.0,0.0,0.0,0.0,0.0,0.0,0.0,0.0,0.0,0.0,0.0,0.0,0.0,0.0,0.0,0.0,0.0,0.0,0.0,0.0,1.0,0.0,0.0,0.0,0.0,0.0,0.0,0.0,0.0,0.0,0.0,0.0,0.0,0.0,0.0,0.0,0.0,0.0,0.0,0.0,0.0,0.0,0.0,0.0,0.0,0.0,0.0,0.0,0.0,0.0,0.0,0.0,0.0,0.0,0.0,0.0,0.0,0.0,0.0,0.0,0.0,0.0
105692,0,0.0,1.0,1.0,0.0,0.0,450000.0,1231501.5,39726.0,949500.0,0.04622,49.96164383561644,-3344.0,-6937.0,-1776.0,22.0,2.0,1.0,1.0,21.0,0.7324793259546764,0.4483929542150794,0.6512602186973006,,,,,,,,,,,,,,,,,,,,,,,,,,,,,,,,,,,,,,,,,,,,,0.0,0.0,0.0,0.0,-939.0,0.0,0.0,0.0,0.0,0.0,3.0,1.0,1.0,1.0,1.0,1.0,1.0,0.0,0.0,0.0,0.0,1.0,1.0,0.0,1.0,0.0,0.0,0.0,0.0,0.0,0.0,0.0,0.0,0.0,0.0,0.0,0.0,0.0,0.0,0.0,0.0,0.0,0.0,3.0,20792.25,,135000.0,0.0,0.0,0.0,0.0,0.0,-1135.0,266.0,-423.0,,123.0,-20.0,3.0,36071.505,810000.0,906228.0,135000.0,810000.0,36.0,-939.0,365243.0,-1714.0,181437.0,-754.0,181443.5,13.0,0.5,0.6208004421950838,-1.0,38.0,60.0,41.5,-19.5,0.0,0.0,38.0,39178.215,39178.215,-571.5,-564.0,12.5,1.0,0.0,,,,,,,,,,,,,,,,,,,,,8359118464.5,184614590542.5,165776877751.5,52044740155.935,1863.0,1706.0,71127.0,70996.0,9141.0,506815.0,,,,,,,128593.0,663746.0,,,,13546492.728766724,-602777535.0,-923202134.0,-296936840.0,-1537355509.0416667,44089.0,30754.0,,,,,,,67588.49864809136,158259.91554658688,126288.20364845188,,,,,,,3719241.0,,,,,,,,,,,,,,,,437143.0,431931.0,1264817.0,6433.882846002894,632844.0,626387.0,,,,,,,,,38.0,91328777.505,,9483045001.244991,3141539306.0999985,108729795.915,865455.8399999995,182.0,24544.0,-30835457.0,13794972.0,-15999501.0,,-18.5,20792.25,,135000.0,0.0,0.0,0.0,0.0,0.0,-1135.0,266.0,-423.0,,326770274.5650002,4652816782.950004,5219558598.195004,76368461.48999996,4652816782.950004,336672.0,-23374054.0,5434042574.5,241432630.5,1225728043.5,533067223.5,1290432521.0,335714.0,5219.0,956.2248830609471,7686422.0,2773966.0,1706761.5,-5607825.0,1867997.0,245559.0,3663664396.897588,3706646447.047587,-223932971.0,-222064114.5,3943087.0,184916.5,,,,,,,,,,,,,,,,,,,,,1469511.0,14860574.0,3237120.0,8568026.0,11624112.0,1417918.0,1061665007.8995012,,72214448109.45712,21707767462.432617,583497901.5569987,5792665.7475,689.5,94245.0,-277318868.0,22000108.0,-123954282.0,,-2025940.0,,,,,,,,,,,,,,,,,,,,,4279379.0,2483008.5,-9016504.0,921451.5,37582.5,3739294350.539957,3663957950.549957,-261004216.5,-257687393.5,2530102.5,269614.0,3931812507.779953,33299055140.76092,36732094270.13265,1732430757.8025498,48153738560.60322,3993744.5,-247930923.5,103235952266.5,1056518077.5,17295488427.5,3508779036.5,18910248789.0,3677278.0,72037.5,20901.589555825973,89880078.5,-66.93134459311254,2.73667,11.327594019030355,565.9452178932538,30.99988672405981,1548.8052994519303,225000.0,1.0,0.0,0.0,0.0,0.0,0.0,0.0,0.0,1.0,0.0,0.0,0.0,0.0,0.0,0.0,1.0,0.0,1.0,0.0,0.0,0.0,0.0,1.0,0.0,0.0,0.0,0.0,1.0,0.0,0.0,0.0,0.0,0.0,0.0,0.0,0.0,0.0,0.0,0.0,0.0,0.0,0.0,1.0,0.0,0.0,0.0,0.0,0.0,0.0,0.0,0.0,0.0,0.0,0.0,0.0,0.0,0.0,1.0,0.0,0.0,0.0,0.0,0.0,0.0,0.0,0.0,0.0,0.0,0.0,0.0,0.0,0.0,0.0,0.0,0.0,0.0,0.0,0.0,0.0,0.0,0.0,0.0,0.0,0.0,0.0,0.0,0.0,0.0,0.0,0.0,0.0,0.0,0.0,0.0,0.0,0.0,0.0,0.0,0.0,0.0,0.0,0.0,0.0,0.0,0.0,0.0,0.0,0.0,0.0,0.0,0.0,0.0,0.0,0.0,0.0,0.0,0.0,0.0,0.0,0.0,0.0,0.0
105706,0,0.0,1.0,0.0,1.0,0.0,121500.0,117000.0,12415.5,117000.0,0.00702,57.158904109589045,-1018.0,-12908.0,-4159.0,,2.0,2.0,2.0,18.0,,0.3604264877089061,0.7407990879702335,,,,,,,,,,,,,,,,,,,,,,,,,,,,,,,,,,,,,,,,,,,,,0.0,0.0,0.0,0.0,0.0,0.0,0.0,0.0,0.0,0.0,1.0,1.0,1.0,1.0,1.0,0.0,0.0,0.0,0.0,0.0,0.0,1.0,1.0,0.0,1.0,0.0,0.0,0.0,0.0,0.0,0.0,0.0,0.0,0.0,0.0,0.0,0.0,0.0,0.0,0.0,0.0,0.0,0.0,2.0,0.0,,377300.25,7996.1625,0.0,0.0,0.0,0.0,-1449.5,-384.5,-93.5,-726.0,96.0,-37.5,1.0,16649.325,166482.0,149832.0,16650.0,166482.0,10.0,-557.0,365243.0,-525.0,-255.0,-255.0,-244.0,16.0,0.0,0.1089208661378625,138.0,21.0,10.0,5.0,-18.0,0.0,0.0,19.0,16635.285,16635.285,-532.0,-525.0,7.0,1.0,0.0,,,,,,,,,,,,,,,,,,,,,8359130880.0,184614707542.5,165776994751.5,52044861655.935,1863.0,1706.0,71127.0,70996.0,9141.0,506816.0,,,,,,,128593.0,663748.0,,,,13546549.887670835,-602778553.0,-923206293.0,-296936840.0,-1537368417.0416667,44089.0,30754.0,,,,,,,,158260.2759730746,126288.94444753983,,,,,,,3719259.0,,,,,,,,,,,,,,,,437143.0,431931.0,,6433.889866002894,632846.0,626389.0,,,,,,,,,48.0,91349569.755,,9501338327.66999,3146827304.024998,109025994.195,865455.8399999995,183.0,24544.0,-30936430.5,13778657.5,-16055999.0,-17482889.0,-23.5,0.0,,652500.0,0.0,0.0,0.0,0.0,0.0,-2613.0,-787.0,-152.0,-726.0,327534570.54000014,4663151293.140003,5232376879.695004,76549266.17999996,4663151293.140003,337524.0,-23436397.0,5446639932.0,242114961.0,1227514631.0,534859620.0,1292220538.0,336678.0,5229.0,959.3848673672808,7694897.0,2778319.0,1709479.0,-5620204.0,1868030.0,245592.0,3669162070.3650775,3712026246.435079,-224517048.0,-222643667.0,3953374.0,185231.0,,,,,,,,,,,,,,,,,,,,,1469513.0,14860670.0,3237120.0,8568047.0,11624131.0,1417919.0,1061665007.8995012,,72214825409.70712,21707775458.59512,583497901.5569987,5792665.7475,689.5,94245.0,-277320317.5,21999723.5,-123954375.5,-219012478.0,-2025977.5,,,,,,,,,,,,,,,,,,,,,4279389.0,2483013.5,-9016522.0,921451.5,37582.5,3739310985.824957,3663974585.834957,-261004748.5,-257687918.5,2530109.5,269615.0,3931829157.104952,33299221622.76092,36732244102.13265,1732447407.8025498,48153905042.60322,3993754.5,-247931480.5,103236317509.5,1056517552.5,17295488172.5,3508778781.5,18910248545.0,3677294.0,72037.5,20901.698476692112,89880216.5,-17.809998562047642,0.9629629629629628,9.786154403769482,559.3658611666923,9.423704240666908,538.6486070494074,60750.0,-0.2225209339563146,-0.9749279121818236,0.0,1.0,0.0,0.0,0.0,0.0,0.0,0.0,1.0,0.0,0.0,0.0,0.0,0.0,0.0,0.0,0.0,0.0,1.0,0.0,1.0,0.0,0.0,0.0,0.0,1.0,0.0,0.0,0.0,0.0,0.0,0.0,0.0,0.0,0.0,0.0,0.0,0.0,1.0,0.0,0.0,0.0,0.0,0.0,0.0,0.0,0.0,0.0,0.0,0.0,0.0,0.0,0.0,1.0,0.0,0.0,0.0,0.0,0.0,0.0,0.0,0.0,0.0,0.0,0.0,0.0,0.0,0.0,0.0,0.0,0.0,0.0,0.0,0.0,0.0,0.0,0.0,0.0,0.0,0.0,0.0,0.0,0.0,0.0,0.0,0.0,0.0,0.0,0.0,0.0,0.0,0.0,0.0,0.0,0.0,0.0,0.0,0.0,0.0,0.0,0.0,0.0,0.0,0.0,0.0,0.0,0.0,0.0,0.0,0.0,0.0,0.0,0.0,0.0,0.0,0.0,0.0,0.0,0.0,0.0
105712,0,0.0,1.0,0.0,1.0,1.0,90000.0,405000.0,19480.5,405000.0,0.04622,48.4,-2560.0,-4490.0,-1204.0,,3.0,1.0,1.0,14.0,,0.6421337607708159,0.5867400085415683,0.0866,,0.9429,0.218,0.0599,0.0,0.1034,0.125,0.1667,0.029,0.0706,0.097,0.0,0.0,0.0882,,0.9429,0.2486,0.0604,0.0,0.1034,0.125,0.1667,0.0297,0.0771,0.1011,0.0,0.0,0.0874,,0.9429,0.2285,0.0603,0.0,0.1034,0.125,0.1667,0.0295,0.0718,0.0988,0.0,0.0,0.1091,2.0,2.0,0.0,2.0,0.0,-2291.0,0.0,0.0,0.0,0.0,1.0,1.0,1.0,1.0,0.0,1.0,0.0,0.0,0.0,0.0,0.0,0.0,0.0,0.0,0.0,1.0,0.0,0.0,0.0,0.0,0.0,0.0,0.0,0.0,0.0,0.0,0.0,0.0,0.0,0.0,0.0,0.0,0.0,0.0,5.0,0.0,2093.985,99000.0,0.0,0.0,0.0,0.0,0.0,-970.0,-689.5,-635.0,-891.0,167.0,-19.0,5.0,11408.625,73251.0,61695.0,3825.0,80678.25,6.0,-797.0,365243.0,-766.0,-736.0,-616.0,-733.0,17.0,0.0,0.1090373701681121,25.0,16.0,6.0,5.0,-26.5,0.0,0.0,15.0,11408.625,27000.0,-774.0,-766.0,3.0,1.0,0.0,,,,,,,,,,,,,,,,,,,,,8359150360.5,184615112542.5,165777399751.5,52044951655.935,1863.0,1706.0,71127.0,70997.0,9141.0,506817.0,17833.420800002314,17895.749399999127,17346.778399998002,,,,128594.0,663751.0,4143.387800000114,4141.072500000012,3951.6387000000927,13546598.287670836,-602781113.0,-923207497.0,-296939131.0,-1537372907.0416667,44089.0,30754.0,11363.933999999192,11239.879999998986,10723.827499997293,22920.371600009825,22842.132200009783,22226.89710000835,,158260.91810683536,126289.5311875484,35050.240500028034,34990.347900028464,34435.51110002888,22984.149199995874,22957.212299995448,22603.58059999569,3719273.0,8307.414900000163,8412.115400000079,8135.54610000023,9830.24680000072,9945.327000002157,10305.667099999631,16491.104899999722,16676.6475999997,16273.341899999696,829.3505000001771,814.5288000000461,760.4485000000133,3918.699800000124,3901.9459000001616,3734.600300000161,437145.0,431933.0,,6433.936086002896,632847.0,626390.0,,16355.200999999795,154405.3933999908,154408.13549999034,154299.83729998718,77717.42159999636,78055.71360000657,78457.76580000669,32.0,91370800.755,31735559.970000014,9510928282.16999,3152634585.524998,109029695.265,865455.8399999995,183.0,24544.0,-30959380.0,13776014.5,-16066471.0,-17495911.0,-15.5,0.0,2093.985,85261.5,0.0,0.0,0.0,0.0,0.0,-1325.0,-1142.0,-958.0,-1142.0,327698349.345,4665389253.660004,5235395707.215004,76596714.17999996,4665408356.160004,337770.0,-23454139.0,5450289768.0,242101077.0,1227870100.0,535217639.0,1292942241.0,336919.0,5232.0,960.1223188151704,7698002.0,2780528.0,1711037.5,-5624652.5,1868030.0,245592.0,3672078747.030085,3715926673.275088,-224756474.0,-222881317.0,3957996.0,185379.0,,,,,,,,,,,,,,,,,,,,,1469518.0,14860837.0,3237120.0,8568063.0,11624146.0,1417924.0,1061665007.8995012,802278699.4349952,72214924409.70712,21707775458.59512,583497901.5569987,5792665.7475,689.5,94245.0,-277321287.5,21999034.0,-123955010.5,-219013369.0,-2025996.5,,,,,,,,,,,,,,,,,,,,,4279395.0,2483018.5,-9016548.5,921451.5,37582.5,3739322394.449957,3664001585.834957,-261005522.5,-257688684.5,2530112.5,269616.0,3931840565.729952,33299294873.76092,36732305797.13265,1732451232.8025498,48153985720.85322,3993760.5,-247932277.5,103236682752.5,1056516786.5,17295487436.5,3508778165.5,18910247812.0,3677311.0,72037.5,20901.80751406228,89880241.5,-52.89256198347108,4.5,4.62000462000462,223.6082236082236,20.79002079002079,1006.2370062370062,30000.0,-0.9009688679024191,-0.433883739117558,0.0,0.0,0.0,0.0,0.0,0.0,1.0,0.0,0.0,0.0,0.0,0.0,0.0,1.0,0.0,0.0,0.0,0.0,1.0,0.0,1.0,0.0,0.0,0.0,0.0,1.0,0.0,0.0,0.0,0.0,0.0,0.0,0.0,0.0,0.0,0.0,0.0,0.0,1.0,0.0,0.0,0.0,0.0,0.0,0.0,0.0,0.0,0.0,0.0,0.0,0.0,0.0,0.0,0.0,0.0,0.0,0.0,0.0,0.0,0.0,0.0,0.0,0.0,0.0,0.0,0.0,0.0,0.0,0.0,0.0,0.0,0.0,0.0,0.0,0.0,0.0,0.0,0.0,0.0,0.0,0.0,1.0,0.0,0.0,0.0,0.0,0.0,0.0,0.0,0.0,0.0,0.0,0.0,0.0,0.0,0.0,0.0,0.0,0.0,0.0,0.0,0.0,0.0,0.0,0.0,0.0,1.0,0.0,0.0,0.0,1.0,0.0,0.0,0.0,0.0,0.0,0.0,0.0,1.0,0.0
105720,0,0.0,0.0,0.0,0.0,1.0,135000.0,208512.0,21892.5,180000.0,0.020246,34.95342465753425,-1070.0,-1295.0,-4161.0,,2.0,3.0,3.0,11.0,0.3733464873894629,0.4469979308552204,0.7209441499436497,0.0722,0.085,0.9786,0.7076,0.0087,0.0,0.1379,0.125,0.1667,0.0372,0.0588,0.066,0.0,0.0,0.0735,0.0882,0.9786,0.7190000000000001,0.0088,0.0,0.1379,0.125,0.1667,0.0381,0.0643,0.0688,0.0,0.0,0.0729,0.085,0.9786,0.7115,0.0088,0.0,0.1379,0.125,0.1667,0.0379,0.0599,0.0672,0.0,0.0,0.0567,1.0,2.0,1.0,2.0,1.0,-627.0,0.0,0.0,0.0,0.0,1.0,1.0,1.0,1.0,0.0,1.0,0.0,1.0,0.0,0.0,0.0,0.0,0.0,0.0,0.0,1.0,0.0,0.0,0.0,0.0,0.0,0.0,0.0,0.0,0.0,0.0,0.0,0.0,0.0,0.0,0.0,0.0,0.0,0.0,2.0,0.0,,84314.25,0.0,0.0,0.0,0.0,0.0,-947.5,-749.5,-746.0,-747.0,63.0,-15.0,5.0,9106.695,67455.0,76360.5,3015.0,67455.0,10.0,-624.0,365243.0,-465.0,-270.0,105.0,-265.0,7.0,0.5,0.1033702945305155,-1.0,92.0,6.0,0.0,-33.5,397.0,0.0,26.0,9106.695,9106.695,-505.0,-504.0,4.0,1.0,18.0,0.0,45000.0,,0.0,,,0.0,,0.0,0.0,0.0,0.0,,0.0,,,0.0,-12.5,0.0,0.0,8359172253.0,184615321054.5,165777579751.5,52045086655.935,1863.0,1706.0,71127.0,70998.0,9141.0,506818.0,17833.493000002312,17895.822299999127,17346.851899997997,11312.149000000096,11249.975600000094,11197.480200000064,128595.0,663753.0,4143.396500000114,4141.081300000013,3951.647500000093,13546633.24109549,-602782183.0,-923211658.0,-296939758.0,-1537374202.0416667,44090.0,30755.0,11363.933999999192,11239.879999998986,10723.827499997293,22920.509500009823,22842.27010000979,22227.03500000835,67588.87199457876,158261.36510476618,126290.25213169832,35050.365500028034,34990.472900028464,34435.63610002888,22984.31589999588,22957.378999995453,22603.747299995688,3719284.0,8307.452100000164,8412.153300000078,8135.58420000023,9830.30560000072,9945.386900002157,10305.731399999631,16491.17089999972,16676.7147999997,16273.410699999697,829.3505000001771,814.5288000000461,760.4485000000133,3918.699800000124,3901.9459000001616,3734.600300000161,437147.0,431935.0,,6433.956332002896,632850.0,626393.0,,16355.257699999793,154406.3719999908,154409.11409999034,154300.81589998718,77718.12919999637,78056.42510000659,78458.48480000668,31.5,91413053.865,,9527172289.91999,3158553760.919998,109441447.42499998,865455.8399999995,183.0,24544.0,-30989397.0,13770336.5,-16077748.0,-17510782.5,-15.25,0.0,,119974.5,0.0,0.0,0.0,0.0,0.0,-964.0,-719.0,-718.0,-719.0,328387477.14000016,4674829106.160004,5245500227.715004,76651249.67999996,4674829106.160004,338214.0,-23485397.0,5458507360.5,242081748.0,1229316856.0,535574712.0,1294389390.0,337328.0,5244.5,961.31800143923,7850781.0,2784678.0,1713742.0,-5630616.0,1907157.5,245592.0,3682329811.80756,3726089633.857564,-225287561.0,-223408638.0,3981309.5,185671.5,3407322554.639953,9231507000.0,,438469425.2249997,,,193061412.08999893,,443372133.4199975,3271643882.59502,3394977589.3499346,3395155212.4499326,,38788.0,,,1119101.0,-1994364.0,814107.0,1872.0,1469520.0,14860900.0,3237138.0,8568155.0,11624172.0,1417929.0,1061665007.8995012,,72215008723.95712,21707775458.59512,583497901.5569987,5792665.7475,689.5,94245.0,-277322235.0,21998284.5,-123955756.5,-219014116.0,-2026011.5,5928919112.834962,18751725000.0,,448445207.8124977,,,309413623.9274987,,459561448.8224992,5713879200.592535,5892163506.967498,5892406689.7125,,80974.5,,,972473.5,-1700920.5,177364.0,6755.0,4279401.0,2483018.5,-9016582.0,921848.5,37582.5,3739331501.144957,3664010692.529957,-261006027.5,-257689188.5,2530116.5,269617.0,3931849672.424953,33299362328.76092,36732382157.63265,1732454247.8025498,48154053175.85322,3993770.5,-247932901.5,103237047995.5,1056516321.5,17295487166.5,3508778270.5,18910247547.0,3677318.0,72038.0,20901.91088435681,89880240.5,-30.612164916131054,1.544533333333333,6.166495375128468,215.5401314955864,9.524357656731755,332.9089177659829,67500.0,-0.2225209339563146,-0.9749279121818236,0.0,0.0,0.0,0.0,0.0,0.0,1.0,0.0,0.0,0.0,0.0,0.0,0.0,1.0,0.0,1.0,0.0,0.0,0.0,0.0,0.0,0.0,1.0,0.0,0.0,1.0,0.0,0.0,0.0,0.0,0.0,0.0,0.0,0.0,0.0,0.0,0.0,0.0,1.0,0.0,0.0,0.0,0.0,0.0,0.0,0.0,0.0,0.0,0.0,0.0,0.0,0.0,0.0,1.0,0.0,0.0,0.0,0.0,0.0,0.0,0.0,0.0,0.0,0.0,0.0,0.0,0.0,0.0,0.0,0.0,0.0,0.0,0.0,0.0,0.0,0.0,0.0,0.0,0.0,0.0,0.0,0.0,0.0,0.0,0.0,0.0,0.0,0.0,0.0,0.0,0.0,0.0,0.0,0.0,0.0,0.0,0.0,0.0,0.0,0.0,0.0,0.0,0.0,0.0,0.0,0.0,0.0,0.0,1.0,0.0,1.0,0.0,0.0,0.0,0.0,0.0,0.0,0.0,1.0,0.0
105734,0,0.0,0.0,1.0,1.0,0.0,157500.0,52128.0,6313.5,45000.0,0.030755,37.47671232876712,-1050.0,-7299.0,-2065.0,3.0,2.0,2.0,2.0,17.0,0.6539979285295678,0.611392532803395,0.7106743858828587,,,,,,,,,,,,,,,,,,,,,,,,,,,,,,,,,,,,,,,,,,,,,4.0,0.0,4.0,0.0,-390.0,0.0,0.0,0.0,0.0,0.0,1.0,1.0,1.0,0.0,1.0,0.0,0.0,0.0,0.0,0.0,1.0,1.0,0.0,0.0,1.0,0.0,0.0,0.0,0.0,0.0,0.0,0.0,0.0,0.0,0.0,0.0,0.0,0.0,0.0,0.0,0.0,0.0,0.0,2.0,0.0,0.0,84528.0,0.0,0.0,0.0,0.0,0.0,-1444.0,-1079.5,-848.0,-852.5,97.0,-24.0,1.0,10727.01,136080.0,152248.5,0.0,136080.0,18.0,-390.0,365243.0,-360.0,365243.0,150.0,365243.0,19.0,1.0,0.0,200.0,12.0,18.0,12.5,-7.5,0.0,0.0,13.0,10727.01,10727.01,-190.0,-180.0,7.0,1.0,0.0,,,,,,,,,,,,,,,,,,,,,8359178566.5,184615373182.5,165777624751.5,52045244155.935,1863.0,1706.0,71127.0,70998.0,9141.0,506819.0,,,,,,,128595.0,663755.0,,,,13546670.71780782,-602783233.0,-923213723.0,-296940148.0,-1537381501.0416667,44090.0,30755.0,,,,,,,67589.52599250729,158261.976497299,126290.96280608422,,,,,,,3719301.0,,,,,,,,,,,,,,,,437151.0,431939.0,1264820.0,6433.987087002894,632852.0,626395.0,,,,,,,,,48.5,91531223.865,31822886.29500002,9549635894.54999,3167743324.1399984,110230638.65999998,866315.3399999995,185.0,24583.0,-31075175.0,13860557.5,-16123451.5,-17565522.5,-23.75,0.0,0.0,52650.0,0.0,0.0,0.0,0.0,0.0,-2038.0,-1674.0,-1217.0,-1220.0,329343641.14500016,4691599413.885004,5264557493.715004,76756099.90499996,4691599413.885004,339388.0,-23549440.0,5473294960.0,243129081.0,1233297878.0,537380083.0,1298737816.0,338089.0,5264.0,963.4318462585138,7862764.0,2795869.0,1721587.0,-5647791.5,1936800.0,245595.0,3697214886.315053,3741212555.460056,-226276206.0,-224389700.0,4009171.0,186244.0,,,,,,,,,,,,,,,,,,,,,1469522.0,14860997.0,3237138.0,8568167.0,11624185.0,1417930.0,1061665007.8995012,802278699.4349952,72215093251.95712,21707775458.59512,583497901.5569987,5792665.7475,689.5,94245.0,-277323679.0,21997205.0,-123956604.5,-219014968.5,-2026035.5,,,,,,,,,,,,,,,,,,,,,4279419.0,2483031.0,-9016589.5,921848.5,37582.5,3739342228.154957,3664021419.539957,-261006217.5,-257689368.5,2530123.5,269618.0,3931860399.434953,33299498408.76092,36732534406.13265,1732454247.8025498,48154189255.85322,3993788.5,-247933291.5,103237413238.5,1056515961.5,17295852409.5,3508778420.5,18910612790.0,3677337.0,72039.0,20901.91088435681,89880440.5,-28.01739893267052,0.3309714285714286,24.94654312188168,934.914420175944,8.256593014967926,309.42996123766096,78750.0,-0.2225209339563143,0.9749279121818236,0.0,0.0,0.0,0.0,0.0,0.0,1.0,0.0,0.0,0.0,0.0,0.0,0.0,1.0,0.0,1.0,0.0,0.0,0.0,0.0,1.0,0.0,0.0,0.0,0.0,1.0,0.0,0.0,0.0,0.0,0.0,0.0,0.0,0.0,0.0,0.0,0.0,0.0,0.0,0.0,0.0,0.0,0.0,0.0,0.0,1.0,0.0,0.0,0.0,0.0,0.0,0.0,0.0,1.0,0.0,0.0,0.0,0.0,0.0,0.0,0.0,0.0,0.0,0.0,0.0,0.0,0.0,0.0,0.0,0.0,0.0,0.0,0.0,0.0,0.0,0.0,0.0,0.0,0.0,0.0,0.0,0.0,0.0,0.0,0.0,0.0,0.0,0.0,0.0,0.0,0.0,0.0,0.0,0.0,0.0,0.0,0.0,0.0,0.0,0.0,0.0,0.0,0.0,0.0,0.0,0.0,0.0,0.0,0.0,0.0,0.0,0.0,0.0,0.0,0.0,0.0,0.0,0.0,0.0,0.0
105735,0,0.0,0.0,0.0,1.0,0.0,112500.0,558706.5,43366.5,495000.0,0.030755,50.02465753424657,-2749.0,-2974.0,-1805.0,,2.0,2.0,2.0,13.0,,0.5627356295408189,0.7001838506835805,,,,,,,,,,,,,,,,,,,,,,,,,,,,,,,,,,,,,,,,,,,,,1.0,0.0,1.0,0.0,-309.0,0.0,0.0,0.0,0.0,0.0,2.0,1.0,1.0,0.0,1.0,0.0,0.0,0.0,0.0,0.0,0.0,0.0,0.0,0.0,1.0,0.0,0.0,0.0,0.0,0.0,0.0,0.0,0.0,0.0,0.0,0.0,0.0,0.0,0.0,0.0,0.0,0.0,0.0,6.0,0.0,0.0,112522.5,0.0,0.0,0.0,0.0,0.0,-1445.5,-1290.0,-1038.5,-1214.0,277.0,-23.0,2.0,13015.5975,85275.0,88589.25,0.0,85275.0,3.0,-309.0,365243.0,182482.0,182557.0,182557.0,182560.0,11.0,0.5,0.0,510.0,7.0,6.0,3.0,-7.0,0.0,0.0,7.0,23781.195,23781.195,-198.0,-189.0,4.0,1.0,9.0,0.0,0.0,,0.0,,,0.0,,0.0,0.0,0.0,0.0,,0.0,,,0.0,-6.0,0.0,0.0,8359221933.0,184615931889.0,165778119751.5,52045356655.935,1863.0,1706.0,71127.0,70998.0,9141.0,506821.0,,,,,,,128595.0,663757.0,,,,13546720.742465356,-602785982.0,-923215528.0,-296940457.0,-1537384475.0416667,44090.0,30755.0,,,,,,,,158262.53923292857,126291.6629899349,,,,,,,3719314.0,,,,,,,,,,,,,,,,437152.0,431940.0,,6434.017842002894,632854.0,626397.0,,,,,,,,,48.0,91531223.865,31822886.29500002,9550067080.04999,3167743324.1399984,110230638.65999998,866315.3399999995,185.0,24583.0,-31081131.0,13856359.0,-16127448.0,-17569209.0,-23.5,0.0,0.0,103950.0,0.0,0.0,0.0,0.0,0.0,-1474.0,-1290.0,-1075.0,-1214.0,329368547.3400001,4691747463.885004,5264712172.215004,76756099.90499996,4691747463.885004,339394.0,-23549903.5,5473842824.5,243311423.5,1233480370.5,537562575.5,1298920314.5,338105.5,5265.0,963.4318462585138,7863284.0,2795992.0,1721669.0,-5647862.0,1936800.0,245595.0,3697350935.985055,3741372730.3500576,-226278096.0,-224391476.0,4009231.0,186255.0,3425004106.199951,9270319500.0,,439791559.0199997,,,194260135.4099989,,445623978.19499743,3288617708.4450173,3412645486.5149364,3412823109.6149354,,38862.0,,,1127526.0,-2007482.0,814119.0,1877.0,1469528.0,14861274.0,3237147.0,8568174.0,11624192.0,1417932.0,1061665007.8995012,802278699.4349952,72215205774.45712,21707775458.59512,583497901.5569987,5792665.7475,689.5,94245.0,-277325124.5,21995915.0,-123957643.0,-219016182.5,-2026058.5,5928919112.834962,18751725000.0,,448445207.8124977,,,309413623.9274987,,459561448.8224992,5713879200.592535,5892163506.967498,5892406689.7125,,80974.5,,,972473.5,-1700926.5,177364.0,6755.0,4279425.0,2483034.0,-9016596.5,921848.5,37582.5,3739366009.349957,3664045200.734957,-261006415.5,-257689557.5,2530127.5,269619.0,3931873415.032453,33299583683.76092,36732622995.38265,1732454247.8025498,48154274530.85322,3993791.5,-247933600.5,103237778481.5,1056698443.5,17296034966.5,3508960977.5,18910795350.0,3677348.0,72039.5,20901.91088435681,89880950.5,-54.95289993975575,4.96628,2.594168309639929,129.7723812759328,12.883366192798588,644.4859816830394,56250.0,-0.9009688679024191,0.4338837391175582,0.0,0.0,0.0,0.0,0.0,0.0,1.0,0.0,1.0,0.0,0.0,0.0,0.0,0.0,0.0,0.0,0.0,0.0,1.0,1.0,0.0,0.0,0.0,0.0,0.0,1.0,0.0,0.0,0.0,0.0,0.0,1.0,0.0,0.0,0.0,0.0,0.0,0.0,0.0,0.0,0.0,0.0,0.0,0.0,0.0,0.0,0.0,0.0,0.0,0.0,0.0,0.0,0.0,0.0,0.0,0.0,0.0,0.0,0.0,0.0,0.0,0.0,0.0,0.0,0.0,0.0,0.0,0.0,0.0,0.0,0.0,0.0,0.0,0.0,0.0,0.0,0.0,0.0,0.0,0.0,0.0,0.0,1.0,0.0,0.0,0.0,0.0,0.0,0.0,0.0,0.0,0.0,0.0,0.0,0.0,0.0,0.0,0.0,0.0,0.0,0.0,0.0,0.0,0.0,0.0,0.0,0.0,0.0,0.0,0.0,0.0,0.0,0.0,0.0,0.0,0.0,0.0,0.0,0.0,0.0
105736,0,0.0,0.0,0.0,1.0,2.0,135000.0,369720.0,23755.5,292500.0,0.019101,41.6109589041096,-97.0,-3129.0,-6091.0,,4.0,2.0,2.0,14.0,0.2465956397540348,0.6365267170771043,0.2353105173615833,,,,,,,,,,,,,,,,,,,,,,,,,,,,,,,,,,,,,,,,,,,,,1.0,1.0,1.0,1.0,-893.0,0.0,0.0,0.0,0.0,1.0,1.0,1.0,1.0,0.0,1.0,0.0,0.0,0.0,0.0,0.0,0.0,0.0,0.0,0.0,1.0,0.0,0.0,0.0,0.0,0.0,0.0,0.0,0.0,0.0,0.0,0.0,0.0,0.0,0.0,0.0,0.0,0.0,0.0,4.0,0.0,0.0,90000.0,0.0,0.0,0.0,0.0,0.0,-447.5,-372.0,-387.0,-390.5,48.0,-7.0,4.0,12810.375,111204.0,110391.75,0.0,124168.5,4.0,-540.0,365243.0,-525.0,182254.5,-315.0,182265.0,15.0,0.5,0.0,45.0,14.0,12.0,6.0,-16.5,0.0,0.0,14.0,12810.375,12810.375,-218.0,-211.0,3.5,1.0,0.0,,,,,,,,,,,,,,,,,,,,,8359245688.5,184616301609.0,165778412251.5,52045491655.935,1863.0,1706.0,71127.0,70999.0,9141.0,506822.0,,,,,,,128597.0,663761.0,,,,13546762.35342426,-602786079.0,-923221619.0,-296941350.0,-1537387604.0416667,44091.0,30756.0,,,,,,,67589.77258814704,158263.17575964562,126291.89830045226,,,,,,,3719328.0,,,,,,,,,,,,,,,,437153.0,431941.0,,6434.036943002894,632856.0,626399.0,,,,,,,,,15.5,91531223.865,31822886.29500002,9550715941.88999,3167743324.1399984,110230638.65999998,866315.3399999995,185.0,24583.0,-31084695.5,13854252.0,-16130207.0,-17571527.5,-7.25,0.0,0.0,90000.0,0.0,0.0,0.0,0.0,0.0,-467.0,-390.5,-402.0,-409.0,329390357.7150001,4692051632.385004,5265034367.715004,76756099.90499996,4692051632.385004,339406.0,-23551124.0,5474573310.5,243493407.0,1234027868.0,537744934.0,1299467822.5,338149.0,5266.0,963.4318462585138,7864151.5,2796094.0,1721746.0,-5647945.0,1936800.0,245595.0,3697518005.707555,3741526989.697558,-226279855.0,-224393153.0,4009270.0,186267.5,,,,,,,,,,,,,,,,,,,,,1469532.0,14861322.0,3237147.0,8568188.0,11624206.0,1417936.0,1061665007.8995012,802278699.4349952,72215295774.45712,21707775458.59512,583497901.5569987,5792665.7475,689.5,94245.0,-277325572.0,21995543.0,-123958030.0,-219016573.0,-2026065.5,,,,,,,,,,,,,,,,,,,,,4279437.0,2483040.0,-9016613.0,921848.5,37582.5,3739378819.724957,3664058011.109957,-261006633.5,-257689768.5,2530131.0,269620.0,3931886225.407453,33299694887.76092,36732733387.13265,1732454247.8025498,48154398699.35322,3993795.5,-247934140.5,103238143724.5,1056697918.5,17296217221.0,3508960662.5,18910977615.0,3677363.0,72040.0,20901.91088435681,89880995.5,-2.3311166710560967,2.7386666666666666,5.682894487592348,236.4706889795961,15.563553703352907,647.6143935521203,33750.0,-0.2225209339563146,-0.9749279121818236,0.0,0.0,0.0,0.0,0.0,0.0,1.0,0.0,0.0,0.0,0.0,0.0,0.0,1.0,0.0,1.0,0.0,0.0,0.0,0.0,1.0,0.0,0.0,0.0,0.0,1.0,0.0,0.0,0.0,0.0,0.0,0.0,0.0,0.0,0.0,0.0,0.0,0.0,0.0,0.0,0.0,0.0,0.0,0.0,0.0,0.0,0.0,0.0,0.0,0.0,0.0,0.0,0.0,1.0,0.0,0.0,0.0,0.0,0.0,0.0,0.0,0.0,0.0,0.0,0.0,0.0,0.0,0.0,0.0,0.0,0.0,0.0,0.0,0.0,0.0,0.0,0.0,0.0,0.0,0.0,0.0,0.0,0.0,0.0,0.0,0.0,0.0,0.0,0.0,0.0,0.0,0.0,0.0,0.0,0.0,0.0,0.0,0.0,0.0,0.0,0.0,0.0,0.0,0.0,0.0,0.0,0.0,0.0,0.0,0.0,0.0,0.0,0.0,0.0,0.0,0.0,0.0,0.0,0.0,0.0
105737,0,0.0,0.0,1.0,0.0,0.0,220500.0,1094688.0,39321.0,945000.0,0.072508,58.21917808219178,-481.0,-4467.0,-4504.0,5.0,2.0,1.0,1.0,14.0,0.7284224363670094,0.6157218961331407,0.6347055309763198,0.2448,0.0986,0.9925,0.898,0.1627,0.28,0.1207,0.6667,0.7083,0.0,0.1992,0.1508,0.0019,0.0017,0.1418,0.0588,0.9926,0.902,0.0938,0.1611,0.069,0.6667,0.7083,0.0,0.124,0.089,0.0,0.0,0.2472,0.0986,0.9925,0.8994,0.1637,0.28,0.1207,0.6667,0.7083,0.0,0.2027,0.1535,0.0019,0.0018,0.2978,1.0,1.0,0.0,1.0,0.0,0.0,0.0,0.0,0.0,0.0,1.0,3.0,1.0,1.0,0.0,1.0,1.0,0.0,0.0,0.0,0.0,0.0,0.0,0.0,0.0,1.0,0.0,0.0,0.0,0.0,0.0,0.0,0.0,0.0,0.0,0.0,0.0,0.0,0.0,0.0,0.0,0.0,0.0,0.0,9.0,19355.22,0.0,155539.8,0.0,0.0,0.0,0.0,0.0,-765.0,-247.5,-154.0,-498.5,296.0,-19.5,6.0,25052.4225,227585.25,222511.5,10395.45,227585.25,11.0,-1583.0,365243.0,-1552.5,-1372.5,-1312.5,-1365.0,15.0,0.5,0.1089112626192128,603.0,63.0,11.0,6.0,-36.0,0.0,0.0,61.0,24920.055,24920.055,-1102.0,-1096.0,6.0,1.0,0.0,,,,,,,,,,,,,,,,,,,,,8359285009.5,184617396297.0,165779357251.5,52045712155.935,1863.0,1706.0,71127.0,71000.0,9141.0,506825.0,17833.737800002313,17896.069499999132,17346.993699998002,11312.247600000095,11250.074200000096,11197.539000000064,128597.0,663763.0,4143.559200000114,4141.245000000013,3951.741300000093,13546820.57260234,-602786560.0,-923226123.0,-296941350.0,-1537392071.0416667,44091.0,30756.0,11364.213999999192,11240.159999998988,10723.988599997288,22920.630200009826,22842.39080000979,22227.10400000835,67590.50101058341,158263.79148154176,126292.53300598323,35051.03220002804,34991.139600028466,34436.30280002888,22985.024199995874,22958.087299995448,22604.45559999569,3719342.0,8307.452100000164,8412.153300000078,8135.58420000023,9830.50480000072,9945.589600002157,10305.855399999631,16491.32169999972,16676.8682999997,16273.499699999697,829.3524000001771,814.5307000000461,760.4485000000133,3918.701500000124,3901.9477000001616,3734.600300000161,437154.0,431942.0,1264825.0,6434.109451002894,632857.0,626400.0,,16355.555499999791,154407.3644999908,154410.10659999037,154301.80849998718,77719.02719999637,78057.32450000657,78459.38680000669,26.0,91550579.085,31822886.29500002,9551664511.739988,3167778914.6399984,110356527.19499998,866315.3399999995,185.0,24583.0,-31089949.0,13853643.5,-16132435.0,-17574197.5,-12.5,0.0,0.0,155539.8,0.0,0.0,0.0,0.0,0.0,-1474.0,-517.0,-515.0,-516.0,329535150.09750015,4693848838.335004,5266894262.715004,76792442.35499996,4693848838.335004,339455.0,-23556708.5,5476034282.5,243488680.0,1234023996.0,537741497.0,1299463981.0,338220.5,5268.0,963.9606542364132,7865903.5,2796503.0,1722003.0,-5649220.0,1936817.0,245595.0,3700438191.720053,3744380377.305055,-226314201.0,-224427154.0,4009465.0,186309.0,,,,,,,,,,,,,,,,,,,,,1469541.0,14861618.0,3237147.0,8568251.0,11624267.0,1417942.0,1061684363.1195012,802278699.4349952,72215451314.25713,21707775458.59512,583497901.5569987,5792665.7475,689.5,94245.0,-277326337.0,21995295.5,-123958184.0,-219017071.5,-2026085.0,,,,,,,,,,,,,,,,,,,,,4279448.0,2483046.0,-9016649.0,921848.5,37582.5,3739403739.779957,3664082931.164957,-261007735.5,-257690864.5,2530137.0,269621.0,3931911277.829953,33299922473.01092,36732955898.63265,1732464643.25255,48154626284.60322,3993806.5,-247935723.5,103238508967.5,1056696366.0,17296215848.5,3508959350.0,18910976250.0,3677378.0,72040.5,20902.019795619428,89881598.5,-8.261882352941178,4.964571428571428,5.607690547035935,326.4751345877085,27.83978027008469,1620.8091253131497,110250.0,-0.9009688679024191,0.4338837391175582,0.0,0.0,0.0,0.0,0.0,0.0,1.0,0.0,0.0,0.0,0.0,0.0,0.0,1.0,0.0,0.0,0.0,0.0,1.0,0.0,1.0,0.0,0.0,0.0,0.0,0.0,1.0,0.0,0.0,0.0,0.0,0.0,0.0,0.0,0.0,0.0,0.0,0.0,1.0,0.0,0.0,0.0,0.0,0.0,0.0,0.0,0.0,0.0,0.0,0.0,0.0,0.0,0.0,0.0,0.0,0.0,0.0,0.0,0.0,1.0,0.0,0.0,0.0,0.0,0.0,0.0,0.0,0.0,0.0,0.0,0.0,0.0,0.0,0.0,0.0,0.0,0.0,0.0,0.0,0.0,0.0,0.0,0.0,0.0,0.0,0.0,0.0,0.0,0.0,0.0,0.0,0.0,0.0,0.0,0.0,0.0,0.0,0.0,0.0,0.0,0.0,0.0,0.0,0.0,0.0,0.0,0.0,0.0,1.0,0.0,1.0,0.0,0.0,0.0,0.0,0.0,0.0,1.0,0.0,0.0
105738,0,0.0,1.0,0.0,1.0,0.0,157500.0,225000.0,17775.0,225000.0,0.030755,50.26301369863014,-2243.0,-4563.0,-1904.0,,2.0,2.0,2.0,15.0,,0.6763466118432908,0.2314393514998941,,,,,,,,,,,,,,,,,,,,,,,,,,,,,,,,,,,,,,,,,,,,,0.0,0.0,0.0,0.0,-2081.0,0.0,0.0,0.0,0.0,0.0,1.0,1.0,1.0,0.0,1.0,0.0,0.0,0.0,0.0,0.0,0.0,1.0,1.0,0.0,1.0,0.0,0.0,0.0,0.0,0.0,0.0,0.0,0.0,0.0,0.0,0.0,0.0,0.0,0.0,0.0,0.0,0.0,0.0,2.0,0.0,,427500.0,76119.75,0.0,0.0,0.0,0.0,-1260.0,386.0,-137.5,-238.0,83.0,-20.0,2.0,5543.28,44032.5,46489.5,2250.0,44032.5,12.0,-2081.0,365243.0,-2050.0,-1720.0,-1720.0,-1716.0,17.0,0.0,0.0493605379392181,42.0,13.0,12.0,6.0,-62.0,0.0,0.0,12.0,5543.28,5543.28,-1890.5,-1885.0,6.5,1.0,0.0,,,,,,,,,,,,,,,,,,,,,8359302784.5,184617621297.0,165779582251.5,52045869655.935,1863.0,1706.0,71127.0,71000.0,9141.0,506826.0,,,,,,,128597.0,663765.0,,,,13546870.83561604,-602788803.0,-923228027.0,-296943431.0,-1537396634.0416667,44091.0,30756.0,,,,,,,,158264.4678281536,126292.76444533476,,,,,,,3719357.0,,,,,,,,,,,,,,,,437154.0,431942.0,,6434.140206002894,632859.0,626402.0,,,,,,,,,41.5,91569934.305,,9554642267.759989,3168025948.8899984,110482415.72999996,866315.3399999995,185.0,24583.0,-31096078.5,13852167.5,-16134554.5,-17576247.0,-20.25,0.0,,675000.0,0.0,0.0,0.0,0.0,0.0,-1337.0,-241.0,-228.0,-238.0,329617897.38000005,4695172913.835004,5268254077.215004,76817259.85499996,4695172913.835004,339502.0,-23565704.5,5477312633.0,243480833.0,1234017169.0,537734955.0,1299457180.0,338288.5,5269.0,964.1189260369716,7869166.0,2797058.0,1722344.0,-5651701.0,1936817.0,245595.0,3701363473.575052,3745278490.095056,-226391835.0,-224504609.0,4009675.5,186345.5,,,,,,,,,,,,,,,,,,,,,1469543.0,14861701.0,3237147.0,8568264.0,11624279.0,1417944.0,1061684363.1195012,,72215878814.25713,21707851578.34512,583497901.5569987,5792665.7475,689.5,94245.0,-277327597.0,21995681.5,-123958321.5,-219017309.5,-2026105.0,,,,,,,,,,,,,,,,,,,,,4279460.0,2483052.0,-9016711.0,921848.5,37582.5,3739409283.059957,3664088474.444957,-261009626.0,-257692749.5,2530143.5,269622.0,3931916821.109953,33299966505.51092,36733002388.13265,1732466893.25255,48154670317.10322,3993818.5,-247937804.5,103238874210.5,1056694316.0,17296214128.5,3508957630.0,18910974534.0,3677395.0,72040.5,20902.06915615737,89881640.5,-44.625258912024414,1.4285714285714286,8.860759493670884,445.3684758106468,12.658227848101266,636.2406797294955,78750.0,1.0,0.0,0.0,1.0,0.0,0.0,0.0,0.0,0.0,0.0,0.0,0.0,0.0,0.0,0.0,1.0,0.0,0.0,0.0,0.0,1.0,0.0,1.0,0.0,0.0,0.0,0.0,1.0,0.0,0.0,0.0,0.0,0.0,0.0,0.0,0.0,0.0,0.0,0.0,0.0,1.0,0.0,0.0,0.0,0.0,0.0,0.0,0.0,0.0,0.0,0.0,0.0,0.0,0.0,0.0,0.0,0.0,1.0,0.0,0.0,0.0,0.0,0.0,0.0,0.0,0.0,0.0,0.0,0.0,0.0,0.0,0.0,0.0,0.0,0.0,0.0,0.0,0.0,0.0,0.0,0.0,0.0,0.0,0.0,0.0,0.0,0.0,0.0,0.0,0.0,0.0,0.0,0.0,0.0,0.0,0.0,0.0,0.0,0.0,0.0,0.0,0.0,0.0,0.0,0.0,0.0,0.0,0.0,0.0,0.0,0.0,0.0,0.0,0.0,0.0,0.0,0.0,0.0,0.0,0.0,0.0,0.0
105740,0,0.0,1.0,1.0,1.0,0.0,180000.0,296280.0,23539.5,225000.0,0.0096569999999999,24.64383561643836,-1713.0,-7875.0,-600.0,18.0,1.0,2.0,2.0,16.0,0.322056386369924,0.4297606457980159,0.228883416700673,0.0443,,0.9776,,,,0.069,0.0417,,,,0.0145,,,0.0452,,0.9777,,,,0.069,0.0417,,,,0.0152,,,0.0448,,0.9776,,,,0.069,0.0417,,,,0.0148,,,0.0114,1.0,0.0,0.0,0.0,0.0,-1367.0,0.0,0.0,0.0,0.0,0.0,3.0,1.0,1.0,0.0,1.0,0.0,0.0,0.0,0.0,0.0,0.0,0.0,0.0,0.0,0.0,0.0,0.0,0.0,0.0,1.0,0.0,0.0,0.0,0.0,0.0,0.0,0.0,0.0,0.0,0.0,0.0,0.0,0.0,11.0,0.0,0.0,45000.0,0.0,0.0,0.0,0.0,0.0,-623.0,-1.0,-20.0,-233.0,187.0,-12.0,7.0,4688.594999999998,27405.0,29866.5,2740.5,67500.0,4.0,-250.0,365243.0,-938.0,-593.0,-578.0,-591.0,15.0,0.5,0.0915341379569919,-1.0,26.0,18.0,7.0,-14.5,0.0,0.0,26.0,15944.58,15944.58,-386.5,-385.0,7.0,1.0,0.0,,,,,,,,,,,,,,,,,,,,,8359326324.0,184617917577.0,165779807251.5,52046049655.935,1863.0,1706.0,71127.0,71000.0,9141.0,506829.0,17833.782100002314,17896.114299999128,17347.038899998002,,,,128597.0,663766.0,,,,13546895.479451654,-602790516.0,-923228627.0,-296944798.0,-1537404509.0416667,44091.0,30756.0,,,,22920.699200009825,22842.45980000979,22227.173000008348,67590.82306696978,158264.8975887994,126292.99332875144,35051.07390002804,34991.181300028475,34436.344500028885,,,,3719373.0,,,,,,,16491.336199999718,16676.8830999997,16273.514899999696,,,,,,,437154.0,431942.0,1264843.0,6434.149863002895,632861.0,626404.0,,16355.566899999792,154408.3420999908,154411.08419999038,154302.78619998714,,,,21.0,91585234.305,31827872.29500002,9555339290.759989,3168414845.6399984,110482415.72999996,866315.3399999995,185.0,24583.0,-31098461.0,13884151.0,-16134969.0,-17576609.0,-10.0,5935.5,0.0,107100.0,0.0,0.0,0.0,0.0,0.0,-799.0,994.0,-17.0,-258.0,329832026.82000005,4697355899.835004,5271483457.215004,76830665.35499996,4697445899.835004,339596.0,-23573722.0,5478590983.5,243477575.0,1234015021.0,537732912.0,1299455048.0,338462.0,5270.0,964.3687880750936,7869711.0,2797604.0,1722653.0,-5652843.5,1936818.0,245596.0,3701965437.450053,3745878002.730057,-226423042.0,-224535445.0,4009945.5,186385.5,,,,,,,,,,,,,,,,,,,,,1469554.0,14861888.0,3237147.0,8568290.0,11624305.0,1417951.0,1061684363.1195012,802278699.4349952,72215923814.25713,21707851578.34512,583497901.5569987,5792665.7475,689.5,94245.0,-277328220.0,21995680.5,-123958341.5,-219017542.5,-2026117.0,,,,,,,,,,,,,,,,,,,,,4279478.0,2483059.0,-9016725.5,921848.5,37582.5,3739425227.639957,3664104419.024957,-261010012.5,-257693134.5,2530150.5,269623.0,3931921509.704953,33299993910.51092,36733032254.63265,1732469633.75255,48154737817.10322,3993822.5,-247938054.5,103239239453.5,1056693378.0,17296213535.5,3508957052.0,18910973943.0,3677410.0,72041.0,20902.160690295324,89881639.5,-69.51028349082824,1.646,7.646721468170522,188.4445468662845,12.58650353660868,310.1797241419044,180000.0,-0.2225209339563143,0.9749279121818236,0.0,0.0,0.0,0.0,0.0,0.0,1.0,0.0,0.0,0.0,0.0,0.0,0.0,1.0,0.0,0.0,0.0,0.0,1.0,0.0,0.0,0.0,1.0,0.0,0.0,1.0,0.0,0.0,0.0,0.0,0.0,0.0,0.0,0.0,0.0,0.0,0.0,0.0,0.0,0.0,0.0,0.0,0.0,0.0,0.0,0.0,0.0,0.0,0.0,0.0,0.0,0.0,0.0,1.0,0.0,0.0,0.0,0.0,0.0,0.0,0.0,0.0,0.0,0.0,0.0,0.0,0.0,0.0,0.0,0.0,0.0,0.0,0.0,0.0,0.0,0.0,0.0,0.0,0.0,0.0,0.0,0.0,0.0,0.0,0.0,0.0,0.0,0.0,0.0,0.0,0.0,0.0,0.0,0.0,0.0,0.0,0.0,0.0,0.0,0.0,0.0,0.0,0.0,0.0,0.0,0.0,0.0,0.0,0.0,0.0,1.0,0.0,0.0,0.0,0.0,0.0,0.0,0.0,0.0,0.0
105744,0,0.0,0.0,1.0,0.0,0.0,225000.0,493204.5,25312.5,369000.0,0.032561,29.156164383561645,-126.0,-3941.0,-3181.0,9.0,1.0,1.0,1.0,19.0,0.2604544318293883,0.7174683574582414,0.363945238612397,0.0216,0.0588,0.9687,0.5716,0.0045,0.0,0.1034,0.0833,0.125,0.0,0.0177,0.0268,0.0,0.0,0.0221,0.061,0.9687,0.5884,0.0046,0.0,0.1034,0.0833,0.125,0.0,0.0193,0.0279,0.0,0.0,0.0219,0.0588,0.9687,0.5773,0.0045,0.0,0.1034,0.0833,0.125,0.0,0.018,0.0273,0.0,0.0,0.0294,1.0,0.0,0.0,0.0,0.0,-516.0,0.0,0.0,0.0,0.0,0.0,1.0,1.0,1.0,0.0,1.0,0.0,0.0,0.0,0.0,0.0,0.0,0.0,0.0,0.0,0.0,0.0,0.0,0.0,0.0,1.0,0.0,0.0,0.0,0.0,0.0,0.0,0.0,0.0,0.0,0.0,0.0,0.0,0.0,4.0,20594.25,0.0,281250.0,53633.25,0.0,0.0,0.0,0.0,-717.0,501.0,-159.0,-380.5,94.0,-14.5,2.0,20404.35,187807.5,187807.5,0.0,187807.5,11.0,-368.5,365243.0,-330.0,182514.5,-30.0,182518.0,17.0,0.0,0.0,60.0,18.0,10.0,7.0,-8.5,0.0,0.0,16.0,27682.38,27682.38,-259.5,-259.0,4.0,1.0,0.0,,,,,,,,,,,,,,,,,,,,,8359351636.5,184618410781.5,165780176251.5,52046274655.935,1863.0,1706.0,71127.0,71000.0,9141.0,506830.0,17833.803700002314,17896.136199999128,17347.060999997997,11312.306400000096,11250.133000000094,11197.600000000064,128597.0,663767.0,4143.563700000114,4141.249500000013,3951.7459000000927,13546924.63561604,-602790642.0,-923231808.0,-296945314.0,-1537408450.0416667,44091.0,30756.0,11364.213999999192,11240.159999998988,10723.988599997288,22920.802600009825,22842.56320000979,22227.276400008348,67591.08352140161,158265.61505715686,126293.35727399006,35051.15720002804,34991.264600028466,34436.42780002888,22985.149199995874,22958.212299995448,22604.58059999569,3719392.0,8307.452100000164,8412.153300000078,8135.58420000023,9830.52250000072,9945.607600002157,10305.874699999633,16491.362999999717,16676.910399999702,16273.542799999695,829.3524000001771,814.5307000000461,760.4485000000133,3918.701500000124,3901.9477000001616,3734.600300000161,437154.0,431942.0,1264852.0,6434.182424002895,632862.0,626405.0,,16355.596299999792,154409.3107999908,154412.05289999038,154303.75489998714,77719.59879999635,78057.90180000657,78459.97520000668,24.0,91662553.305,31853426.17500002,9562226451.479986,3170927794.1399984,110831858.77499998,866315.3399999995,185.0,24583.0,-31130712.5,13972806.0,-16152342.5,-17595425.5,-11.5,33988.5,0.0,450000.0,0.0,0.0,0.0,0.0,0.0,-759.0,501.0,-305.0,-451.0,330163184.52,4702752353.340004,5277272495.220004,76854411.85499996,4702752353.340004,339954.0,-23597556.5,5484434871.5,243458597.0,1234914193.5,537721614.0,1300354302.5,338736.5,5275.0,964.9217562968894,7872829.0,2801654.0,1725235.0,-5658461.5,1936818.0,245596.0,3707863926.120052,3752272550.115053,-226587084.0,-224697497.0,4011559.5,186629.5,,,,,,,,,,,,,,,,,,,,,1469558.0,14861982.0,3237147.0,8568308.0,11624321.0,1417953.0,1061704957.3695012,802278699.4349952,72216205064.25713,21707905211.59512,583497901.5569987,5792665.7475,689.5,94245.0,-277328937.0,21996181.5,-123958500.5,-219017923.0,-2026131.5,,,,,,,,,,,,,,,,,,,,,4279488.0,2483066.0,-9016734.0,921848.5,37582.5,3739452910.019957,3664132101.404957,-261010272.0,-257693393.5,2530154.5,269624.0,3931941914.054953,33300181718.01092,36733220062.13265,1732469633.75255,48154925624.60322,3993833.5,-247938423.0,103239604696.5,1056693048.0,17296396050.0,3508957022.0,18911156461.0,3677427.0,72041.0,20902.160690295324,89881699.5,-4.321556098477728,2.19202,8.888888888888891,259.1659056316591,19.484622222222217,568.0968484627093,225000.0,-0.9009688679024191,0.4338837391175582,0.0,0.0,0.0,0.0,0.0,0.0,1.0,0.0,1.0,0.0,0.0,0.0,0.0,0.0,0.0,1.0,0.0,0.0,0.0,0.0,0.0,0.0,1.0,0.0,0.0,1.0,0.0,0.0,0.0,0.0,0.0,0.0,0.0,0.0,0.0,0.0,0.0,0.0,0.0,0.0,1.0,0.0,0.0,0.0,0.0,0.0,0.0,0.0,0.0,0.0,0.0,0.0,0.0,1.0,0.0,0.0,0.0,0.0,0.0,0.0,0.0,0.0,0.0,0.0,0.0,0.0,0.0,0.0,0.0,0.0,0.0,0.0,0.0,0.0,0.0,0.0,0.0,0.0,0.0,0.0,0.0,0.0,0.0,0.0,0.0,0.0,0.0,0.0,0.0,0.0,0.0,0.0,0.0,0.0,0.0,0.0,0.0,0.0,0.0,0.0,0.0,0.0,0.0,0.0,0.0,0.0,0.0,0.0,0.0,1.0,1.0,0.0,0.0,0.0,0.0,0.0,0.0,1.0,0.0,0.0
105747,0,0.0,0.0,0.0,1.0,1.0,126000.0,177768.0,10332.0,135000.0,0.030755,44.50684931506849,-7211.0,-4518.0,-4521.0,,3.0,2.0,2.0,12.0,,0.3015595167412775,0.5638350489514956,,,,,,,,,,,,,,,,,,,,,,,,,,,,,,,,,,,,,,,,,,,,,4.0,2.0,4.0,0.0,-2441.0,0.0,0.0,0.0,0.0,0.0,2.0,1.0,1.0,0.0,1.0,0.0,0.0,0.0,0.0,0.0,0.0,0.0,0.0,0.0,1.0,0.0,0.0,0.0,0.0,0.0,0.0,0.0,0.0,0.0,0.0,0.0,0.0,0.0,0.0,0.0,0.0,0.0,0.0,14.0,0.0,0.0,58977.0,0.0,0.0,0.0,0.0,0.0,-1896.5,-1599.0,-582.5,-1415.5,797.0,-31.0,5.0,7125.435,31585.5,31585.5,13500.0,76295.25,11.0,-1324.0,365243.0,-1849.5,-1594.5,-1579.5,-1590.0,12.0,0.0,0.4652909039123793,46.0,43.0,11.0,7.0,-40.0,0.0,0.0,41.0,9004.5,9004.5,-1209.0,-1199.0,6.0,1.0,0.0,,,,,,,,,,,,,,,,,,,,,8359361968.5,184618588549.5,165780311251.5,52046400655.935,1863.0,1706.0,71127.0,71000.0,9141.0,506832.0,,,,,,,128598.0,663770.0,,,,13546969.142465357,-602797853.0,-923236329.0,-296947755.0,-1537412968.0416667,44093.0,30756.0,,,,,,,,158265.91661667358,126293.921109039,,,,,,,3719404.0,,,,,,,,,,,,,,,,437158.0,431946.0,,6434.213179002893,632864.0,626407.0,,,,,,,,,63.0,91666153.305,31853426.17500002,9563522296.364986,3171283955.6399984,110831858.77499998,866315.3399999995,185.0,24583.0,-31146333.0,13962436.5,-16158115.5,-17608493.0,-31.0,0.0,0.0,39307.5,0.0,0.0,0.0,0.0,0.0,-2099.0,-1796.0,-1117.0,-1694.0,330268382.73,4704156560.340004,5278758530.220004,76887797.35499996,4704141575.340004,340068.0,-23607977.0,5487356499.5,243450237.0,1235818707.0,538081488.5,1301258854.5,338868.0,5277.0,965.6687390943224,7873618.0,2802840.0,1726070.0,-5660447.0,1936824.0,245602.0,3708927876.465057,3753283788.495056,-226647607.0,-224757466.0,4012224.0,186700.0,,,,,,,,,,,,,,,,,,,,,1469572.0,14862779.0,3237147.0,8568351.0,11624362.0,1417958.0,1061704957.3695012,802278699.4349952,72216264041.25713,21707905211.59512,583497901.5569987,5792665.7475,689.5,94245.0,-277330833.5,21994582.5,-123959083.0,-219019338.5,-2026162.5,,,,,,,,,,,,,,,,,,,,,4279499.0,2483073.0,-9016774.0,921848.5,37582.5,3739461914.519957,3664141105.904957,-261011481.0,-257694592.5,2530160.5,269625.0,3931949039.489953,33300213303.51092,36733251647.63265,1732483133.75255,48155001919.85322,3993844.5,-247939747.0,103239969939.5,1056691198.5,17296394455.5,3508955442.5,18911154871.0,3677439.0,72041.0,20902.62598119924,89881745.5,-162.02000615574022,1.4108571428571428,12.19512195121951,542.7664550618109,17.205574912891983,765.7659300272063,42000.0,1.0,0.0,0.0,0.0,0.0,0.0,0.0,0.0,1.0,0.0,0.0,0.0,0.0,0.0,0.0,1.0,0.0,0.0,0.0,0.0,1.0,1.0,0.0,0.0,0.0,0.0,0.0,1.0,0.0,0.0,0.0,0.0,0.0,0.0,0.0,0.0,0.0,0.0,1.0,0.0,0.0,0.0,0.0,0.0,0.0,0.0,0.0,0.0,0.0,0.0,0.0,0.0,0.0,0.0,0.0,0.0,0.0,0.0,0.0,0.0,0.0,0.0,0.0,0.0,0.0,0.0,0.0,0.0,0.0,0.0,0.0,0.0,0.0,0.0,0.0,0.0,0.0,0.0,0.0,0.0,0.0,0.0,0.0,0.0,0.0,0.0,0.0,0.0,0.0,0.0,0.0,0.0,0.0,0.0,0.0,0.0,0.0,0.0,0.0,0.0,0.0,0.0,0.0,1.0,0.0,0.0,0.0,0.0,0.0,0.0,0.0,0.0,0.0,0.0,0.0,0.0,0.0,0.0,0.0,0.0,0.0,0.0
105749,0,0.0,0.0,0.0,1.0,2.0,67500.0,130320.0,14161.5,112500.0,0.028663,29.52054794520548,-779.0,-2092.0,-2141.0,,4.0,2.0,2.0,9.0,,0.3394440091497896,0.3139166772114369,0.0124,0.0,0.9791,,,0.0,0.069,0.0417,,0.0063,,0.0098,,0.0023,0.0126,0.0,0.9791,,,0.0,0.069,0.0417,,0.0065,,0.0103,,0.0024,0.0125,0.0,0.9791,,,0.0,0.069,0.0417,,0.0064,,0.01,,0.0023,0.0082,1.0,0.0,0.0,0.0,0.0,-2008.0,0.0,0.0,0.0,0.0,0.0,0.0,1.0,1.0,1.0,1.0,0.0,0.0,0.0,0.0,0.0,0.0,0.0,0.0,0.0,1.0,0.0,0.0,0.0,0.0,0.0,0.0,0.0,0.0,0.0,0.0,0.0,0.0,0.0,0.0,0.0,0.0,0.0,0.0,3.0,11624.985,0.0,55399.5,0.0,0.0,0.0,0.0,0.0,-466.0,-100.0,-314.0,-645.5,66.0,-10.5,15.0,9227.925,77962.5,86197.5,2376.0,77962.5,12.0,-923.0,365243.0,-920.0,-680.0,-590.0,-671.5,13.0,0.0,0.052134179510426,32.0,97.0,12.0,9.0,-29.0,0.0,0.0,122.0,9452.88,9452.88,-603.0,-596.0,7.0,1.0,15.0,44998.785,112500.0,0.0,0.0,0.0,0.0,2278.26,2700.0,2520.0,44020.395,44586.495,44586.495,0.0,0.0,0.0,0.0,4.0,-8.0,0.0,0.0,8359376130.0,184618718869.5,165780423751.5,52046468155.935,1863.0,1706.0,71127.0,71000.0,9141.0,506832.0,17833.816100002314,17896.148699999132,17347.073599997995,11312.306400000096,11250.133000000094,11197.600000000064,128600.0,663774.0,,,,13546998.663013302,-602798632.0,-923238470.0,-296949763.0,-1537415060.0416667,44093.0,30756.0,11364.213999999192,11240.159999998988,10723.988599997288,22920.871600009825,22842.632200009783,22227.34540000835,,158266.25606068276,126294.23502571625,35051.19890002804,34991.306300028475,34436.469500028885,,,,3719413.0,8307.458400000163,8412.159700000078,8135.590700000232,,,,16491.37279999972,16676.9203999997,16273.553099999695,,,,3918.703800000124,3901.9500000001617,3734.60270000016,437158.0,431946.0,,6434.241842002894,632866.0,626409.0,,16355.604499999792,154410.2898999908,154413.03199999034,154304.73399998716,,,,16.0,91691548.29,31863858.30000002,9566463496.364986,3171837091.6349983,111282569.27999996,866315.3399999995,185.0,24583.0,-31173227.0,13946232.0,-16170990.0,-17624414.5,-7.5,11624.985,0.0,24686.505,0.0,0.0,0.0,0.0,0.0,-1159.0,-975.0,-969.0,-975.0,330417825.885,4705814553.840004,5280407087.220004,76962929.35499996,4705814553.840004,340182.0,-23620190.0,5490643508.0,243804672.5,1236181649.5,538442880.5,1301256467.0,339025.0,5279.5,966.4275614823086,7875946.0,2803746.0,1726619.0,-5663808.0,1936824.0,245602.0,3710067340.2525578,3754383987.802556,-226747267.0,-224855804.0,4012777.0,186784.0,3427521356.159951,9279274500.0,288323346.375,440277041.5199997,13307355.540000005,138164602.0949999,194365811.7899989,483905546.5949929,445903381.9799973,3290982741.990016,3415113753.209937,3415291376.309936,14887.0,38904.0,196.0,23818.5,1127618.0,-2007684.0,814137.0,1877.0,1469575.0,14862845.0,3237162.0,8568448.0,11624484.0,1417973.0,1061716582.3545012,802278699.4349952,72216319440.75713,21707905211.59512,583497901.5569987,5792665.7475,689.5,94245.0,-277331299.5,21994482.5,-123959397.0,-219019984.0,-2026173.0,5928964111.619962,18751837500.0,198923232.825,448445207.8124977,1948107.735,257088950.66250083,309415902.1874987,637152076.3949977,459563968.8224992,5713923220.987535,5892208093.462498,5892451276.2075,13396.0,80974.5,44.0,70474.5,972477.5,-1700934.5,177364.0,6755.0,4279511.0,2483082.0,-9016803.0,921848.5,37582.5,3739471367.399957,3664150558.784957,-261012084.0,-257695188.5,2530167.5,269626.0,3931958267.414953,33300291266.01092,36733337845.13265,1732485509.75255,48155079882.35322,3993856.5,-247940670.0,103240335182.5,1056690278.5,17296393775.5,3508954852.5,18911154199.5,3677452.0,72041.0,20902.67811537875,89881777.5,-26.388399071925758,1.9306666666666668,4.766444232602479,140.70804549668958,9.202414998411186,271.6603331722754,16875.0,-0.2225209339563143,0.9749279121818236,0.0,0.0,0.0,0.0,0.0,0.0,1.0,0.0,0.0,0.0,0.0,0.0,0.0,1.0,0.0,0.0,0.0,0.0,1.0,0.0,1.0,0.0,0.0,0.0,0.0,1.0,0.0,0.0,0.0,0.0,0.0,0.0,0.0,0.0,0.0,0.0,0.0,0.0,1.0,0.0,0.0,0.0,0.0,0.0,0.0,0.0,0.0,0.0,0.0,0.0,0.0,0.0,0.0,0.0,0.0,0.0,0.0,0.0,0.0,0.0,0.0,0.0,0.0,0.0,0.0,0.0,0.0,0.0,0.0,0.0,0.0,0.0,0.0,0.0,0.0,0.0,0.0,0.0,0.0,0.0,0.0,0.0,0.0,1.0,0.0,0.0,0.0,0.0,0.0,0.0,0.0,0.0,0.0,0.0,0.0,0.0,0.0,0.0,0.0,0.0,0.0,0.0,0.0,0.0,0.0,0.0,0.0,0.0,0.0,0.0,1.0,0.0,0.0,0.0,0.0,0.0,0.0,0.0,1.0,0.0
105754,0,0.0,0.0,0.0,0.0,0.0,90000.0,146038.5,7024.5,110902.5,0.015221,56.72328767123288,-3036.0,-9755.0,-4261.0,,1.0,2.0,2.0,9.0,,0.5716197625863495,0.3622772470384314,0.1474,0.1026,0.9866,0.8164,,0.16,0.1379,0.3333,0.0417,0.0926,,0.1465,,0.0082,0.1502,0.1064,0.9866,0.8236,,0.1611,0.1379,0.3333,0.0417,0.0947,,0.1526,,0.0087,0.1489,0.1026,0.9866,0.8189,,0.16,0.1379,0.3333,0.0417,0.0942,,0.1491,,0.0084,0.1315,1.0,0.0,0.0,0.0,0.0,-720.0,0.0,0.0,0.0,0.0,2.0,1.0,1.0,1.0,1.0,1.0,0.0,0.0,0.0,0.0,0.0,0.0,0.0,0.0,0.0,1.0,0.0,0.0,0.0,0.0,0.0,0.0,0.0,0.0,0.0,0.0,0.0,0.0,0.0,0.0,0.0,0.0,0.0,0.0,15.0,5548.5,0.0,135000.0,0.0,0.0,0.0,0.0,0.0,-606.0,-55.5,-211.0,-660.0,510.0,-23.0,1.0,8261.145,88123.5,79308.0,8815.5,88123.5,12.0,-720.0,365243.0,-687.0,-567.0,-357.0,-562.0,15.0,0.0,0.1089480207786902,20.0,6.0,12.0,9.5,-20.5,0.0,0.0,5.0,8261.145,8261.145,-674.0,-627.0,3.0,1.0,0.0,,,,,,,,,,,,,,,,,,,,,8359383154.5,184618864908.0,165780534654.0,52046558155.935,1863.0,1706.0,71127.0,71002.0,9141.0,506833.0,17833.963500002315,17896.297599999132,17347.223799997995,11312.409000000096,11250.235600000096,11197.706400000065,128600.0,663775.0,,,,13547055.386300972,-602801668.0,-923242731.0,-296950483.0,-1537424815.0416667,44093.0,30756.0,11364.373999999192,11240.319999998988,10724.149699997288,22921.009500009823,22842.77010000979,22227.48330000835,,158266.82768044533,126294.59730296324,35051.53220002804,34991.639600028466,34436.80280002888,22985.19089999588,22958.253999995453,22604.622299995688,3719422.0,8307.551000000163,8412.253900000078,8135.68540000023,,,,16491.51929999972,16677.0694999997,16273.705699999697,,,,3918.712000000124,3901.958400000162,3734.61140000016,437158.0,431946.0,,6434.257063002893,632868.0,626411.0,,16355.735999999792,154411.2764999908,154414.01859999038,154305.72059998714,77720.41519999635,78058.72070000657,78460.79880000668,20.0,91750124.79,31864083.30000002,9572753256.569986,3173113446.974998,111390716.47499996,866315.3399999995,186.0,24583.0,-31227783.0,13978323.0,-16204386.0,-17657018.5,-9.5,0.0,6332.535,135000.0,0.0,0.0,0.0,0.0,0.0,-2041.0,-1448.0,-859.0,-1448.0,330711957.27,4709334359.340004,5284195380.720004,77018571.85499996,4709334359.340004,340438.0,-23645434.0,5495939353.0,243787842.0,1236894385.0,538791908.0,1301969403.0,339332.0,5284.0,967.2381121420397,7885532.0,2805531.0,1727678.0,-5668103.5,1936840.0,245618.0,3712680458.685065,3757227294.330061,-227052008.0,-225158439.0,4022135.0,186989.0,,,,,,,,,,,,,,,,,,,,,1469590.0,14863355.0,3237162.0,8568454.0,11624489.0,1417974.0,1061722130.8545012,802278699.4349952,72216454440.75713,21707905211.59512,583497901.5569987,5792665.7475,689.5,94245.0,-277331905.5,21994427.0,-123959608.0,-219020644.0,-2026196.0,,,,,,,,,,,,,,,,,,,,,4279523.0,2483091.5,-9016823.5,921848.5,37582.5,3739479628.544957,3664158819.929957,-261012758.0,-257695815.5,2530170.5,269627.0,3931966528.559953,33300379389.51092,36733417153.13265,1732494325.25255,48155168005.85322,3993868.5,-247941390.0,103240700425.5,1056689591.5,17296393208.5,3508954495.5,18911153637.5,3677467.0,72041.0,20902.78706339953,89881797.5,-53.52299072642968,1.62265,12.812299807815506,726.7557677288005,20.789878283151825,1179.270246505138,90000.0,-0.9009688679024191,-0.433883739117558,0.0,0.0,0.0,0.0,0.0,0.0,1.0,0.0,0.0,0.0,0.0,0.0,0.0,1.0,0.0,0.0,0.0,0.0,1.0,0.0,0.0,0.0,0.0,1.0,0.0,1.0,0.0,0.0,0.0,0.0,0.0,0.0,0.0,0.0,0.0,0.0,0.0,0.0,0.0,0.0,0.0,0.0,0.0,0.0,0.0,0.0,0.0,0.0,0.0,0.0,0.0,0.0,0.0,0.0,0.0,0.0,0.0,0.0,0.0,0.0,0.0,0.0,0.0,0.0,0.0,0.0,0.0,0.0,0.0,0.0,0.0,0.0,0.0,0.0,0.0,0.0,0.0,0.0,0.0,0.0,0.0,1.0,0.0,0.0,0.0,0.0,0.0,0.0,0.0,0.0,0.0,0.0,0.0,0.0,0.0,0.0,0.0,0.0,0.0,0.0,0.0,0.0,0.0,0.0,0.0,0.0,0.0,0.0,0.0,1.0,1.0,0.0,0.0,0.0,0.0,0.0,0.0,1.0,0.0,0.0
105758,0,0.0,0.0,1.0,1.0,0.0,270000.0,729792.0,37390.5,630000.0,0.035792,38.14246575342465,-697.0,-7831.0,-5422.0,22.0,2.0,2.0,2.0,16.0,0.5021508075413433,0.7039416147692028,0.4956658291397297,0.0722,0.0768,0.9757,0.6668,0.0077,0.0,0.1379,0.1667,0.2083,0.056,0.0546,0.051,0.0193,0.0516,0.0735,0.0797,0.9757,0.6798,0.0077,0.0,0.1379,0.1667,0.2083,0.0573,0.0597,0.0531,0.0195,0.0546,0.0729,0.0768,0.9757,0.6713,0.0077,0.0,0.1379,0.1667,0.2083,0.057,0.0556,0.0519,0.0194,0.0527,0.0513,1.0,0.0,0.0,0.0,0.0,-3879.0,0.0,0.0,0.0,0.0,0.0,1.0,1.0,1.0,0.0,1.0,1.0,0.0,0.0,0.0,0.0,0.0,0.0,0.0,0.0,1.0,0.0,0.0,0.0,0.0,0.0,0.0,0.0,0.0,0.0,0.0,0.0,0.0,0.0,0.0,0.0,0.0,0.0,0.0,4.0,15093.0,813.3525,206215.875,0.0,0.0,0.0,0.0,0.0,-1540.0,-793.0,-391.0,-868.0,160.0,-26.0,0.0,,,,,,,,,,,,,,,,,0.0,,,,,,0.0,,,,,,,0.0,,,,,,,,,,,,,,,,,,,,,8359420545.0,184619594700.0,165781164654.0,52046828155.935,1863.0,1706.0,71127.0,71002.0,9141.0,506834.0,17834.035700002314,17896.370499999128,17347.297299997994,11312.485800000097,11250.312400000095,11197.786100000065,128600.0,663777.0,4143.571400000114,4141.257200000012,3951.753600000093,13547093.528766723,-602802365.0,-923248153.0,-296954362.0,-1537432646.0416667,44093.0,30756.0,11364.373999999192,11240.319999998988,10724.149699997288,22921.147400009828,22842.90800000979,22227.62120000835,67591.58567220916,158267.5316220601,126295.0929687924,35051.69890002804,34991.806300028475,34436.969500028885,22985.399199995874,22958.462299995448,22604.83059999569,3719438.0,8307.607000000164,8412.310900000079,8135.742700000232,9830.57710000072,9945.663200002156,10305.934399999633,16491.57029999972,16677.121399999698,16273.758799999694,829.3717000001773,814.5501000000461,760.4680000000131,3918.763600000124,3902.0111000001625,3734.66600000016,437158.0,431946.0,1264874.0,6434.292855002893,632870.0,626413.0,,16355.78729999979,154412.25219999082,154414.9942999904,154306.69629998718,77721.08199999637,78059.39200000657,78461.47860000668,51.0,91831165.29,31886303.04000001,9575978577.749989,3173917331.474998,111392356.58999996,866315.3399999995,186.0,24583.0,-31249109.0,13967154.5,-16216588.5,-17670068.0,-25.0,0.0,1626.705,112932.0,0.0,0.0,0.0,0.0,0.0,-1540.0,-809.0,-764.0,-868.0,,,,,,,,,,,,,,,,,,,,,,,,,,,,,,,,,,,,,,,,,,,,,,,,1469594.0,14863515.0,3237162.0,8568454.0,11624489.0,1417974.0,1061737223.8545012,802279512.7874951,72216660656.63213,21707905211.59512,583497901.5569987,5792665.7475,689.5,94245.0,-277333445.5,21993634.0,-123959999.0,-219021512.0,-2026222.0,,,,,,,,,,,,,,,,,,,,,,,,,,,,,,,,,,,,,,,,,,,,,,,,-18.273595747737392,2.702933333333333,7.221085569864003,275.4300090510867,19.518112889637734,744.4689524644839,135000.0,1.0,0.0,0.0,1.0,0.0,0.0,0.0,0.0,0.0,0.0,1.0,0.0,0.0,0.0,0.0,0.0,0.0,0.0,0.0,0.0,1.0,0.0,1.0,0.0,0.0,0.0,0.0,0.0,1.0,0.0,0.0,0.0,0.0,0.0,0.0,0.0,0.0,0.0,0.0,0.0,0.0,0.0,0.0,0.0,0.0,0.0,1.0,0.0,0.0,0.0,0.0,0.0,0.0,0.0,0.0,0.0,0.0,0.0,0.0,0.0,0.0,0.0,0.0,0.0,0.0,0.0,0.0,0.0,0.0,0.0,0.0,0.0,0.0,0.0,0.0,0.0,0.0,0.0,0.0,0.0,0.0,0.0,0.0,1.0,0.0,0.0,0.0,0.0,0.0,0.0,0.0,0.0,0.0,0.0,0.0,0.0,0.0,0.0,0.0,0.0,0.0,0.0,0.0,0.0,0.0,0.0,0.0,0.0,0.0,0.0,1.0,0.0,1.0,0.0,0.0,0.0,0.0,0.0,0.0,0.0,1.0,0.0
105760,0,0.0,0.0,0.0,0.0,1.0,112500.0,525735.0,36720.0,450000.0,0.009175,42.47945205479452,-1599.0,-1117.0,-4386.0,,3.0,2.0,2.0,16.0,,0.6928881428087281,0.5154953751603267,0.3995,0.3217,0.997,0.9592,0.1159,0.44,0.3793,0.375,0.4167,0.2365,0.2881,0.4655,0.0232,0.0,0.2447,0.1895,0.9965,0.9673,0.0866,0.6042,0.5172,0.375,0.4167,0.1652,0.2084,0.3003,0.0233,0.0,0.3981,0.2544,0.997,0.9665,0.1166,0.46,0.3966,0.375,0.4167,0.2582,0.2959,0.4902,0.0233,0.0,0.2267,1.0,2.0,2.0,2.0,2.0,0.0,0.0,0.0,0.0,0.0,2.0,1.0,1.0,1.0,0.0,1.0,0.0,0.0,0.0,0.0,0.0,0.0,0.0,0.0,0.0,1.0,0.0,0.0,0.0,0.0,0.0,0.0,0.0,0.0,0.0,0.0,0.0,0.0,0.0,0.0,0.0,0.0,0.0,0.0,2.0,,,90000.0,868.5,0.0,0.0,0.0,0.0,-342.0,-183.0,-295.5,-361.0,24.0,-5.5,4.0,7319.7225,20092.5,20245.5,9756.0,77141.25,12.0,-514.5,365243.0,-1312.0,-1042.0,-982.0,-1038.0,14.0,0.0,0.1452396697070485,18.0,21.0,12.0,7.0,-59.0,0.0,0.0,23.0,4940.82,4940.82,-1768.0,-1755.0,6.0,1.0,0.0,,,,,,,,,,,,,,,,,,,,,8359457265.0,184620120435.0,165781614654.0,52046940655.935,1863.0,1706.0,71127.0,71004.0,9141.0,506835.0,17834.435200002314,17896.768599999126,17347.541999997993,11312.807500000095,11250.566800000095,11197.975600000063,128601.0,663780.0,4143.687300000114,4141.373800000012,3951.840200000093,13547136.00821878,-602803964.0,-923252539.0,-296954362.0,-1537433763.0416667,44095.0,30758.0,11364.813999999193,11240.779999998987,10724.753899997288,22921.52670000983,22843.30460000979,22228.13840000835,,158268.22451020288,126295.60846416756,35052.07390002804,34992.181300028475,34437.344500028885,22985.81589999588,22958.878999995453,22605.247299995688,3719454.0,8307.843500000165,8412.569100000079,8135.907900000232,9830.86520000072,9945.959100002154,10306.142799999632,16492.035799999718,16677.6115999997,16274.059099999697,829.3949000001771,814.5734000000459,760.4913000000131,3918.763600000124,3902.0111000001625,3734.66600000016,437160.0,431948.0,,6434.302030002893,632872.0,626415.0,,16356.01399999979,154413.24919999082,154415.9912999904,154307.69279998716,77722.04119999635,78060.35850000657,78462.44590000669,12.0,,,9577957307.399986,3175367199.974998,111392356.58999996,866315.3399999995,186.0,24583.0,-31261178.0,13959101.0,-16225182.5,-17678785.0,-5.5,,,0.0,0.0,0.0,0.0,0.0,0.0,-396.0,-108.0,-324.0,-361.0,331109633.70000005,4714448352.840004,5289860277.720004,77103860.35499996,4714428260.340004,340802.0,-23666026.5,5501599276.5,243773866.5,1239442533.5,539518001.5,1304517612.0,339691.5,5293.0,967.8942294607104,7891239.5,2808795.0,1729901.0,-5671479.0,1936843.0,245621.0,3719128519.350055,3764234051.010051,-227185002.0,-225289600.0,4026139.0,187231.0,,,,,,,,,,,,,,,,,,,,,1469596.0,14863539.0,3237162.0,8568475.0,11624512.0,1417978.0,,,72216750656.63213,21707906080.09512,583497901.5569987,5792665.7475,689.5,94245.0,-277333787.5,21993451.0,-123960294.5,-219021873.0,-2026227.5,,,,,,,,,,,,,,,,,,,,,4279535.0,2483098.5,-9016882.5,921848.5,37582.5,3739484569.364957,3664163760.749958,-261014526.0,-257697570.5,2530176.5,269628.0,3931973848.282453,33300399482.01092,36733437398.63265,1732504081.25255,48155245147.10322,3993880.5,-247941904.5,103241065668.5,1056688279.5,17296392166.5,3508953513.5,18911152599.5,3677481.0,72041.0,20902.932303069232,89881815.5,-37.64172847468559,4.6732,3.063725490196078,130.14538006983616,14.317401960784313,608.1953901423584,37500.0,0.6234898018587336,0.7818314824680298,0.0,0.0,0.0,0.0,0.0,0.0,1.0,0.0,0.0,0.0,0.0,0.0,0.0,1.0,0.0,0.0,0.0,0.0,1.0,1.0,0.0,0.0,0.0,0.0,0.0,1.0,0.0,0.0,0.0,0.0,0.0,0.0,0.0,0.0,0.0,0.0,0.0,0.0,0.0,0.0,0.0,0.0,0.0,0.0,0.0,0.0,0.0,0.0,0.0,0.0,0.0,0.0,0.0,1.0,0.0,0.0,0.0,0.0,0.0,0.0,0.0,0.0,0.0,0.0,0.0,0.0,0.0,0.0,0.0,0.0,0.0,0.0,0.0,0.0,0.0,0.0,0.0,0.0,0.0,0.0,0.0,0.0,0.0,0.0,0.0,0.0,0.0,0.0,0.0,0.0,0.0,0.0,0.0,0.0,0.0,0.0,0.0,0.0,0.0,0.0,0.0,0.0,0.0,0.0,0.0,0.0,0.0,0.0,0.0,1.0,1.0,0.0,0.0,1.0,0.0,0.0,0.0,0.0,0.0,0.0
105767,0,0.0,0.0,0.0,1.0,0.0,207000.0,450000.0,23107.5,450000.0,0.018209,57.58904109589041,,-9571.0,-4512.0,,2.0,3.0,3.0,9.0,,0.3348795580912284,0.3016248916841194,,,,,,,,,,,,,,,,,,,,,,,,,,,,,,,,,,,,,,,,,,,,,0.0,0.0,0.0,0.0,-1761.0,0.0,0.0,0.0,0.0,0.0,6.0,1.0,0.0,0.0,1.0,0.0,0.0,0.0,0.0,0.0,0.0,0.0,0.0,0.0,0.0,0.0,0.0,1.0,0.0,0.0,0.0,0.0,0.0,0.0,0.0,0.0,0.0,0.0,0.0,0.0,0.0,0.0,0.0,6.0,16830.0,0.0,399375.0,77841.0,0.0,0.0,0.0,0.0,-326.5,917.0,-36.5,-328.0,128.0,-13.0,14.0,14167.485,186108.75,207994.5,6617.25,353250.0,36.0,-879.5,365243.0,-1731.0,-1077.0,-597.0,-1071.0,7.0,1.0,0.0490958976645671,-1.0,119.0,24.0,20.0,-42.0,0.0,0.0,215.0,9000.0,7869.015,-1300.0,-1281.0,17.0,1.0,86.0,138451.77000000002,270000.0,0.0,0.0,0.0,0.0,9000.0,7875.0,7875.0,132276.375,138451.77000000002,138451.77000000002,0.0,0.0,0.0,0.0,42.5,-43.5,0.0,0.0,8359480372.5,184620570435.0,165782064654.0,52047147655.935,1863.0,1706.0,71127.0,71004.0,9141.0,506841.0,,,,,,,128601.0,663782.0,,,,13547193.597259875,,-923257051.0,-296956123.0,-1537443334.0416667,44095.0,30758.0,,,,,,,,158268.559389761,126295.91008905924,,,,,,,3719463.0,,,,,,,,,,,,,,,,437160.0,431948.0,,6434.320239002893,632875.0,626418.0,,,,,,,,,11.5,91962698.805,31909073.940000016,9593697465.719986,3178106217.224998,111668863.58999996,866315.3399999995,186.0,24583.0,-31286375.0,13975998.0,-16234421.5,-17688198.0,-5.25,16830.0,0.0,468000.0,148617.0,0.0,0.0,0.0,0.0,-1279.0,917.0,-28.0,-328.0,331628998.095,4721346366.840004,5297562869.220004,77190732.85499996,4721346366.840004,341312.0,-23691129.5,5507985614.0,243753478.0,1241257129.0,540241548.0,1306332304.0,340184.5,5300.0,969.4463419135664,7902469.5,2814191.0,1733490.0,-5678042.0,1936844.0,245622.0,3723015699.990048,3768413503.410045,-227598693.0,-225698837.0,4036695.0,187449.0,3453681580.492451,9323514000.0,290967546.375,443344135.9049997,13445055.540000005,138483979.82999992,195853999.13999888,487700899.7399916,449572807.9799975,3316019202.135013,3441166122.532435,3441343745.632434,14999.0,39039.0,197.0,23843.0,1135801.5,-2019561.0,814140.0,1880.0,1469602.0,14863667.0,3237248.0,8568594.0,11624727.0,1417992.0,1061754053.8545012,802279512.7874951,72217150031.63213,21707983921.09512,583497901.5569987,5792665.7475,689.5,94245.0,-277334114.0,21994368.0,-123960331.0,-219022201.0,-2026240.5,5929102563.389961,18752107500.0,198923232.825,448445207.8124977,1948107.735,257088950.66250083,309424902.1874987,637159951.3949977,459571843.8224992,5714055497.362535,5892346545.232497,5892589727.977499,13396.0,80974.5,44.0,70474.5,972520.0,-1700978.0,177364.0,6755.0,4279559.0,2483118.5,-9016924.5,921848.5,37582.5,3739493569.364957,3664171629.764957,-261015826.0,-257698851.5,2530193.5,269629.0,3931988015.767453,33300585590.76092,36733645393.13265,1732510698.50255,48155598397.10322,3993916.5,-247942784.0,103241430911.5,1056686548.5,17296391089.5,3508952916.5,18911151528.5,3677488.0,72042.0,20902.9813989669,89881814.5,,2.1739130434782608,8.95813047711782,515.8901441890864,19.474196689386567,1121.5003134545357,103500.0,0.6234898018587334,-0.7818314824680299,0.0,0.0,0.0,0.0,0.0,0.0,1.0,0.0,0.0,1.0,0.0,0.0,0.0,0.0,0.0,0.0,0.0,0.0,1.0,0.0,1.0,0.0,0.0,0.0,0.0,1.0,0.0,0.0,0.0,0.0,0.0,0.0,0.0,0.0,0.0,0.0,0.0,0.0,0.0,0.0,0.0,0.0,0.0,0.0,0.0,0.0,0.0,0.0,0.0,0.0,0.0,0.0,0.0,0.0,0.0,0.0,0.0,0.0,0.0,0.0,0.0,0.0,0.0,0.0,0.0,0.0,0.0,0.0,0.0,0.0,0.0,0.0,0.0,0.0,0.0,0.0,0.0,0.0,0.0,0.0,0.0,0.0,0.0,0.0,0.0,0.0,0.0,0.0,0.0,0.0,0.0,0.0,0.0,0.0,0.0,0.0,0.0,0.0,0.0,0.0,0.0,0.0,0.0,0.0,0.0,1.0,0.0,0.0,0.0,0.0,0.0,0.0,0.0,0.0,0.0,0.0,0.0,0.0,0.0,0.0
105784,0,0.0,0.0,0.0,1.0,1.0,180000.0,182448.0,21780.0,157500.0,0.009334,30.15890410958904,-1964.0,-10689.0,-2508.0,,3.0,2.0,2.0,15.0,0.4051595051881917,0.5567486968121161,0.2176285202779586,,,,,,,,,,,,,,,,,,,,,,,,,,,,,,,,,,,,,,,,,,,,,1.0,0.0,1.0,0.0,-390.0,0.0,0.0,0.0,0.0,0.0,4.0,1.0,1.0,0.0,1.0,0.0,0.0,0.0,0.0,0.0,0.0,0.0,0.0,0.0,1.0,0.0,0.0,0.0,0.0,0.0,0.0,0.0,0.0,0.0,0.0,0.0,0.0,0.0,0.0,0.0,0.0,0.0,0.0,4.0,9531.0,8240.265,132750.0,95437.485,0.0,0.0,0.0,0.0,-758.5,483.0,-77.5,-738.0,102.0,-15.5,2.0,5686.4025,55957.5,46467.0,22500.0,55957.5,3.0,-390.0,365243.0,182441.5,182516.5,182516.5,365243.0,13.0,0.5,0.3479079060474406,30.0,10.0,6.0,1.5,-8.5,0.0,0.0,6.0,9122.805,9122.805,-296.0,-285.0,3.5,1.0,10.0,0.0,90000.0,,0.0,,,0.0,,0.0,0.0,0.0,0.0,,0.0,,,0.0,-8.5,0.0,0.0,8359502152.5,184620752883.0,165782222154.0,52047327655.935,1863.0,1706.0,71127.0,71004.0,9141.0,506845.0,,,,,,,128602.0,663785.0,,,,13547223.756163985,-602805928.0,-923259559.0,-296956513.0,-1537454023.0416667,44095.0,30758.0,,,,,,,67591.99083171434,158269.11613845784,126296.12771757953,,,,,,,3719478.0,,,,,,,,,,,,,,,,437161.0,431949.0,,6434.329573002893,632877.0,626420.0,,,,,,,,,25.5,92016689.805,32353123.725000016,9637511600.609983,3185867475.5399976,112219360.19999996,866315.3399999995,187.0,24583.0,-31368648.5,14066972.0,-16276667.5,-17733138.0,-12.25,9531.0,8240.265,130500.0,95437.485,0.0,0.0,0.0,0.0,-1192.0,483.0,-129.0,-738.0,332386474.0050003,4732855116.840004,5310489744.720004,77400270.85499996,4732855116.840004,342330.0,-23754016.0,5523870505.5,243885468.5,1244694768.5,541495550.5,1310135628.5,341021.5,5318.0,972.5977479271912,7915916.0,2826566.0,1741409.0,-5699245.5,1936888.0,245634.0,3740881925.497527,3785934672.157529,-228673860.0,-226766249.0,4057432.5,188085.5,3480262546.6799545,9373374000.0,,447444503.0099998,,,197218989.5399989,,454199013.49499744,3341464869.690013,3467689365.82494,3467866988.924939,,39793.0,,,1142776.0,-2033393.5,814143.0,1883.0,1469606.0,14863769.0,3237258.0,8568604.0,11624733.0,1417994.0,1061763584.8545012,802287753.0524951,72217282781.63213,21708079358.58012,583497901.5569987,5792665.7475,689.5,94245.0,-277334872.5,21994851.0,-123960408.5,-219022939.0,-2026256.0,5929102563.389961,18752197500.0,,448445207.8124977,,,309424902.1874987,,459571843.8224992,5714055497.362535,5892346545.232497,5892589727.977499,,80974.5,,,972520.0,-1700986.5,177364.0,6755.0,4279565.0,2483120.0,-9016933.0,921848.5,37582.5,3739502692.169957,3664180752.569957,-261016122.0,-257699136.5,2530197.0,269630.0,3931993702.169953,33300641548.26092,36733691860.13265,1732533198.50255,48155654354.60322,3993919.5,-247943174.0,103241796154.5,1056868990.0,17296573606.0,3509135433.0,18911516771.5,3677501.0,72042.5,20903.32930687295,89881844.5,-65.1217296511628,1.0136,8.264462809917353,249.24714140156232,8.37685950413223,252.6369025246236,60000.0,-0.9009688679024191,-0.433883739117558,0.0,0.0,0.0,0.0,0.0,0.0,1.0,0.0,1.0,0.0,0.0,0.0,0.0,0.0,0.0,0.0,0.0,0.0,1.0,1.0,0.0,0.0,0.0,0.0,0.0,1.0,0.0,0.0,0.0,0.0,0.0,0.0,0.0,0.0,0.0,0.0,0.0,0.0,0.0,0.0,0.0,0.0,0.0,0.0,1.0,0.0,0.0,0.0,0.0,0.0,0.0,0.0,0.0,0.0,0.0,0.0,0.0,0.0,0.0,0.0,0.0,0.0,0.0,0.0,0.0,0.0,0.0,0.0,0.0,0.0,0.0,0.0,0.0,0.0,0.0,0.0,0.0,0.0,0.0,0.0,0.0,0.0,0.0,0.0,0.0,0.0,0.0,0.0,0.0,0.0,1.0,0.0,0.0,0.0,0.0,0.0,0.0,0.0,0.0,0.0,0.0,0.0,0.0,0.0,0.0,0.0,0.0,0.0,0.0,0.0,0.0,0.0,0.0,0.0,0.0,0.0,0.0,0.0,0.0,0.0
105791,0,0.0,0.0,0.0,0.0,0.0,274500.0,769500.0,32733.0,769500.0,0.010006,57.58356164383562,-4769.0,-1137.0,-1034.0,,2.0,2.0,2.0,11.0,0.6787219671794557,0.549673704143955,0.5620604831738043,0.133,0.1405,0.9791,0.7144,,0.0,0.2759,0.1667,0.2083,0.0432,0.1051,0.0857,0.0154,0.0406,0.1355,0.1458,0.9791,0.7256,,0.0,0.2759,0.1667,0.2083,0.0442,0.1148,0.0893,0.0156,0.043,0.1343,0.1405,0.9791,0.7182,,0.0,0.2759,0.1667,0.2083,0.044,0.1069,0.0872,0.0155,0.0414,0.0987,1.0,2.0,0.0,2.0,0.0,-659.0,0.0,0.0,0.0,0.0,0.0,2.0,1.0,1.0,0.0,1.0,1.0,0.0,0.0,0.0,0.0,0.0,0.0,0.0,0.0,0.0,0.0,1.0,0.0,0.0,0.0,0.0,0.0,0.0,0.0,0.0,0.0,0.0,0.0,0.0,0.0,0.0,0.0,0.0,7.0,0.0,,111361.5,0.0,0.0,0.0,0.0,0.0,-1369.0,-417.0,-388.0,-732.5,284.0,-22.0,4.0,7288.74,118095.75,124537.5,5017.5,118095.75,10.0,-481.0,365243.0,-444.5,182418.5,35.5,182421.5,11.5,0.5,0.1013974919536041,300.0,89.0,10.0,0.0,-46.0,0.0,0.0,28.0,9147.51,9147.51,-569.5,-541.0,5.0,1.0,9.0,0.0,0.0,,0.0,,,0.0,,0.0,0.0,0.0,0.0,,0.0,,,0.0,-5.0,0.0,0.0,8359534885.5,184621522383.0,165782991654.0,52047602155.935,1863.0,1706.0,71127.0,71004.0,9141.0,506847.0,17834.568200002315,17896.902899999128,17347.677499997993,11312.948000000097,11250.707300000096,11198.121400000064,128602.0,663787.0,,,,13547281.339725628,-602810697.0,-923260593.0,-296957172.0,-1537455160.0416667,44095.0,30758.0,11364.813999999193,11240.779999998987,10724.753899997288,22921.80260000983,22843.58050000979,22228.41430000835,67592.66955368152,158269.66581216195,126296.68977806268,35052.24060002804,34992.34800002848,34437.51120002889,22986.024199995874,22959.087299995448,22605.45559999569,3719489.0,8307.886700000165,8412.613100000079,8135.952100000232,9830.97030000072,9946.066000002154,10306.257599999632,16492.121499999717,16677.6987999997,16274.148399999694,829.4103000001771,814.5889000000459,760.5069000000129,3918.804200000124,3902.052500000162,3734.70900000016,437163.0,431951.0,,6434.339579002894,632879.0,626422.0,,16356.11269999979,154414.22829999082,154416.9703999904,154308.67189998718,77722.75559999635,78061.07670000657,78463.17150000669,46.0,92016689.805,,9644575526.549982,3186715541.174997,112592297.56499995,866315.3399999995,187.0,24583.0,-31402975.0,14058452.0,-16296153.0,-17749892.0,-22.5,0.0,,90000.0,0.0,0.0,0.0,0.0,0.0,-1435.0,-733.5,-689.0,-1049.0,332937285.97500026,4741857234.765004,5320150307.145004,77492772.85499996,4741857234.765004,342890.0,-23786164.5,5530444879.5,244409213.5,1245769579.5,542025605.0,1311211553.0,341441.0,5327.5,973.274538442326,7920865.0,2829112.0,1742748.0,-5708987.0,1936985.0,245731.0,3744347280.795023,3789211275.630023,-228918666.5,-227009361.5,4058492.0,188276.5,3480262546.6799545,9373621500.0,,447444503.0099998,,,197218989.5399989,,454199013.49499744,3341464869.690013,3467689365.82494,3467866988.924939,,39793.0,,,1142776.0,-2033465.0,814143.0,1883.0,1469613.0,14864053.0,3237267.0,8568693.0,11624761.0,1417998.0,1061763584.8545012,,72217394143.13213,21708079358.58012,583497901.5569987,5792665.7475,689.5,94245.0,-277336241.5,21994434.0,-123960796.5,-219023671.5,-2026278.0,5929102563.389961,18752197500.0,,448445207.8124977,,,309424902.1874987,,459571843.8224992,5714055497.362535,5892346545.232497,5892589727.977499,,80974.5,,,972520.0,-1700991.5,177364.0,6755.0,4279575.0,2483120.0,-9016979.0,921848.5,37582.5,3739511839.679957,3664189900.079958,-261016691.5,-257699677.5,2530202.0,269631.0,3932000990.909953,33300759644.01092,36733816397.63265,1732538216.00255,48155772450.35322,3993929.5,-247943655.0,103242161397.5,1056868545.5,17296756024.5,3509135468.5,18911699193.0,3677512.5,72043.0,20903.430704364902,89882144.5,-82.81877438386145,2.80327868852459,8.386032444322243,482.89761620483534,23.50838603244432,1353.6965962463416,137250.0,-0.9009688679024191,0.4338837391175582,1.0,0.0,0.0,0.0,0.0,0.0,0.0,0.0,0.0,0.0,0.0,0.0,0.0,1.0,0.0,0.0,0.0,0.0,1.0,1.0,0.0,0.0,0.0,0.0,0.0,1.0,0.0,0.0,0.0,0.0,0.0,0.0,0.0,0.0,0.0,0.0,0.0,0.0,0.0,0.0,0.0,0.0,0.0,0.0,1.0,0.0,0.0,0.0,0.0,0.0,0.0,0.0,0.0,0.0,0.0,0.0,0.0,0.0,0.0,0.0,0.0,0.0,0.0,0.0,0.0,0.0,0.0,0.0,0.0,0.0,0.0,0.0,0.0,0.0,0.0,0.0,0.0,0.0,0.0,0.0,0.0,0.0,0.0,0.0,0.0,0.0,0.0,0.0,0.0,0.0,1.0,0.0,0.0,0.0,0.0,0.0,0.0,0.0,0.0,0.0,0.0,0.0,0.0,0.0,0.0,0.0,0.0,0.0,1.0,0.0,1.0,0.0,0.0,1.0,0.0,0.0,0.0,0.0,0.0,0.0
105802,0,0.0,0.0,0.0,1.0,0.0,180000.0,601470.0,30838.5,450000.0,0.0196889999999999,27.63561643835617,-417.0,-4781.0,-2757.0,,1.0,2.0,2.0,13.0,0.0539102982601882,0.4834596281088239,0.6528965519806539,0.0918,0.0269,0.9846,0.7892,0.0,0.0,0.069,0.1667,0.2083,0.0,0.0748,0.0654,0.0154,0.0187,0.0935,0.0279,0.9846,0.7975,0.0,0.0,0.069,0.1667,0.2083,0.0,0.0817,0.0681,0.0156,0.0198,0.0926,0.0269,0.9846,0.792,0.0,0.0,0.069,0.1667,0.2083,0.0,0.0761,0.0665,0.0155,0.0191,0.0772,1.0,1.0,1.0,1.0,1.0,-1916.0,0.0,0.0,0.0,0.0,0.0,1.0,1.0,1.0,0.0,1.0,0.0,0.0,0.0,0.0,0.0,0.0,0.0,0.0,0.0,1.0,0.0,0.0,0.0,0.0,0.0,0.0,0.0,0.0,0.0,0.0,0.0,0.0,0.0,0.0,0.0,0.0,0.0,0.0,10.0,0.0,,42653.25,0.0,0.0,0.0,0.0,0.0,-1413.0,-709.0,-11.0,-863.0,482.0,-24.0,4.0,3256.02,33635.25,31065.75,5240.25,33635.25,10.0,-1701.0,365243.0,-1878.0,-1188.0,-1188.0,-1184.0,14.0,0.0,0.190757523860535,30.5,41.0,24.0,7.0,-54.0,0.0,0.0,38.0,3145.995,3145.995,-1638.5,-1623.0,8.0,1.0,0.0,,,,,,,,,,,,,,,,,,,,,8359565724.0,184622123853.0,165783441654.0,52047782155.935,1863.0,1706.0,71127.0,71004.0,9141.0,506848.0,17834.660000002314,17896.995499999128,17347.770999997992,11312.974900000096,11250.734200000095,11198.149300000065,128602.0,663788.0,4143.687300000114,4141.373800000012,3951.840200000093,13547308.975342069,-602811114.0,-923263350.0,-296959088.0,-1537459941.0416667,44096.0,30759.0,11364.813999999193,11240.779999998987,10724.753899997288,22921.87160000983,22843.64950000979,22228.48330000835,67592.72346397978,158270.14927179003,126297.34267461469,35052.40730002804,34992.51470002848,34437.67790002889,22986.232499995876,22959.29559999545,22605.663899995685,3719502.0,8307.886700000165,8412.613100000079,8135.952100000232,9831.04510000072,9946.142100002156,10306.339299999632,16492.186899999717,16677.7652999997,16274.216499999697,829.4257000001771,814.604400000046,760.522500000013,3918.822900000124,3902.0716000001626,3734.72880000016,437164.0,431952.0,,6434.359268002893,632881.0,626424.0,,16356.18989999979,154415.21289999082,154417.95499999038,154309.65649998718,77723.54479999635,78061.86870000657,78463.96900000669,47.0,92058409.305,,9653645539.799982,3187818739.1249967,112592297.56499995,866315.3399999995,188.0,24583.0,-31455779.5,14110476.0,-16316422.5,-17774714.0,-23.0,0.0,,40306.5,0.0,0.0,0.0,0.0,0.0,-1413.0,-752.0,-11.0,-1909.0,333661233.3750004,4751114026.815004,5329854453.195004,77680242.85499996,4751114026.815004,343410.0,-23817255.0,5540489029.0,244748073.0,1249587216.0,542376809.0,1315030205.0,341924.0,5341.0,975.4884401639476,7934713.5,2835513.0,1746546.0,-5719937.0,1936999.0,245745.0,3752621017.717515,3797677138.612513,-229354005.5,-227442752.0,4066090.0,188601.5,,,,,,,,,,,,,,,,,,,,,1469623.0,14864535.0,3237267.0,8568734.0,11624799.0,1418002.0,1061763584.8545012,,72217436796.38213,21708079358.58012,583497901.5569987,5792665.7475,689.5,94245.0,-277337654.5,21993725.0,-123960807.5,-219024534.5,-2026302.0,,,,,,,,,,,,,,,,,,,,,4279599.0,2483127.0,-9017033.0,921848.5,37582.5,3739514985.674957,3664193046.074957,-261018330.0,-257701300.5,2530210.0,269632.0,3932004246.929953,33300793279.26092,36733847463.38265,1732543456.25255,48155806085.60322,3993939.5,-247945356.0,103242526640.5,1056866667.5,17296754836.5,3509134280.5,18911698009.0,3677526.5,72043.0,20903.621461888764,89882175.0,-15.089223753345893,3.3415,5.836859769444039,161.30521779282742,19.50386691959725,539.0013852547329,180000.0,1.0,0.0,0.0,0.0,0.0,0.0,0.0,0.0,1.0,0.0,1.0,0.0,0.0,0.0,0.0,0.0,0.0,0.0,0.0,0.0,1.0,0.0,0.0,0.0,1.0,0.0,0.0,1.0,0.0,0.0,0.0,0.0,0.0,0.0,0.0,1.0,0.0,0.0,0.0,0.0,0.0,0.0,0.0,0.0,0.0,0.0,0.0,0.0,0.0,0.0,0.0,0.0,0.0,0.0,0.0,0.0,0.0,0.0,0.0,0.0,0.0,0.0,0.0,0.0,0.0,0.0,0.0,0.0,0.0,0.0,0.0,0.0,0.0,0.0,0.0,0.0,0.0,0.0,0.0,0.0,0.0,0.0,1.0,0.0,0.0,0.0,0.0,0.0,0.0,0.0,0.0,0.0,0.0,0.0,0.0,0.0,0.0,0.0,0.0,0.0,0.0,0.0,0.0,0.0,0.0,0.0,0.0,0.0,0.0,0.0,1.0,0.0,1.0,0.0,0.0,0.0,0.0,0.0,0.0,0.0,1.0,0.0
105807,0,0.0,1.0,0.0,1.0,0.0,112500.0,332946.0,17127.0,238500.0,0.0066709999999999,33.42465753424658,-340.0,-29.0,-4639.0,,2.0,2.0,2.0,19.0,,0.1531673728344253,0.6397075677637197,0.0619,0.0759,0.9901,,,0.0,0.1379,0.1667,,0.0,,0.0354,,0.0769,0.063,0.0787,0.9901,,,0.0,0.1379,0.1667,,0.0,,0.0368,,0.0815,0.0625,0.0759,0.9901,,,0.0,0.1379,0.1667,,0.0,,0.036,,0.0786,0.0481,1.0,1.0,0.0,1.0,0.0,0.0,0.0,0.0,0.0,0.0,0.0,4.0,1.0,1.0,0.0,1.0,0.0,1.0,0.0,0.0,0.0,0.0,1.0,1.0,0.0,1.0,0.0,0.0,0.0,0.0,0.0,0.0,0.0,0.0,0.0,0.0,0.0,0.0,0.0,0.0,0.0,0.0,0.0,0.0,6.0,19291.5,0.0,513607.5,372145.5,0.0,0.0,0.0,0.0,-665.0,339.5,-564.5,-846.5,163.0,-13.0,5.0,8610.3225,53280.0,49734.0,5872.5,56002.5,11.0,-1273.0,365243.0,-1484.0,-1244.0,-1214.0,-1235.5,7.0,0.0,0.1089090909090909,25.0,43.0,14.0,7.0,-36.0,0.0,0.0,39.0,10776.645,10776.645,-1066.0,-1057.0,5.0,1.0,0.0,,,,,,,,,,,,,,,,,,,,,8359582851.0,184622456799.0,165783680154.0,52047894655.935,1863.0,1706.0,71127.0,71004.0,9141.0,506852.0,17834.721900002314,17897.057999999128,17347.83399999799,11313.050800000095,11250.810100000095,11198.228000000065,128602.0,663790.0,,,,13547342.399999602,-602811454.0,-923267989.0,-296959088.0,-1537459970.0416667,44096.0,30759.0,11364.813999999193,11240.779999998987,10724.753899997288,22922.00950000983,22843.78740000979,22228.62120000835,,158270.3024391629,126297.98238218244,35052.574000028035,34992.68140002848,34437.84460002889,,,,3719521.0,8307.886700000165,8412.613100000079,8135.952100000232,,,,16492.222299999718,16677.8012999997,16274.253299999697,,,,3918.899800000124,3902.150200000162,3734.81030000016,437165.0,431953.0,,6434.365939002893,632883.0,626426.0,,16356.23799999979,154416.2029999908,154418.94509999038,154310.64659998714,,,,22.5,92096992.305,32518290.06000001,9659675851.469982,3190866609.4199967,112740797.56499995,866315.3399999995,189.0,24583.0,-31500717.0,14155424.0,-16340458.5,-17800534.0,-10.75,19291.5,0.0,291465.0,113400.0,0.0,0.0,0.0,0.0,-1085.0,-899.0,-898.0,-899.0,333997492.7475003,4758162043.815004,5337599664.195004,77710883.35499996,4758191406.315004,343789.0,-23830111.0,5543958837.5,244740026.5,1249947203.5,542373367.5,1315390241.0,342121.0,5343.0,975.9741577669048,7935570.0,2837596.0,1747931.0,-5722321.0,1936999.0,245745.0,3755828267.775011,3800985377.67001,-229420933.0,-227508502.0,4066776.0,188703.0,,,,,,,,,,,,,,,,,,,,,1469629.0,14864698.0,3237267.0,8568777.0,11624838.0,1418007.0,1061782876.3545012,802287753.0524951,72217950403.88213,21708451504.08012,583497901.5569987,5792665.7475,689.5,94245.0,-277338319.5,21994064.5,-123961372.0,-219025381.0,-2026315.0,,,,,,,,,,,,,,,,,,,,,4279613.0,2483134.0,-9017069.0,921848.5,37582.5,3739525762.319957,3664203822.719957,-261019396.0,-257702357.5,2530215.0,269633.0,3932012857.252453,33300846559.26092,36733897197.38265,1732549328.75255,48155862088.10322,3993950.5,-247946629.0,103242891883.5,1056865183.5,17296753592.5,3509133066.5,18911696773.5,3677533.5,72043.0,20903.730370979672,89882200.0,-10.172131147540982,2.95952,6.568575932737782,219.55240103945465,19.439831844456123,649.7697219242867,56250.0,-0.9009688679024191,0.4338837391175582,0.0,0.0,0.0,0.0,0.0,1.0,0.0,0.0,0.0,0.0,0.0,0.0,0.0,1.0,0.0,0.0,0.0,0.0,1.0,0.0,1.0,0.0,0.0,0.0,0.0,1.0,0.0,0.0,0.0,0.0,0.0,0.0,0.0,0.0,0.0,0.0,0.0,0.0,1.0,0.0,0.0,0.0,0.0,0.0,0.0,0.0,0.0,0.0,0.0,0.0,0.0,0.0,0.0,1.0,0.0,0.0,0.0,0.0,0.0,0.0,0.0,0.0,0.0,0.0,0.0,0.0,0.0,0.0,0.0,0.0,0.0,0.0,0.0,0.0,0.0,0.0,0.0,0.0,0.0,0.0,0.0,0.0,0.0,0.0,0.0,0.0,0.0,0.0,0.0,0.0,0.0,0.0,0.0,0.0,0.0,0.0,0.0,0.0,0.0,0.0,0.0,0.0,0.0,0.0,0.0,0.0,0.0,0.0,0.0,0.0,1.0,0.0,0.0,1.0,0.0,0.0,0.0,0.0,0.0,0.0
105809,0,0.0,0.0,1.0,1.0,0.0,148500.0,407520.0,25060.5,360000.0,0.0116569999999999,56.38082191780822,-2281.0,-6725.0,-3168.0,15.0,2.0,1.0,1.0,11.0,,0.723969262961902,,0.0062,0.0167,0.9513,0.3336,0.0008,0.0,0.0345,0.0417,0.0833,0.0,0.005,0.006,0.0,0.0,0.0063,0.0173,0.9513,0.3597,0.0008,0.0,0.0345,0.0417,0.0833,0.0,0.0055,0.0062,0.0,0.0,0.0062,0.0167,0.9513,0.3425,0.0008,0.0,0.0345,0.0417,0.0833,0.0,0.0051,0.0061,0.0,0.0,0.0051,1.0,0.0,0.0,0.0,0.0,-1904.0,0.0,0.0,0.0,0.0,0.0,1.0,1.0,1.0,1.0,1.0,0.0,0.0,0.0,1.0,1.0,0.0,1.0,1.0,0.0,1.0,0.0,0.0,0.0,0.0,0.0,0.0,0.0,0.0,0.0,0.0,0.0,0.0,0.0,0.0,0.0,0.0,0.0,0.0,11.0,3600.0,25722.675,571725.0,0.0,36000.0,0.0,0.0,0.0,-1002.0,-24.5,-712.0,-714.0,379.0,-18.0,2.0,16673.872499999998,151222.5,183498.75,1622.25,151222.5,12.0,-2138.5,365243.0,-2337.0,-2187.0,-2187.0,-1913.0,11.5,0.0,0.0521334846271773,54.0,17.0,6.0,0.0,-70.0,0.0,0.0,7.0,6248.52,6248.52,-2262.0,-2247.0,4.0,1.0,0.0,,,,,,,,,,,,,,,,,,,,,8359607911.5,184622864319.0,165784040154.0,52048043155.935,1863.0,1706.0,71127.0,71004.0,9141.0,506853.0,17834.728100002314,17897.064199999128,17347.84029999799,11313.067500000096,11250.826800000095,11198.245300000064,128602.0,663792.0,4143.688100000114,4141.374600000012,3951.8410000000927,13547398.78082152,-602813735.0,-923271157.0,-296960992.0,-1537466695.0416667,44096.0,30759.0,11364.813999999193,11240.779999998987,10724.753899997288,22922.044000009828,22843.82190000979,22228.65570000835,,158271.02640842585,,35052.615700028044,34992.72310002848,34437.886300028884,22986.315799995868,22959.37889999545,22605.747199995683,3719532.0,8307.886700000165,8412.613100000079,8135.952100000232,9831.05010000072,9946.147200002157,10306.344799999632,16492.22829999972,16677.8073999997,16274.259499999696,829.4257000001771,814.604400000046,760.522500000013,3918.899800000124,3902.150200000162,3734.81030000016,437165.0,431953.0,1264889.0,6434.377596002893,632884.0,626427.0,,16356.24309999979,154417.1542999908,154419.89639999036,154311.59789998716,77723.87839999635,78062.21120000657,78464.32870000669,33.0,92160941.805,32544012.73500001,9663817633.469982,3192371857.1699967,112776797.56499995,866315.3399999995,189.0,24583.0,-31511369.0,14153807.5,-16348265.0,-17805267.0,-16.0,5031.0,25722.675,571725.0,0.0,36000.0,0.0,0.0,0.0,-1191.0,-461.0,-930.0,-1097.0,334075745.7900003,4758733116.315004,5338240896.195004,77712505.60499996,4758733116.315004,343827.0,-23838707.5,5545237188.0,244733380.0,1249941112.0,542367306.0,1315384436.0,342185.5,5344.0,976.0262912515316,7940956.5,2837872.0,1748069.0,-5724423.0,1937147.0,245745.0,3756225934.21501,3801383044.110009,-229468730.0,-227555911.0,4066904.0,188734.0,,,,,,,,,,,,,,,,,,,,,1469640.0,14865077.0,3237267.0,8568794.0,11624845.0,1418009.0,1061786476.3545012,802313475.7274951,72218522128.88213,21708451504.08012,583533901.5569987,5792665.7475,689.5,94245.0,-277339321.5,21994040.0,-123962084.0,-219026095.0,-2026333.0,,,,,,,,,,,,,,,,,,,,,4279619.0,2483134.0,-9017139.0,921848.5,37582.5,3739532010.839957,3664210071.239957,-261021658.0,-257704604.5,2530219.0,269634.0,3932029531.124953,33300997781.76092,36734080696.13265,1732550951.00255,48156013310.60322,3993962.5,-247948767.5,103243257126.5,1056862846.5,17296751405.5,3509130879.5,18911694860.5,3677545.0,72043.0,20903.7825044643,89882254.0,-40.45701929151076,2.744242424242424,5.925659903034656,334.0935757384937,16.261447297539956,916.8337642084238,74250.0,0.6234898018587336,0.7818314824680298,0.0,0.0,0.0,0.0,0.0,0.0,1.0,0.0,0.0,0.0,1.0,0.0,0.0,0.0,0.0,0.0,0.0,0.0,1.0,0.0,1.0,0.0,0.0,0.0,0.0,1.0,0.0,0.0,0.0,0.0,0.0,0.0,0.0,0.0,0.0,0.0,0.0,0.0,0.0,0.0,0.0,0.0,0.0,0.0,0.0,0.0,0.0,1.0,0.0,0.0,0.0,0.0,0.0,0.0,0.0,0.0,0.0,0.0,0.0,0.0,0.0,0.0,0.0,0.0,0.0,0.0,0.0,0.0,0.0,0.0,0.0,0.0,0.0,0.0,0.0,0.0,0.0,0.0,0.0,0.0,0.0,1.0,0.0,0.0,0.0,0.0,0.0,0.0,0.0,0.0,0.0,0.0,0.0,0.0,0.0,0.0,0.0,0.0,0.0,0.0,0.0,0.0,0.0,0.0,0.0,0.0,0.0,0.0,1.0,0.0,1.0,0.0,0.0,0.0,0.0,0.0,0.0,0.0,0.0,1.0
105816,0,0.0,0.0,0.0,0.0,0.0,135000.0,964575.0,31113.0,675000.0,0.018209,52.81917808219178,-3692.0,-8595.0,-2814.0,,2.0,3.0,3.0,8.0,,0.5280558256986227,0.5814837058057234,0.1113,0.0841,0.9871,0.8232,0.1911,0.12,0.1034,0.3333,0.0417,0.0146,0.0908,0.1174,0.0,0.0557,0.1134,0.0873,0.9871,0.8301,0.1928,0.1208,0.1034,0.3333,0.0417,0.0149,0.0992,0.1223,0.0,0.059,0.1124,0.0841,0.9871,0.8256,0.1923,0.12,0.1034,0.3333,0.0417,0.0149,0.0923,0.1195,0.0,0.0569,0.1045,1.0,1.0,0.0,1.0,0.0,-191.0,0.0,0.0,0.0,0.0,1.0,2.0,1.0,1.0,1.0,1.0,1.0,0.0,0.0,0.0,0.0,0.0,0.0,0.0,0.0,1.0,0.0,0.0,0.0,0.0,0.0,0.0,0.0,0.0,0.0,0.0,0.0,0.0,0.0,0.0,0.0,0.0,0.0,0.0,3.0,8523.0,,63360.0,271161.0,0.0,0.0,0.0,0.0,-1690.0,-1597.0,-1210.0,-1405.0,143.0,-32.0,5.0,4066.29,97623.0,87259.5,10363.5,140908.5,12.0,-2530.0,365243.0,-1900.5,-1157.0,275.5,-619.0,14.0,0.5,0.1156161318169246,1500.0,25.0,10.0,6.0,-44.0,0.0,0.0,122.0,2250.0,2250.0,-1445.0,-1437.5,39.5,0.0,81.0,67.5,45000.0,0.0,0.0,0.0,0.0,79.0875,484.11,0.0,0.0,0.0,0.0,0.0,0.0,0.0,0.0,40.5,-43.0,0.0,0.0,8359639024.5,184623828894.0,165784715154.0,52048178155.935,1863.0,1706.0,71127.0,71005.0,9141.0,506855.0,17834.839400002318,17897.17659999913,17347.95369999799,11313.151600000096,11250.910900000095,11198.332600000063,128602.0,663794.0,4143.879200000114,4141.5669000000125,3952.033800000093,13547451.5999996,-602817427.0,-923273971.0,-296961183.0,-1537475290.0416667,44096.0,30759.0,11364.933999999192,11240.899999998986,10724.874699997288,22922.147400009828,22843.92530000979,22228.75910000835,,158271.55446425153,126298.56386588824,35052.949000028035,34993.05640002848,34438.21960002889,22986.357499995876,22959.42059999545,22605.788899995685,3719540.0,8307.901300000165,8412.628000000079,8135.967000000232,9831.14090000072,9946.239500002155,10306.443999999632,16492.345699999718,16677.9268999997,16274.381799999695,829.4257000001771,814.604400000046,760.522500000013,3918.955500000124,3902.2071000001615,3734.86930000016,437166.0,431954.0,,6434.395805002893,632887.0,626430.0,,16356.34759999979,154418.1413999908,154420.88349999036,154312.58499998716,77724.70159999635,78063.03680000658,78465.1588000067,56.0,92329291.305,,9673775179.469982,3193087843.1699967,112776797.56499995,866315.3399999995,189.0,24583.0,-31534461.0,14176220.0,-16360631.0,-17819783.5,-27.5,0.0,,63360.0,271161.0,0.0,0.0,0.0,0.0,-2427.0,-1882.0,-1210.0,-1213.0,334285764.3000004,4762771336.890004,5342639112.495005,77845739.12999997,4762787527.890004,344080.0,-23855483.0,5549434424.5,245452319.0,1251394108.0,543459611.5,1316838592.5,342526.0,5348.5,977.3505047061626,7942902.0,2839733.0,1749358.0,-5728004.0,1938080.0,245747.0,3757890914.325014,3803027952.555013,-229619647.0,-227705948.0,4070396.0,188832.0,3484994639.849954,9387616500.0,292889046.375,447629129.23499984,13459095.540000005,140823061.875,197521907.71499896,492841366.3349951,454564447.6049975,3346013249.235013,3472422245.639939,3472601128.739938,15112.0,39808.0,198.0,24498.0,1148070.5,-2039947.0,814151.0,1890.0,1469643.0,14865220.0,3237348.0,8568819.0,11624967.0,1418014.0,1061794999.3545012,,72218585488.88213,21708722665.08012,583533901.5569987,5792665.7475,689.5,94245.0,-277341011.5,21992443.0,-123963294.0,-219027500.0,-2026365.0,5929102630.889961,18752242500.0,198923232.825,448445207.8124977,1948107.735,257088950.66250083,309424981.27499866,637160435.5049977,459571843.8224992,5714055497.362535,5892346545.232497,5892589727.977499,13396.0,80974.5,44.0,70474.5,972560.5,-1701034.5,177364.0,6755.0,4279629.0,2483140.0,-9017183.0,921848.5,37582.5,3739534260.839957,3664212321.239957,-261023103.0,-257706042.0,2530258.5,269634.0,3932033597.414953,33301095404.76092,36734167955.63265,1732561314.50255,48156154219.10322,3993974.5,-247951297.5,103243622369.5,1056860946.0,17296750248.5,3509131155.0,18911694241.5,3677559.0,72043.5,20903.89812059612,89883754.0,-69.89885367498314,7.145,4.339022273647672,229.18359017439303,31.00231414521261,1637.5167517960383,67500.0,0.6234898018587336,0.7818314824680298,0.0,0.0,0.0,0.0,0.0,0.0,1.0,0.0,0.0,0.0,0.0,0.0,0.0,1.0,0.0,0.0,0.0,0.0,1.0,1.0,0.0,0.0,0.0,0.0,0.0,1.0,0.0,0.0,0.0,0.0,1.0,0.0,0.0,0.0,0.0,0.0,0.0,0.0,0.0,0.0,0.0,0.0,0.0,0.0,0.0,0.0,0.0,0.0,0.0,0.0,0.0,0.0,0.0,0.0,0.0,0.0,0.0,0.0,0.0,0.0,0.0,0.0,0.0,0.0,0.0,0.0,0.0,0.0,0.0,0.0,0.0,0.0,0.0,0.0,0.0,0.0,0.0,0.0,0.0,0.0,0.0,0.0,0.0,0.0,0.0,0.0,0.0,0.0,0.0,0.0,1.0,0.0,0.0,0.0,0.0,0.0,0.0,0.0,0.0,0.0,0.0,0.0,0.0,0.0,0.0,0.0,0.0,0.0,1.0,0.0,1.0,0.0,0.0,0.0,0.0,0.0,0.0,1.0,0.0,0.0
105817,0,0.0,0.0,1.0,0.0,0.0,315000.0,732915.0,77089.5,675000.0,0.02461,27.315068493150694,-617.0,-547.0,-536.0,4.0,2.0,2.0,2.0,12.0,0.4327116887616269,0.7471768824822509,0.4382813743111921,0.1433,0.1362,0.9757,0.6668,0.0168,0.0,0.2414,0.1667,0.2083,0.111,0.1168,0.1194,0.0,0.0,0.146,0.1413,0.9757,0.6798,0.0169,0.0,0.2414,0.1667,0.2083,0.1136,0.1276,0.1244,0.0,0.0,0.1447,0.1362,0.9757,0.6713,0.0169,0.0,0.2414,0.1667,0.2083,0.113,0.1189,0.1216,0.0,0.0,0.0939,1.0,1.0,0.0,1.0,0.0,-1825.0,0.0,0.0,0.0,0.0,1.0,4.0,1.0,1.0,0.0,1.0,1.0,1.0,0.0,0.0,0.0,0.0,0.0,0.0,0.0,1.0,0.0,0.0,0.0,0.0,0.0,0.0,0.0,0.0,0.0,0.0,0.0,0.0,0.0,0.0,0.0,0.0,0.0,0.0,2.0,0.0,,498375.0,0.0,0.0,0.0,0.0,0.0,-604.5,403.0,-119.5,-281.0,40.0,-9.5,6.0,23748.03,80788.5,75456.0,9085.5,136710.0,6.0,-678.5,365243.0,-871.0,-811.0,-721.0,-808.0,14.0,0.0,0.1466872517224179,150.0,18.0,6.0,5.0,-28.5,0.0,0.0,17.0,23748.03,23748.03,-878.0,-871.0,3.0,1.0,0.0,,,,,,,,,,,,,,,,,,,,,8359716114.0,184624561809.0,165785390154.0,52048493155.935,1863.0,1706.0,71127.0,71006.0,9141.0,506859.0,17834.982700002314,17897.32129999913,17348.09969999799,11313.287800000098,11251.047100000098,11198.473900000065,128602.0,663796.0,4143.896000000114,4141.583800000011,3952.050700000093,13547478.915068096,-602818044.0,-923274507.0,-296963008.0,-1537475837.0416667,44096.0,30759.0,11364.933999999192,11240.899999998986,10724.874699997288,22922.38880000983,22844.16670000979,22229.00050000835,67593.15617566854,158272.30164113405,126299.00214726257,35053.115700028044,34993.22310002848,34438.386300028884,22986.565799995868,22959.62889999545,22605.997199995683,3719552.0,8308.012300000166,8412.741000000078,8136.080600000232,9831.25770000072,9946.358400002156,10306.571599999632,16492.465099999717,16678.0484999997,16274.506199999694,829.4257000001771,814.604400000046,760.522500000013,3918.955500000124,3902.2071000001615,3734.86930000016,437167.0,431955.0,1264893.0,6434.420415002895,632889.0,626432.0,,16356.44149999979,154419.1170999908,154421.85919999034,154313.56069998714,77725.36839999635,78063.70810000657,78465.8386000067,20.0,92329291.305,,9674786914.469982,3193087843.1699967,112776797.56499995,866315.3399999995,189.0,24583.0,-31537719.5,14175215.0,-16362011.5,-17820881.5,-9.5,0.0,,96750.0,0.0,0.0,0.0,0.0,0.0,-755.0,-142.0,-137.0,-141.0,334383593.7150004,4763876563.890004,5343755260.995005,77867438.12999997,4763876563.890004,344132.0,-23864391.0,5550712775.0,245447163.0,1251389537.0,543456366.0,1316834046.0,342602.5,5351.0,977.7075116470144,7949971.0,2839996.0,1749531.5,-5729212.5,1938080.0,245747.0,3760420280.805015,3805551572.8950143,-229719875.0,-227805482.0,4072470.0,188866.0,,,,,,,,,,,,,,,,,,,,,1469645.0,14865260.0,3237348.0,8568837.0,11624984.0,1418020.0,1061794999.3545012,,72219083863.88213,21708722665.08012,583533901.5569987,5792665.7475,689.5,94245.0,-277341616.0,21992846.0,-123963413.5,-219027781.0,-2026374.5,,,,,,,,,,,,,,,,,,,,,4279635.0,2483145.0,-9017211.5,921848.5,37582.5,3739558008.869957,3664236069.269958,-261023981.0,-257706913.0,2530261.5,269635.0,3932057345.444953,33301176193.26092,36734243411.63265,1732570400.00255,48156290929.10322,3993980.5,-247951976.0,103243987612.5,1056860075.0,17296749437.5,3509130434.0,18911693433.5,3677573.0,72043.5,20904.04480784784,89883904.0,-22.588264794383143,2.326714285714285,4.086159593718989,111.61372917637895,9.507325900414452,259.6932581565263,157500.0,-0.2225209339563143,0.9749279121818236,0.0,0.0,0.0,0.0,0.0,0.0,1.0,0.0,1.0,0.0,0.0,0.0,0.0,0.0,0.0,1.0,0.0,0.0,0.0,0.0,1.0,0.0,0.0,0.0,0.0,1.0,0.0,0.0,0.0,0.0,0.0,0.0,0.0,0.0,0.0,0.0,0.0,0.0,0.0,0.0,0.0,0.0,1.0,0.0,0.0,0.0,0.0,0.0,0.0,0.0,0.0,0.0,0.0,1.0,0.0,0.0,0.0,0.0,0.0,0.0,0.0,0.0,0.0,0.0,0.0,0.0,0.0,0.0,0.0,0.0,0.0,0.0,0.0,0.0,0.0,0.0,0.0,0.0,0.0,0.0,0.0,0.0,0.0,0.0,0.0,0.0,0.0,0.0,0.0,0.0,0.0,0.0,0.0,0.0,0.0,0.0,0.0,0.0,0.0,0.0,0.0,0.0,0.0,0.0,0.0,0.0,0.0,0.0,0.0,0.0,1.0,0.0,0.0,0.0,0.0,0.0,0.0,1.0,0.0,0.0
105824,0,0.0,1.0,1.0,1.0,2.0,360000.0,280170.0,28836.0,247500.0,0.020246,45.38082191780822,-852.0,-3883.0,-96.0,12.0,4.0,3.0,3.0,7.0,,0.4644397306311482,0.524496446363472,,,,,,,,,,,,,,,,,,,,,,,,,,,,,,,,,,,,,,,,,,,,,0.0,0.0,0.0,0.0,-699.0,0.0,0.0,0.0,0.0,0.0,0.0,1.0,1.0,0.0,1.0,0.0,0.0,0.0,0.0,0.0,0.0,0.0,0.0,0.0,1.0,0.0,0.0,0.0,0.0,0.0,0.0,0.0,0.0,0.0,0.0,0.0,0.0,0.0,0.0,0.0,0.0,0.0,0.0,2.0,,0.0,103776.75,0.0,0.0,0.0,0.0,0.0,-2629.0,-2261.5,-2257.0,-2258.0,174.0,-43.0,3.0,26570.115,270000.0,270000.0,0.0,331200.0,6.0,-379.0,182432.0,-500.5,-274.0,182453.0,-273.5,11.0,0.0,0.0,-1.0,12.0,11.0,5.5,-17.5,0.0,0.0,25.0,39640.23,39640.23,-355.0,-355.0,7.0,0.0,11.0,6282.0,270000.0,0.0,0.0,0.0,0.0,2250.0,4500.0,19.755,0.0,0.0,0.0,0.0,0.0,0.0,0.0,4.0,-8.0,0.0,0.0,8359744950.0,184624841979.0,165785637654.0,52048853155.935,1863.0,1706.0,71127.0,71006.0,9141.0,506859.0,,,,,,,128604.0,663800.0,,,,13547524.29589001,-602818896.0,-923274603.0,-296963707.0,-1537479720.0416667,44096.0,30759.0,,,,,,,,158272.76608086468,126299.52664370892,,,,,,,3719559.0,,,,,,,,,,,,,,,,437167.0,431955.0,1264905.0,6434.440661002895,632892.0,626435.0,,,,,,,,,87.0,,32552936.82000001,9689438553.659985,3195437514.7499967,112965360.02999996,866315.3399999995,191.0,24583.0,-31586210.5,14183829.5,-16386159.5,-17846334.0,-43.0,,0.0,106573.5,0.0,0.0,0.0,0.0,0.0,-2731.0,-2183.0,-2141.0,-2142.0,334749251.70000035,4769546514.390004,5349421800.495005,77982350.12999997,4769350314.390004,344407.0,-23894254.0,5557834615.5,246523585.5,1253200162.5,544540030.5,1318279481.0,343077.0,5359.0,979.9151273950796,7956651.0,2842354.5,1751042.5,-5734937.5,1938157.0,245751.0,3763928429.640017,3809829917.880016,-229908933.0,-227993182.0,4073479.0,189061.0,3486267044.4599533,9402016500.0,293024046.375,447764376.0599998,13459095.540000005,140823308.7,197588233.84499896,493225442.63999534,454926157.9199975,3347232190.965012,3473689240.034938,3473868123.1349373,15115.0,39812.0,198.0,24499.0,1149214.0,-2042204.0,814151.0,1890.0,1469647.0,14865434.0,3237359.0,8568849.0,11625009.0,1418023.0,,802313475.7274951,72219187640.63213,21708722665.08012,583533901.5569987,5792665.7475,689.5,94245.0,-277344245.0,21990584.5,-123965670.5,-219030039.0,-2026417.5,5929108912.889961,18752512500.0,198923232.825,448445207.8124977,1948107.735,257088950.66250083,309427231.27499866,637164935.5049977,459571863.5774992,5714055497.362535,5892346545.232497,5892589727.977499,13396.0,80974.5,44.0,70474.5,972564.5,-1701042.5,177364.0,6755.0,4279646.0,2483150.5,-9017229.0,921848.5,37582.5,3739597649.099958,3664275709.499958,-261024336.0,-257707268.0,2530268.5,269635.0,3932083915.559953,33301446193.26092,36734513411.63265,1732570400.00255,48156622129.10322,3993986.5,-247952355.0,103244170044.5,1056859574.5,17296749163.5,3509312887.0,18911693160.0,3677584.0,72043.5,20904.04480784784,89883903.0,-18.774450615793285,0.77825,12.484394506866414,566.552083867768,9.715980024968788,440.91915927009046,90000.0,-0.2225209339563143,0.9749279121818236,0.0,0.0,0.0,0.0,0.0,0.0,1.0,0.0,0.0,0.0,0.0,0.0,0.0,1.0,0.0,0.0,0.0,0.0,1.0,0.0,1.0,0.0,0.0,0.0,0.0,1.0,0.0,0.0,0.0,0.0,0.0,0.0,0.0,0.0,1.0,0.0,0.0,0.0,0.0,0.0,0.0,0.0,0.0,0.0,0.0,0.0,0.0,0.0,0.0,0.0,0.0,0.0,0.0,0.0,0.0,0.0,0.0,0.0,0.0,0.0,0.0,0.0,0.0,0.0,0.0,0.0,0.0,0.0,0.0,0.0,0.0,0.0,0.0,0.0,0.0,0.0,0.0,0.0,0.0,0.0,0.0,0.0,0.0,0.0,0.0,0.0,0.0,0.0,0.0,0.0,1.0,0.0,0.0,0.0,0.0,0.0,0.0,0.0,0.0,0.0,0.0,0.0,0.0,0.0,0.0,0.0,0.0,0.0,0.0,0.0,0.0,0.0,0.0,0.0,0.0,0.0,0.0,0.0,0.0,0.0
105832,0,0.0,1.0,0.0,1.0,0.0,112500.0,130320.0,13482.0,112500.0,0.018634,27.03287671232877,-428.0,-5859.0,-2031.0,,1.0,2.0,2.0,18.0,,0.6267685446705719,0.4596904504249018,,,0.9776,,,0.0,0.0345,0.1667,,,,0.0614,,0.0,,,0.9777,,,0.0,0.0345,0.1667,,,,0.0639,,0.0,,,0.9776,,,0.0,0.0345,0.1667,,,,0.0625,,0.0,0.0483,1.0,0.0,0.0,0.0,0.0,-851.0,0.0,0.0,0.0,0.0,0.0,0.0,1.0,1.0,0.0,1.0,0.0,0.0,0.0,0.0,0.0,0.0,0.0,0.0,0.0,0.0,0.0,0.0,0.0,0.0,1.0,0.0,0.0,0.0,0.0,0.0,0.0,0.0,0.0,0.0,0.0,0.0,0.0,0.0,1.0,6750.0,0.0,67500.0,0.0,0.0,0.0,0.0,0.0,-413.0,667.0,-9.0,,14.0,-6.5,3.0,11663.28,77265.0,70515.0,3375.0,94630.5,11.0,-316.0,365243.0,-460.5,182347.0,-160.5,182351.0,17.0,0.0,0.0475724042992534,170.0,15.0,10.0,7.0,-21.0,0.0,0.0,14.0,14752.62,14752.62,-633.5,-624.0,4.0,1.0,0.0,,,,,,,,,,,,,,,,,,,,,8359758432.0,184624972299.0,165785750154.0,52048965655.935,1863.0,1706.0,71127.0,71006.0,9141.0,506859.0,,,,,,,128604.0,663801.0,,,,13547551.328766724,-602819324.0,-923276634.0,-296964558.0,-1537485579.0416667,44096.0,30759.0,11364.933999999192,11240.899999998986,10724.874699997288,22922.42330000984,22844.2012000098,22229.03500000836,,158273.39284940934,126299.98633415936,35053.282400028045,34993.38980002848,34438.553000028885,,,,3719577.0,,,,,,,16492.526499999716,16678.1109999997,16274.570099999695,,,,3918.955500000124,3902.2071000001615,3734.86930000016,437167.0,431955.0,,6434.459295002895,632894.0,626437.0,,16356.48979999979,154420.09469999082,154422.8367999904,154314.53839998716,,,,14.0,92472069.19499998,32552936.82000001,9705802353.47998,3199152674.2499967,112976610.02999996,866315.3399999995,191.0,24583.0,-31618379.0,14212297.0,-16399212.0,,-6.5,6750.0,0.0,67500.0,0.0,0.0,0.0,0.0,0.0,-413.0,667.0,-9.0,,335110896.54000044,4774196882.340004,5355233710.245005,78057885.32999997,4774158249.840004,344723.0,-23913393.0,5562946973.5,246874790.0,1254469031.5,545264106.0,1319548445.5,343374.0,5361.0,980.7004533536974,7961342.0,2845133.0,1752940.0,-5739071.0,1938157.0,245751.0,3769096998.600021,3816130211.460018,-230061887.0,-228144159.5,4076340.0,189215.5,,,,,,,,,,,,,,,,,,,,,1469648.0,14865448.0,3237359.0,8568864.0,11625023.0,1418026.0,1061801749.3545012,802313475.7274951,72219255140.63213,21708722665.08012,583533901.5569987,5792665.7475,689.5,94245.0,-277344658.0,21991251.5,-123965679.5,,-2026424.0,,,,,,,,,,,,,,,,,,,,,4279656.0,2483157.5,-9017250.0,921848.5,37582.5,3739612401.719957,3664290462.119957,-261024969.5,-257707892.0,2530272.5,269636.0,3932095578.839953,33301523458.26092,36734583926.63265,1732573775.00255,48156716759.60322,3993997.5,-247952671.0,103244535287.5,1056859114.0,17296931510.5,3509312726.5,18911875511.0,3677601.0,72043.5,20904.092380252143,89884073.0,-15.83257322387757,1.1584,8.344459279038718,225.57473892130147,9.666221628838452,261.3057775664356,112500.0,-0.2225209339563143,0.9749279121818236,0.0,0.0,0.0,0.0,0.0,0.0,1.0,0.0,1.0,0.0,0.0,0.0,0.0,0.0,0.0,0.0,0.0,0.0,1.0,0.0,0.0,0.0,1.0,0.0,0.0,1.0,0.0,0.0,0.0,0.0,0.0,0.0,0.0,0.0,0.0,0.0,0.0,0.0,1.0,0.0,0.0,0.0,0.0,0.0,0.0,0.0,0.0,0.0,0.0,0.0,0.0,1.0,0.0,0.0,0.0,0.0,0.0,0.0,0.0,0.0,0.0,0.0,0.0,0.0,0.0,0.0,0.0,0.0,0.0,0.0,0.0,0.0,0.0,0.0,0.0,0.0,0.0,0.0,0.0,0.0,0.0,0.0,0.0,0.0,0.0,0.0,0.0,0.0,0.0,0.0,0.0,0.0,0.0,0.0,0.0,0.0,0.0,0.0,0.0,0.0,0.0,0.0,0.0,0.0,0.0,0.0,0.0,0.0,0.0,0.0,1.0,0.0,0.0,0.0,0.0,0.0,0.0,0.0,1.0,0.0
105856,0,0.0,0.0,0.0,1.0,1.0,76500.0,126000.0,6192.0,126000.0,0.0084739999999999,27.50958904109589,-2052.0,-3171.0,-1705.0,,3.0,2.0,2.0,10.0,0.4829557982321389,0.6709478655062604,,0.0619,0.0516,0.9771,,,0.0,0.1379,0.1667,,0.0757,,0.0523,,0.0,0.063,0.0536,0.9772,,,0.0,0.1379,0.1667,,0.0775,,0.0545,,0.0,0.0625,0.0516,0.9771,,,0.0,0.1379,0.1667,,0.077,,0.0533,,0.0,0.0411,1.0,5.0,0.0,5.0,0.0,-1022.0,0.0,0.0,0.0,0.0,1.0,3.0,1.0,1.0,0.0,1.0,0.0,1.0,0.0,0.0,0.0,0.0,0.0,0.0,0.0,1.0,0.0,0.0,0.0,0.0,0.0,0.0,0.0,0.0,0.0,0.0,0.0,0.0,0.0,0.0,0.0,0.0,0.0,0.0,1.0,,,168799.14,0.0,,0.0,0.0,0.0,-918.0,-158.0,-184.0,-186.0,31.0,-15.0,4.0,12274.0425,63805.5,120575.25,0.0,82611.0,9.0,-742.5,365243.0,-712.0,182291.0,-292.0,182293.5,16.0,0.0,0.0,449.5,38.0,24.0,9.0,-19.5,0.0,0.0,76.0,4164.57,4164.57,-403.0,-400.0,13.0,0.0,22.0,678284.7975,765000.0,0.0,11211.03,0.0,1165.5,33213.8925,36000.0,36000.0,652730.49,675688.95,675688.95,0.0,1.0,0.0,0.5,9.5,-11.5,0.0,0.0,8359764624.0,184625098299.0,165785876154.0,52049042155.935,1863.0,1706.0,71127.0,71007.0,9141.0,506862.0,17835.04460000232,17897.38379999913,17348.16269999799,11313.3394000001,11251.0987000001,11198.52750000006,128605.0,663804.0,,,,13547578.838355765,-602821376.0,-923278339.0,-296965580.0,-1537488750.0416667,44096.0,30759.0,11364.933999999192,11240.899999998986,10724.874699997288,22922.561200009837,22844.339100009794,22229.172900008354,67593.63913146677,158274.06379727484,,35053.449100028054,34993.556500028484,34438.719700028894,,,,3719587.0,8308.088000000165,8412.818000000078,8136.158100000232,,,,16492.578799999716,16678.1642999997,16274.624599999695,,,,3918.955500000124,3902.2071000001615,3734.86930000016,437172.0,431960.0,,6434.467769002894,632896.0,626439.0,,16356.53089999979,154421.0717999908,154423.81389999035,154315.51559998715,,,,31.0,,,9732685977.94498,3213359611.3349967,,866315.3399999995,191.0,24583.0,-31723204.0,14256918.0,-16458255.0,-17926918.0,-15.0,,,168799.14,0.0,,0.0,0.0,0.0,-918.0,-158.0,-184.0,-186.0,336316424.67000043,4791026352.420004,5375042358.975004,78311677.67999996,4791067657.920004,346162.0,-24019623.0,5587046811.5,248260968.5,1262087857.0,548877815.0,1327169467.5,344816.5,5386.0,984.2476097052228,8005269.5,2862411.0,1763768.0,-5762423.5,1938299.0,245877.0,3783048652.1925454,3829649588.662533,-231011181.0,-229084129.0,4093725.5,190104.0,3513060345.6674533,9466726500.0,295346046.375,451371876.2099999,13459095.540000005,142108802.73000002,199032286.6349989,496647052.5149948,457914432.05999726,3372852668.940011,3500379727.267437,3500558610.367436,15219.5,40177.0,198.0,24759.5,1154743.5,-2055198.0,814152.0,1890.0,1469649.0,14865479.0,3237381.0,8568902.0,11625099.0,1418030.0,,,72219423939.77213,21708722665.08012,,5792665.7475,689.5,94245.0,-277345576.0,21991093.5,-123965863.5,-219030225.0,-2026439.0,5929787197.687462,18753277500.0,198923232.825,448456418.8424977,1948107.735,257090116.16250083,309460445.16749865,637200935.5049977,459607863.5774992,5714708227.852535,5893022234.182498,5893265416.927499,13396.0,80975.5,44.0,70475.0,972574.0,-1701054.0,177364.0,6755.0,4279680.0,2483166.5,-9017269.5,921848.5,37582.5,3739616566.289958,3664294626.6899576,-261025372.5,-257708292.0,2530285.5,269636.0,3932107852.882453,33301587263.76092,36734704501.88265,1732573775.00255,48156799370.60322,3994006.5,-247953413.5,103244900530.5,1056858402.0,17297113801.5,3509312434.5,18912057804.5,3677617.0,72043.5,20904.092380252143,89884522.5,-74.59217209441292,1.6470588235294117,12.354651162790692,339.87137623446955,20.348837209302324,559.7881490920673,25500.0,-0.9009688679024191,-0.433883739117558,0.0,0.0,0.0,0.0,0.0,1.0,0.0,0.0,0.0,0.0,0.0,0.0,0.0,1.0,0.0,1.0,0.0,0.0,0.0,0.0,1.0,0.0,0.0,0.0,0.0,0.0,0.0,0.0,0.0,1.0,0.0,0.0,0.0,0.0,0.0,0.0,0.0,0.0,0.0,0.0,0.0,0.0,0.0,0.0,0.0,0.0,0.0,0.0,0.0,0.0,0.0,0.0,0.0,1.0,0.0,0.0,0.0,0.0,0.0,0.0,0.0,0.0,0.0,0.0,0.0,0.0,0.0,0.0,0.0,0.0,0.0,0.0,0.0,0.0,0.0,0.0,0.0,0.0,0.0,0.0,0.0,0.0,0.0,0.0,0.0,0.0,0.0,0.0,0.0,0.0,0.0,0.0,0.0,0.0,0.0,0.0,0.0,0.0,0.0,0.0,0.0,0.0,0.0,0.0,0.0,0.0,0.0,0.0,0.0,0.0,1.0,0.0,0.0,0.0,0.0,0.0,0.0,1.0,0.0,0.0
105865,0,0.0,0.0,0.0,1.0,0.0,76500.0,281938.5,21946.5,252000.0,0.018029,65.34520547945205,,-3622.0,-5867.0,,2.0,3.0,3.0,7.0,,0.3827254642244592,0.7544061731797895,,,,,,,,,,,,,,,,,,,,,,,,,,,,,,,,,,,,,,,,,,,,,5.0,0.0,5.0,0.0,-1745.0,0.0,0.0,0.0,0.0,1.0,0.0,1.0,0.0,0.0,1.0,0.0,0.0,0.0,0.0,0.0,0.0,0.0,0.0,0.0,1.0,0.0,0.0,0.0,0.0,0.0,0.0,0.0,0.0,0.0,0.0,0.0,0.0,0.0,0.0,0.0,0.0,0.0,0.0,3.0,0.0,,315000.0,0.0,0.0,0.0,0.0,0.0,-1435.0,-339.0,-688.0,-735.0,143.0,-23.0,2.0,9934.47,109800.0,115825.5,11250.0,109800.0,15.0,-929.0,365243.0,-898.5,182117.0,-478.5,182125.5,6.0,0.5,0.246422958885625,1286.0,29.0,24.0,10.0,-43.0,0.0,0.0,32.0,14514.57,14514.57,-1344.0,-1249.0,13.5,1.0,0.0,,,,,,,,,,,,,,,,,,,,,8359786570.5,184625380237.5,165786128154.0,52049118655.935,1863.0,1706.0,71127.0,71008.0,9141.0,506862.0,,,,,,,128605.0,663806.0,,,,13547644.183561243,,-923284206.0,-296967325.0,-1537492372.0416667,44096.0,30759.0,,,,,,,,158274.44652273908,126300.74074033252,,,,,,,3719594.0,,,,,,,,,,,,,,,,437177.0,431965.0,,6434.485798002895,632899.0,626442.0,,,,,,,,,48.0,92625772.67999998,,9740456193.46498,3215900582.9999967,114123020.53499997,866315.3399999995,191.0,24583.0,-31763597.0,14237436.0,-16478643.0,-17948867.0,-23.5,0.0,,315000.0,0.0,0.0,0.0,0.0,0.0,-1435.0,-339.0,-688.0,-735.0,336580084.57500046,4794689291.670004,5379369358.725004,78355327.67999996,4794689291.670004,346547.0,-24040322.5,5594716586.5,248607998.5,1264632842.5,549235765.5,1329714549.5,345130.0,5395.5,985.1381901768948,8017189.0,2866577.0,1766458.0,-5768799.0,1938299.0,245877.0,3786364880.707527,3832906831.110016,-231345246.5,-229414906.0,4098741.0,190355.5,,,,,,,,,,,,,,,,,,,,,1469652.0,14865622.0,3237381.0,8568931.0,11625131.0,1418032.0,1061801749.3545012,,72219738939.77213,21708722665.08012,583533901.5569987,5792665.7475,689.5,94245.0,-277347011.0,21990754.5,-123966551.5,-219030960.0,-2026462.0,,,,,,,,,,,,,,,,,,,,,4279704.0,2483176.5,-9017312.5,921848.5,37582.5,3739631080.8599577,3664309141.259958,-261026716.5,-257709541.0,2530299.0,269637.0,3932117787.352453,33301697063.76092,36734820327.38265,1732585025.00255,48156909170.60322,3994021.5,-247954342.5,103245265773.5,1056857503.5,17297295918.5,3509311956.0,18912239930.0,3677623.0,72044.0,20904.338803211023,89885808.5,,3.6854705882352943,3.4857494361287675,227.77701315371849,12.846627024810337,839.4654826541132,38250.0,-0.9009688679024191,-0.433883739117558,0.0,0.0,0.0,0.0,0.0,0.0,1.0,0.0,0.0,1.0,0.0,0.0,0.0,0.0,0.0,0.0,0.0,0.0,1.0,0.0,1.0,0.0,0.0,0.0,0.0,1.0,0.0,0.0,0.0,0.0,0.0,0.0,0.0,0.0,0.0,0.0,0.0,0.0,0.0,0.0,0.0,0.0,0.0,0.0,0.0,0.0,0.0,0.0,0.0,0.0,0.0,0.0,0.0,0.0,0.0,0.0,0.0,0.0,0.0,0.0,0.0,0.0,0.0,0.0,0.0,0.0,0.0,0.0,0.0,0.0,0.0,0.0,0.0,0.0,0.0,0.0,0.0,0.0,0.0,0.0,0.0,0.0,0.0,0.0,0.0,0.0,0.0,0.0,0.0,0.0,0.0,0.0,0.0,0.0,0.0,0.0,0.0,0.0,0.0,0.0,0.0,0.0,0.0,0.0,0.0,1.0,0.0,0.0,0.0,0.0,0.0,0.0,0.0,0.0,0.0,0.0,0.0,0.0,0.0,0.0
105899,1,0.0,0.0,0.0,1.0,0.0,121500.0,450000.0,35685.0,450000.0,0.028663,28.16986301369863,-2858.0,-188.0,-913.0,,2.0,2.0,2.0,14.0,0.4860841834475362,0.5499064495827369,0.1161249142719599,0.0619,0.0608,0.9866,0.8164,0.0089,0.0,0.1379,0.1667,0.2083,0.0403,0.0504,0.0559,0.0,0.0,0.063,0.0631,0.9866,0.8236,0.0089,0.0,0.1379,0.1667,0.2083,0.0413,0.0551,0.0583,0.0,0.0,0.0625,0.0608,0.9866,0.8189,0.0089,0.0,0.1379,0.1667,0.2083,0.041,0.0513,0.057,0.0,0.0,0.0488,1.0,5.0,2.0,5.0,2.0,0.0,0.0,0.0,0.0,0.0,0.0,3.0,1.0,1.0,0.0,1.0,0.0,1.0,0.0,0.0,0.0,0.0,0.0,0.0,0.0,1.0,0.0,0.0,0.0,0.0,0.0,0.0,0.0,0.0,0.0,0.0,0.0,0.0,0.0,0.0,0.0,0.0,0.0,0.0,12.0,999.0,3047.1975,127401.84,10012.5,0.0,0.0,0.0,0.0,-705.5,899.0,-30.5,-597.0,315.0,-14.0,4.0,10300.14,101250.0,108805.5,,101250.0,18.0,-583.0,365243.0,-553.0,365243.0,137.0,365243.0,14.0,0.0,,30.0,32.0,24.0,10.5,-16.5,0.0,0.0,35.0,10666.35,9933.93,-467.0,-463.0,8.0,1.0,19.0,0.0,135000.0,,0.0,,,0.0,,0.0,0.0,0.0,0.0,,0.0,,,0.0,-10.0,0.0,0.0,8359822255.5,184625830237.5,165786578154.0,52049240155.935,1863.0,1706.0,71127.0,71008.0,9141.0,506865.0,17835.106500002315,17897.44629999913,17348.225699997987,11313.400200000098,11251.159500000098,11198.59060000006,128605.0,663808.0,4143.904900000114,4141.592700000011,3952.059600000093,13547672.35342426,-602824234.0,-923285119.0,-296967325.0,-1537492560.0416667,44098.0,30761.0,11364.933999999192,11240.899999998986,10724.874699997288,22922.699100009835,22844.4770000098,22229.31080000836,67594.12521565023,158274.99642918867,126300.8568652468,35053.61580002805,34993.723200028486,34438.886400028896,22986.77409999587,22959.83719999545,22606.205499995685,3719608.0,8308.128300000166,8412.859000000077,8136.199400000232,9831.30810000072,9946.409700002154,10306.626699999631,16492.63469999972,16678.2212999997,16274.682899999694,829.4257000001771,814.604400000046,760.522500000013,3918.955500000124,3902.2071000001615,3734.86930000016,437182.0,431970.0,,6434.514461002895,632901.0,626444.0,,16356.579699999793,154422.0583999908,154424.80049999038,154316.50219998715,77726.18479999635,78064.52700000658,78466.6622000067,24.0,92972171.56499998,32688979.67250001,9784172317.229984,3230461745.954997,114526354.90499996,866315.3399999995,192.0,24583.0,-31908475.5,14241549.0,-16567560.0,-18041212.0,-11.5,999.0,6094.395,135000.0,0.0,0.0,0.0,0.0,0.0,-976.0,882.0,-28.0,-597.0,337833627.88500047,4811209834.320004,5398273221.975004,,4811209834.320004,348012.0,-24135298.5,5620830163.0,249633063.0,1272068759.0,552117143.0,1337516178.0,346752.0,5418.0,,8036313.5,2878699.0,1773922.0,-5793549.5,1938382.0,245927.0,3799568801.655046,3845723140.980032,-232277128.0,-230337359.0,4109909.0,191163.0,3525128581.4999514,9518206500.0,,453748054.545,,,199775966.9849989,,460214893.3949973,3384397636.335008,3512371761.179935,3512552219.279934,,40926.0,,,1162043.0,-2065516.0,814165.0,1903.0,1469664.0,14865937.0,3237400.0,8568963.0,11625166.0,1418036.0,1061802748.3545012,802316522.9249951,72219866341.61212,21708732677.58012,583533901.5569987,5792665.7475,689.5,94245.0,-277347716.5,21991653.5,-123966582.0,-219031557.0,-2026476.0,5929787197.687462,18753412500.0,,448456418.8424977,,,309460445.16749865,,459607863.5774992,5714708227.852535,5893022234.182498,5893265416.927499,,80975.5,,,972574.0,-1701064.0,177364.0,6755.0,4279728.0,2483187.0,-9017329.0,921848.5,37582.5,3739641747.2099576,3664319075.1899576,-261027183.5,-257710004.0,2530307.0,269638.0,3932128087.492453,33301798313.76092,36734929132.88265,,48157010420.60322,3994039.5,-247954925.5,103245631016.5,1056856950.5,17297661161.5,3509312093.0,18912605173.0,3677637.0,72044.0,,89885838.5,-101.455942423653,3.703703703703704,3.4047919293820934,95.91252224084025,12.61034047919294,355.23156385496384,60750.0,1.0,0.0,0.0,0.0,0.0,0.0,0.0,0.0,1.0,0.0,0.0,0.0,0.0,0.0,0.0,1.0,0.0,1.0,0.0,0.0,0.0,0.0,1.0,0.0,0.0,0.0,0.0,1.0,0.0,0.0,0.0,0.0,0.0,0.0,0.0,1.0,0.0,0.0,0.0,0.0,0.0,0.0,0.0,0.0,0.0,0.0,0.0,0.0,0.0,0.0,0.0,0.0,0.0,0.0,0.0,0.0,0.0,0.0,0.0,0.0,0.0,0.0,0.0,0.0,0.0,0.0,0.0,0.0,0.0,0.0,0.0,0.0,0.0,0.0,0.0,0.0,0.0,0.0,1.0,0.0,0.0,0.0,0.0,0.0,0.0,0.0,0.0,0.0,0.0,0.0,0.0,0.0,0.0,0.0,0.0,0.0,0.0,0.0,0.0,0.0,0.0,0.0,0.0,0.0,0.0,0.0,0.0,0.0,0.0,0.0,1.0,0.0,1.0,0.0,0.0,0.0,0.0,0.0,0.0,0.0,1.0,0.0
105906,0,0.0,0.0,1.0,1.0,0.0,157500.0,225000.0,23184.0,225000.0,0.026392,65.28219178082192,,-226.0,-4581.0,65.0,2.0,2.0,2.0,11.0,,0.6512963851447869,0.6817058776720116,0.0814,0.081,0.9767,,,0.0,0.1379,0.1667,,0.0594,,0.072,,0.0,0.083,0.0841,0.9767,,,0.0,0.1379,0.1667,,0.0608,,0.075,,0.0,0.0822,0.081,0.9767,,,0.0,0.1379,0.1667,,0.0604,,0.0733,,0.0,0.0566,1.0,5.0,2.0,5.0,2.0,-1171.0,0.0,0.0,0.0,0.0,1.0,2.0,1.0,0.0,0.0,1.0,0.0,0.0,0.0,0.0,0.0,0.0,0.0,0.0,0.0,0.0,0.0,0.0,1.0,0.0,0.0,0.0,0.0,0.0,0.0,0.0,0.0,0.0,0.0,0.0,0.0,0.0,0.0,0.0,4.0,0.0,0.0,102854.25,0.0,0.0,0.0,0.0,0.0,-2474.0,-1379.0,-2382.0,-2382.0,303.0,-37.0,20.0,23641.65,157500.0,177806.25,0.0,157500.0,12.0,-1225.0,365243.0,-1231.0,-1045.0,-1045.0,-1041.0,15.0,1.0,0.0,0.0,74.0,18.0,8.0,-48.0,0.0,0.0,93.0,23641.65,7241.22,-1585.0,-1579.0,8.0,1.0,0.0,,,,,,,,,,,,,,,,,,,,,8359845439.5,184626055237.5,165786803154.0,52049397655.935,1863.0,1706.0,71127.0,71009.0,9141.0,506867.0,17835.18790000232,17897.52849999913,17348.308699997986,11313.481200000098,11251.240500000098,11198.67470000006,128605.0,663810.0,,,,13547737.63561604,,-923289700.0,-296968496.0,-1537492786.0416667,44100.0,30763.0,11364.933999999192,11240.899999998986,10724.874699997288,22922.83700000984,22844.6149000098,22229.44870000836,,158275.64772557386,126301.53857112446,35053.78250002805,34993.88990002849,34439.053100028905,,,,3719619.0,8308.187700000166,8412.919400000077,8136.260200000232,,,,16492.706699999715,16678.2945999997,16274.757899999697,,,,3918.955500000124,3902.2071000001615,3734.86930000016,437187.0,431975.0,1264970.0,6434.540853002894,632903.0,626446.0,,16356.636299999793,154423.0350999908,154425.77719999038,154317.47889998715,,,,82.0,93108625.06499998,32695080.48000001,9786688735.229984,3231401030.909997,114552454.90499996,866315.3399999995,192.0,24583.0,-31928368.0,14279484.0,-16576485.0,-18051146.0,-40.5,0.0,0.0,157500.0,0.0,0.0,0.0,0.0,0.0,-2474.0,-1379.0,-2382.0,-2382.0,338403313.89000064,4817487238.155004,5404876626.060004,78821249.57999997,4817487238.155004,348577.0,-24177067.5,5630691347.0,250339843.0,1274242426.0,552834439.0,1339324684.0,347344.5,5429.0,991.419596259698,8047717.0,2882233.0,1776085.5,-5801362.5,1938466.0,246011.0,3803616021.0150537,3849136159.9950366,-232531890.0,-230589742.0,4111812.0,191408.0,,,,,,,,,,,,,,,,,,,,,1469668.0,14866240.0,3237400.0,8569037.0,11625259.0,1418056.0,1061802748.3545012,802316522.9249951,72219969195.86212,21708732677.58012,583533901.5569987,5792665.7475,689.5,94245.0,-277350190.5,21990274.5,-123968964.0,-219033939.0,-2026513.0,,,,,,,,,,,,,,,,,,,,,4279746.0,2483195.0,-9017377.0,921848.5,37582.5,3739665388.8599577,3664326316.409957,-261028768.5,-257711583.0,2530315.0,269639.0,3932151729.142453,33301955813.76092,36735106939.13265,1732585025.00255,48157167920.60322,3994051.5,-247956150.5,103245996259.5,1056855719.5,17297660116.5,3509311048.0,18912604132.0,3677652.0,72045.0,20904.338803211023,89885838.5,,1.4285714285714286,6.793478260869565,443.49315068493166,9.70496894409938,633.5616438356166,78750.0,-0.9009688679024191,-0.433883739117558,0.0,0.0,0.0,0.0,0.0,0.0,1.0,0.0,0.0,1.0,0.0,0.0,0.0,0.0,0.0,0.0,0.0,0.0,1.0,0.0,1.0,0.0,0.0,0.0,0.0,1.0,0.0,0.0,0.0,0.0,0.0,0.0,0.0,0.0,0.0,0.0,0.0,0.0,0.0,0.0,0.0,0.0,0.0,0.0,0.0,0.0,0.0,0.0,0.0,0.0,0.0,0.0,0.0,0.0,0.0,0.0,0.0,0.0,0.0,0.0,0.0,0.0,0.0,0.0,0.0,0.0,0.0,0.0,0.0,0.0,0.0,0.0,0.0,0.0,0.0,0.0,0.0,0.0,0.0,0.0,0.0,0.0,0.0,0.0,0.0,0.0,0.0,0.0,0.0,0.0,0.0,0.0,0.0,0.0,0.0,0.0,0.0,0.0,0.0,0.0,0.0,0.0,0.0,0.0,0.0,1.0,0.0,0.0,0.0,0.0,1.0,0.0,0.0,0.0,0.0,0.0,0.0,1.0,0.0,0.0
105916,0,0.0,0.0,0.0,0.0,0.0,180000.0,323460.0,26064.0,270000.0,0.031329,52.33150684931507,-6894.0,-3413.0,-2650.0,,2.0,2.0,2.0,14.0,,0.4590375111218346,0.4650692149562261,,0.0748,0.9762,0.6736,,0.0,0.2069,0.1667,,0.0162,0.0756,0.0745,,,,0.0777,0.9762,0.6864,,0.0,0.2069,0.1667,,0.0165,0.0826,0.0776,,,,0.0748,0.9762,0.6779999999999999,,0.0,0.2069,0.1667,,0.0165,0.077,0.0758,,,0.0586,1.0,0.0,0.0,0.0,0.0,-2505.0,0.0,0.0,0.0,0.0,1.0,4.0,1.0,1.0,1.0,1.0,0.0,0.0,0.0,0.0,0.0,0.0,0.0,0.0,0.0,1.0,0.0,0.0,0.0,0.0,0.0,0.0,0.0,0.0,0.0,0.0,0.0,0.0,0.0,0.0,0.0,0.0,0.0,0.0,9.0,0.0,0.0,85326.57,0.0,0.0,0.0,0.0,0.0,-1121.0,-796.5,-562.0,-1028.0,381.0,-25.0,16.0,16590.87,145134.0,86332.5,5400.0,180000.0,12.0,-847.0,365243.0,-1111.5,-916.5,-901.5,-910.0,11.5,0.5,0.1085562829893754,0.5,70.0,10.0,5.0,-38.5,0.0,0.0,68.0,9946.89,9946.89,-1250.0,-1189.0,4.5,1.0,11.0,0.0,90000.0,,0.0,,,0.0,,0.0,0.0,0.0,0.0,,0.0,,,0.0,-7.0,0.0,0.0,8359871503.5,184626378697.5,165787073154.0,52049577655.935,1863.0,1706.0,71127.0,71010.0,9141.0,506871.0,,,,11313.5560000001,11251.315300000098,11198.75240000006,128605.0,663812.0,,,,13547789.96712289,-602831128.0,-923292350.0,-296971001.0,-1537496199.0416667,44100.0,30763.0,11364.933999999192,11240.899999998986,10724.874699997288,22923.04390000984,22844.8218000098,22229.65560000836,,158276.10676308494,126302.00364033943,35053.94920002805,34994.05660002849,34439.2198000289,,,,3719633.0,8308.203900000166,8412.935900000077,8136.276700000232,9831.38370000072,9946.486700002151,10306.709299999631,16492.781199999714,16678.370399999698,16274.835499999695,,,,,,,437187.0,431975.0,,6434.572182002894,632905.0,626448.0,,16356.694899999791,154424.01129999082,154426.75339999038,154318.45509998716,77726.85839999634,78065.20500000658,78467.3486000067,37.0,93122125.06499998,32724105.39000001,9799715417.489985,3236029703.909997,114586153.15499996,866315.3399999995,195.0,24583.0,-31997187.0,14273954.5,-16622852.0,-18094990.0,-18.0,0.0,0.0,67027.5,0.0,0.0,0.0,0.0,0.0,-1624.0,-1289.0,-886.0,-1318.0,339440721.6600007,4829928807.510003,5418344093.310004,79251589.93499997,4829928807.510003,349423.0,-24245238.0,5644387291.5,250661208.0,1276762976.0,553537134.0,1342211250.0,348163.0,5445.0,995.5358128692676,8064815.5,2888949.0,1780359.0,-5814339.5,1938594.0,246049.0,3812826613.882544,3858391328.782526,-232922056.0,-230975070.0,4114829.5,191968.5,3535278527.6099515,9541665000.0,,454908834.36,,,200264551.96499896,,461044084.04999727,3394306842.165008,3522490384.8149343,3522670842.9149327,,40963.0,,,1162197.0,-2066021.0,814173.0,1903.0,1469677.0,14866621.0,3237411.0,8569107.0,11625327.0,1418072.0,1061802748.3545012,802316522.9249951,72220054522.43213,21708732677.58012,583533901.5569987,5792665.7475,689.5,94245.0,-277351311.5,21989478.0,-123969526.0,-219034967.0,-2026538.0,5929787197.687462,18753502500.0,,448456418.8424977,,,309460445.16749865,,459607863.5774992,5714708227.852535,5893022234.182498,5893265416.927499,,80975.5,,,972574.0,-1701071.0,177364.0,6755.0,4279756.0,2483200.0,-9017415.5,921848.5,37582.5,3739675335.749958,3664336263.299957,-261030018.5,-257712772.0,2530319.5,269640.0,3932168320.012453,33302100947.76092,36735193271.63265,1732590425.00255,48157347920.60322,3994063.5,-247956997.5,103246361502.5,1056854608.0,17297659200.0,3509310146.5,18912603222.0,3677663.5,72045.5,20904.44735949401,89885839.0,-131.73708182817654,1.797,6.906077348066297,361.4054340422312,12.410220994475136,649.4455649738892,90000.0,-0.2225209339563146,-0.9749279121818236,0.0,0.0,0.0,0.0,0.0,0.0,1.0,0.0,0.0,0.0,0.0,0.0,0.0,1.0,0.0,0.0,0.0,0.0,1.0,0.0,1.0,0.0,0.0,0.0,0.0,1.0,0.0,0.0,0.0,0.0,0.0,0.0,0.0,0.0,0.0,0.0,0.0,0.0,1.0,0.0,0.0,0.0,0.0,0.0,0.0,0.0,0.0,0.0,0.0,0.0,0.0,0.0,1.0,0.0,0.0,0.0,0.0,0.0,0.0,0.0,0.0,0.0,0.0,0.0,0.0,0.0,0.0,0.0,0.0,0.0,0.0,0.0,0.0,0.0,0.0,0.0,0.0,0.0,0.0,0.0,0.0,0.0,0.0,0.0,0.0,0.0,0.0,0.0,0.0,0.0,0.0,0.0,0.0,0.0,0.0,0.0,0.0,0.0,0.0,0.0,0.0,0.0,0.0,0.0,0.0,0.0,0.0,0.0,1.0,0.0,1.0,0.0,0.0,0.0,0.0,0.0,0.0,1.0,0.0,0.0
105923,0,0.0,0.0,0.0,1.0,0.0,112500.0,164182.5,17811.0,148500.0,0.00823,51.75068493150685,-1137.0,-8.0,-2422.0,,2.0,2.0,2.0,9.0,0.3880082823040573,0.4930703036640655,0.5638350489514956,,,,,,,,,,,,,,,,,,,,,,,,,,,,,,,,,,,,,,,,,,,,,0.0,0.0,0.0,0.0,-722.0,0.0,0.0,0.0,0.0,1.0,3.0,1.0,1.0,0.0,1.0,0.0,0.0,0.0,0.0,0.0,0.0,0.0,0.0,0.0,1.0,0.0,0.0,0.0,0.0,0.0,0.0,0.0,0.0,0.0,0.0,0.0,0.0,0.0,0.0,0.0,0.0,0.0,0.0,16.0,0.0,0.0,45434.25,0.0,0.0,0.0,0.0,0.0,-904.5,-225.0,-278.0,-469.0,542.0,-25.0,7.0,13581.6075,87768.0,254700.0,0.0,225000.0,24.0,-509.0,365243.0,-404.0,-77.0,433.0,-323.0,15.0,1.0,0.0,-1.0,51.0,24.0,20.0,-21.0,0.0,0.0,48.0,10579.68,10579.68,-630.5,-617.0,6.5,1.0,22.0,0.0,292500.0,,0.0,,,0.0,,0.0,0.0,0.0,0.0,,0.0,,,0.0,-13.5,0.0,0.0,8359889314.5,184626542880.0,165787221654.0,52049690155.935,1863.0,1706.0,71127.0,71011.0,9141.0,506874.0,,,,,,,128605.0,663814.0,,,,13547841.717807822,-602832265.0,-923294772.0,-296971723.0,-1537496207.0416667,44100.0,30763.0,,,,,,,67594.51322393253,158276.59983338858,126302.56747538836,,,,,,,3719642.0,,,,,,,,,,,,,,,,437187.0,431975.0,,6434.580412002894,632907.0,626450.0,,,,,,,,,30.5,93157000.06499998,32724105.39000001,9802805023.439983,3237379282.484997,114640679.42999998,866315.3399999995,195.0,24583.0,-32023287.5,14263336.5,-16637108.5,-18110650.0,-14.75,0.0,0.0,45868.5,0.0,0.0,0.0,0.0,0.0,-1778.0,-1594.0,-1333.0,-1625.0,339737765.04000086,4833850919.535003,5423072753.835004,79267047.43499997,4833850919.535003,349746.0,-24271647.0,5650778749.0,251009505.0,1279308992.0,554256729.0,1344391766.0,348617.0,5453.0,996.100727096318,8072581.0,2891255.0,1781681.0,-5820209.0,1938715.0,246075.0,3814239629.1150384,3859703940.600021,-233094395.5,-231145573.0,4116315.5,192136.5,3536291486.6099524,9546997500.0,,455050931.67,,,200312570.24999896,,461093671.9799973,3395269076.3100085,3523494313.5749345,3523674771.674933,,41006.0,,,1162233.0,-2066282.0,814173.0,1903.0,1469693.0,14867163.0,3237433.0,8569158.0,11625375.0,1418079.0,1061802748.3545012,802316522.9249951,72220099956.68213,21708732677.58012,583533901.5569987,5792665.7475,689.5,94245.0,-277352216.0,21989253.0,-123969804.0,-219035436.0,-2026563.0,5929787197.687462,18753795000.0,,448456418.8424977,,,309460445.16749865,,459607863.5774992,5714708227.852535,5893022234.182498,5893265416.927499,,80975.5,,,972574.0,-1701084.5,177364.0,6755.0,4279780.0,2483220.0,-9017436.5,921848.5,37582.5,3739685915.429957,3664346842.979957,-261030649.0,-257713389.0,2530326.0,269641.0,3932181901.619953,33302188715.76092,36735447971.63265,1732590425.00255,48157572920.60322,3994087.5,-247957506.5,103246726745.5,1056854204.0,17297659123.0,3509310579.5,18912602899.0,3677678.5,72046.5,20904.44735949401,89885838.0,-21.970723701625285,1.4594,6.316321374431531,326.8739573743485,9.218039413845377,477.0398533921242,56250.0,-0.2225209339563143,0.9749279121818236,0.0,0.0,0.0,0.0,0.0,0.0,1.0,0.0,0.0,0.0,0.0,0.0,0.0,1.0,0.0,0.0,0.0,0.0,1.0,0.0,1.0,0.0,0.0,0.0,0.0,1.0,0.0,0.0,0.0,0.0,0.0,0.0,0.0,0.0,0.0,0.0,0.0,0.0,1.0,0.0,0.0,0.0,0.0,0.0,0.0,0.0,0.0,0.0,0.0,0.0,0.0,0.0,0.0,1.0,0.0,0.0,0.0,0.0,0.0,0.0,0.0,0.0,0.0,0.0,0.0,0.0,0.0,0.0,0.0,0.0,0.0,0.0,0.0,0.0,0.0,0.0,0.0,0.0,0.0,0.0,0.0,0.0,0.0,0.0,0.0,0.0,0.0,0.0,0.0,0.0,0.0,0.0,0.0,0.0,0.0,0.0,0.0,0.0,0.0,0.0,0.0,0.0,0.0,0.0,0.0,0.0,0.0,0.0,0.0,0.0,0.0,0.0,0.0,0.0,0.0,0.0,0.0,0.0,0.0,0.0
105937,0,0.0,1.0,1.0,1.0,1.0,225000.0,523152.0,48114.0,463500.0,0.035792,28.80821917808219,-691.0,-848.0,-3110.0,11.0,3.0,2.0,2.0,13.0,0.2207899582035766,0.47123952709415,0.3328505641648731,,,,,,,,,,,,,,,,,,,,,,,,,,,,,,,,,,,,,,,,,,,,,3.0,0.0,3.0,0.0,-1442.0,0.0,0.0,0.0,0.0,1.0,2.0,1.0,1.0,0.0,1.0,0.0,0.0,0.0,0.0,0.0,0.0,1.0,1.0,0.0,0.0,0.0,0.0,0.0,0.0,1.0,0.0,0.0,0.0,0.0,0.0,0.0,0.0,0.0,0.0,0.0,0.0,0.0,0.0,8.0,0.0,0.0,169904.25,55316.25,0.0,0.0,0.0,0.0,-436.5,108.0,-16.0,-654.0,169.0,-11.0,6.0,8138.8125,35977.275,30473.775,4502.025,44955.0,6.0,-952.0,365243.0,-1286.5,-1196.5,-1136.5,-1192.5,11.5,1.0,0.1172783392658821,75.0,10.0,6.0,4.5,-79.5,0.0,0.0,8.0,9317.79,9317.79,-2428.5,-2405.0,2.5,1.0,0.0,,,,,,,,,,,,,,,,,,,,,8359937428.5,184627066032.0,165787685154.0,52049915155.935,1863.0,1706.0,71127.0,71012.0,9141.0,506876.0,,,,,,,128606.0,663817.0,,,,13547870.526027,-602832956.0,-923297882.0,-296973165.0,-1537497055.0416667,44100.0,30763.0,,,,,,,67594.73401389072,158277.0710729157,126302.90032595252,,,,,,,3719655.0,,,,,,,,,,,,,,,,437190.0,431978.0,1264981.0,6434.616204002894,632909.0,626452.0,,,,,,,,,15.0,93580801.06499998,32766326.460000016,9834079931.279984,3243797748.8999968,114713490.01499996,866315.3399999995,195.0,24583.0,-32103805.5,14350925.5,-16682106.0,-18157905.0,-7.0,0.0,0.0,170788.5,72787.5,0.0,0.0,0.0,0.0,-792.0,-51.0,-26.0,-654.0,340745809.9500009,4846994505.585003,5438477715.885004,79315206.43499997,4847063814.585003,350774.0,-24333218.5,5664836019.5,251701318.0,1284394104.0,556068748.0,1350210122.0,349726.5,5479.5,997.1967282854332,8083229.0,2899742.0,1787957.5,-5831196.0,1938717.0,246077.0,3825935810.2350335,3872097321.300015,-233557106.0,-231604014.0,4122624.0,192694.5,,,,,,,,,,,,,,,,,,,,,1469701.0,14867332.0,3237433.0,8569168.0,11625383.0,1418085.0,1061802748.3545012,802316522.9249951,72220269860.93213,21708787993.83012,583533901.5569987,5792665.7475,689.5,94245.0,-277352652.5,21989361.0,-123969820.0,-219036090.0,-2026574.0,,,,,,,,,,,,,,,,,,,,,4279786.0,2483224.5,-9017516.0,921848.5,37582.5,3739695233.219957,3664356160.769957,-261033077.5,-257715794.0,2530328.5,269642.0,3932190040.432453,33302224693.03592,36735478445.40765,1732594927.02755,48157617875.60322,3994093.5,-247958458.5,103247091988.5,1056852917.5,17297657926.5,3509309443.0,18912601706.5,3677690.0,72047.5,20904.56463783328,89885913.0,-23.98621017593913,2.32512,4.676393565282454,134.71857079163013,10.87317620650954,313.2368433190352,75000.0,-0.2225209339563146,-0.9749279121818236,0.0,0.0,0.0,0.0,0.0,0.0,1.0,0.0,1.0,0.0,0.0,0.0,0.0,0.0,0.0,1.0,0.0,0.0,0.0,0.0,1.0,0.0,0.0,0.0,0.0,1.0,0.0,0.0,0.0,0.0,0.0,0.0,0.0,0.0,0.0,0.0,0.0,0.0,1.0,0.0,0.0,0.0,0.0,0.0,0.0,0.0,0.0,0.0,0.0,0.0,0.0,0.0,0.0,0.0,0.0,1.0,0.0,0.0,0.0,0.0,0.0,0.0,0.0,0.0,0.0,0.0,0.0,0.0,0.0,0.0,0.0,0.0,0.0,0.0,0.0,0.0,0.0,0.0,0.0,0.0,0.0,0.0,0.0,0.0,0.0,0.0,0.0,0.0,0.0,0.0,0.0,0.0,0.0,0.0,0.0,0.0,0.0,0.0,0.0,0.0,0.0,0.0,0.0,0.0,0.0,0.0,0.0,0.0,0.0,0.0,0.0,0.0,0.0,0.0,0.0,0.0,0.0,0.0,0.0,0.0
105965,0,0.0,0.0,0.0,1.0,0.0,234000.0,314055.0,13329.0,238500.0,0.035792,64.57808219178082,,-4623.0,-4628.0,,2.0,2.0,2.0,15.0,,0.6764614857225041,0.6894791426446275,,,,,,,,,,,,,,,,,,,,,,,,,,,,,,,,,,,,,,,,,,,,,0.0,0.0,0.0,0.0,-2559.0,0.0,0.0,0.0,0.0,0.0,5.0,1.0,0.0,0.0,1.0,0.0,0.0,0.0,0.0,0.0,0.0,0.0,0.0,0.0,0.0,0.0,0.0,1.0,0.0,0.0,0.0,0.0,0.0,0.0,0.0,0.0,0.0,0.0,0.0,0.0,0.0,0.0,0.0,5.0,17082.0,0.0,308628.0,0.0,0.0,0.0,0.0,0.0,-692.0,447.0,-235.0,-485.5,124.0,-13.0,15.0,14189.175,225000.0,225000.0,0.0,229500.0,24.0,-465.0,365243.0,-979.0,-439.0,360.0,-436.0,10.0,0.0,0.0,-1.0,97.0,30.0,17.0,-35.0,0.0,0.0,135.0,14189.175,12746.25,-865.0,-840.0,11.0,1.0,15.0,53754.3,90000.0,0.0,3795.75,0.0,7709.1075,2250.0,4500.0,2250.0,53754.3,53754.3,53754.3,0.0,1.0,0.0,1.0,4.0,-8.0,0.0,0.0,8359950757.5,184627380087.0,165787923654.0,52050149155.935,1863.0,1706.0,71127.0,71012.0,9141.0,506881.0,,,,,,,128606.0,663819.0,,,,13547935.104109192,,-923302510.0,-296975724.0,-1537501678.0416667,44100.0,30763.0,,,,,,,,158277.74753440142,126303.58980509518,,,,,,,3719670.0,,,,,,,,,,,,,,,,437190.0,431978.0,,6434.651996002895,632911.0,626454.0,,,,,,,,,23.0,93959467.37999998,32816552.175000016,9875841443.99998,3264198944.444997,115095881.96999995,866315.3399999995,196.0,24583.0,-32240397.0,14432286.0,-16760014.0,-18233698.0,-11.0,0.0,0.0,675000.0,0.0,0.0,0.0,0.0,0.0,-714.0,367.0,-286.0,-685.0,342206436.51000094,4869411333.075003,5463720471.375004,79584765.43499997,4869181833.075003,352373.0,-24435997.0,5691675224.0,253457002.0,1292379335.0,560422792.0,1357830748.0,351235.0,5503.0,1001.4527265285594,8109850.0,2913381.0,1797068.0,-5851450.0,1940691.0,246103.0,3846946786.20003,3895915618.125015,-234535204.0,-232577663.0,4141986.0,193578.0,3573735985.6199555,9653580000.0,299467821.375,458096403.7799999,13472469.540000005,144645464.04750013,202397960.204999,503336944.4849933,464400990.44999737,3431103369.120011,3560792962.9499383,3560973421.049937,15453.0,41331.0,202.0,25675.0,1175750.0,-2084945.0,841763.0,1925.0,1469706.0,14867456.0,3237448.0,8569265.0,11625518.0,1418100.0,1061819830.3545012,802316522.9249951,72220578488.93213,21708787993.83012,583533901.5569987,5792665.7475,689.5,94245.0,-277353344.5,21989808.0,-123970055.0,-219036575.5,-2026587.0,5929840951.987462,18753885000.0,198923232.825,448460214.5924977,1948107.735,257097825.2700008,309462695.16749865,637205435.5049977,459610113.5774992,5714761982.152535,5893075988.482497,5893319171.227499,13396.0,80976.5,44.0,70476.0,972578.0,-1701092.5,177364.0,6755.0,4279816.0,2483241.5,-9017551.0,921848.5,37582.5,3739709422.394958,3664368907.019957,-261033942.5,-257716634.0,2530339.5,269643.0,3932204229.607453,33302449693.03592,36735703445.40765,1732594927.02755,48157847375.60322,3994117.5,-247958923.5,103247457231.5,1056851938.5,17297657487.5,3509309803.0,18912601270.5,3677700.0,72047.5,20904.56463783328,89885912.0,,1.3421153846153846,17.555705604321403,1133.7137994505747,23.561782579338285,1521.574731993377,117000.0,0.6234898018587336,0.7818314824680298,0.0,0.0,0.0,0.0,0.0,0.0,1.0,0.0,0.0,1.0,0.0,0.0,0.0,0.0,0.0,0.0,0.0,0.0,1.0,0.0,1.0,0.0,0.0,0.0,0.0,1.0,0.0,0.0,0.0,0.0,0.0,0.0,0.0,0.0,0.0,0.0,0.0,0.0,0.0,0.0,0.0,0.0,0.0,0.0,0.0,0.0,0.0,0.0,0.0,0.0,0.0,0.0,0.0,0.0,0.0,0.0,0.0,0.0,0.0,0.0,0.0,0.0,0.0,0.0,0.0,0.0,0.0,0.0,0.0,0.0,0.0,0.0,0.0,0.0,0.0,0.0,0.0,0.0,0.0,0.0,0.0,0.0,0.0,0.0,0.0,0.0,0.0,0.0,0.0,0.0,0.0,0.0,0.0,0.0,0.0,0.0,0.0,0.0,0.0,0.0,0.0,0.0,0.0,0.0,0.0,1.0,0.0,0.0,0.0,0.0,0.0,0.0,0.0,0.0,0.0,0.0,0.0,0.0,0.0,0.0
105966,0,0.0,0.0,0.0,0.0,1.0,90000.0,234000.0,18238.5,234000.0,0.0088659999999999,29.126027397260277,-187.0,-1359.0,-1778.0,,3.0,2.0,2.0,10.0,0.6257173393551139,0.3427713154959965,0.4400578303966329,0.2639,,0.9851,,,0.08,0.0345,0.3333,,0.2187,,0.0713,,0.2154,0.2689,,0.9851,,,0.0806,0.0345,0.3333,,0.2236,,0.0743,,0.2281,0.2665,,0.9851,,,0.08,0.0345,0.3333,,0.2225,,0.0725,,0.2199,0.1093,1.0,2.0,0.0,2.0,0.0,0.0,0.0,0.0,0.0,0.0,0.0,4.0,1.0,1.0,0.0,1.0,0.0,0.0,0.0,0.0,0.0,0.0,0.0,0.0,0.0,1.0,0.0,0.0,0.0,0.0,0.0,0.0,0.0,0.0,0.0,0.0,0.0,0.0,0.0,0.0,0.0,0.0,0.0,0.0,6.0,13689.0,0.0,102705.75,2677.5,0.0,0.0,0.0,0.0,-437.5,322.0,-221.0,-678.0,130.0,-11.0,6.0,22500.0,268908.75,273849.75,1125.0,450000.0,24.0,-681.0,365243.0,-1273.0,-1153.0,-1041.0,-1145.0,13.0,0.0,0.0654030091935448,-1.0,31.0,10.0,5.0,-43.0,0.0,0.0,27.0,6519.42,4536.765,-1186.0,-1183.0,5.0,1.0,0.0,,,,,,,,,,,,,,,,,,,,,8359968996.0,184627614087.0,165788157654.0,52050239155.935,1863.0,1706.0,71127.0,71012.0,9141.0,506885.0,17835.451800002316,17897.794999999132,17348.577599997985,,,,128607.0,663822.0,,,,13547964.23013659,-602833143.0,-923304288.0,-296975724.0,-1537503037.0416667,44100.0,30763.0,11365.013999999192,11240.979999998986,10724.955299997288,22923.07840000984,22844.8563000098,22229.69010000836,67595.35973123008,158278.0903057169,126304.02986292554,35054.28250002805,34994.38990002849,34439.553100028905,,,,3719680.0,8308.422600000165,8413.158400000077,8136.500300000232,,,,16492.852499999713,16678.442899999696,16274.909799999696,,,,3919.170900000124,3902.4270000001625,3735.09740000016,437192.0,431980.0,,6434.660862002895,632913.0,626456.0,,16356.804199999791,154424.9963999908,154427.73849999034,154319.44019998715,,,,15.0,94036079.87999998,32816552.175000016,9878556942.67498,3265912026.944997,115135526.96999995,866315.3399999995,196.0,24583.0,-32244469.0,14463721.5,-16761595.0,-18235765.0,-7.0,0.0,0.0,159700.5,0.0,0.0,0.0,0.0,0.0,-770.0,-678.0,-563.0,-1246.0,342355861.170001,4872065196.825003,5466652570.125004,79587015.43499997,4872021288.075003,352571.0,-24444851.0,5693135807.0,253451573.0,1292377774.0,560422071.0,1357829200.0,351346.5,5504.0,1001.5835325469463,8110458.0,2914945.0,1797982.0,-5855548.0,1940691.0,246103.0,3848892069.915041,3897619710.525024,-234673897.0,-232715738.0,4142981.0,193671.0,,,,,,,,,,,,,,,,,,,,,1469712.0,14867586.0,3237448.0,8569296.0,11625545.0,1418106.0,1061833519.3545012,802316522.9249951,72220681194.68213,21708790671.33012,583533901.5569987,5792665.7475,689.5,94245.0,-277353782.0,21990130.0,-123970276.0,-219037253.5,-2026598.0,,,,,,,,,,,,,,,,,,,,,4279826.0,2483246.5,-9017594.0,921848.5,37582.5,3739715941.8149576,3664373443.784957,-261035128.5,-257717817.0,2530344.5,269644.0,3932226729.607453,33302718601.78592,36735977295.15765,1732596052.02755,48158297375.60322,3994141.5,-247959604.5,103247822474.5,1056850665.5,17297656334.5,3509308762.0,18912600125.5,3677713.0,72047.5,20904.630040842472,89885911.0,-6.4203743768225,2.6,4.934616333580063,143.72577052682095,12.830002467308168,373.6870033697346,30000.0,-0.9009688679024191,0.4338837391175582,0.0,0.0,0.0,0.0,0.0,0.0,1.0,0.0,0.0,0.0,0.0,0.0,0.0,1.0,0.0,0.0,1.0,0.0,0.0,0.0,1.0,0.0,0.0,0.0,0.0,1.0,0.0,0.0,0.0,0.0,0.0,0.0,0.0,1.0,0.0,0.0,0.0,0.0,0.0,0.0,0.0,0.0,0.0,0.0,0.0,0.0,0.0,0.0,0.0,0.0,0.0,0.0,0.0,0.0,0.0,0.0,0.0,0.0,0.0,0.0,0.0,0.0,0.0,0.0,0.0,0.0,0.0,0.0,0.0,0.0,0.0,0.0,0.0,0.0,0.0,0.0,1.0,0.0,0.0,0.0,0.0,0.0,0.0,0.0,0.0,0.0,0.0,0.0,0.0,0.0,0.0,0.0,0.0,0.0,0.0,0.0,0.0,0.0,0.0,0.0,0.0,0.0,0.0,0.0,0.0,0.0,0.0,0.0,0.0,0.0,1.0,0.0,0.0,0.0,0.0,0.0,0.0,0.0,1.0,0.0
105968,0,0.0,1.0,1.0,1.0,1.0,270000.0,324216.0,23719.5,256500.0,0.014464,34.512328767123286,-623.0,-6677.0,-1699.0,15.0,3.0,2.0,2.0,4.0,0.1414656774910347,0.6673994002356698,,0.301,0.1731,0.9856,0.8028,0.0174,0.32,0.2759,0.3333,0.375,0.313,0.2429,0.3173,0.0116,0.0243,0.3067,0.1797,0.9856,0.8105,0.0175,0.3222,0.2759,0.3333,0.375,0.3201,0.2654,0.3306,0.0117,0.0257,0.3039,0.1731,0.9856,0.8054,0.0175,0.32,0.2759,0.3333,0.375,0.3184,0.2471,0.3229999999999999,0.0116,0.0248,0.3498,1.0,3.0,0.0,3.0,0.0,-1998.0,,,,,,,1.0,1.0,0.0,1.0,0.0,1.0,0.0,0.0,0.0,0.0,0.0,0.0,0.0,0.0,0.0,0.0,0.0,0.0,1.0,0.0,0.0,0.0,0.0,0.0,0.0,0.0,0.0,0.0,0.0,0.0,0.0,0.0,0.0,,,,,,,,,,,,,0.0,,6.0,9182.61,132682.5,99814.5,0.0,132682.5,11.0,-665.0,365243.0,-832.0,-652.0,-502.0,-644.0,7.5,0.0,0.0,160.0,44.0,11.0,9.0,-27.5,0.0,0.0,43.0,9529.74,9529.74,-855.0,-832.0,6.0,1.0,15.0,0.0,45000.0,,0.0,,,0.0,,0.0,0.0,0.0,0.0,,0.0,,,0.0,-8.0,0.0,0.0,8359992715.5,184627938303.0,165788414154.0,52050509155.935,,,,,,,17835.752800002316,17898.09889999913,17348.884299997986,11313.7291000001,11251.488400000098,11198.932100000062,128608.0,663825.0,4143.922300000114,4141.610200000011,3952.0771000000927,13547998.742465356,-602833766.0,-923305987.0,-296977722.0,-1537509714.0416667,44100.0,30763.0,11365.333999999191,11241.299999998986,10725.277499997288,22923.35430000984,22845.1322000098,22229.96600000836,67595.50119690756,158278.75770511714,,35054.61580002805,34994.723200028486,34439.886400028896,22987.14909999587,22960.21219999545,22606.580499995685,3719684.0,8308.735600000166,8413.476800000077,8136.820400000231,9831.626600000718,9946.733800002154,10306.974699999631,16493.169799999712,16678.765899999697,16275.240399999697,829.4373000001773,814.6160000000459,760.534200000013,3919.195200000124,3902.451800000162,3735.12310000016,437195.0,431983.0,1264996.0,6434.675326002895,632915.0,626458.0,,16357.153999999791,154425.98199999082,154428.7240999904,154320.42579998716,77727.66119999635,78066.01040000658,78468.15910000671,,,,,,,,,,,,,,,,,,,,,,,,,,,342462181.00500095,4873370635.575003,5468186122.875004,79599948.43499997,4873370635.575003,352684.0,-24449612.0,5694962022.0,253812172.0,1293104269.0,560784650.0,1358555717.0,351425.5,5506.0,1001.6849138798716,8114741.0,2915739.0,1798457.0,-5857035.0,1940691.0,246103.0,3849405869.2500367,3898097291.520021,-234716232.0,-232756095.0,4143304.0,193722.0,3573891402.9299564,9655470000.0,,458199470.4749999,,,202408223.84999892,,464562333.31499743,3431258014.500011,3560948380.2599382,3561128838.3599367,,41342.0,,,1175764.0,-2085075.0,841763.0,1925.0,1469712.0,14867586.0,3237463.0,8569340.0,11625588.0,1418112.0,,,,,,,,,,,,,,5929840951.987462,18753930000.0,,448460214.5924977,,,309462695.16749865,,459610113.5774992,5714761982.152535,5893075988.482497,5893319171.227499,,80976.5,,,972578.0,-1701100.5,177364.0,6755.0,4279837.0,2483255.5,-9017621.5,921848.5,37582.5,3739725471.554957,3664382973.524957,-261035983.5,-257718649.0,2530350.5,269645.0,3932235912.217453,33302851284.28592,36736077109.65765,1732596052.02755,48158430058.10322,3994152.5,-247960269.5,103248187717.5,1056849833.5,17297655682.5,3509308260.0,18912599481.5,3677720.5,72047.5,20904.630040842472,89886071.0,-18.051520203222992,1.2008,11.383039271485488,392.85519370658267,13.668753557199771,471.74051660286455,90000.0,0.6234898018587334,-0.7818314824680299,0.0,1.0,0.0,0.0,0.0,0.0,0.0,0.0,0.0,0.0,1.0,0.0,0.0,0.0,0.0,0.0,0.0,0.0,1.0,0.0,1.0,0.0,0.0,0.0,0.0,1.0,0.0,0.0,0.0,0.0,0.0,0.0,0.0,1.0,0.0,0.0,0.0,0.0,0.0,0.0,0.0,0.0,0.0,0.0,0.0,0.0,0.0,0.0,0.0,0.0,0.0,0.0,0.0,0.0,0.0,0.0,0.0,0.0,0.0,0.0,0.0,0.0,0.0,0.0,0.0,0.0,0.0,0.0,0.0,0.0,0.0,0.0,0.0,0.0,0.0,0.0,0.0,0.0,0.0,1.0,0.0,0.0,0.0,0.0,0.0,0.0,0.0,0.0,0.0,0.0,0.0,0.0,0.0,0.0,0.0,0.0,0.0,0.0,0.0,0.0,0.0,0.0,0.0,0.0,0.0,0.0,0.0,0.0,1.0,0.0,1.0,0.0,0.0,0.0,0.0,0.0,0.0,0.0,1.0,0.0
105973,0,0.0,0.0,1.0,0.0,0.0,135000.0,225000.0,11488.5,225000.0,0.009334,47.624657534246566,-1836.0,-366.0,-545.0,6.0,2.0,2.0,2.0,9.0,,0.7266704001454548,0.5352762504724826,,,,,,,,,,,,,,,,,,,,,,,,,,,,,,,,,,,,,,,,,,,,1.0,6.0,0.0,6.0,0.0,-2046.0,0.0,0.0,0.0,0.0,0.0,5.0,1.0,1.0,0.0,1.0,0.0,0.0,0.0,0.0,0.0,0.0,0.0,0.0,0.0,1.0,0.0,0.0,0.0,0.0,0.0,0.0,0.0,0.0,0.0,0.0,0.0,0.0,0.0,0.0,0.0,0.0,0.0,0.0,11.0,2250.0,0.0,77850.0,0.0,0.0,0.0,0.0,0.0,-861.0,411.0,-156.0,-496.0,369.0,-18.0,18.0,6687.450000000002,45000.0,50433.75,0.0,45000.0,12.0,-928.0,365243.0,-1236.5,-1011.5,-882.5,-1005.0,14.5,0.5,0.0,35.0,130.0,18.0,7.0,-32.0,0.0,0.0,134.0,8175.825,6708.06,-941.0,-941.0,7.0,1.0,0.0,,,,,,,,,,,,,,,,,,,,,8360004204.0,184628163303.0,165788639154.0,52050644155.935,1863.0,1706.0,71127.0,71012.0,9141.0,506890.0,,,,,,,128608.0,663827.0,,,,13548046.36712289,-602835602.0,-923306532.0,-296979768.0,-1537510080.0416667,44100.0,30763.0,,,,,,,,158279.4843755173,126304.56513917603,,,,,,,3719693.0,,,,,,,,,,,,,,,,437201.0,431989.0,1265002.0,6434.684660002894,632917.0,626460.0,,,,,,,,,29.0,94141870.37999998,32844208.50000001,9886207448.56498,3270646377.989997,115165999.21499996,866315.3399999995,196.0,24583.0,-32276752.0,14485975.0,-16776547.0,-18252071.0,-14.0,0.0,0.0,79083.0,0.0,0.0,0.0,0.0,0.0,-1416.0,-496.0,-389.0,-496.0,342868307.89500093,4878224358.075003,5473493868.375004,79754815.93499997,4878243906.075003,353127.0,-24483570.0,5701719017.5,254155707.0,1293819206.0,560770469.0,1359270796.0,351805.5,5513.0,1003.3977024365925,8126468.5,2918926.0,1800308.0,-5864571.0,1940699.0,246111.0,3851954830.19254,3900469763.1150217,-234944499.5,-232982191.5,4144769.0,193967.5,,,,,,,,,,,,,,,,,,,,,1469723.0,14867955.0,3237463.0,8569470.0,11625722.0,1418130.0,1061835769.3545012,802316522.9249951,72220759044.68213,21708790671.33012,583533901.5569987,5792665.7475,689.5,94245.0,-277354643.0,21990541.0,-123970432.0,-219037749.5,-2026616.0,,,,,,,,,,,,,,,,,,,,,4279855.0,2483262.5,-9017653.5,921848.5,37582.5,3739733647.379957,3664389681.584957,-261036924.5,-257719590.0,2530357.5,269646.0,3932242599.667453,33302896284.28592,36736127543.40765,1732596052.02755,48158475058.10322,3994164.5,-247961197.5,103248552960.5,1056848597.0,17297654671.0,3509307377.5,18912598476.5,3677735.0,72048.0,20904.630040842472,89886106.0,-38.551458321348456,1.6666666666666667,11.750881316098706,559.6316984047776,19.584802193497847,932.719497341296,67500.0,-0.9009688679024191,0.4338837391175582,0.0,0.0,0.0,0.0,0.0,0.0,1.0,0.0,0.0,0.0,0.0,0.0,0.0,1.0,0.0,0.0,0.0,0.0,1.0,0.0,1.0,0.0,0.0,0.0,0.0,1.0,0.0,0.0,0.0,0.0,0.0,1.0,0.0,0.0,0.0,0.0,0.0,0.0,0.0,0.0,0.0,0.0,0.0,0.0,0.0,0.0,0.0,0.0,0.0,0.0,0.0,0.0,1.0,0.0,0.0,0.0,0.0,0.0,0.0,0.0,0.0,0.0,0.0,0.0,0.0,0.0,0.0,0.0,0.0,0.0,0.0,0.0,0.0,0.0,0.0,0.0,0.0,0.0,0.0,0.0,0.0,0.0,0.0,0.0,0.0,0.0,0.0,0.0,0.0,0.0,0.0,0.0,0.0,0.0,0.0,0.0,0.0,0.0,0.0,0.0,0.0,0.0,0.0,0.0,0.0,0.0,0.0,0.0,0.0,0.0,0.0,0.0,0.0,0.0,0.0,0.0,0.0,0.0,0.0,0.0
105976,0,0.0,0.0,0.0,0.0,0.0,90000.0,225000.0,16371.0,225000.0,0.0088659999999999,27.819178082191783,-1401.0,-3626.0,-1037.0,,2.0,2.0,2.0,15.0,,0.3588854178504576,,0.0124,,0.9791,,,0.0,0.069,0.0417,,,,0.009,,,0.0126,,0.9791,,,0.0,0.069,0.0417,,,,0.0094,,,0.0125,,0.9791,,,0.0,0.069,0.0417,,,,0.0092,,,0.0071,1.0,3.0,0.0,3.0,0.0,-1349.0,0.0,0.0,0.0,0.0,0.0,0.0,1.0,1.0,1.0,1.0,0.0,0.0,0.0,0.0,0.0,0.0,1.0,1.0,0.0,1.0,0.0,0.0,0.0,0.0,0.0,0.0,0.0,0.0,0.0,0.0,0.0,0.0,0.0,0.0,0.0,0.0,0.0,0.0,1.0,0.0,,173250.0,94122.0,,0.0,0.0,0.0,-841.0,984.0,-8.0,,28.0,-13.5,3.0,5940.675,47340.0,52024.5,0.0,47340.0,10.0,-1179.0,365243.0,-1148.0,-638.0,-638.0,-226.0,11.0,0.0,0.0,108.0,46.0,18.0,4.0,-23.5,0.0,0.0,42.0,9968.94,5940.675,-772.5,-758.0,7.5,1.0,0.0,,,,,,,,,,,,,,,,,,,,,8360020575.0,184628388303.0,165788864154.0,52050734155.935,1863.0,1706.0,71127.0,71012.0,9141.0,506890.0,17835.765200002315,17898.111399999132,17348.896899997984,,,,128608.0,663829.0,,,,13548074.186300972,-602837003.0,-923307569.0,-296981117.0,-1537513706.0416667,44100.0,30763.0,11365.333999999191,11241.299999998986,10725.277499997288,22923.42330000984,22845.2012000098,22230.03500000836,,158279.84326093513,,35054.65750002805,34994.76490002849,34439.928100028905,,,,3719708.0,,,,,,,16493.17879999971,16678.775099999693,16275.249799999698,,,,,,,437204.0,431992.0,,6434.693526002894,632919.0,626462.0,,16357.161099999792,154426.96109999082,154429.70319999038,154321.40489998716,,,,28.0,94150870.37999998,,9886758233.17498,3270902256.989997,,866315.3399999995,196.0,24583.0,-32282205.0,14486029.0,-16778419.0,,-13.5,0.0,,173250.0,94122.0,,0.0,0.0,0.0,-841.0,984.0,-8.0,,343101399.70500094,4881173638.725002,5476583626.875004,79807946.08499998,4881173638.725002,353294.0,-24497535.0,5705554069.0,254143310.0,1294539412.0,560761669.0,1359991482.0,351991.0,5515.0,1003.7588383838328,8129986.0,2921461.0,1801713.0,-5868953.0,1940708.0,246111.0,3855661790.4450502,3904186185.270032,-235068483.0,-233105852.0,4146299.0,194167.5,,,,,,,,,,,,,,,,,,,,,1469724.0,14867983.0,3237463.0,8569516.0,11625764.0,1418133.0,1061835769.3545012,,72220932294.68213,21708884793.33012,,5792665.7475,689.5,94245.0,-277355484.0,21991525.0,-123970440.0,,-2026629.5,,,,,,,,,,,,,,,,,,,,,4279873.0,2483266.5,-9017677.0,921848.5,37582.5,3739743616.319957,3664395622.259957,-261037697.0,-257720348.0,2530365.0,269647.0,3932248540.342453,33302943624.28592,36736179567.90765,1732596052.02755,48158522398.10322,3994174.5,-247962376.5,103248918203.5,1056847449.0,17297654033.0,3509306739.5,18912598250.5,3677746.0,72048.0,20904.630040842472,89886214.0,-50.36094150088636,2.5,5.497526113249038,152.9366579559746,13.743815283122595,382.3416448899365,45000.0,1.0,0.0,0.0,0.0,0.0,0.0,0.0,0.0,1.0,0.0,0.0,0.0,0.0,0.0,0.0,1.0,0.0,0.0,0.0,0.0,1.0,0.0,1.0,0.0,0.0,0.0,0.0,1.0,0.0,0.0,0.0,0.0,0.0,0.0,0.0,0.0,0.0,0.0,0.0,0.0,0.0,0.0,0.0,0.0,0.0,0.0,1.0,0.0,0.0,0.0,0.0,1.0,0.0,0.0,0.0,0.0,0.0,0.0,0.0,0.0,0.0,0.0,0.0,0.0,0.0,0.0,0.0,0.0,0.0,0.0,0.0,0.0,0.0,0.0,0.0,0.0,0.0,0.0,0.0,0.0,0.0,0.0,0.0,0.0,0.0,0.0,0.0,0.0,0.0,0.0,0.0,0.0,0.0,0.0,0.0,0.0,0.0,0.0,0.0,0.0,0.0,0.0,0.0,0.0,0.0,0.0,0.0,0.0,0.0,0.0,0.0,0.0,1.0,0.0,0.0,0.0,0.0,0.0,0.0,0.0,0.0,1.0
105978,0,0.0,0.0,0.0,0.0,1.0,135000.0,817560.0,30820.5,675000.0,0.00702,37.145205479452045,-1733.0,-7585.0,-1925.0,,3.0,2.0,2.0,16.0,0.3658683220457285,0.5725886924647053,0.3556387169923543,0.1608,0.1259,0.9846,0.7892,0.1467,0.28,0.2414,0.3333,0.375,0.0344,0.1306,0.1733,0.0025,0.0509,0.105,0.084,0.9841,0.7909,0.0277,0.1611,0.1379,0.3333,0.375,0.0,0.0909,0.1105,0.0039,0.0048,0.1499,0.0917,0.9846,0.792,0.0361,0.2,0.1724,0.3333,0.375,0.0351,0.1223,0.1547,0.0039,0.0637,0.2836,1.0,8.0,1.0,8.0,0.0,-319.0,0.0,0.0,0.0,1.0,0.0,2.0,1.0,1.0,0.0,1.0,0.0,0.0,0.0,0.0,0.0,0.0,0.0,0.0,0.0,1.0,0.0,0.0,0.0,0.0,0.0,0.0,0.0,0.0,0.0,0.0,0.0,0.0,0.0,0.0,0.0,0.0,0.0,0.0,15.0,7299.0,0.0,90000.0,0.0,0.0,0.0,0.0,0.0,-769.0,-211.0,-99.0,-677.5,459.0,-17.0,5.0,3647.385,19710.0,20686.5,0.0,25960.5,9.0,-1571.0,365243.0,-2497.5,-2287.5,-2257.5,-2284.0,11.0,0.5,0.0,28.0,17.0,11.0,4.0,-75.0,0.0,0.0,18.0,3142.98,3142.98,-2249.5,-2232.0,4.5,1.0,0.0,,,,,,,,,,,,,,,,,,,,,8360051395.5,184629205863.0,165789539154.0,52050869155.935,1863.0,1706.0,71128.0,71012.0,9141.0,506892.0,17835.926000002317,17898.261299999132,17349.001899997984,11313.855000000098,11251.5801000001,11199.016100000064,128609.0,663832.0,4144.069000000114,4141.646300000011,3952.104800000093,13548111.331506452,-602838736.0,-923309494.0,-296981436.0,-1537521291.0416667,44101.0,30763.0,11365.613999999194,11241.499999998989,10725.438599997287,22923.66470000984,22845.3736000098,22230.17290000836,67595.8670652296,158280.4158496276,126304.92077789304,35054.99080002805,34995.098200028486,34440.261400028896,22987.52409999587,22960.58719999545,22606.955499995685,3719724.0,8308.770000000166,8413.511900000076,8136.820400000231,9831.75720000072,9946.856100002156,10307.06559999963,16493.35209999971,16678.929799999696,16275.360299999697,829.4398000001773,814.6199000000461,760.5381000000132,3919.246100000124,3902.515500000163,3735.127900000161,437212.0,432000.0,,6434.700546002894,632921.0,626464.0,,16357.444699999793,154427.9456999908,154430.68779999038,154322.38899998716,77728.45039999635,78066.80240000658,78468.95000000673,26.0,94158214.37999998,32844208.50000001,9889043202.67498,3272285291.489997,115166866.99499996,866315.3399999995,196.0,24583.0,-32289235.0,14516381.5,-16778975.0,-18256456.0,-12.5,7344.0,0.0,55926.0,0.0,0.0,0.0,0.0,0.0,-1206.0,-617.0,-323.0,-785.0,343245825.49500096,4882399006.725002,5478532045.875004,79809251.08499998,4882399006.725002,353495.0,-24509069.0,5707562905.5,254500851.5,1294899181.5,561121013.5,1360351268.0,352144.0,5517.5,1003.8088837591516,8130175.0,2922367.0,1802086.0,-5871434.0,1940736.0,246139.0,3856385566.93505,3904792616.8800297,-235152961.0,-233189700.0,4146820.5,194230.5,,,,,,,,,,,,,,,,,,,,,1469739.0,14868442.0,3237463.0,8569533.0,11625782.0,1418138.0,1061843068.3545012,802316522.9249951,72221022294.68213,21708884793.33012,583533901.5569987,5792665.7475,689.5,94245.0,-277356253.0,21991314.0,-123970539.0,-219038427.0,-2026646.5,,,,,,,,,,,,,,,,,,,,,4279884.0,2483270.5,-9017752.0,921848.5,37582.5,3739746759.299957,3664398765.239957,-261039946.5,-257722580.0,2530369.5,269648.0,3932252187.727453,33302963334.28592,36736200254.40765,1732596052.02755,48158548358.60322,3994183.5,-247963947.5,103249283446.5,1056844951.5,17297651745.5,3509304482.0,18912595966.5,3677757.0,72048.5,20904.630040842472,89886242.0,-46.65474258740228,6.056,4.380201489268506,162.70348436028058,26.52650021901008,985.3323012858592,45000.0,0.6234898018587336,0.7818314824680298,0.0,0.0,0.0,0.0,0.0,0.0,1.0,0.0,0.0,0.0,1.0,0.0,0.0,0.0,0.0,1.0,0.0,0.0,0.0,0.0,1.0,0.0,0.0,0.0,0.0,1.0,0.0,0.0,0.0,0.0,0.0,0.0,0.0,1.0,0.0,0.0,0.0,0.0,0.0,0.0,0.0,0.0,0.0,0.0,0.0,0.0,0.0,0.0,0.0,0.0,0.0,0.0,0.0,0.0,0.0,0.0,0.0,0.0,0.0,0.0,0.0,0.0,0.0,0.0,0.0,0.0,0.0,0.0,0.0,0.0,0.0,0.0,0.0,0.0,0.0,0.0,0.0,0.0,1.0,0.0,0.0,0.0,0.0,0.0,0.0,0.0,0.0,0.0,0.0,0.0,0.0,0.0,0.0,0.0,0.0,0.0,0.0,0.0,0.0,0.0,0.0,0.0,0.0,0.0,0.0,0.0,0.0,1.0,0.0,0.0,1.0,0.0,0.0,0.0,0.0,0.0,0.0,1.0,0.0,0.0
105979,0,0.0,1.0,1.0,1.0,0.0,292500.0,1441687.5,46638.0,1237500.0,0.020713,39.01643835616439,-2641.0,-156.0,-4908.0,16.0,2.0,3.0,2.0,13.0,0.6516178094389321,0.5210861197360144,0.5762088360175724,0.1763,0.1604,0.9866,0.8164,0.04,0.24,0.2069,0.3333,0.0417,0.0781,0.1437,0.2239,0.0,0.0,0.1796,0.1664,0.9866,0.8236,0.0404,0.2417,0.2069,0.3333,0.0417,0.0799,0.157,0.2332,0.0,0.0,0.178,0.1604,0.9866,0.8189,0.0403,0.24,0.2069,0.3333,0.0417,0.0795,0.1462,0.2279,0.0,0.0,0.2004,1.0,7.0,0.0,7.0,0.0,0.0,0.0,0.0,0.0,0.0,0.0,2.0,1.0,1.0,0.0,1.0,0.0,0.0,0.0,0.0,0.0,0.0,0.0,0.0,0.0,1.0,0.0,0.0,0.0,0.0,0.0,0.0,0.0,0.0,0.0,0.0,0.0,0.0,0.0,0.0,0.0,0.0,0.0,0.0,6.0,35689.5,0.0,182436.795,274464.0,0.0,0.0,0.0,0.0,-843.0,438.0,-16.5,-628.0,197.0,-16.0,3.0,5690.295,49941.0,49693.5,4995.0,49941.0,12.0,-805.0,365243.0,-770.0,-650.0,-80.0,-629.0,13.0,0.0,0.0994726330199052,25.0,28.0,12.0,5.0,-27.5,0.0,0.0,22.0,5690.25,5690.25,-812.5,-801.0,4.0,1.0,0.0,,,,,,,,,,,,,,,,,,,,,8360098033.5,184630647550.5,165790776654.0,52051161655.935,1863.0,1706.0,71128.0,71012.0,9141.0,506894.0,17836.102300002316,17898.439299999132,17349.181499997983,11314.015400000098,11251.7405000001,11199.182500000064,128609.0,663834.0,4144.109000000114,4141.686600000011,3952.1452000000927,13548150.347944807,-602841377.0,-923314402.0,-296981436.0,-1537521447.0416667,44101.0,30763.0,11365.853999999194,11241.739999998988,10725.680299997288,22923.87160000984,22845.5805000098,22230.379800008363,67596.51868303903,158280.93693574733,126305.49698672903,35055.324100028054,34995.431500028484,34440.594700028894,22987.565799995868,22960.62889999545,22606.997199995683,3719737.0,8308.848100000167,8413.591400000076,8136.900300000232,9831.90090000072,9947.002300002154,10307.22259999963,16493.57599999971,16679.157699999698,16275.5934999997,829.4398000001773,814.6199000000461,760.5381000000132,3919.246100000124,3902.515500000163,3735.127900000161,437219.0,432007.0,1265018.0,6434.721259002894,632924.0,626466.0,,16357.645099999792,154428.93229999082,154431.67439999038,154323.37559998714,77729.26679999635,78067.62130000658,78469.77360000672,28.0,94251917.87999998,32846464.12500001,9892872435.91498,3273581642.489997,115166866.99499996,866315.3399999995,196.0,24583.0,-32301229.0,14513615.0,-16785151.0,-18262681.0,-13.5,71442.0,0.0,270000.0,274464.0,0.0,0.0,0.0,0.0,-1354.0,473.0,-13.0,-628.0,343265484.55500096,4882692757.725002,5478784054.875004,79854251.08499998,4882692757.725002,353528.0,-24513113.0,5708476013.0,254498575.0,1294897235.0,561119652.0,1360349346.0,352190.0,5519.0,1004.0087169534802,8130239.0,2922603.0,1802256.0,-5872324.0,1940736.0,246139.0,3856687192.372549,3905091206.4825296,-235178527.5,-233214978.0,4146895.5,194252.5,,,,,,,,,,,,,,,,,,,,,1469745.0,14868639.0,3237463.0,8569561.0,11625804.0,1418141.0,1061878757.8545012,802316522.9249951,72221204731.47713,21709159257.33012,583533901.5569987,5792665.7475,689.5,94245.0,-277357096.0,21991752.0,-123970555.5,-219039055.0,-2026662.5,,,,,,,,,,,,,,,,,,,,,4279896.0,2483275.5,-9017779.5,921848.5,37582.5,3739752449.549957,3664404455.489957,-261040759.0,-257723381.0,2530373.5,269649.0,3932257878.022453,33303013275.28592,36736249947.90765,1732601047.02755,48158598299.60322,3994195.5,-247964752.5,103249648689.5,1056844181.5,17297651095.5,3509304402.0,18912595337.5,3677770.0,72048.5,20904.729513475493,89886267.0,-67.68941787795801,4.928846153846154,6.271709764569664,244.69977741708647,30.91229255113856,1206.0875567692171,146250.0,-0.9009688679024191,0.4338837391175582,0.0,0.0,0.0,0.0,0.0,1.0,0.0,0.0,0.0,0.0,0.0,0.0,0.0,1.0,0.0,1.0,0.0,0.0,0.0,0.0,1.0,0.0,0.0,0.0,0.0,1.0,0.0,0.0,0.0,0.0,0.0,0.0,0.0,0.0,0.0,0.0,1.0,0.0,0.0,0.0,0.0,0.0,0.0,0.0,0.0,0.0,0.0,0.0,0.0,0.0,0.0,0.0,0.0,0.0,0.0,1.0,0.0,0.0,0.0,0.0,0.0,0.0,0.0,0.0,0.0,0.0,0.0,0.0,0.0,0.0,0.0,0.0,0.0,0.0,0.0,0.0,0.0,0.0,0.0,0.0,0.0,0.0,0.0,0.0,0.0,0.0,0.0,0.0,0.0,0.0,0.0,0.0,0.0,0.0,0.0,0.0,0.0,0.0,0.0,0.0,0.0,0.0,0.0,0.0,0.0,0.0,0.0,0.0,1.0,0.0,1.0,0.0,0.0,0.0,0.0,0.0,0.0,1.0,0.0,0.0
105991,0,0.0,0.0,1.0,1.0,1.0,157500.0,104256.0,11074.5,90000.0,0.006305,33.98630136986301,-1582.0,-5982.0,-2167.0,11.0,3.0,3.0,3.0,5.0,0.094489241929324,0.5947800668761665,,,,,,,,,,,,,,,,,,,,,,,,,,,,,,,,,,,,,,,,,,,,,,0.0,0.0,0.0,0.0,0.0,,,,,,,1.0,1.0,0.0,1.0,0.0,0.0,0.0,0.0,0.0,0.0,0.0,0.0,0.0,1.0,0.0,0.0,0.0,0.0,0.0,0.0,0.0,0.0,0.0,0.0,0.0,0.0,0.0,0.0,0.0,0.0,0.0,0.0,0.0,,,,,,,,,,,,,0.0,,0.0,,,,,,,,,,,,,,,,,0.0,,,,,,0.0,,,,,,,0.0,,,,,,,,,,,,,,,,,,,,,8360109108.0,184630751806.5,165790866654.0,52051319155.935,,,,,,,,,,,,,128610.0,663837.0,,,,13548184.334246175,-602842959.0,-923316569.0,-296981436.0,-1537527429.0416667,44101.0,30763.0,,,,,,,67596.61317228098,158281.5317158142,,,,,,,,3719742.0,,,,,,,,,,,,,,,,437219.0,432007.0,1265029.0,6434.727564002895,632927.0,626469.0,,,,,,,,,,,,,,,,,,,,,,,,,,,,,,,,,,,,,,,,,,,,,,,,,,,,,,,,,,,,,,,,,,,,,,,,,,,,,,,,,,1469745.0,14868639.0,3237463.0,8569561.0,11625804.0,1418141.0,,,,,,,,,,,,,,,,,,,,,,,,,,,,,,,,,,,,,,,,,,,,,,,,,,,,,,,,,,,,,-46.54816606207174,0.6619428571428572,14.221861032100772,483.3484550772879,9.414059325477448,319.94905734944587,52500.0,0.6234898018587336,0.7818314824680298,0.0,0.0,0.0,0.0,0.0,0.0,1.0,0.0,0.0,0.0,0.0,0.0,0.0,1.0,0.0,1.0,0.0,0.0,0.0,1.0,0.0,0.0,0.0,0.0,0.0,1.0,0.0,0.0,0.0,0.0,0.0,0.0,0.0,0.0,0.0,0.0,0.0,0.0,1.0,0.0,0.0,0.0,0.0,0.0,0.0,0.0,0.0,0.0,0.0,0.0,0.0,0.0,0.0,0.0,0.0,0.0,0.0,0.0,0.0,0.0,0.0,0.0,0.0,0.0,0.0,0.0,0.0,0.0,1.0,0.0,0.0,0.0,0.0,0.0,0.0,0.0,0.0,0.0,0.0,0.0,0.0,0.0,0.0,0.0,0.0,0.0,0.0,0.0,0.0,0.0,0.0,0.0,0.0,0.0,0.0,0.0,0.0,0.0,0.0,0.0,0.0,0.0,0.0,0.0,0.0,0.0,0.0,0.0,0.0,0.0,0.0,0.0,0.0,0.0,0.0,0.0,0.0,0.0,0.0,0.0
105998,0,0.0,0.0,1.0,1.0,0.0,247500.0,964575.0,31113.0,675000.0,0.018634,38.42739726027396,-866.0,-6791.0,-5074.0,9.0,2.0,2.0,2.0,17.0,0.2345579677102997,0.6279034800557356,0.1624419982223248,,,,,,,,,,,,,,,,,,,,,,,,,,,,,,,,,,,,,,,,,,,,,0.0,0.0,0.0,0.0,-269.0,0.0,0.0,0.0,0.0,0.0,1.0,1.0,1.0,1.0,1.0,1.0,0.0,0.0,1.0,1.0,0.0,1.0,1.0,0.0,1.0,0.0,0.0,0.0,0.0,0.0,0.0,0.0,0.0,0.0,0.0,0.0,0.0,0.0,0.0,0.0,0.0,0.0,0.0,6.0,40500.0,0.0,389541.42,0.0,0.0,0.0,0.0,0.0,-917.5,54.5,-91.5,-453.0,229.0,-20.0,3.0,3984.9975,42016.5,41557.5,3366.0,42016.5,12.0,-1691.0,365243.0,-1980.0,-1755.0,-1650.0,-1745.5,17.0,0.0,0.1000305742050259,163.0,19.0,10.0,4.0,-68.0,0.0,0.0,17.0,3683.745,3683.745,-2094.0,-2060.0,5.0,1.0,0.0,,,,,,,,,,,,,,,,,,,,,8360140221.0,184631716381.5,165791541654.0,52051566655.935,1863.0,1706.0,71128.0,71012.0,9141.0,506895.0,,,,,,,128610.0,663839.0,,,,13548222.761643438,-602843825.0,-923321643.0,-296981705.0,-1537534220.0416667,44101.0,30763.0,,,,,,,67596.84773024869,158282.15961929425,126305.65942872726,,,,,,,3719759.0,,,,,,,,,,,,,,,,437219.0,432007.0,1265038.0,6434.746198002894,632929.0,626471.0,,,,,,,,,30.5,95028998.84999998,32861083.95000001,9928725226.42498,3283470778.364997,115220075.30999996,866315.3399999995,196.0,24583.0,-32411631.5,14601641.0,-16835731.5,-18316914.0,-14.75,40500.0,0.0,176082.84,0.0,0.0,0.0,0.0,0.0,-1538.0,-180.0,-6.0,-1105.0,344044997.12250113,4895028031.2750025,5493331771.875004,79956373.63499998,4895028031.2750025,354602.0,-24560540.0,5720344008.5,254830137.0,1297065145.0,561833698.0,1362884550.0,352995.0,5529.0,1005.4560861995348,8140395.0,2930463.0,1807201.0,-5883396.0,1940779.0,246179.0,3863802773.25006,3911982667.155042,-235839654.0,-233869142.0,4166869.0,194659.0,,,,,,,,,,,,,,,,,,,,,1469751.0,14868868.0,3237463.0,8569580.0,11625821.0,1418144.0,1061919257.8545012,802316522.9249951,72221594272.89713,21709159257.33012,583533901.5569987,5792665.7475,689.5,94245.0,-277358013.5,21991806.5,-123970647.0,-219039508.0,-2026682.5,,,,,,,,,,,,,,,,,,,,,4279906.0,2483279.5,-9017847.5,921848.5,37582.5,3739756133.294957,3664408139.234957,-261042853.0,-257725441.0,2530378.5,269650.0,3932261863.019953,33303055291.78592,36736291505.40765,1732604413.02755,48158640316.10322,3994207.5,-247966443.5,103250013932.5,1056842201.5,17297649340.5,3509302752.0,18912593592.0,3677787.0,72048.5,20904.8295440497,89886430.0,-22.53600456295452,3.897272727272728,7.954874168354063,305.6851098228332,31.00231414521261,1191.338241645896,123750.0,-0.2225209339563143,0.9749279121818236,0.0,0.0,0.0,0.0,0.0,0.0,1.0,0.0,0.0,0.0,0.0,0.0,0.0,1.0,0.0,1.0,0.0,0.0,0.0,0.0,1.0,0.0,0.0,0.0,0.0,1.0,0.0,0.0,0.0,0.0,0.0,0.0,0.0,1.0,0.0,0.0,0.0,0.0,0.0,0.0,0.0,0.0,0.0,0.0,0.0,0.0,0.0,0.0,0.0,0.0,0.0,0.0,0.0,0.0,0.0,0.0,0.0,0.0,0.0,0.0,0.0,0.0,0.0,0.0,0.0,0.0,0.0,0.0,0.0,0.0,0.0,0.0,0.0,0.0,0.0,0.0,0.0,0.0,0.0,0.0,0.0,0.0,0.0,0.0,0.0,0.0,0.0,0.0,0.0,0.0,0.0,0.0,0.0,0.0,0.0,0.0,0.0,0.0,1.0,0.0,0.0,0.0,0.0,0.0,0.0,0.0,0.0,0.0,0.0,0.0,0.0,0.0,0.0,0.0,0.0,0.0,0.0,0.0,0.0,0.0
105999,0,0.0,0.0,1.0,1.0,3.0,202500.0,224149.5,23665.5,193500.0,0.019101,37.09315068493151,-1527.0,-7001.0,-4298.0,12.0,5.0,2.0,2.0,10.0,0.3242973037512864,0.7011998926560473,0.4902575124990026,,,,,,,,,,,,,,,,,,,,,,,,,,,,,,,,,,,,,,,,,,,,,0.0,0.0,0.0,0.0,-1434.0,0.0,0.0,0.0,0.0,1.0,1.0,1.0,1.0,0.0,1.0,0.0,0.0,0.0,0.0,0.0,0.0,0.0,0.0,0.0,1.0,0.0,0.0,0.0,0.0,0.0,0.0,0.0,0.0,0.0,0.0,0.0,0.0,0.0,0.0,0.0,0.0,0.0,0.0,4.0,0.0,,117679.5,0.0,0.0,0.0,0.0,0.0,-1178.0,-630.0,-591.0,-940.0,160.0,-19.5,6.0,8158.095,48851.50500000001,49202.50500000001,0.0,57567.51,10.0,-547.5,365243.0,-744.0,-54.0,-54.0,-48.0,13.5,0.0,0.0,56.5,53.0,10.0,6.5,-11.0,0.0,0.0,48.0,8158.095,8158.095,-297.5,-288.5,6.0,1.0,0.0,,,,,,,,,,,,,,,,,,,,,8360163886.5,184631940531.0,165791735154.0,52051769155.935,1863.0,1706.0,71128.0,71013.0,9141.0,506896.0,,,,,,,128613.0,663844.0,,,,13548259.854794122,-602845352.0,-923325941.0,-296983139.0,-1537541221.0416667,44101.0,30763.0,,,,,,,67597.17202755244,158282.8608191869,126306.1496862398,,,,,,,3719769.0,,,,,,,,,,,,,,,,437219.0,432007.0,1265050.0,6434.765299002895,632931.0,626473.0,,,,,,,,,39.0,95069498.84999998,,9930006596.92498,3284142929.864997,115220075.30999996,866315.3399999995,196.0,24583.0,-32416364.5,14600478.0,-16837913.5,-18318665.0,-19.0,0.0,,115074.0,0.0,0.0,0.0,0.0,0.0,-1336.0,-970.0,-940.0,-940.0,344074071.24000114,4895286166.530004,5493590147.880004,79960473.13499998,4895314950.285003,354632.0,-24562886.5,5721622359.0,254827145.0,1297427067.0,561831387.0,1363246496.0,353053.0,5529.0,1005.6684950666258,8140574.0,2930761.0,1807367.0,-5884498.0,1940779.0,246179.0,3864093852.442559,3912273746.347541,-235869010.0,-233898161.0,4167008.0,194692.5,,,,,,,,,,,,,,,,,,,,,1469755.0,14869028.0,3237463.0,8569633.0,11625869.0,1418150.0,1061919257.8545012,,72221711952.39713,21709159257.33012,583533901.5569987,5792665.7475,689.5,94245.0,-277359191.5,21991176.5,-123971238.0,-219040448.0,-2026702.0,,,,,,,,,,,,,,,,,,,,,4279916.0,2483286.0,-9017858.5,921848.5,37582.5,3739764291.389957,3664416297.329957,-261043150.5,-257725729.5,2530384.5,269651.0,3932270021.114953,33303104143.29092,36736340707.91264,1732604413.02755,48158697883.61322,3994217.5,-247966991.0,103250379175.5,1056841457.5,17297649286.5,3509302698.0,18912593544.0,3677800.5,72048.5,20904.8295440497,89886486.5,-41.1666297363173,1.1069111111111112,8.556759840273816,317.3971821300472,9.471572542308424,351.3304675351062,40500.0,-0.2225209339563146,-0.9749279121818236,0.0,0.0,0.0,0.0,0.0,0.0,1.0,0.0,0.0,0.0,0.0,0.0,0.0,1.0,0.0,0.0,0.0,0.0,1.0,0.0,1.0,0.0,0.0,0.0,0.0,1.0,0.0,0.0,0.0,0.0,0.0,0.0,0.0,0.0,0.0,0.0,0.0,0.0,1.0,0.0,0.0,0.0,0.0,0.0,0.0,0.0,0.0,0.0,0.0,0.0,0.0,0.0,0.0,1.0,0.0,0.0,0.0,0.0,0.0,0.0,0.0,0.0,0.0,0.0,0.0,0.0,0.0,0.0,0.0,0.0,0.0,0.0,0.0,0.0,0.0,0.0,0.0,0.0,0.0,0.0,0.0,0.0,0.0,0.0,0.0,0.0,0.0,0.0,0.0,0.0,0.0,0.0,0.0,0.0,0.0,0.0,0.0,0.0,0.0,0.0,0.0,0.0,0.0,0.0,0.0,0.0,0.0,0.0,0.0,0.0,0.0,0.0,0.0,0.0,0.0,0.0,0.0,0.0,0.0,0.0
106000,0,0.0,1.0,1.0,1.0,0.0,90000.0,360000.0,22153.5,360000.0,0.018209,62.361643835616434,,-2110.0,-12.0,34.0,2.0,3.0,3.0,6.0,,0.2455925655188868,0.3062022983135042,,,,,,,,,,,,,,,,,,,,,,,,,,,,,,,,,,,,,,,,,,,,,5.0,0.0,5.0,0.0,0.0,0.0,0.0,0.0,0.0,0.0,0.0,1.0,0.0,0.0,1.0,0.0,1.0,0.0,0.0,0.0,0.0,0.0,0.0,0.0,1.0,0.0,0.0,0.0,0.0,0.0,0.0,0.0,0.0,0.0,0.0,0.0,0.0,0.0,0.0,0.0,0.0,0.0,0.0,4.0,11686.5,1210.5,768768.75,112617.0,0.0,0.0,0.0,0.0,-508.5,900.0,-129.5,-497.0,98.0,-12.0,2.0,8578.4625,125655.75,127795.5,6880.5,125655.75,21.0,-2458.0,365243.0,-2427.0,-1857.0,-1827.0,-1852.5,9.0,0.0,0.0577219314360983,578.0,41.0,24.0,10.0,-75.0,0.0,0.0,40.0,5408.37,5408.37,-2285.5,-2276.0,10.5,1.0,0.0,,,,,,,,,,,,,,,,,,,,,8360186040.0,184632300531.0,165792095154.0,52051859155.935,1863.0,1706.0,71128.0,71013.0,9141.0,506896.0,,,,,,,128613.0,663846.0,,,,13548322.216437958,,-923325953.0,-296983139.0,-1537543331.0416667,44101.0,30763.0,,,,,,,,158283.1064117524,126306.45588853813,,,,,,,3719775.0,,,,,,,,,,,,,,,,437224.0,432012.0,1265084.0,6434.783508002894,632934.0,626476.0,,,,,,,,,17.5,95083624.34999998,32862294.45000001,9931580415.67498,3284467847.864997,115220075.30999996,867111.8399999995,196.0,24817.0,-32419196.0,14602397.0,-16838945.0,-18320480.0,-8.25,4878.0,1210.5,1076737.5,112617.0,0.0,0.0,0.0,0.0,-1526.0,-430.0,-497.0,-497.0,344105668.5750011,4895658442.035003,5493995185.635004,79975381.63499998,4895658442.035003,354690.0,-24568276.0,5722900709.5,254821961.5,1297424438.5,561827952.5,1363243873.0,353106.5,5529.0,1005.9380968434076,8141745.0,2931739.0,1807862.0,-5886210.0,1940779.0,246179.0,3864519510.615051,3912699404.520034,-235918983.0,-233947612.5,4167478.5,194737.5,,,,,,,,,,,,,,,,,,,,,1469759.0,14869126.0,3237463.0,8569674.0,11625909.0,1418152.0,1061930944.3545012,802317733.4249951,72222480721.14713,21709271874.33012,583533901.5569987,5792665.7475,689.5,94245.0,-277359700.0,21992076.5,-123971367.5,-219040945.0,-2026714.0,,,,,,,,,,,,,,,,,,,,,4279940.0,2483296.0,-9017933.5,921848.5,37582.5,3739769699.759957,3664421705.699957,-261045436.0,-257728005.5,2530395.0,269652.0,3932278599.577453,33303229799.04092,36736468503.41264,1732611293.52755,48158823539.36322,3994238.5,-247969449.0,103250744418.5,1056839030.5,17297647429.5,3509300871.0,18912591691.5,3677809.5,72048.5,20904.88726598113,89887064.5,,4.0,4.062563477554336,253.34813664682684,16.250253910217346,1013.3925465873076,45000.0,1.0,0.0,0.0,1.0,0.0,0.0,0.0,0.0,0.0,0.0,0.0,1.0,0.0,0.0,0.0,0.0,0.0,0.0,0.0,1.0,0.0,0.0,1.0,0.0,0.0,0.0,0.0,1.0,0.0,0.0,0.0,0.0,0.0,0.0,0.0,0.0,0.0,0.0,0.0,0.0,0.0,0.0,0.0,0.0,0.0,0.0,0.0,0.0,0.0,0.0,0.0,0.0,0.0,0.0,0.0,0.0,0.0,0.0,0.0,0.0,0.0,0.0,0.0,0.0,0.0,0.0,0.0,0.0,0.0,0.0,0.0,0.0,0.0,0.0,0.0,0.0,0.0,0.0,0.0,0.0,0.0,0.0,0.0,0.0,0.0,0.0,0.0,0.0,0.0,0.0,0.0,0.0,0.0,0.0,0.0,0.0,0.0,0.0,0.0,0.0,0.0,0.0,0.0,0.0,0.0,0.0,0.0,1.0,0.0,0.0,0.0,0.0,0.0,0.0,0.0,0.0,0.0,0.0,0.0,0.0,0.0,0.0
106001,0,0.0,0.0,0.0,1.0,0.0,67500.0,52128.0,5472.0,45000.0,0.0088659999999999,46.71232876712329,-240.0,-6082.0,-594.0,,1.0,2.0,2.0,14.0,,0.3850270065935933,0.6545292802242897,0.0722,0.0624,0.9747,0.6532,0.0094,0.0,0.1379,0.1667,0.2083,0.0644,0.0588,0.067,0.0,0.0,0.0735,0.0647,0.9747,0.6668,0.0095,0.0,0.1379,0.1667,0.2083,0.0659,0.0643,0.0698,0.0,0.0,0.0729,0.0624,0.9747,0.6578,0.0095,0.0,0.1379,0.1667,0.2083,0.0655,0.0599,0.0682,0.0,0.0,0.0578,1.0,0.0,0.0,0.0,0.0,0.0,0.0,0.0,0.0,0.0,0.0,1.0,1.0,1.0,0.0,1.0,0.0,0.0,0.0,0.0,0.0,0.0,0.0,0.0,0.0,1.0,0.0,0.0,0.0,0.0,0.0,0.0,0.0,0.0,0.0,0.0,0.0,0.0,0.0,0.0,0.0,0.0,0.0,0.0,3.0,5780.25,0.0,50827.5,0.0,0.0,0.0,0.0,0.0,-1050.0,-866.0,-889.0,-902.0,104.0,-17.0,2.0,4208.625,58425.75,54357.75,5960.25,58425.75,16.0,-2412.0,365243.0,-2380.0,-1930.0,-1930.0,-1922.5,13.5,0.0,0.1048802638623876,1385.0,33.0,18.0,8.0,-72.0,0.0,0.0,32.0,6575.67,6575.67,-2187.5,-2182.0,8.5,1.0,0.0,,,,,,,,,,,,,,,,,,,,,8360191512.0,184632352659.0,165792140154.0,52051926655.935,1863.0,1706.0,71128.0,71013.0,9141.0,506897.0,17836.17450000232,17898.51219999913,17349.254999997982,11314.0778000001,11251.8029000001,11199.247200000063,128613.0,663847.0,4144.118400000114,4141.696100000011,3952.154700000093,13548368.928766726,-602845592.0,-923326547.0,-296983139.0,-1537549413.0416667,44101.0,30763.0,11365.853999999194,11241.739999998988,10725.680299997288,22924.00950000984,22845.7184000098,22230.517700008364,,158283.491438759,126307.11041781832,35055.49080002805,34995.598200028486,34440.761400028896,22987.77409999587,22960.83719999545,22607.205499995685,3719789.0,8308.912500000166,8413.656900000076,8136.966200000232,9831.95970000072,9947.062200002154,10307.28689999963,16493.64299999971,16679.2258999997,16275.663299999696,829.4398000001773,814.6199000000461,760.5381000000132,3919.246100000124,3902.515500000163,3735.127900000161,437224.0,432012.0,,6434.792374002895,632936.0,626478.0,,16357.702899999793,154429.9069999908,154432.64909999038,154324.35029998716,77729.91999999635,78068.27910000658,78470.44040000673,35.0,95104432.34999998,32862294.45000001,9933097700.92498,3284985977.864997,115220075.30999996,867111.8399999995,196.0,24817.0,-32423446.0,14600860.0,-16841383.0,-18322575.0,-17.0,11560.5,0.0,50827.5,0.0,0.0,0.0,0.0,0.0,-1050.0,-866.0,-889.0,-902.0,344115869.2200011,4895832376.035003,5494153110.885004,79993282.63499998,4895832376.035003,354727.0,-24573474.0,5723631195.5,254816827.5,1297420354.5,561823868.5,1363239804.0,353130.5,5529.0,1006.1551584271474,8143540.5,2932525.0,1808273.0,-5889231.0,1940779.0,246179.0,3864733378.47005,3912913272.375032,-236007191.0,-234035512.5,4167900.0,194773.5,,,,,,,,,,,,,,,,,,,,,1469762.0,14869230.0,3237463.0,8569707.0,11625941.0,1418154.0,1061936724.6045012,802317733.4249951,72222531548.64713,21709271874.33012,583533901.5569987,5792665.7475,689.5,94245.0,-277360750.0,21991210.5,-123972256.5,-219041847.0,-2026731.0,,,,,,,,,,,,,,,,,,,,,4279958.0,2483304.0,-9018005.5,921848.5,37582.5,3739776275.429957,3664428281.369957,-261047623.5,-257730187.5,2530403.5,269653.0,3932282808.202453,33303288224.79092,36736522861.16264,1732617253.77755,48158881965.11322,3994254.5,-247971861.0,103251109661.5,1056836650.5,17297645499.5,3509298941.0,18912589769.0,3677823.0,72048.5,20904.992146245,89888449.5,-5.137829912023459,0.7722666666666667,12.335526315789476,576.2211607786589,9.526315789473683,444.9963950973324,67500.0,1.0,0.0,0.0,0.0,0.0,0.0,0.0,0.0,1.0,0.0,0.0,0.0,0.0,0.0,0.0,1.0,0.0,0.0,0.0,0.0,1.0,0.0,0.0,0.0,1.0,0.0,0.0,1.0,0.0,0.0,0.0,0.0,0.0,0.0,0.0,0.0,0.0,0.0,0.0,0.0,1.0,0.0,0.0,0.0,0.0,0.0,0.0,0.0,0.0,0.0,0.0,0.0,0.0,0.0,0.0,0.0,0.0,0.0,0.0,0.0,0.0,1.0,0.0,0.0,0.0,0.0,0.0,0.0,0.0,0.0,0.0,0.0,0.0,0.0,0.0,0.0,0.0,0.0,0.0,0.0,0.0,0.0,0.0,0.0,0.0,0.0,0.0,0.0,0.0,0.0,0.0,0.0,0.0,0.0,0.0,0.0,0.0,0.0,0.0,0.0,0.0,0.0,0.0,0.0,0.0,0.0,0.0,0.0,0.0,0.0,1.0,0.0,1.0,0.0,0.0,0.0,0.0,0.0,0.0,0.0,1.0,0.0
106010,0,0.0,0.0,0.0,1.0,0.0,540000.0,1096020.0,52857.0,900000.0,0.008019,56.07945205479452,-878.0,-5460.0,-3937.0,,1.0,2.0,2.0,11.0,,0.7324859582362662,0.1674084472266241,0.0619,0.0604,0.9811,0.7416,0.027,0.0,0.1379,0.1667,0.2083,0.0462,0.0504,0.075,0.0,0.0,0.063,0.0626,0.9811,0.7517,0.0272,0.0,0.1379,0.1667,0.2083,0.0473,0.0551,0.0782,0.0,0.0,0.0625,0.0604,0.9811,0.7451,0.0272,0.0,0.1379,0.1667,0.2083,0.047,0.0513,0.0764,0.0,0.0,0.0738,1.0,0.0,0.0,0.0,0.0,-2963.0,0.0,0.0,0.0,0.0,2.0,2.0,1.0,1.0,0.0,1.0,0.0,0.0,0.0,1.0,1.0,0.0,0.0,0.0,0.0,1.0,0.0,0.0,0.0,0.0,0.0,0.0,0.0,0.0,0.0,0.0,0.0,0.0,0.0,0.0,0.0,0.0,0.0,0.0,21.0,0.0,0.0,337500.0,0.0,0.0,0.0,0.0,0.0,-608.0,1115.0,-312.0,-368.0,506.0,-12.0,23.0,40002.975,382500.0,400171.5,0.0,699750.0,36.0,-523.0,365243.0,-1493.0,-934.0,-694.0,-922.0,13.0,1.0,0.0,-1.0,103.0,18.0,11.0,-42.0,0.0,0.0,216.0,9000.0,9000.0,-1346.0,-1340.0,15.0,0.0,90.0,167497.58250000002,180000.0,0.0,0.0,0.0,0.0,9000.0,9000.0,9000.0,159753.9375,167497.58250000002,167497.58250000002,0.0,0.0,0.0,0.0,45.0,-45.5,0.0,0.0,8360244369.0,184633448679.0,165793040154.0,52052466655.935,1863.0,1706.0,71128.0,71015.0,9141.0,506899.0,17836.236400002315,17898.57469999913,17349.31799999798,11314.1382000001,11251.8633000001,11199.309800000065,128613.0,663848.0,4144.145400000114,4141.723300000012,3952.181900000093,13548425.00821878,-602846470.0,-923330484.0,-296986102.0,-1537554873.0416667,44101.0,30763.0,11365.853999999194,11241.739999998988,10725.680299997288,22924.14740000984,22845.856300009804,22230.65560000837,,158284.22392471723,126307.27782626556,35055.65750002805,34995.76490002849,34440.928100028905,22987.982399995868,22961.045499995445,22607.413799995684,3719800.0,8308.958700000167,8413.703900000077,8137.013500000232,9832.01010000072,9947.113500002151,10307.34199999963,16493.71799999971,16679.3022999997,16275.741499999698,829.4398000001773,814.6199000000461,760.5381000000132,3919.246100000124,3902.515500000163,3735.127900000161,437224.0,432012.0,,6434.800393002894,632938.0,626480.0,,16357.776699999791,154430.8880999908,154433.63019999038,154325.33139998716,77730.66159999634,78069.02420000658,78471.19210000672,21.0,95109832.34999998,32900559.16500001,9953726569.28998,3288607775.099997,115265941.24499996,867111.8399999995,196.0,24817.0,-32500275.0,14611489.0,-16885811.0,-18365901.0,-10.0,0.0,1287.0,168327.0,0.0,0.0,0.0,0.0,0.0,-954.0,538.0,-356.0,-372.0,344936663.1900012,4910590168.785003,5510428845.885004,80040469.63499998,4909240168.785003,355438.0,-24619269.0,5730746944.0,254787803.0,1298859508.0,563270038.0,1365411932.0,353705.0,5538.0,1007.1325632728352,8147504.0,2936164.0,1810330.0,-5898144.0,1940794.0,246194.0,3871909113.5250297,3919500807.975014,-236695869.0,-234720668.0,4180912.5,195062.0,3590218886.129957,9739377000.0,301025046.375,460388702.9249999,13493165.040000005,145364753.79000017,203743861.109999,506422755.22499263,467430907.3649975,3446869994.0325136,3577248160.244941,3577428618.3449407,15552.0,41512.0,203.0,25757.0,1185763.0,-2108799.5,841786.0,1940.0,1469783.0,14869736.0,3237553.0,8569810.0,11626157.0,1418177.0,1061936724.6045012,802317733.4249951,72222869048.64713,21709271874.33012,583533901.5569987,5792665.7475,689.5,94245.0,-277361358.0,21992325.5,-123972568.5,-219042215.0,-2026743.0,5930008449.569962,18754110000.0,198923232.825,448460214.5924977,1948107.735,257097825.2700008,309471695.16749865,637214435.5049977,459619113.5774992,5714921736.090035,5893243486.065,5893486668.809999,13396.0,80976.5,44.0,70476.0,972623.0,-1701146.0,177364.0,6755.0,4279976.0,2483315.0,-9018047.5,921848.5,37582.5,3739785275.429957,3664437281.369957,-261048969.5,-257731527.5,2530418.5,269653.0,3932322811.177453,33303670724.79092,36736923032.66264,1732617253.77755,48159581715.11322,3994290.5,-247972384.0,103251474904.5,1056835157.5,17297644565.5,3509298247.0,18912588847.0,3677836.0,72049.5,20904.992146245,89888448.5,-15.656358395622648,2.0296666666666665,10.21624382768602,572.9213559148087,20.7355695555934,1162.8393787217567,540000.0,-0.9009688679024191,-0.433883739117558,0.0,0.0,0.0,0.0,0.0,0.0,1.0,0.0,0.0,0.0,0.0,0.0,0.0,1.0,0.0,1.0,0.0,0.0,0.0,0.0,0.0,0.0,1.0,0.0,0.0,1.0,0.0,0.0,0.0,0.0,0.0,0.0,0.0,0.0,0.0,0.0,0.0,0.0,0.0,0.0,0.0,0.0,1.0,0.0,0.0,0.0,0.0,0.0,0.0,0.0,0.0,0.0,0.0,0.0,0.0,0.0,0.0,0.0,0.0,0.0,0.0,0.0,0.0,0.0,0.0,0.0,0.0,0.0,0.0,0.0,0.0,0.0,0.0,0.0,0.0,0.0,0.0,0.0,0.0,0.0,0.0,0.0,0.0,0.0,0.0,0.0,0.0,0.0,0.0,0.0,1.0,0.0,0.0,0.0,0.0,0.0,0.0,0.0,0.0,0.0,0.0,0.0,0.0,0.0,0.0,0.0,0.0,1.0,0.0,0.0,1.0,0.0,0.0,0.0,0.0,0.0,0.0,1.0,0.0,0.0
106011,0,0.0,0.0,0.0,0.0,0.0,112500.0,63000.0,6745.5,63000.0,0.02461,36.33424657534247,-1506.0,-7339.0,-1877.0,,1.0,2.0,2.0,15.0,0.7605324075218121,0.6248380028942719,0.5226973172821112,0.0021,0.0,0.9841,,,0.0,0.069,0.0,,0.0004,,0.0028,,0.0,0.0021,0.0,0.9841,,,0.0,0.069,0.0,,0.0004,,0.0029,,0.0,0.0021,0.0,0.9841,,,0.0,0.069,0.0,,0.0004,,0.0028,,0.0,0.0022,1.0,0.0,0.0,0.0,0.0,-321.0,0.0,0.0,0.0,0.0,1.0,0.0,1.0,1.0,0.0,1.0,0.0,0.0,0.0,0.0,0.0,1.0,1.0,0.0,0.0,0.0,0.0,1.0,0.0,0.0,0.0,0.0,0.0,0.0,0.0,0.0,0.0,0.0,0.0,0.0,0.0,0.0,0.0,0.0,8.0,0.0,0.0,82082.25,0.0,0.0,0.0,0.0,0.0,-783.5,-289.5,-292.0,-534.0,262.0,-19.0,3.0,2250.0,45000.0,45000.0,0.0,45000.0,0.0,-321.0,365243.0,182476.0,182536.0,182551.0,-190.5,11.0,0.5,0.0,4000.0,6.0,6.0,3.5,-8.5,0.0,0.0,5.0,5297.4,5297.4,-244.0,-231.0,3.0,1.0,10.0,0.0,0.0,,0.0,,,0.0,,0.0,0.0,0.0,0.0,,0.0,,,0.0,-6.5,0.0,0.0,8360251114.5,184633511679.0,165793103154.0,52052579155.935,1863.0,1706.0,71128.0,71016.0,9141.0,506899.0,17836.238500002317,17898.57679999913,17349.32009999798,11314.1382000001,11251.8633000001,11199.309800000065,128613.0,663849.0,,,,13548461.342465354,-602847976.0,-923332361.0,-296986423.0,-1537562212.0416667,44101.0,30763.0,11365.853999999194,11241.739999998988,10725.680299997288,22924.21640000984,22845.925300009803,22230.724600008365,67597.93255995997,158284.84876272012,126307.80052358285,35055.65750002805,34995.76490002849,34440.928100028905,,,,3719815.0,8308.959100000167,8413.704300000078,8137.013900000232,,,,16493.720799999708,16679.3050999997,16275.744399999698,,,,3919.246100000124,3902.515500000163,3735.127900000161,437224.0,432012.0,,6434.825003002894,632940.0,626482.0,,16357.778899999796,154431.87219999082,154434.61429999038,154326.31549998716,,,,26.0,95347719.94499998,32901846.16500001,9967536273.77998,3291411221.099997,115265941.24499996,867111.8399999995,196.0,24817.0,-32511241.0,14661405.5,-16890738.5,-18371290.5,-12.5,0.0,8203.5,267696.0,0.0,0.0,0.0,0.0,0.0,-1741.0,-1321.0,-888.0,-1321.0,345250495.3500012,4915387168.785003,5516184314.385004,80040469.63499998,4915387168.785003,355714.0,-24627417.0,5732025294.5,255147951.5,1299222202.5,563996827.5,1365410021.5,353863.0,5540.5,1007.1325632728352,8157985.0,2937338.0,1811141.5,-5900914.0,1940794.0,246194.0,3874214032.785029,3921765742.080013,-236851456.0,-234875143.0,4185613.0,195093.0,3595198661.279957,9745092000.0,,460446752.9249999,,,203995861.109999,,467688847.3649975,3451640242.905013,3582227935.3949423,3582408393.4949408,,41522.0,,,1187537.0,-2110791.5,841787.0,1941.0,1469791.0,14869998.0,3237563.0,8569816.0,11626162.0,1418180.0,1061936724.6045012,802317733.4249951,72222951130.89713,21709271874.33012,583533901.5569987,5792665.7475,689.5,94245.0,-277362141.5,21992036.0,-123972860.5,-219042749.0,-2026762.0,5930008449.569962,18754110000.0,,448460214.5924977,,,309471695.16749865,,459619113.5774992,5714921736.090035,5893243486.065,5893486668.809999,,80976.5,,,972623.0,-1701152.5,177364.0,6755.0,4279982.0,2483318.5,-9018056.0,921848.5,37582.5,3739790572.829957,3664442578.769957,-261049213.5,-257731758.5,2530421.5,269654.0,3932325061.177453,33303715724.79092,36736968032.66264,1732617253.77755,48159626715.11322,3994290.5,-247972705.0,103251840147.5,1057017633.5,17297827101.5,3509480798.0,18912588656.5,3677847.0,72050.0,20904.992146245,89892448.5,-41.44849947217615,0.56,16.67778519012675,605.9747594286603,9.33955970647098,339.34586528004974,112500.0,-0.9009688679024191,0.4338837391175582,0.0,0.0,0.0,0.0,0.0,0.0,1.0,0.0,1.0,0.0,0.0,0.0,0.0,0.0,0.0,0.0,0.0,0.0,1.0,0.0,0.0,0.0,1.0,0.0,0.0,0.0,0.0,0.0,1.0,0.0,0.0,0.0,0.0,0.0,0.0,0.0,0.0,0.0,0.0,0.0,0.0,0.0,0.0,0.0,0.0,0.0,0.0,0.0,0.0,0.0,0.0,0.0,0.0,1.0,0.0,0.0,0.0,0.0,0.0,0.0,0.0,0.0,0.0,0.0,0.0,0.0,0.0,0.0,0.0,0.0,0.0,0.0,0.0,0.0,0.0,0.0,0.0,0.0,0.0,0.0,0.0,0.0,0.0,0.0,0.0,0.0,0.0,0.0,0.0,0.0,0.0,0.0,0.0,0.0,0.0,0.0,0.0,0.0,0.0,0.0,0.0,0.0,0.0,0.0,0.0,0.0,0.0,0.0,0.0,0.0,1.0,0.0,0.0,0.0,0.0,0.0,0.0,1.0,0.0,0.0
106013,0,0.0,0.0,0.0,1.0,2.0,135000.0,225000.0,17775.0,225000.0,0.035792,37.945205479452056,-1003.0,-2734.0,-359.0,,4.0,2.0,2.0,12.0,,0.1225064581065985,0.5884877883422673,,,,,,,,,,,,,,,,,,,,,,,,,,,,,,,,,,,,,,,,,,,,,4.0,0.0,4.0,0.0,-652.0,0.0,0.0,0.0,0.0,1.0,1.0,1.0,1.0,1.0,1.0,0.0,0.0,0.0,0.0,0.0,0.0,0.0,0.0,0.0,1.0,0.0,0.0,0.0,0.0,0.0,0.0,0.0,0.0,0.0,0.0,0.0,0.0,0.0,0.0,0.0,0.0,0.0,0.0,2.0,6660.0,,121500.0,21651.75,0.0,0.0,0.0,0.0,-919.5,270.5,-119.5,,62.0,-15.0,3.0,13076.7975,78165.0,82291.5,0.0,87608.25,8.0,-456.0,365243.0,-523.0,-313.0,-313.0,-305.5,12.0,0.0,0.0,142.0,18.0,10.0,4.0,-14.5,0.0,0.0,16.0,11615.175,11615.175,-427.5,-418.0,4.5,1.0,0.0,,,,,,,,,,,,,,,,,,,,,8360268889.5,184633736679.0,165793328154.0,52052714155.935,1863.0,1706.0,71128.0,71017.0,9141.0,506900.0,,,,,,,128615.0,663853.0,,,,13548499.287670836,-602848979.0,-923332720.0,-296987075.0,-1537564946.0416667,44101.0,30763.0,,,,,,,,158284.97126917823,126308.38901137115,,,,,,,3719827.0,,,,,,,,,,,,,,,,437228.0,432016.0,,6434.860795002895,632942.0,626484.0,,,,,,,,,31.0,95354379.94499998,,9968338150.01998,3291432872.849997,115265941.24499996,867111.8399999995,196.0,24817.0,-32516531.5,14659807.0,-16893548.5,,-15.0,6660.0,,121500.0,21651.75,0.0,0.0,0.0,0.0,-919.5,270.5,-119.5,,345291057.85500115,4915817040.285003,5516717168.385004,80040469.63499998,4915777957.785003,355769.0,-24629592.0,5733121023.5,255146256.5,1299586871.5,563996602.5,1365774703.5,353913.0,5542.0,1007.1325632728352,8162360.0,2938311.0,1811780.5,-5901392.5,1940794.0,246194.0,3874719228.2325296,3922329442.612514,-236866521.5,-234889974.5,4185971.0,195178.5,,,,,,,,,,,,,,,,,,,,,1469793.0,14870060.0,3237563.0,8569834.0,11626178.0,1418183.0,1061943384.6045012,,72223072630.89713,21709293526.08012,583533901.5569987,5792665.7475,689.5,94245.0,-277363061.0,21992306.5,-123972980.0,,-2026777.0,,,,,,,,,,,,,,,,,,,,,4279992.0,2483322.5,-9018070.5,921848.5,37582.5,3739802188.004957,3664454193.944957,-261049641.0,-257732176.5,2530426.0,269655.0,3932338137.974953,33303793889.79092,36737050324.16264,1732617253.77755,48159714323.36322,3994298.5,-247973161.0,103252205390.5,1057017110.5,17297826788.5,3509480485.0,18912588351.0,3677859.0,72050.0,20904.992146245,89892590.5,-26.43285198555957,1.6666666666666667,7.594936708860758,288.19143402115486,12.658227848101266,480.3190567019248,33750.0,1.0,0.0,0.0,0.0,0.0,0.0,0.0,0.0,1.0,0.0,0.0,0.0,0.0,0.0,0.0,1.0,0.0,0.0,0.0,0.0,1.0,0.0,1.0,0.0,0.0,0.0,0.0,1.0,0.0,0.0,0.0,0.0,0.0,0.0,0.0,0.0,0.0,0.0,0.0,0.0,1.0,0.0,0.0,0.0,0.0,0.0,0.0,0.0,0.0,0.0,0.0,0.0,0.0,0.0,0.0,0.0,0.0,0.0,0.0,0.0,0.0,0.0,0.0,0.0,0.0,0.0,0.0,0.0,0.0,0.0,0.0,0.0,0.0,0.0,0.0,0.0,0.0,0.0,0.0,0.0,0.0,0.0,0.0,1.0,0.0,0.0,0.0,0.0,0.0,0.0,0.0,0.0,0.0,0.0,0.0,0.0,0.0,0.0,0.0,0.0,0.0,0.0,0.0,0.0,0.0,0.0,0.0,0.0,0.0,0.0,0.0,0.0,0.0,0.0,0.0,0.0,0.0,0.0,0.0,0.0,0.0,0.0
106015,0,0.0,0.0,0.0,0.0,0.0,54000.0,99504.0,10192.5,90000.0,0.02461,55.42739726027397,,-6562.0,-3685.0,,2.0,2.0,2.0,18.0,,0.6880604603396241,,,,,,,,,,,,,,,,,,,,,,,,,,,,,,,,,,,,,,,,,,,,,,0.0,0.0,0.0,0.0,-1211.0,,,,,,,1.0,0.0,0.0,1.0,1.0,0.0,0.0,0.0,0.0,0.0,0.0,0.0,0.0,1.0,0.0,0.0,0.0,0.0,0.0,0.0,0.0,0.0,0.0,0.0,0.0,0.0,0.0,0.0,0.0,0.0,0.0,0.0,0.0,,,,,,,,,,,,,0.0,,2.0,10027.7325,92936.25,98298.0,1125.0,92936.25,11.0,-786.0,365243.0,-751.0,182167.0,-451.0,182170.5,11.0,0.0,0.0194411086949466,94.5,24.0,10.0,6.0,-20.5,0.0,0.0,21.0,12896.46,12896.46,-341.0,-323.0,6.0,1.0,0.0,,,,,,,,,,,,,,,,,,,,,8360279082.0,184633836183.0,165793418154.0,52052768155.935,,,,,,,,,,,,,128615.0,663855.0,,,,13548554.715068094,,-923336405.0,-296988286.0,-1537571508.0416667,44101.0,30763.0,,,,,,,,158285.65932963858,,,,,,,,3719845.0,,,,,,,,,,,,,,,,437228.0,432016.0,,6434.885405002894,632944.0,626486.0,,,,,,,,,,,,,,,,,,,,,,,,,,,,,,,,,,,345338789.80500126,4916461237.785003,5517365602.635004,80042719.63499998,4916461237.785003,355812.0,-24631658.5,5734216752.5,255144240.5,1299768043.5,563995786.5,1365955892.5,353952.5,5542.0,1007.1714454902252,8162726.5,2938587.0,1811957.0,-5901996.5,1940794.0,246194.0,3875455117.665032,3923065332.045016,-236881474.0,-234904753.0,4186066.0,195201.0,,,,,,,,,,,,,,,,,,,,,1469793.0,14870060.0,3237563.0,8569858.0,11626199.0,1418185.0,,,,,,,,,,,,,,,,,,,,,,,,,,,,,,,,,,4280002.0,2483328.5,-9018091.0,921848.5,37582.5,3739815084.464957,3664467090.404957,-261049982.0,-257732499.5,2530432.0,269656.0,3932348165.707453,33303886826.04092,36737148622.16264,1732618378.77755,48159807259.61322,3994309.5,-247973947.0,103252570633.5,1057016359.5,17298008955.5,3509480034.0,18912770521.5,3677870.0,72050.0,20905.01158735369,89892685.0,,1.842666666666667,5.298013245033113,293.65508482264363,9.762472406181017,541.1084362998578,27000.0,-0.2225209339563146,-0.9749279121818236,0.0,0.0,0.0,0.0,0.0,0.0,1.0,0.0,0.0,1.0,0.0,0.0,0.0,0.0,0.0,0.0,0.0,0.0,1.0,1.0,0.0,0.0,0.0,0.0,0.0,0.0,1.0,0.0,0.0,0.0,0.0,0.0,0.0,0.0,0.0,0.0,0.0,0.0,0.0,0.0,0.0,0.0,0.0,0.0,0.0,0.0,0.0,0.0,0.0,0.0,0.0,0.0,0.0,0.0,0.0,0.0,0.0,0.0,0.0,0.0,0.0,0.0,0.0,0.0,0.0,0.0,0.0,0.0,0.0,0.0,0.0,0.0,0.0,0.0,0.0,0.0,0.0,0.0,0.0,0.0,0.0,0.0,0.0,0.0,0.0,0.0,0.0,0.0,0.0,0.0,0.0,0.0,0.0,0.0,0.0,0.0,0.0,0.0,0.0,0.0,0.0,0.0,0.0,0.0,0.0,1.0,0.0,0.0,0.0,0.0,0.0,0.0,0.0,0.0,0.0,0.0,0.0,0.0,0.0,0.0
106026,0,0.0,0.0,0.0,1.0,0.0,144000.0,1024740.0,43416.0,900000.0,0.00496,47.47945205479452,-6896.0,-5449.0,-864.0,,2.0,2.0,2.0,16.0,,0.5779743432569489,0.7922644738669378,,,,,,,,,,,,,,,,,,,,,,,,,,,,,,,,,,,,,,,,,,,,,1.0,0.0,1.0,0.0,-1448.0,0.0,0.0,0.0,0.0,0.0,1.0,1.0,1.0,0.0,1.0,1.0,0.0,0.0,0.0,0.0,0.0,0.0,0.0,0.0,1.0,0.0,0.0,0.0,0.0,0.0,0.0,0.0,0.0,0.0,0.0,0.0,0.0,0.0,0.0,0.0,0.0,0.0,0.0,2.0,11418.75,0.0,349508.25,85455.675,0.0,0.0,0.0,0.0,-1510.0,-912.5,-1080.5,-2151.0,100.0,-26.5,2.0,12933.855,97814.25,98419.5,6750.0,97814.25,9.0,-1046.0,365243.0,-1014.5,-774.5,-774.5,-770.5,17.5,0.0,0.0546037958298136,1038.5,20.0,12.0,4.0,-37.5,0.0,0.0,20.0,12113.1,12113.1,-1159.5,-1147.0,5.5,1.0,0.0,,,,,,,,,,,,,,,,,,,,,8360322498.0,184634860923.0,165794318154.0,52052912155.935,1863.0,1706.0,71128.0,71017.0,9141.0,506901.0,,,,,,,128615.0,663857.0,,,,13548602.194520151,-602855875.0,-923337269.0,-296989734.0,-1537576957.0416667,44101.0,30763.0,,,,,,,,158286.23730398185,126309.18127584504,,,,,,,3719861.0,,,,,,,,,,,,,,,,437229.0,432017.0,,6434.890365002894,632946.0,626488.0,,,,,,,,,50.0,95507465.44499998,32910049.66500001,9984007486.03498,3294921706.8749967,115729309.84499995,867399.8399999995,196.0,24820.0,-32580592.0,14630744.0,-16929618.5,-18412752.0,-24.5,4000.5,0.0,24016.5,0.0,0.0,0.0,0.0,0.0,-2332.0,-2151.0,-2150.0,-2151.0,346407618.91500133,4935933175.185002,5538559002.885004,80151476.53499998,4935933175.185002,356535.0,-24669684.0,5743710747.5,255115283.0,1301389250.0,564343728.0,1367944376.0,354590.0,5548.0,1008.4604959684664,8171282.0,2942061.0,1814095.0,-5910623.5,1940797.0,246197.0,3880171123.650033,3927797987.940017,-237226352.5,-235246267.5,4190912.5,195536.5,,,,,,,,,,,,,,,,,,,,,1469795.0,14870160.0,3237563.0,8569878.0,11626219.0,1418187.0,1061954803.3545012,802317733.4249951,72223422139.14713,21709378981.75512,583533901.5569987,5792665.7475,689.5,94245.0,-277364571.0,21991394.0,-123974060.5,-219044900.0,-2026803.5,,,,,,,,,,,,,,,,,,,,,4280014.0,2483332.5,-9018128.5,921848.5,37582.5,3739827197.564957,3664479203.504957,-261051141.5,-257733646.5,2530437.5,269657.0,3932361099.562453,33303984640.29092,36737247041.66264,1732625128.77755,48159905073.86322,3994318.5,-247974993.0,103252935876.5,1057015345.0,17298008181.0,3509479259.5,18912769751.0,3677887.5,72050.0,20905.066191149523,89893723.5,-145.24177726485863,7.11625,3.316749585406302,157.47745291805808,23.602819237147603,1120.648924328131,72000.0,-0.9009688679024191,-0.433883739117558,0.0,0.0,0.0,0.0,0.0,0.0,1.0,0.0,0.0,0.0,1.0,0.0,0.0,0.0,0.0,1.0,0.0,0.0,0.0,0.0,1.0,0.0,0.0,0.0,0.0,1.0,0.0,0.0,0.0,0.0,0.0,0.0,1.0,0.0,0.0,0.0,0.0,0.0,0.0,0.0,0.0,0.0,0.0,0.0,0.0,0.0,0.0,0.0,0.0,0.0,0.0,0.0,0.0,0.0,0.0,0.0,0.0,0.0,0.0,0.0,0.0,0.0,0.0,0.0,0.0,0.0,0.0,0.0,0.0,0.0,0.0,0.0,0.0,0.0,0.0,0.0,1.0,0.0,0.0,0.0,0.0,0.0,0.0,0.0,0.0,0.0,0.0,0.0,0.0,0.0,0.0,0.0,0.0,0.0,0.0,0.0,0.0,0.0,0.0,0.0,0.0,0.0,0.0,0.0,0.0,0.0,0.0,0.0,0.0,0.0,0.0,0.0,0.0,0.0,0.0,0.0,0.0,0.0,0.0,0.0
106032,0,0.0,0.0,0.0,1.0,0.0,72000.0,104256.0,10813.5,90000.0,0.030755,66.13972602739726,,-12377.0,-4944.0,,2.0,2.0,2.0,10.0,,0.218674521053514,0.5262949398096192,,,,,,,,,,,,,,,,,,,,,,,,,,,,,,,,,,,,,,,,,,,,,0.0,0.0,0.0,0.0,0.0,0.0,0.0,0.0,0.0,1.0,4.0,1.0,0.0,0.0,1.0,1.0,0.0,0.0,0.0,0.0,0.0,0.0,0.0,0.0,1.0,0.0,0.0,0.0,0.0,0.0,0.0,0.0,0.0,0.0,0.0,0.0,0.0,0.0,0.0,0.0,0.0,0.0,0.0,10.0,4702.5,0.0,53610.75,0.0,0.0,0.0,0.0,0.0,-794.5,-413.0,-441.0,-859.0,308.0,-18.0,8.0,8620.335,51727.5,54013.5,0.0,69727.5,9.0,-713.0,365243.0,-980.0,-830.0,-830.0,-822.0,10.0,1.0,0.0,-1.0,57.0,12.0,6.0,-34.0,0.0,0.0,53.0,8542.305,8542.305,-1080.0,-1071.0,5.0,1.0,0.0,,,,,,,,,,,,,,,,,,,,,8360333311.5,184634965179.0,165794408154.0,52052984155.935,1863.0,1706.0,71128.0,71018.0,9141.0,506905.0,,,,,,,128615.0,663859.0,,,,13548668.33424618,,-923342213.0,-296989734.0,-1537589334.0416667,44101.0,30763.0,,,,,,,,158286.4559785029,126309.70757078484,,,,,,,3719871.0,,,,,,,,,,,,,,,,437229.0,432017.0,,6434.921120002894,632948.0,626490.0,,,,,,,,,26.5,95530076.41499998,32918556.24000001,9989046101.11498,3295813787.549997,116190568.84499995,867399.8399999995,196.0,24820.0,-32618047.5,14606914.5,-16955140.5,-18441095.5,-12.75,9405.0,0.0,45000.0,0.0,0.0,0.0,0.0,0.0,-1629.0,-1447.0,-857.0,-1447.0,346599150.77250147,4937467000.140002,5540105751.885004,80231292.98999998,4937534500.140002,356773.0,-24693833.0,5750102500.0,255095041.0,1302103776.0,564328271.0,1368659174.0,354886.0,5554.0,1009.7470007456602,8185922.0,2944855.0,1815584.0,-5917202.0,1941231.0,246212.0,3881598961.6350174,3929119056.135005,-237414942.0,-235432909.0,4192495.0,195730.0,,,,,,,,,,,,,,,,,,,,,1469805.0,14870468.0,3237563.0,8569935.0,11626272.0,1418195.0,1061959505.8545012,802317733.4249951,72223475749.89713,21709378981.75512,583533901.5569987,5792665.7475,689.5,94245.0,-277365365.5,21990981.0,-123974501.5,-219045759.0,-2026821.5,,,,,,,,,,,,,,,,,,,,,4280026.0,2483338.5,-9018162.5,921848.5,37582.5,3739835739.869957,3664487745.809957,-261052221.5,-257734717.5,2530442.5,269658.0,3932369719.897453,33304036367.79092,36737301055.16264,1732625128.77755,48159974801.36322,3994327.5,-247975706.0,103253301119.5,1057014365.0,17298007351.0,3509478429.5,18912768929.0,3677897.5,72051.0,20905.066191149523,89893722.5,,1.4480000000000002,6.658343736995423,440.3810305611137,9.641281731169371,637.6717322524926,36000.0,-0.2225209339563143,0.9749279121818236,0.0,0.0,0.0,0.0,0.0,0.0,1.0,0.0,0.0,1.0,0.0,0.0,0.0,0.0,0.0,1.0,0.0,0.0,0.0,0.0,1.0,0.0,0.0,0.0,0.0,1.0,0.0,0.0,0.0,0.0,0.0,0.0,0.0,0.0,0.0,0.0,0.0,0.0,0.0,0.0,0.0,0.0,0.0,0.0,0.0,0.0,0.0,0.0,0.0,0.0,0.0,0.0,0.0,0.0,0.0,0.0,0.0,0.0,0.0,0.0,0.0,0.0,0.0,0.0,0.0,0.0,0.0,0.0,0.0,0.0,0.0,0.0,0.0,0.0,0.0,0.0,0.0,0.0,0.0,0.0,0.0,0.0,0.0,0.0,0.0,0.0,0.0,0.0,0.0,0.0,0.0,0.0,0.0,0.0,0.0,0.0,0.0,0.0,0.0,0.0,0.0,0.0,0.0,0.0,0.0,1.0,0.0,0.0,0.0,0.0,0.0,0.0,0.0,0.0,0.0,0.0,0.0,0.0,0.0,0.0
106035,0,0.0,0.0,1.0,1.0,2.0,85500.0,254700.0,20119.5,225000.0,0.007114,37.46575342465753,-1799.0,-1509.0,-172.0,21.0,4.0,2.0,2.0,10.0,0.1765623205336287,0.4903922638443398,0.1021187878635838,0.0722,0.062,0.9816,0.7484,0.0087,0.0,0.1379,0.1667,0.2083,0.0611,0.0588,0.0678,0.0,0.0,0.0735,0.0643,0.9816,0.7583,0.0087,0.0,0.1379,0.1667,0.2083,0.0625,0.0643,0.0706,0.0,0.0,0.0729,0.062,0.9816,0.7518,0.0087,0.0,0.1379,0.1667,0.2083,0.0622,0.0599,0.069,0.0,0.0,0.058,1.0,0.0,0.0,0.0,0.0,-1594.0,0.0,0.0,0.0,0.0,0.0,0.0,1.0,1.0,0.0,1.0,0.0,0.0,0.0,0.0,0.0,0.0,0.0,0.0,0.0,1.0,0.0,0.0,0.0,0.0,0.0,0.0,0.0,0.0,0.0,0.0,0.0,0.0,0.0,0.0,0.0,0.0,0.0,0.0,5.0,9885.105,0.0,66150.0,0.0,0.0,0.0,0.0,0.0,-235.0,-760.5,-173.0,-1364.0,141.0,-26.0,6.0,5286.487499999998,29619.45,28656.0,2272.5,29619.45,7.5,-2206.0,365243.0,-2175.0,-2010.0,-2010.0,-2000.5,16.5,0.0,0.0991698622551714,700.0,70.0,12.0,5.0,-62.5,0.0,0.0,80.0,5463.855,5343.1875,-1527.5,-1518.0,6.0,1.0,0.0,,,,,,,,,,,,,,,,,,,,,8360353431.0,184635219879.0,165794633154.0,52053069655.935,1863.0,1706.0,71128.0,71018.0,9141.0,506905.0,17836.310700002316,17898.649699999132,17349.39359999798,11314.2002000001,11251.9253000001,11199.374100000065,128617.0,663863.0,4144.154100000114,4141.732000000012,3952.1906000000927,13548705.799999606,-602857674.0,-923342385.0,-296991328.0,-1537590843.0416667,44101.0,30763.0,11365.853999999194,11241.739999998988,10725.680299997288,22924.354300009843,22846.063200009805,22230.86250000837,67598.1091222805,158286.94637076673,126309.80968957274,35055.82420002805,34995.93160002849,34441.0948000289,22988.190699995863,22961.253799995444,22607.62209999568,3719881.0,8309.020200000168,8413.766500000078,8137.076400000232,9832.06890000072,9947.173400002152,10307.40629999963,16493.78859999971,16679.3740999997,16275.814999999697,829.4398000001773,814.6199000000461,760.5381000000132,3919.246100000124,3902.515500000163,3735.127900000161,437229.0,432017.0,1265105.0,6434.928234002894,632950.0,626492.0,,16357.836899999797,154432.8537999908,154435.59589999038,154327.29709998716,77731.40999999634,78069.77600000658,78471.95040000672,8.0,95572494.26999998,32918556.24000001,9991136126.11498,3297038292.8549967,116194622.03999996,867399.8399999995,196.0,24820.0,-32628903.0,14605287.0,-16960808.0,-18448837.0,-3.5,4609.71,0.0,20440.35,0.0,540.9,0.0,0.0,0.0,-1590.0,-1478.0,-1359.0,-1364.0,346718167.94250137,4938509264.040003,5541260823.135004,80243353.88999999,4938509264.040003,356884.0,-24708590.0,5753206818.5,255083657.5,1302460286.5,564685321.5,1369015728.0,355099.5,5558.0,1010.1537636977672,8191220.0,2946185.0,1816274.5,-5920260.0,1941254.0,246235.0,3882791712.847508,3930151953.172498,-237508873.5,-235525905.5,4193469.0,195819.5,,,,,,,,,,,,,,,,,,,,,1469810.0,14870609.0,3237563.0,8570005.0,11626352.0,1418201.0,1061969390.9595011,802317733.4249951,72223541899.89713,21709378981.75512,583533901.5569987,5792665.7475,689.5,94245.0,-277365600.5,21990220.5,-123974674.5,-219047123.0,-2026847.5,,,,,,,,,,,,,,,,,,,,,4280038.0,2483343.5,-9018225.0,921848.5,37582.5,3739841203.724957,3664493088.997457,-261053749.0,-257736235.5,2530448.5,269659.0,3932375006.384953,33304065987.24092,36737329711.16264,1732627401.27755,48160004420.81322,3994335.0,-247977912.0,103253666362.5,1057012190.0,17298005341.0,3509476419.5,18912766928.5,3677914.0,72051.0,20905.165361011783,89894422.5,-48.01718464351006,2.978947368421053,4.249608588682621,159.21478753488998,12.659360322075598,474.2924723407775,21375.0,0.6234898018587336,0.7818314824680298,0.0,0.0,0.0,0.0,0.0,0.0,1.0,0.0,0.0,0.0,0.0,0.0,0.0,1.0,0.0,0.0,0.0,0.0,1.0,0.0,1.0,0.0,0.0,0.0,0.0,1.0,0.0,0.0,0.0,0.0,0.0,0.0,0.0,0.0,0.0,0.0,0.0,0.0,0.0,0.0,0.0,0.0,0.0,0.0,0.0,0.0,0.0,0.0,0.0,0.0,0.0,0.0,0.0,0.0,0.0,0.0,0.0,0.0,0.0,0.0,0.0,0.0,0.0,0.0,0.0,0.0,0.0,0.0,0.0,0.0,0.0,0.0,0.0,0.0,0.0,0.0,0.0,0.0,1.0,0.0,0.0,0.0,0.0,0.0,0.0,0.0,0.0,0.0,0.0,0.0,0.0,0.0,0.0,0.0,0.0,0.0,0.0,0.0,0.0,0.0,0.0,0.0,0.0,0.0,0.0,0.0,0.0,0.0,1.0,0.0,1.0,0.0,0.0,0.0,0.0,0.0,0.0,0.0,1.0,0.0
106040,0,0.0,0.0,0.0,1.0,1.0,225000.0,685386.0,43933.5,585000.0,0.072508,38.98630136986301,-1246.0,-5190.0,-389.0,,2.0,1.0,1.0,15.0,0.6053037251072543,0.6604809144405648,,0.0278,0.058,0.9722,,,0.0,0.1034,0.0833,,0.0965,,0.0358,,0.0,0.0284,0.0601,0.9722,,,0.0,0.1034,0.0833,,0.0987,,0.0373,,0.0,0.0281,0.058,0.9722,,,0.0,0.1034,0.0833,,0.0982,,0.0365,,0.0,0.0304,1.0,3.0,0.0,3.0,0.0,-339.0,0.0,0.0,0.0,0.0,0.0,0.0,1.0,1.0,0.0,1.0,0.0,0.0,1.0,1.0,0.0,1.0,1.0,0.0,0.0,1.0,0.0,0.0,0.0,0.0,0.0,0.0,0.0,0.0,0.0,0.0,0.0,0.0,0.0,0.0,0.0,0.0,0.0,0.0,0.0,,,,,,,,,,,,,0.0,,5.0,23521.14,315000.0,400045.5,12712.5,315000.0,12.0,-1176.0,365243.0,-1145.0,-774.0,-654.0,-770.0,11.0,0.0,0.1048425558275546,-1.0,69.0,24.0,9.0,-30.0,0.0,0.0,110.0,23521.14,21629.61,-677.0,-667.0,10.0,1.0,7.0,61830.0,315000.0,0.0,185940.0,0.0,185940.0,4142.79,140421.15,81605.7,61830.0,61830.0,61830.0,0.0,5.0,0.0,5.0,3.0,-4.0,0.0,0.0,8360397364.5,184635905265.0,165795218154.0,52053294655.935,1863.0,1706.0,71128.0,71018.0,9141.0,506905.0,17836.338500002315,17898.677799999132,17349.42199999798,11314.2582000001,11251.983300000102,11199.434200000063,128618.0,663865.0,,,,13548744.786300976,-602858920.0,-923342774.0,-296991667.0,-1537596033.0416667,44101.0,30763.0,11365.853999999194,11241.739999998988,10725.680299997288,22924.457700009843,22846.166600009805,22230.96590000837,67598.71442600561,158287.60685168116,,35055.90750002805,34996.01490002849,34441.178100028905,,,,3719896.0,8309.116700000168,8413.864700000078,8137.1751000002305,,,,16493.82439999971,16679.410599999694,16275.852299999697,,,,3919.246100000124,3902.515500000163,3735.127900000161,437232.0,432020.0,,6435.000742002894,632951.0,626493.0,,16357.867299999794,154433.8259999908,154436.56809999034,154328.26929998715,,,,,,,,,,,,,,,,,,,,,,,,,,,,,,346954191.88500136,4942074725.415002,5544865403.460004,80352849.68999998,4942074725.415002,357211.0,-24730930.0,5759963299.0,255428284.0,1303907480.0,565039213.0,1370463008.0,355496.0,5561.0,1011.2694288414776,8198542.0,2949443.0,1818359.0,-5927659.0,1941254.0,246235.0,3886133292.135,3933461584.889993,-237748286.0,-235762724.0,4195344.0,196045.0,3596869722.599957,9755532000.0,301271196.375,461771896.3649999,13493165.040000005,146501797.23000017,204116592.59999892,507747992.6699939,468826687.3499975,3453225453.4500136,3583863704.204943,3584044162.304942,15572.0,41677.0,203.0,25902.0,1188475.0,-2113915.0,841790.0,1944.0,1469810.0,14870609.0,3237570.0,8570074.0,11626462.0,1418206.0,,,,,,,,,,,,,,5930070279.569962,18754425000.0,198923232.825,448646154.5924977,1948107.735,257283765.2700008,309475837.95749867,637354856.6549977,459700719.2774992,5714983566.090035,5893305316.065,5893548498.809999,13396.0,80981.5,44.0,70481.0,972626.0,-1701156.5,177364.0,6755.0,4280062.0,2483352.5,-9018255.0,921848.5,37582.5,3739864724.864957,3664514718.607457,-261054426.0,-257736902.5,2530458.5,269660.0,3932398527.524953,33304380987.24092,36737729756.66264,1732640113.77755,48160319420.81322,3994347.0,-247979088.0,103254031605.5,1057011045.0,17298004567.0,3509475765.5,18912766158.5,3677925.0,72051.0,20905.27020356761,89894421.5,-31.959943780744904,3.04616,5.121376626037079,199.66353257125385,15.600532623169109,608.2070663772505,112500.0,0.6234898018587334,-0.7818314824680299,0.0,0.0,0.0,0.0,0.0,0.0,1.0,0.0,1.0,0.0,0.0,0.0,0.0,0.0,0.0,0.0,0.0,0.0,1.0,0.0,0.0,1.0,0.0,0.0,0.0,1.0,0.0,0.0,0.0,0.0,0.0,0.0,0.0,0.0,0.0,0.0,0.0,0.0,0.0,0.0,0.0,0.0,0.0,0.0,0.0,0.0,0.0,0.0,0.0,0.0,0.0,0.0,0.0,1.0,0.0,0.0,0.0,0.0,0.0,0.0,0.0,0.0,0.0,0.0,0.0,0.0,0.0,0.0,0.0,0.0,0.0,0.0,0.0,0.0,0.0,0.0,0.0,0.0,0.0,0.0,0.0,0.0,0.0,0.0,0.0,0.0,0.0,0.0,0.0,0.0,0.0,0.0,0.0,0.0,0.0,0.0,0.0,0.0,0.0,0.0,0.0,0.0,0.0,0.0,0.0,0.0,0.0,0.0,0.0,0.0,1.0,0.0,0.0,0.0,0.0,0.0,0.0,0.0,1.0,0.0
106041,0,0.0,1.0,1.0,1.0,2.0,180000.0,550980.0,43659.0,450000.0,0.030755,35.512328767123286,-881.0,-7018.0,-4679.0,3.0,4.0,2.0,2.0,14.0,,0.3390420635525435,0.4956658291397297,,,,,,,,,,,,,,,,,,,,,,,,,,,,,,,,,,,,,,,,,,,,,1.0,1.0,1.0,1.0,-1441.0,0.0,0.0,0.0,0.0,0.0,0.0,1.0,1.0,0.0,1.0,1.0,0.0,0.0,0.0,0.0,0.0,1.0,1.0,0.0,1.0,0.0,0.0,0.0,0.0,0.0,0.0,0.0,0.0,0.0,0.0,0.0,0.0,0.0,0.0,0.0,0.0,0.0,0.0,6.0,0.0,0.0,318375.0,300888.0,49817.25,0.0,0.0,0.0,-616.5,-1343.5,-414.0,-530.5,181.0,-18.0,4.0,20356.4025,97245.0,308947.5,3825.0,157500.0,11.0,-1101.0,365243.0,-1071.0,-771.0,-741.0,-764.0,15.0,0.0,0.1126188896261888,-1.0,25.0,10.0,5.0,-38.0,0.0,0.0,64.0,4523.715,4523.715,-801.0,-801.0,11.5,0.0,34.0,0.0,450000.0,0.0,0.0,0.0,0.0,2250.0,131.49,131.49,0.0,0.0,0.0,0.0,0.0,0.0,0.0,15.0,-20.5,0.0,0.0,8360441023.5,184636456245.0,165795668154.0,52053474655.935,1863.0,1706.0,71128.0,71018.0,9141.0,506905.0,,,,,,,128620.0,663869.0,,,,13548780.29862974,-602859801.0,-923347453.0,-296993108.0,-1537603051.0416667,44102.0,30764.0,,,,,,,,158287.9458937447,126310.30535540186,,,,,,,3719910.0,,,,,,,,,,,,,,,,437233.0,432021.0,1265108.0,6435.031497002894,632953.0,626495.0,,,,,,,,,20.5,95644008.80999996,32918556.24000001,9996522102.22498,3297830067.8549967,116294797.43999995,867399.8399999995,196.0,24820.0,-32673168.0,14577708.0,-16988846.5,-18474052.5,-9.75,0.0,0.0,112500.0,300888.0,0.0,0.0,0.0,0.0,-1145.0,-2359.0,-556.0,-1204.0,347099079.0825013,4944808475.415002,5548100682.960004,80358857.18999998,4944887225.415002,357301.0,-24734242.5,5760692791.0,255425298.0,1304269702.0,565767342.0,1370825560.0,355557.5,5563.0,1011.4363343797072,8198539.5,2950400.0,1818870.0,-5928889.0,1941256.0,246237.0,3888947809.665001,3936041006.219993,-237786608.5,-235800765.5,4196723.5,196074.0,3600185293.4849577,9762417000.0,301673496.375,462473197.8299999,13493165.040000005,146802373.69500017,204324339.239999,508400583.07499385,469080598.6349975,3456374331.825014,3587150701.124944,3587331159.224942,15600.0,41724.5,203.0,25922.0,1188652.0,-2114324.5,841790.0,1944.0,1469816.0,14870790.0,3237604.0,8570099.0,11626526.0,1418210.0,1061969390.9595011,802317733.4249951,72223860274.89713,21709679869.75512,583583718.8069987,5792665.7475,689.5,94245.0,-277366217.0,21988877.0,-123975088.5,-219047653.5,-2026865.5,5930070279.569962,18754875000.0,198923232.825,448646154.5924977,1948107.735,257283765.2700008,309478087.95749867,637354988.1449977,459700850.7674992,5714983566.090035,5893305316.065,5893548498.809999,13396.0,80981.5,44.0,70481.0,972641.0,-1701177.0,177364.0,6755.0,4280072.0,2483357.5,-9018293.0,921848.5,37582.5,3739869248.579957,3664519242.322457,-261055227.0,-257737703.5,2530470.0,269660.0,3932418883.927453,33304478232.24092,36738038704.16264,1732643938.77755,48160476920.81322,3994358.0,-247980189.0,103254396848.5,1057009974.0,17298003796.0,3509475024.5,18912765394.5,3677940.0,72051.0,20905.382822457235,89894420.5,-24.808285758370623,3.0610000000000004,4.1228612657184085,146.41240472943016,12.620078334364049,448.1683708767857,45000.0,1.0,0.0,0.0,0.0,0.0,0.0,0.0,0.0,1.0,0.0,0.0,0.0,0.0,0.0,0.0,1.0,0.0,0.0,0.0,0.0,1.0,1.0,0.0,0.0,0.0,0.0,0.0,1.0,0.0,0.0,0.0,0.0,0.0,0.0,0.0,0.0,0.0,0.0,0.0,0.0,0.0,0.0,0.0,0.0,0.0,0.0,0.0,0.0,0.0,0.0,0.0,0.0,0.0,0.0,0.0,1.0,0.0,0.0,0.0,0.0,0.0,0.0,0.0,0.0,0.0,0.0,0.0,0.0,0.0,0.0,0.0,0.0,0.0,0.0,0.0,0.0,0.0,0.0,0.0,0.0,0.0,0.0,0.0,0.0,0.0,0.0,0.0,0.0,0.0,0.0,0.0,0.0,0.0,0.0,0.0,0.0,0.0,0.0,0.0,0.0,0.0,0.0,0.0,0.0,0.0,0.0,0.0,0.0,0.0,0.0,0.0,0.0,0.0,0.0,0.0,0.0,0.0,0.0,0.0,0.0,0.0,0.0
106044,0,0.0,0.0,0.0,1.0,0.0,112500.0,1092190.5,46404.0,927000.0,0.020246,61.82739726027398,,-4173.0,-5655.0,,2.0,3.0,3.0,6.0,0.8529839510499929,0.55876603015652,0.7338145369642702,0.0722,0.0764,0.9786,0.7076,0.0,0.0,0.1607,0.1667,0.2083,0.0648,0.0504,0.0653,0.0,0.0,0.063,0.0679,0.9786,0.7190000000000001,0.0,0.0,0.1379,0.1667,0.2083,0.0395,0.0551,0.0562,0.0,0.0,0.0625,0.0655,0.9786,0.7115,0.0,0.0,0.1379,0.1667,0.2083,0.0595,0.0513,0.0551,0.0,0.0,0.0425,1.0,0.0,0.0,0.0,0.0,-1151.0,0.0,0.0,0.0,0.0,0.0,1.0,1.0,0.0,0.0,1.0,0.0,1.0,0.0,0.0,0.0,0.0,0.0,0.0,0.0,0.0,0.0,0.0,1.0,0.0,0.0,0.0,0.0,0.0,0.0,0.0,0.0,0.0,0.0,0.0,0.0,0.0,0.0,0.0,5.0,0.0,0.0,181966.5,0.0,0.0,0.0,0.0,0.0,-1521.0,-1138.0,-897.0,-1138.0,245.0,-25.0,1.0,9030.42,77706.0,85914.0,0.0,77706.0,12.0,-1151.0,365243.0,-1119.0,-849.0,-789.0,-842.0,7.0,0.0,0.0,664.0,11.0,12.0,7.0,-33.0,0.0,0.0,10.0,9030.42,9030.42,-995.5,-984.0,5.5,1.0,0.0,,,,,,,,,,,,,,,,,,,,,8360487427.5,184637548435.5,165796595154.0,52053587155.935,1863.0,1706.0,71128.0,71018.0,9141.0,506906.0,17836.410700002314,17898.740299999132,17349.484999997978,11314.3346000001,11252.048800000102,11199.502100000063,128620.0,663871.0,4144.154100000114,4141.732000000012,3952.1906000000927,13548842.126027,,-923353108.0,-296994259.0,-1537607224.0416667,44102.0,30764.0,11365.853999999194,11241.739999998988,10725.680299997288,22924.618400009844,22846.30450000981,22231.103800008368,67599.56740995665,158288.50465977483,126311.0391699388,35056.07420002805,34996.18160002849,34441.3448000289,22988.398999995865,22961.46209999544,22607.83039999568,3719916.0,8309.181500000168,8413.924200000078,8137.21460000023,9832.11930000072,9947.224700002153,10307.461399999627,16493.88969999971,16679.4656999997,16275.908499999698,829.4398000001773,814.6199000000461,760.5381000000132,3919.246100000124,3902.515500000163,3735.127900000161,437233.0,432021.0,,6435.051743002894,632956.0,626498.0,,16357.909799999796,154434.8045999908,154437.54669999034,154329.24789998715,77732.11759999633,78070.48750000657,78472.66940000672,50.0,95725166.30999996,32918556.24000001,9999103873.54498,3298046563.214997,116294797.43999995,867399.8399999995,196.0,24820.0,-32695179.0,14562927.0,-17000019.0,-18490240.0,-24.5,0.0,0.0,99709.02,0.0,0.0,0.0,0.0,0.0,-1971.0,-1759.0,-897.0,-1848.0,347215802.58000153,4946389662.915002,5549842533.960004,80362007.18999998,4946389662.915002,357425.0,-24743070.0,5762883471.0,255417337.0,1304629104.0,566128724.0,1371184999.0,355628.0,5565.0,1011.5407534505694,8201649.0,2951767.0,1819888.0,-5930996.0,1941265.0,246246.0,3891507406.649996,3938523013.484989,-237876650.5,-235890043.5,4197948.5,196148.5,,,,,,,,,,,,,,,,,,,,,1469821.0,14871035.0,3237604.0,8570110.0,11626536.0,1418211.0,1061969390.9595011,802317733.4249951,72224042241.39713,21709679869.75512,583583718.8069987,5792665.7475,689.5,94245.0,-277367738.0,21987739.0,-123975985.5,-219048791.5,-2026890.5,,,,,,,,,,,,,,,,,,,,,4280084.0,2483364.5,-9018326.0,921848.5,37582.5,3739878278.999957,3664528272.742457,-261056222.5,-257738687.5,2530475.5,269661.0,3932427914.347453,33304555938.24092,36738124618.16264,1732643938.77755,48160554626.81322,3994370.0,-247981340.0,103254762091.5,1057008855.0,17298002947.0,3509474235.5,18912764552.5,3677947.0,72051.0,20905.382822457235,89895084.5,,9.70836,2.4243599689681923,149.89186690330192,23.53655934833204,1455.2042049693405,56250.0,-0.2225209339563143,0.9749279121818236,0.0,0.0,0.0,0.0,0.0,0.0,1.0,0.0,0.0,1.0,0.0,0.0,0.0,0.0,0.0,0.0,0.0,0.0,1.0,0.0,1.0,0.0,0.0,0.0,0.0,1.0,0.0,0.0,0.0,0.0,0.0,0.0,0.0,0.0,0.0,0.0,0.0,0.0,0.0,0.0,0.0,0.0,0.0,0.0,0.0,0.0,0.0,0.0,0.0,0.0,0.0,0.0,0.0,0.0,0.0,0.0,0.0,0.0,0.0,0.0,0.0,0.0,0.0,0.0,0.0,0.0,0.0,0.0,0.0,0.0,0.0,0.0,0.0,0.0,0.0,0.0,0.0,0.0,0.0,0.0,0.0,0.0,0.0,0.0,0.0,0.0,0.0,0.0,0.0,0.0,0.0,0.0,0.0,0.0,0.0,0.0,0.0,0.0,0.0,0.0,0.0,0.0,0.0,0.0,0.0,1.0,0.0,0.0,1.0,0.0,1.0,0.0,0.0,0.0,0.0,0.0,0.0,1.0,0.0,0.0
106053,0,0.0,0.0,0.0,0.0,0.0,315000.0,215865.0,26856.0,202500.0,0.04622,23.4,-223.0,-8498.0,-615.0,,2.0,1.0,1.0,11.0,0.4896002144469835,0.2114909450300888,0.1862929496555374,0.0474,,0.9752,,,0.0,0.1379,0.1042,,0.0831,,,,,0.0126,,0.9702,,,0.0,0.069,0.0417,,0.0582,,,,,0.0479,,0.9752,,,0.0,0.1379,0.1042,,0.0846,,,,,0.0712,1.0,0.0,0.0,0.0,0.0,0.0,0.0,0.0,0.0,0.0,1.0,0.0,1.0,1.0,0.0,1.0,1.0,0.0,0.0,1.0,1.0,0.0,1.0,1.0,0.0,1.0,0.0,0.0,0.0,0.0,0.0,0.0,0.0,0.0,0.0,0.0,0.0,0.0,0.0,0.0,0.0,0.0,0.0,0.0,8.0,11926.1025,0.0,94997.025,42041.25,0.0,0.0,0.0,0.0,-387.0,104.0,-19.0,-154.0,135.0,-10.0,9.0,13846.815,100935.0,104400.0,0.0,100935.0,10.0,-192.0,365243.0,-137.5,182569.5,102.5,182571.5,19.0,0.5,0.0,100.0,30.0,6.0,4.5,-24.5,0.0,0.0,7.0,18060.3,18060.3,-175.0,-164.0,3.0,1.0,0.0,,,,,,,,,,,,,,,,,,,,,8360514283.5,184637764300.5,165796797654.0,52053902155.935,1863.0,1706.0,71128.0,71019.0,9141.0,506906.0,17836.458100002314,17898.78819999913,17349.497599997976,,,,128620.0,663873.0,,,,13548865.526027,-602860024.0,-923353723.0,-296994259.0,-1537615722.0416667,44102.0,30764.0,11365.853999999194,11241.739999998988,10725.680299997288,22924.756300009845,22846.442400009808,22231.172800008368,67600.0570101711,158288.71615071988,126311.22546288848,35056.17840002805,34996.28580002848,34441.3865000289,,,,3719927.0,8309.264600000168,8414.008800000078,8137.272800000232,,,,,,,,,,,,,437233.0,432021.0,,6435.097963002894,632957.0,626499.0,,16357.980999999794,154435.7797999908,154438.52189999036,154330.21809998713,,,,13.0,95773518.80999996,33231018.42000001,10007916945.61498,3302131380.7499967,116315396.68499996,867399.8399999995,196.0,24820.0,-32742770.5,14638774.0,-17022437.0,-18514170.0,-6.0,13212.0,0.0,107904.015,57681.0,0.0,0.0,0.0,0.0,-892.0,104.0,-19.0,-154.0,347714466.14250153,4952993205.915002,5557205861.460004,80384394.68999998,4952993205.915002,357835.0,-24767515.0,5770004669.5,255763844.0,1306076271.0,566483333.0,1372632262.0,356066.0,5570.0,1012.1100952496524,8221631.0,2954360.0,1821548.5,-5937158.5,1941325.0,246246.0,3897263105.999996,3944272875.074987,-238076285.0,-236087598.0,4201605.0,196327.0,,,,,,,,,,,,,,,,,,,,,1469829.0,14871170.0,3237604.0,8570140.0,11626543.0,1418220.0,1061981317.0620012,802317733.4249951,72224137238.42212,21709721911.00512,583583718.8069987,5792665.7475,689.5,94245.0,-277368125.0,21987843.0,-123976004.5,-219048945.5,-2026900.5,,,,,,,,,,,,,,,,,,,,,4280090.0,2483369.0,-9018350.5,921848.5,37582.5,3739896339.299957,3664546333.042457,-261056397.5,-257738851.5,2530478.5,269662.0,3932441761.162453,33304656873.24092,36738229018.16264,1732643938.77755,48160655561.81322,3994380.0,-247981532.0,103255127334.5,1057008717.5,17298185516.5,3509474338.0,18912947124.0,3677966.0,72051.5,20905.382822457235,89895184.5,-9.52991452991453,0.6852857142857143,11.72922252010724,274.46380697050944,8.037868632707776,188.086126005362,157500.0,0.6234898018587336,0.7818314824680298,0.0,0.0,0.0,0.0,0.0,0.0,1.0,0.0,1.0,0.0,0.0,0.0,0.0,0.0,0.0,0.0,0.0,0.0,1.0,0.0,1.0,0.0,0.0,0.0,0.0,1.0,0.0,0.0,0.0,0.0,0.0,0.0,0.0,0.0,0.0,0.0,0.0,0.0,0.0,0.0,0.0,0.0,0.0,0.0,1.0,0.0,0.0,0.0,0.0,0.0,0.0,0.0,0.0,1.0,0.0,0.0,0.0,0.0,0.0,0.0,0.0,0.0,0.0,0.0,0.0,0.0,0.0,0.0,0.0,0.0,0.0,0.0,0.0,0.0,0.0,0.0,0.0,0.0,0.0,0.0,0.0,0.0,0.0,0.0,0.0,0.0,0.0,0.0,0.0,0.0,0.0,0.0,0.0,0.0,0.0,0.0,0.0,0.0,0.0,0.0,0.0,0.0,0.0,0.0,0.0,0.0,0.0,0.0,0.0,0.0,1.0,0.0,0.0,0.0,0.0,0.0,0.0,0.0,1.0,0.0
106054,0,0.0,1.0,1.0,1.0,0.0,225000.0,493497.0,51952.5,454500.0,0.008575,51.67671232876712,-7808.0,-1038.0,-2411.0,1.0,1.0,2.0,2.0,10.0,,0.7007827942531447,0.7047064232963289,0.3464,0.3182,0.9975,0.966,0.0906,0.16,0.1379,0.375,0.0833,0.0728,0.1538,0.2906,0.5907,0.3821,0.3529,0.3302,0.9975,0.9673,0.0914,0.1611,0.1379,0.375,0.0833,0.0745,0.168,0.3028,0.5953,0.4046,0.3497,0.3182,0.9975,0.9665,0.0912,0.16,0.1379,0.375,0.0833,0.0741,0.1565,0.2958,0.5939,0.3902,0.3785,1.0,0.0,0.0,0.0,0.0,-364.0,0.0,0.0,0.0,0.0,1.0,1.0,1.0,1.0,0.0,1.0,1.0,0.0,0.0,0.0,0.0,0.0,0.0,0.0,0.0,0.0,0.0,0.0,0.0,0.0,1.0,0.0,0.0,0.0,0.0,0.0,0.0,0.0,0.0,0.0,0.0,0.0,0.0,0.0,3.0,12087.0,,1305000.0,0.0,0.0,0.0,0.0,0.0,-1284.0,-553.0,-21.0,-815.5,124.0,-20.0,2.0,6280.425,69720.75,69720.75,0.0,139441.5,24.0,-218.0,365243.0,-329.0,-59.0,361.0,-54.0,18.5,0.0,0.0,49.5,10.0,24.0,19.5,-7.5,0.0,0.0,10.0,6280.425,6280.425,-200.5,-194.0,5.5,1.0,0.0,,,,,,,,,,,,,,,,,,,,,8360566236.0,184638257797.5,165797252154.0,52054127155.935,1863.0,1706.0,71128.0,71020.0,9141.0,506907.0,17836.804500002312,17899.137899999132,17349.850499997978,11314.6528000001,11252.367000000102,11199.832300000064,128620.0,663874.0,4144.244700000115,4141.823200000013,3952.282000000093,13548917.20273933,-602867832.0,-923356134.0,-296994623.0,-1537616760.0416667,44102.0,30764.0,11366.013999999192,11241.899999998986,10725.841399997287,22924.894200009847,22846.58030000981,22231.31070000837,,158289.41693351412,126311.93016931176,35056.55340002805,34996.66080002848,34441.7615000289,22988.482299995863,22961.54539999544,22607.913699995675,3719937.0,8309.337400000168,8414.082900000078,8137.3473000002305,9832.27310000072,9947.381200002152,10307.629399999629,16494.18029999971,16679.7614999997,16276.211299999695,830.0305000001773,815.2138000000459,761.133400000013,3919.628200000124,3902.905700000162,3735.53250000016,437233.0,432021.0,1265109.0,6435.106538002894,632959.0,626501.0,,16358.359499999797,154436.7772999908,154439.51939999036,154331.21559998716,77733.08359999633,78071.45400000658,78473.63670000673,43.0,95831085.01499996,,10011300058.079975,3303424232.9999967,116364114.49499996,867399.8399999995,196.0,24820.0,-32747094.0,14640295.0,-17022929.0,-18515665.5,-21.0,0.0,,1305000.0,0.0,0.0,0.0,0.0,0.0,-1284.0,-553.0,-21.0,-1078.0,347752783.35000145,4953522774.960002,5557735430.505004,80384394.68999998,4953522774.960002,357882.0,-24769007.0,5770552534.0,255763388.0,1306076160.0,566483642.0,1372632158.0,356167.0,5570.0,1012.1100952496524,8225065.5,2954615.0,1821725.5,-5937364.5,1941325.0,246246.0,3897351829.237497,3944361598.312489,-238078016.5,-236089254.5,4201644.0,196335.5,,,,,,,,,,,,,,,,,,,,,1469832.0,14871294.0,3237604.0,8570150.0,11626553.0,1418222.0,1061993404.0620012,,72225442238.42212,21709721911.00512,583583718.8069987,5792665.7475,689.5,94245.0,-277369409.0,21987290.0,-123976025.5,-219049761.0,-2026920.5,,,,,,,,,,,,,,,,,,,,,4280114.0,2483388.5,-9018358.0,921848.5,37582.5,3739902619.724958,3664552613.467457,-261056598.0,-257739045.5,2530484.0,269663.0,3932448041.587454,33304726593.99092,36738298738.91264,1732643938.77755,48160795003.31322,3994404.0,-247981750.0,103255492577.5,1057008388.5,17298185457.5,3509474699.0,18912947070.0,3677984.5,72051.5,20905.382822457235,89895234.0,-151.09320326582545,2.19332,4.3308791684712,223.8055969197364,9.499003897791251,490.8772918359961,225000.0,-0.9009688679024191,-0.433883739117558,0.0,1.0,0.0,0.0,0.0,0.0,0.0,0.0,0.0,0.0,0.0,0.0,0.0,1.0,0.0,1.0,0.0,0.0,0.0,0.0,0.0,1.0,0.0,0.0,0.0,1.0,0.0,0.0,0.0,0.0,0.0,0.0,0.0,0.0,0.0,0.0,0.0,0.0,0.0,0.0,0.0,0.0,0.0,0.0,0.0,0.0,0.0,0.0,0.0,0.0,0.0,0.0,0.0,1.0,0.0,0.0,0.0,0.0,0.0,0.0,0.0,0.0,0.0,0.0,0.0,0.0,0.0,0.0,0.0,0.0,0.0,0.0,0.0,0.0,0.0,0.0,0.0,0.0,0.0,0.0,0.0,0.0,0.0,0.0,0.0,0.0,0.0,0.0,0.0,0.0,0.0,0.0,0.0,0.0,0.0,0.0,0.0,0.0,0.0,0.0,0.0,0.0,0.0,0.0,0.0,0.0,0.0,0.0,1.0,0.0,1.0,0.0,0.0,0.0,0.0,1.0,0.0,0.0,0.0,0.0
106065,0,0.0,1.0,0.0,1.0,1.0,193500.0,366588.0,28498.5,306000.0,0.018029,50.43287671232878,-963.0,-2926.0,-1955.0,,3.0,3.0,3.0,9.0,0.4072745766289456,0.4836343793395358,0.1997705696341145,,,,,,,,,,,,,,,,,,,,,,,,,,,,,,,,,,,,,,,,,,,,,6.0,0.0,6.0,0.0,-512.0,0.0,0.0,0.0,0.0,2.0,0.0,1.0,1.0,0.0,1.0,0.0,1.0,0.0,0.0,0.0,0.0,1.0,1.0,0.0,0.0,0.0,0.0,0.0,0.0,1.0,0.0,0.0,0.0,0.0,0.0,0.0,0.0,0.0,0.0,0.0,0.0,0.0,0.0,5.0,31322.25,0.0,303367.5,0.0,0.0,0.0,0.0,0.0,-1503.0,-773.0,-773.0,-1503.0,208.0,-26.5,2.0,7814.7,65310.75,57039.75,13063.5,65310.75,9.0,-1477.5,365243.0,-1446.5,-1326.5,-1206.5,-1321.0,10.0,0.5,0.2036696203652595,246.0,12.0,6.0,4.5,-46.0,0.0,0.0,10.0,9089.82,9089.82,-2288.0,-2277.0,3.0,1.0,0.0,,,,,,,,,,,,,,,,,,,,,8360594734.5,184638624385.5,165797558154.0,52054320655.935,1863.0,1706.0,71128.0,71022.0,9141.0,506907.0,,,,,,,128621.0,663877.0,,,,13548967.635616042,-602868795.0,-923358089.0,-296995135.0,-1537619686.0416667,44102.0,30764.0,,,,,,,67600.46428474774,158289.90056789346,126312.1299398814,,,,,,,3719946.0,,,,,,,,,,,,,,,,437239.0,432027.0,,6435.124567002894,632962.0,626504.0,,,,,,,,,50.0,95996628.58499998,33243852.24000001,10039916286.494976,3317429315.2499967,117251820.31499998,867399.8399999995,196.0,24820.0,-32829384.0,14671166.0,-17067549.0,-18564953.0,-24.5,32823.0,0.0,303367.5,0.0,0.0,0.0,0.0,0.0,-1898.0,-1503.0,-1503.0,-1503.0,348338455.8300013,4960671517.710002,5565873255.255004,80590791.68999998,4960671517.710002,358582.0,-24823102.0,5781689391.5,256088950.5,1307506279.5,567189520.5,1374794182.5,356750.0,5577.0,1014.8718051730838,8237816.0,2960224.0,1825065.0,-5951795.5,1941404.0,246252.0,3904847147.385003,3953293724.069991,-238804491.5,-236811009.0,4215276.0,196910.5,,,,,,,,,,,,,,,,,,,,,1469837.0,14871502.0,3237604.0,8570162.0,11626563.0,1418224.0,1062024726.3120012,802317733.4249951,72225745605.92212,21709721911.00512,583583718.8069987,5792665.7475,689.5,94245.0,-277370912.0,21986517.0,-123976798.5,-219051264.0,-2026947.0,,,,,,,,,,,,,,,,,,,,,4280120.0,2483393.0,-9018404.0,921848.5,37582.5,3739911709.5449576,3664561703.287458,-261058886.0,-257741322.5,2530487.0,269664.0,3932455856.287453,33304791904.74092,36738355778.66264,1732657002.27755,48160860314.06322,3994413.0,-247983227.5,103255857820.5,1057006942.0,17298184131.0,3509473492.5,18912945749.0,3677994.5,72052.0,20905.5864920776,89895480.0,-19.09468709256845,1.8945116279069767,6.789831043739143,342.43071192643885,12.863413863887573,648.7389654971026,64500.0,-0.9009688679024191,-0.433883739117558,0.0,0.0,0.0,0.0,0.0,0.0,1.0,0.0,0.0,0.0,0.0,0.0,0.0,1.0,0.0,1.0,0.0,0.0,0.0,0.0,1.0,0.0,0.0,0.0,0.0,1.0,0.0,0.0,0.0,0.0,0.0,0.0,0.0,0.0,1.0,0.0,0.0,0.0,0.0,0.0,0.0,0.0,0.0,0.0,0.0,0.0,0.0,0.0,0.0,0.0,0.0,0.0,0.0,0.0,0.0,1.0,0.0,0.0,0.0,0.0,0.0,0.0,0.0,0.0,0.0,0.0,0.0,0.0,0.0,0.0,0.0,0.0,0.0,0.0,0.0,0.0,0.0,0.0,0.0,0.0,0.0,0.0,0.0,0.0,0.0,0.0,0.0,0.0,0.0,0.0,0.0,0.0,0.0,0.0,0.0,0.0,0.0,0.0,0.0,0.0,0.0,0.0,0.0,0.0,0.0,0.0,0.0,0.0,0.0,0.0,0.0,0.0,0.0,0.0,0.0,0.0,0.0,0.0,0.0,0.0
106081,0,0.0,0.0,0.0,1.0,0.0,180000.0,677664.0,28840.5,585000.0,0.022625,53.56438356164385,-584.0,-833.0,-3082.0,,1.0,2.0,2.0,10.0,,0.723015593327207,0.4543210601605785,0.6381,,0.9921,,,0.0,0.6207,0.375,,,,,,,0.6502,,0.9921,,,0.0,0.6207,0.375,,,,,,,0.6443,,0.9921,,,0.0,0.6207,0.375,,,,,,,0.5075,1.0,0.0,0.0,0.0,0.0,-442.0,0.0,0.0,0.0,0.0,0.0,3.0,1.0,1.0,0.0,1.0,0.0,0.0,0.0,0.0,0.0,0.0,0.0,0.0,0.0,0.0,0.0,1.0,0.0,0.0,0.0,0.0,0.0,0.0,0.0,0.0,0.0,0.0,0.0,0.0,0.0,0.0,0.0,0.0,6.0,12600.0,0.0,499050.0,0.0,0.0,0.0,0.0,0.0,-961.5,1564.5,-344.0,-761.0,236.0,-23.0,9.0,6373.844999999998,45000.0,45000.0,10163.25,117675.0,10.0,-498.0,365243.0,-866.0,-536.0,-536.0,-530.0,12.0,0.0,0.1091438900552838,2256.0,40.0,12.0,8.5,-21.5,0.0,0.0,64.0,5995.575,5995.575,-401.0,-384.0,8.0,1.0,16.0,40581.7425,225000.0,0.0,0.0,0.0,0.0,2250.0,2250.0,2250.0,38925.0,40136.2425,40136.2425,0.0,0.0,0.0,0.0,4.5,-9.5,0.0,0.0,8360623575.0,184639302049.5,165798143154.0,52054500655.935,1863.0,1706.0,71128.0,71022.0,9141.0,506910.0,17837.442600002312,17899.782199999132,17350.500699997978,,,,128621.0,663878.0,,,,13549021.199999604,-602869379.0,-923361171.0,-296995577.0,-1537620519.0416667,44102.0,30764.0,11366.013999999192,11241.899999998986,10725.841399997287,22925.51490000985,22847.20100000981,22231.93140000837,,158290.6235834868,126312.58426094154,35056.92840002805,34997.03580002848,34442.1365000289,,,,3719956.0,,,,,,,,,,,,,,,,437239.0,432027.0,,6435.147192002894,632964.0,626506.0,,16358.866999999796,154437.7693999908,154440.51149999036,154332.20769998714,,,,32.0,96042416.08499998,33406937.190000005,10056082407.614977,3323142929.8349967,117352061.72999996,867402.9449999995,196.0,26026.0,-32900632.5,14659960.5,-17112547.5,-18602592.5,-15.5,0.0,0.0,971280.0,0.0,0.0,0.0,0.0,0.0,-1422.0,2629.0,-731.0,-933.0,349100266.2075013,4969019273.580003,5575454101.125004,80787392.18999998,4968964333.080003,359205.0,-24880124.0,5795748523.0,256776764.0,1310398383.0,568259770.0,1377688213.0,357661.0,5587.0,1017.3622132680008,8256567.0,2964801.5,1827828.0,-5964613.5,1941499.0,246273.0,3911457869.1225023,3960862241.782496,-239321935.0,-237324270.5,4221826.5,197324.5,3633531582.824957,9825394500.0,303085371.375,465660459.7199999,13493165.040000005,148553460.58500016,206035477.1999989,512476990.4699943,473245582.9049975,3488139207.7200108,3620399506.7849407,3620582441.32494,15681.0,41890.5,203.0,26006.0,1199263.5,-2129251.0,841923.0,1983.0,1469843.0,14871738.0,3237620.0,8570202.0,11626627.0,1418233.0,1062037326.3120012,802317733.4249951,72226244655.92212,21709721911.00512,583583718.8069987,5792665.7475,689.5,94245.0,-277371873.5,21988081.5,-123977142.5,-219052025.0,-2026970.0,5930110861.312463,18755100000.0,198923232.825,448646154.5924977,1948107.735,257283765.2700008,309480337.95749867,637357238.1449977,459703100.7674992,5715022491.090035,5893345452.307499,5893588635.0525,13396.0,80981.5,44.0,70481.0,972645.5,-1701186.5,177364.0,6755.0,4280132.0,2483401.5,-9018425.5,921848.5,37582.5,3739917705.119957,3664567698.862457,-261059287.0,-257741706.5,2530495.0,269665.0,3932462230.132453,33304836904.74092,36738400778.66264,1732667165.52755,48160977989.06322,3994423.0,-247983725.5,103256223063.5,1057006076.0,17298183595.0,3509472956.5,18912945219.0,3678006.5,72052.0,20905.69563596765,89897736.0,-10.902767121886347,3.7648,6.241223279762832,334.3072776510772,23.496957403651123,1258.6000389007752,180000.0,-0.9009688679024191,-0.433883739117558,0.0,0.0,0.0,0.0,0.0,0.0,1.0,0.0,1.0,0.0,0.0,0.0,0.0,0.0,0.0,0.0,0.0,0.0,1.0,0.0,0.0,1.0,0.0,0.0,0.0,1.0,0.0,0.0,0.0,0.0,0.0,0.0,0.0,0.0,0.0,0.0,0.0,0.0,0.0,0.0,0.0,0.0,0.0,0.0,1.0,0.0,0.0,0.0,0.0,0.0,0.0,0.0,0.0,1.0,0.0,0.0,0.0,0.0,0.0,0.0,0.0,0.0,0.0,0.0,0.0,0.0,0.0,0.0,0.0,0.0,0.0,0.0,0.0,0.0,0.0,0.0,0.0,0.0,0.0,0.0,0.0,0.0,0.0,0.0,0.0,0.0,0.0,0.0,0.0,0.0,0.0,0.0,0.0,0.0,0.0,0.0,0.0,0.0,0.0,0.0,0.0,0.0,0.0,0.0,0.0,0.0,0.0,0.0,0.0,0.0,1.0,0.0,0.0,0.0,0.0,0.0,0.0,1.0,0.0,0.0
106083,0,0.0,0.0,0.0,1.0,0.0,202500.0,201663.0,13018.5,166500.0,0.016612,58.03835616438357,,-3793.0,-2251.0,,1.0,2.0,2.0,13.0,,0.5270311685575078,0.4241303111942548,,,,,,,,,,,,,,,,,,,,,,,,,,,,,,,,,,,,,,,,,,,,,6.0,0.0,6.0,0.0,-1844.0,0.0,0.0,0.0,0.0,0.0,7.0,1.0,0.0,0.0,1.0,0.0,0.0,0.0,0.0,0.0,0.0,0.0,0.0,0.0,1.0,0.0,0.0,0.0,0.0,0.0,0.0,0.0,0.0,0.0,0.0,0.0,0.0,0.0,0.0,0.0,0.0,0.0,0.0,7.0,4502.25,0.0,90000.0,0.0,0.0,0.0,0.0,0.0,-749.0,899.0,-45.0,-233.0,169.0,-12.0,19.0,18752.265,112500.0,137538.0,0.0,247500.0,18.0,-969.0,365243.0,-1355.0,-965.0,-845.0,-960.0,11.0,1.0,0.0,-1.0,101.0,18.0,14.0,-46.0,0.0,0.0,154.0,8462.16,8462.16,-956.5,-948.0,12.0,1.0,38.0,0.0,180000.0,0.0,0.0,0.0,0.0,0.0,90.675,90.675,0.0,0.0,0.0,0.0,0.0,0.0,0.0,7.0,-19.5,0.0,0.0,8360636593.5,184639503712.5,165798309654.0,52054703155.935,1863.0,1706.0,71128.0,71022.0,9141.0,506917.0,,,,,,,128621.0,663879.0,,,,13549079.238355769,,-923363422.0,-296997421.0,-1537624312.0416667,44102.0,30764.0,,,,,,,,158291.15061465534,126313.00839125276,,,,,,,3719969.0,,,,,,,,,,,,,,,,437245.0,432033.0,,6435.163804002895,632966.0,626508.0,,,,,,,,,24.0,96090476.08499998,33431543.190000005,10057327598.114977,3323324940.884997,117395050.67999998,867402.9449999995,196.0,26026.0,-32906272.0,14679316.0,-17114206.0,-18605565.5,-12.5,1800.0,0.0,90000.0,0.0,0.0,0.0,0.0,0.0,-749.0,899.0,-45.0,-233.0,349362773.95500124,4973630063.580003,5580491981.625004,80816502.68999998,4973585063.580003,359527.0,-24896738.0,5798669986.0,257134121.0,1312213226.0,569347668.0,1379503140.0,357915.0,5591.0,1017.5865990145212,8262073.0,2967073.0,1829409.0,-5967081.0,1941499.0,246273.0,3914095713.7275047,3963803684.692497,-239402764.5,-237404161.5,4223564.0,197427.0,3635409216.419956,9831411000.0,303430971.375,466035975.7199999,13493165.040000005,148606101.58500016,206114249.9249989,512743197.3524944,473459287.56749743,3489955166.2950096,3622262505.8849406,3622445440.42494,15692.0,41903.0,203.0,26008.0,1199449.5,-2129666.5,841923.0,1983.0,1469850.0,14871907.0,3237658.0,8570303.0,11626781.0,1418252.0,1062041828.5620012,802317733.4249951,72226334655.92212,21709721911.00512,583583718.8069987,5792665.7475,689.5,94245.0,-277372622.5,21988980.5,-123977187.5,-219052258.0,-2026982.0,5930110861.312463,18755280000.0,198923232.825,448646154.5924977,1948107.735,257283765.2700008,309480337.95749867,637357328.8199978,459703191.4424992,5715022491.090035,5893345452.307499,5893588635.0525,13396.0,80981.5,44.0,70481.0,972652.5,-1701206.0,177364.0,6755.0,4280150.0,2483415.5,-9018471.5,921848.5,37582.5,3739926167.279957,3664576161.022457,-261060243.5,-257742654.5,2530507.0,269666.0,3932480982.397453,33304949404.74092,36738538316.66264,1732667165.52755,48161225489.06322,3994441.0,-247984694.5,103256588306.5,1057004721.0,17298182630.0,3509472111.5,18912944259.0,3678017.5,72053.0,20905.69563596765,89897735.0,,0.9958666666666668,15.554787417905288,902.7742922216592,15.490494296577944,899.0428251471429,202500.0,1.0,0.0,0.0,0.0,0.0,0.0,0.0,0.0,0.0,0.0,0.0,1.0,0.0,0.0,0.0,0.0,0.0,0.0,0.0,0.0,1.0,0.0,0.0,1.0,0.0,0.0,0.0,1.0,0.0,0.0,0.0,0.0,0.0,0.0,0.0,0.0,0.0,0.0,0.0,0.0,0.0,0.0,0.0,0.0,0.0,0.0,0.0,0.0,0.0,0.0,0.0,0.0,0.0,0.0,0.0,0.0,0.0,0.0,0.0,0.0,0.0,0.0,0.0,0.0,0.0,0.0,0.0,0.0,0.0,0.0,0.0,0.0,0.0,0.0,0.0,0.0,0.0,0.0,0.0,0.0,0.0,0.0,0.0,0.0,0.0,0.0,0.0,0.0,0.0,0.0,0.0,0.0,0.0,0.0,0.0,0.0,0.0,0.0,0.0,0.0,0.0,0.0,0.0,0.0,0.0,0.0,0.0,1.0,0.0,0.0,0.0,0.0,0.0,0.0,0.0,0.0,0.0,0.0,0.0,0.0,0.0,0.0
106087,0,0.0,0.0,0.0,1.0,1.0,67500.0,247500.0,12037.5,247500.0,0.031329,49.84383561643836,-11321.0,-11502.0,-1744.0,,3.0,2.0,2.0,8.0,,0.6272083707738779,0.656158373001177,,,,,,,,,,,,,,,,,,,,,,,,,,,,,,,,,,,,,,,,,,,,,1.0,1.0,0.0,0.0,-1340.0,0.0,0.0,0.0,0.0,0.0,4.0,1.0,1.0,1.0,1.0,0.0,0.0,0.0,0.0,0.0,0.0,0.0,0.0,0.0,1.0,0.0,0.0,0.0,0.0,0.0,0.0,0.0,0.0,0.0,0.0,0.0,0.0,0.0,0.0,0.0,0.0,0.0,0.0,3.0,12600.0,,121342.5,410616.0,0.0,0.0,0.0,0.0,-1708.0,-1344.0,-1230.0,-1233.0,156.0,-31.0,6.0,14968.17,134507.25,217170.0,1872.0,180000.0,15.0,-1083.0,365243.0,-1310.0,-800.0,-800.0,-793.0,9.5,0.0,0.0545069559891503,25.0,64.0,15.5,7.5,-43.5,0.0,0.0,60.0,14881.14,14881.14,-1309.0,-1295.0,7.5,1.0,27.0,0.0,450000.0,,0.0,,,0.0,,0.0,0.0,0.0,0.0,,0.0,,,0.0,-14.0,0.0,0.0,8360648631.0,184639751212.5,165798557154.0,52054770655.935,1863.0,1706.0,71128.0,71022.0,9141.0,506921.0,,,,,,,128622.0,663882.0,,,,13549129.082191383,-602880700.0,-923365166.0,-296998761.0,-1537635814.0416667,44103.0,30764.0,,,,,,,,158291.77782302615,126313.66454962574,,,,,,,3719977.0,,,,,,,,,,,,,,,,437246.0,432033.0,,6435.195133002894,632968.0,626510.0,,,,,,,,,57.0,96145049.92499998,,10062184920.614977,3325756413.4199967,117495152.14499998,867402.9449999995,197.0,26026.0,-32926920.0,14688456.0,-17124530.0,-18613735.0,-28.0,12600.0,,112500.0,410616.0,0.0,0.0,0.0,0.0,-2553.0,-2176.0,-2183.0,-1233.0,349787446.20000124,4980357797.580003,5587895039.625004,80833157.18999998,4980243047.580003,360205.0,-24930603.5,5805973701.0,257111832.0,1312930891.0,569340214.0,1380221119.0,358462.5,5597.0,1017.8589241523288,8266941.0,2971048.0,1832092.5,-5975626.0,1942159.0,246276.0,3918393900.990007,3968511642.1799984,-239664882.0,-237664248.5,4225727.0,197647.5,3635959576.454956,9842571000.0,,466097625.7199999,,,206143854.34499896,,473484195.6749976,3490489187.3250103,3622810174.919941,3622993109.45994,,41905.0,,,1199566.0,-2130224.0,841923.0,1983.0,1469853.0,14872063.0,3237685.0,8570367.0,11626841.0,1418258.0,1062054428.5620012,,72226455998.42212,21710132527.00512,583583718.8069987,5792665.7475,689.5,94245.0,-277374330.5,21987636.5,-123978417.5,-219053491.0,-2027013.0,5930110861.312463,18755730000.0,,448646154.5924977,,,309480337.95749867,,459703191.4424992,5715022491.090035,5893345452.307499,5893588635.0525,,80981.5,,,972652.5,-1701220.0,177364.0,6755.0,4280165.5,2483423.0,-9018515.0,921848.5,37582.5,3739941048.419957,3664591042.162457,-261061552.5,-257743949.5,2530514.5,269667.0,3932495950.567453,33305083911.99092,36738755486.66264,1732669037.52755,48161405489.06322,3994456.0,-247985777.5,103256953549.5,1057003411.0,17298181830.0,3509471311.5,18912943466.0,3678027.0,72053.0,20905.750142923644,89897760.0,-227.1293904248887,3.6666666666666665,5.607476635514018,279.4981436435796,20.560747663551407,1024.826526693125,22500.0,0.6234898018587336,0.7818314824680298,0.0,0.0,0.0,0.0,0.0,0.0,1.0,0.0,0.0,0.0,0.0,0.0,0.0,1.0,0.0,0.0,0.0,0.0,1.0,0.0,1.0,0.0,0.0,0.0,0.0,1.0,0.0,0.0,0.0,0.0,0.0,0.0,0.0,0.0,0.0,0.0,0.0,0.0,0.0,0.0,0.0,1.0,0.0,0.0,0.0,0.0,0.0,0.0,0.0,0.0,0.0,0.0,0.0,0.0,0.0,0.0,0.0,0.0,0.0,0.0,0.0,0.0,0.0,0.0,0.0,0.0,0.0,0.0,0.0,0.0,0.0,0.0,0.0,0.0,0.0,0.0,0.0,0.0,0.0,0.0,0.0,1.0,0.0,0.0,0.0,0.0,0.0,0.0,0.0,0.0,0.0,0.0,0.0,0.0,0.0,0.0,0.0,0.0,0.0,0.0,0.0,0.0,0.0,0.0,0.0,0.0,0.0,0.0,0.0,0.0,0.0,0.0,0.0,0.0,0.0,0.0,0.0,0.0,0.0,0.0
106090,0,0.0,0.0,0.0,1.0,1.0,202500.0,440784.0,34956.0,360000.0,0.031329,47.8,-530.0,-11518.0,-993.0,,3.0,2.0,2.0,13.0,,0.5500092836383159,0.4311917977993083,0.0801,0.0704,0.9757,0.6668,0.0323,0.0,0.1724,0.1667,0.0971,0.0912,0.0642,0.0572,0.0051,0.0106,0.0735,0.0696,0.9757,0.6798,0.0287,0.0,0.1379,0.1667,0.0417,0.0786,0.0643,0.0336,0.0,0.0,0.0729,0.0687,0.9757,0.6713,0.0294,0.0,0.1379,0.1667,0.0417,0.0871,0.0599,0.0329,0.0,0.0,0.0409,1.0,0.0,0.0,0.0,0.0,0.0,0.0,0.0,0.0,0.0,0.0,2.0,1.0,1.0,0.0,1.0,0.0,0.0,0.0,0.0,0.0,0.0,0.0,0.0,0.0,1.0,0.0,0.0,0.0,0.0,0.0,0.0,0.0,0.0,0.0,0.0,0.0,0.0,0.0,0.0,0.0,0.0,0.0,0.0,1.0,,,180000.0,66163.5,0.0,0.0,0.0,0.0,-238.0,869.0,-118.0,,8.0,-3.5,6.0,12750.0525,90225.0,90225.0,0.0,195007.5,12.0,-303.0,365243.0,-296.0,365243.0,34.0,365243.0,13.0,0.0,0.0,74.5,33.0,12.0,7.0,-9.0,0.0,0.0,32.0,12000.105,12000.105,-238.0,-225.0,6.0,1.0,0.0,,,,,,,,,,,,,,,,,,,,,8360683587.0,184640191996.5,165798917154.0,52054973155.935,1863.0,1706.0,71128.0,71022.0,9141.0,506923.0,17837.522700002308,17899.85509999913,17350.574199997976,11314.7232000001,11252.435700000102,11199.901900000064,128623.0,663885.0,4144.277000000115,4141.852600000012,3952.310700000092,13549176.882191384,-602881230.0,-923366159.0,-296998761.0,-1537647332.0416667,44103.0,30764.0,11366.013999999192,11241.899999998986,10725.841399997287,22925.68730000985,22847.33890000981,22232.06930000837,,158292.32783230973,126314.09574142356,35057.095100028055,34997.202500028485,34442.3032000289,22988.579399995862,22961.58709999544,22607.95539999568,3719990.0,8309.428600000168,8414.170000000078,8137.42590000023,9832.33730000072,9947.441100002152,10307.693699999629,16494.23749999971,16679.794399999693,16276.244899999698,830.0356000001773,815.2138000000459,761.133400000013,3919.638800000124,3902.905700000162,3735.53250000016,437246.0,432033.0,,6435.226462002896,632970.0,626512.0,,16358.907899999796,154438.7450999908,154441.48719999034,154333.18339998717,77733.75039999634,78072.12530000658,78474.31650000672,8.0,,,10065109010.669975,3326428774.529997,118357715.51999998,867402.9449999995,198.0,26026.0,-32935016.0,14716291.0,-17127508.0,,-3.5,,,180000.0,66163.5,0.0,0.0,0.0,0.0,-238.0,869.0,-118.0,,350081309.47500134,4984026229.080003,5592049651.125004,80929362.68999998,4984180421.580003,360505.0,-24949714.0,5811086888.0,257465311.0,1314382541.0,570062757.0,1381672856.0,358872.5,5603.0,1018.5843877175952,8270589.0,2972318.0,1832837.0,-5978069.0,1942159.0,246276.0,3920227658.707506,3970296903.0374975,-239734455.5,-237732541.0,4226366.0,197771.5,,,,,,,,,,,,,,,,,,,,,1469854.0,14872071.0,3237685.0,8570400.0,11626873.0,1418264.0,,,72226635998.42212,21710198690.50512,583583718.8069987,5792665.7475,689.5,94245.0,-277374568.5,21988505.5,-123978535.5,,-2027016.5,,,,,,,,,,,,,,,,,,,,,4280177.5,2483430.0,-9018524.0,921848.5,37582.5,3739953048.524957,3664603042.267457,-261061790.5,-257744174.5,2530520.5,269668.0,3932508700.619953,33305174136.99092,36738845711.66264,1732669037.52755,48161600496.56322,3994468.0,-247986080.5,103257318792.5,1057003115.0,17298547073.0,3509471345.5,18913308709.0,3678040.0,72053.0,20905.750142923644,89897834.5,-11.087866108786612,2.1767111111111106,5.792996910401647,276.90525231719874,12.609680741503606,602.7427394438722,67500.0,1.0,0.0,0.0,0.0,0.0,0.0,0.0,0.0,0.0,0.0,0.0,0.0,0.0,0.0,0.0,1.0,0.0,0.0,0.0,0.0,1.0,0.0,1.0,0.0,0.0,0.0,0.0,1.0,0.0,0.0,0.0,0.0,0.0,0.0,0.0,0.0,0.0,0.0,0.0,0.0,0.0,0.0,0.0,0.0,0.0,0.0,1.0,0.0,0.0,0.0,0.0,0.0,0.0,0.0,0.0,1.0,0.0,0.0,0.0,0.0,0.0,0.0,0.0,0.0,0.0,0.0,0.0,0.0,0.0,0.0,0.0,0.0,0.0,0.0,0.0,0.0,0.0,0.0,0.0,0.0,0.0,0.0,0.0,0.0,0.0,0.0,0.0,0.0,0.0,0.0,0.0,0.0,0.0,0.0,0.0,0.0,0.0,0.0,0.0,0.0,0.0,0.0,0.0,0.0,0.0,0.0,0.0,0.0,0.0,1.0,0.0,0.0,1.0,0.0,0.0,0.0,0.0,0.0,0.0,0.0,1.0,0.0
106101,0,0.0,1.0,1.0,1.0,0.0,72000.0,454500.0,19255.5,454500.0,0.028663,63.96164383561644,,-7807.0,-4271.0,8.0,2.0,2.0,2.0,11.0,0.8877456290390736,0.5978121881237161,0.5989262182569273,0.3351,0.2035,0.9781,0.7008,0.1043,0.24,0.2069,0.3333,0.375,0.1498,0.2723,0.3157,0.0039,0.0007,0.3414,0.2112,0.9782,0.7125,0.1053,0.2417,0.2069,0.3333,0.375,0.1532,0.2975,0.3289,0.0039,0.0008,0.3383,0.2035,0.9781,0.7048,0.105,0.24,0.2069,0.3333,0.375,0.1524,0.277,0.3213,0.0039,0.0007,0.3055,1.0,17.0,1.0,17.0,1.0,-2033.0,0.0,0.0,0.0,0.0,1.0,1.0,1.0,0.0,0.0,1.0,0.0,0.0,0.0,0.0,0.0,0.0,0.0,0.0,0.0,0.0,0.0,0.0,1.0,0.0,0.0,0.0,0.0,0.0,0.0,0.0,0.0,0.0,0.0,0.0,0.0,0.0,0.0,0.0,4.0,7875.0,,67500.0,0.0,0.0,0.0,0.0,0.0,-332.0,701.0,-35.5,-53.0,73.0,-15.0,2.0,9823.5675,69750.0,83513.25,0.0,69750.0,12.0,-2164.5,365243.0,-2134.0,-1804.0,-1804.0,-1796.0,12.5,0.5,0.0,-1.0,26.0,18.0,5.5,-60.5,0.0,0.0,33.0,10476.585,10420.245,-1763.0,-1763.0,9.0,1.0,0.0,,,,,,,,,,,,,,,,,,,,,8360702842.5,184640646496.5,165799371654.0,52055045155.935,1863.0,1706.0,71128.0,71023.0,9141.0,506924.0,17837.857800002308,17900.19339999913,17350.915599997978,11314.9267000001,11252.6392000001,11200.113100000064,128623.0,663887.0,4144.381300000115,4141.9576000000125,3952.416000000093,13549240.84383522,,-923370430.0,-297000794.0,-1537655139.0416667,44104.0,30765.0,11366.253999999191,11242.139999998986,10726.083099997288,22925.894200009847,22847.545800009808,22232.276200008368,67601.35203037677,158292.92564449788,126314.69466764182,35057.42840002805,34997.53580002848,34442.6365000289,22988.954399995862,22961.96209999544,22608.33039999568,3720001.0,8309.578400000168,8414.32240000008,8137.579100000231,9832.609600000722,9947.718100002152,10307.99119999963,16494.553199999707,16680.115699999697,16276.573799999698,830.0395000001773,815.2177000000461,761.1373000000129,3919.639500000124,3902.906400000162,3735.53330000016,437263.0,432050.0,1265117.0,6435.255125002896,632972.0,626514.0,,16359.213399999797,154439.7231999908,154442.46529999038,154334.16159998722,77734.45119999634,78072.83010000657,78475.02900000673,11.5,96292097.90999998,,10080653453.414976,3335436555.029997,118937554.515,867402.9449999995,198.0,26026.0,-32982983.5,14716846.0,-17148070.0,-18636556.0,-5.25,0.0,,0.0,0.0,0.0,0.0,0.0,0.0,-1431.0,1038.0,-42.0,-53.0,350533553.2875012,4990027034.880002,5598912535.875004,81705987.98999998,4990027034.880002,360975.0,-24988598.5,5819301722.5,257801030.5,1316555854.5,571143282.5,1383847817.0,359279.0,5614.5,1020.6307678179828,8276577.5,2981738.0,1838068.0,-5991559.0,1942221.0,246338.0,3929233736.475023,3978956820.9150095,-240222874.0,-238218239.0,4236274.0,198116.0,,,,,,,,,,,,,,,,,,,,,1469858.0,14872144.0,3237685.0,8570426.0,11626906.0,1418266.0,1062062303.5620012,,72226703498.42212,21710198690.50512,583583718.8069987,5792665.7475,689.5,94245.0,-277374900.5,21989206.5,-123978571.0,-219053544.0,-2027031.5,,,,,,,,,,,,,,,,,,,,,4280195.5,2483435.5,-9018584.5,921848.5,37582.5,3739963525.109957,3664613462.512457,-261063553.5,-257745937.5,2530529.5,269669.0,3932518524.187453,33305243886.99092,36738929224.91264,1732669037.52755,48161670246.56322,3994480.0,-247988245.0,103257684035.5,1057000981.0,17298545269.0,3509469541.5,18913306913.0,3678052.5,72053.5,20905.750142923644,89897833.5,,6.3125,3.73919139985978,239.1648285510313,23.603645711614863,1509.7279802283854,36000.0,-0.9009688679024191,0.4338837391175582,0.0,0.0,0.0,0.0,0.0,1.0,0.0,0.0,0.0,1.0,0.0,0.0,0.0,0.0,0.0,1.0,0.0,0.0,0.0,0.0,1.0,0.0,0.0,0.0,0.0,1.0,0.0,0.0,0.0,0.0,0.0,0.0,0.0,0.0,0.0,0.0,0.0,0.0,0.0,0.0,0.0,0.0,0.0,0.0,0.0,0.0,0.0,0.0,0.0,0.0,0.0,0.0,0.0,0.0,0.0,0.0,0.0,0.0,0.0,0.0,0.0,0.0,0.0,0.0,0.0,0.0,0.0,0.0,0.0,0.0,0.0,0.0,0.0,0.0,0.0,0.0,0.0,0.0,0.0,0.0,0.0,0.0,0.0,0.0,0.0,0.0,0.0,0.0,0.0,0.0,0.0,0.0,0.0,0.0,0.0,0.0,0.0,0.0,0.0,0.0,0.0,0.0,0.0,0.0,0.0,1.0,0.0,0.0,1.0,0.0,1.0,0.0,0.0,0.0,0.0,0.0,0.0,1.0,0.0,0.0
106102,0,0.0,1.0,1.0,0.0,0.0,225000.0,149256.0,17712.0,135000.0,0.010276,44.41369863013698,-273.0,-1988.0,-5007.0,26.0,1.0,2.0,2.0,14.0,0.6594381180956048,0.6852845924338548,0.5442347412142162,,,,,,,,,,,,,,,,,,,,,,,,,,,,,,,,,,,,,,,,,,,,,1.0,0.0,1.0,0.0,-1063.0,0.0,0.0,0.0,0.0,0.0,0.0,1.0,1.0,1.0,1.0,0.0,0.0,1.0,1.0,0.0,1.0,1.0,0.0,0.0,0.0,0.0,0.0,0.0,0.0,1.0,0.0,0.0,0.0,0.0,0.0,0.0,0.0,0.0,0.0,0.0,0.0,0.0,0.0,1.0,782.145,0.0,18000.0,0.0,19121.355,0.0,0.0,0.0,-74.0,1737.0,-5.0,,3.0,-1.0,10.0,8045.775,0.0,0.0,61236.0,102060.0,6.0,-195.0,182404.5,-712.5,182105.5,182180.5,182110.0,15.5,0.0,0.6399390772878399,-1.0,2.0,3.5,3.0,-34.5,0.0,0.0,39.0,2250.0,2250.0,-224.0,-210.0,19.0,0.0,14.0,53171.4375,90000.0,0.0,8419.2975,0.0,8419.2975,2399.827500000001,9000.0,4836.87,51378.2325,52648.3575,52648.3575,0.0,4.5,0.0,4.5,5.5,-8.5,0.0,0.0,8360720554.5,184640795752.5,165799506654.0,52055270155.935,1863.0,1706.0,71128.0,71023.0,9141.0,506924.0,,,,,,,128623.0,663888.0,,,,13549285.25753385,-602881503.0,-923375437.0,-297001857.0,-1537657127.0416667,44104.0,30765.0,,,,,,,67602.01146849486,158293.61092909033,126315.23890238303,,,,,,,3720015.0,,,,,,,,,,,,,,,,437264.0,432051.0,1265143.0,6435.265401002896,632974.0,626516.0,,,,,,,,,3.0,96300755.05499998,33471162.81,10080929636.414976,3335615371.529997,118956675.87,867402.9449999995,198.0,26026.0,-32983421.0,14718920.0,-17148128.0,,-1.0,782.145,0.0,18000.0,0.0,19121.355,0.0,0.0,0.0,-74.0,1737.0,-5.0,,350581053.0600012,4990690784.880002,5599730440.125004,81767223.98999998,4990713284.880002,361020.0,-24990849.0,5819666531.5,257799120.0,1316919835.0,571507338.0,1384211804.5,359367.0,5615.0,1021.2707068952708,8276572.5,2981967.0,1838198.0,-5992345.5,1942221.0,246338.0,3929456655.540023,3979117061.3700094,-240254901.0,-238250035.0,4236837.0,198132.0,3655062469.01245,9884304000.0,305540121.375,468468188.0324999,13493165.040000005,148929163.89750016,207405513.0899989,515729744.72999465,476412256.4399977,3508899972.952504,3641841916.267437,3642024850.807436,15787.0,42037.0,203.0,26047.0,1203300.0,-2135101.0,841932.0,1987.0,1469859.0,14872147.0,3237699.0,8570428.0,11626945.0,1418276.0,1062063085.7070012,802317733.4249951,72226721498.42212,21710198690.50512,583602840.1619987,5792665.7475,689.5,94245.0,-277374974.5,21990943.5,-123978576.0,,-2027032.5,5930164032.749963,18755820000.0,198923232.825,448654573.88999766,1948107.735,257292184.56750083,309482737.78499866,637366328.8199978,459708028.3124992,5715073869.322536,5893398100.664999,5893641283.41,13396.0,80986.0,44.0,70485.5,972658.0,-1701228.5,177364.0,6755.0,4280199.0,2483438.5,-9018619.0,921848.5,37582.5,3739965775.109957,3664615712.512457,-261063777.5,-257746147.5,2530548.5,269669.0,3932526569.962453,33305243886.99092,36738929224.91264,1732730273.52755,48161772306.56322,3994486.0,-247988440.0,103257866440.0,1057000268.5,17298727374.5,3509651722.0,18913489023.0,3678068.0,72053.5,20906.390082000933,89897832.5,-6.146752205292702,0.6633600000000001,12.703252032520323,564.1984073950329,8.426829268292684,374.266655529569,225000.0,1.0,0.0,0.0,0.0,0.0,0.0,0.0,0.0,1.0,0.0,0.0,0.0,0.0,0.0,0.0,1.0,0.0,0.0,0.0,0.0,1.0,0.0,0.0,1.0,0.0,0.0,0.0,1.0,0.0,0.0,0.0,0.0,0.0,0.0,0.0,0.0,0.0,0.0,0.0,0.0,1.0,0.0,0.0,0.0,0.0,0.0,0.0,0.0,0.0,0.0,0.0,0.0,0.0,0.0,0.0,1.0,0.0,0.0,0.0,0.0,0.0,0.0,0.0,0.0,0.0,0.0,0.0,0.0,0.0,0.0,0.0,0.0,0.0,0.0,0.0,0.0,0.0,0.0,0.0,0.0,0.0,0.0,0.0,0.0,0.0,0.0,0.0,0.0,0.0,0.0,0.0,0.0,0.0,0.0,0.0,0.0,0.0,0.0,0.0,0.0,0.0,0.0,0.0,0.0,0.0,0.0,0.0,0.0,0.0,0.0,0.0,0.0,0.0,0.0,0.0,0.0,0.0,0.0,0.0,0.0,0.0,0.0
106109,0,0.0,1.0,1.0,1.0,1.0,225000.0,735579.0,40032.0,585000.0,0.010006,26.4986301369863,-1371.0,-9322.0,-2294.0,5.0,3.0,2.0,2.0,11.0,0.303717718699633,0.3213775577118702,0.3842068130556564,0.1175,0.0531,0.9861,0.8096,0.0683,0.08,0.069,0.2917,0.3333,0.0826,0.0958,0.0697,,0.0147,0.1197,0.0551,0.9861,0.8171,0.0689,0.0806,0.069,0.2917,0.3333,0.0845,0.1047,0.0727,,0.0155,0.1187,0.0531,0.9861,0.8121,0.0687,0.08,0.069,0.2917,0.3333,0.0841,0.0975,0.071,,0.015,0.0953,1.0,1.0,0.0,1.0,0.0,0.0,0.0,0.0,0.0,0.0,1.0,0.0,1.0,1.0,0.0,1.0,0.0,1.0,1.0,1.0,0.0,1.0,1.0,0.0,0.0,0.0,0.0,0.0,0.0,0.0,1.0,0.0,0.0,0.0,0.0,0.0,0.0,0.0,0.0,0.0,0.0,0.0,0.0,0.0,3.0,0.0,,225000.0,4158.0,0.0,0.0,0.0,0.0,-1054.0,806.0,-104.0,-107.0,115.0,-19.0,1.0,13822.92,71725.5,67225.5,4500.0,71725.5,6.0,-298.0,365243.0,-262.0,-112.0,-112.0,-105.0,18.0,0.0,0.0683286849294754,50.0,7.0,6.0,3.0,-7.0,0.0,0.0,6.0,13822.92,13822.92,-201.0,-187.0,3.5,1.0,0.0,,,,,,,,,,,,,,,,,,,,,8360760586.5,184641531331.5,165800091654.0,52055495155.935,1863.0,1706.0,71128.0,71024.0,9141.0,506924.0,17837.975300002312,17900.31209999913,17351.035299997977,11314.9798000001,11252.6923000001,11200.168200000064,128624.0,663891.0,4144.4496000001145,4142.026300000011,3952.4849000000927,13549311.756163985,-602882874.0,-923377731.0,-297001857.0,-1537666449.0416667,44104.0,30765.0,11366.333999999191,11242.219999998986,10726.163699997289,22925.96320000985,22847.61480000981,22232.34520000837,67602.31518621357,158293.93230664806,126315.6231091961,35057.720100028055,34997.827500028485,34442.9282000289,22989.28769999586,22962.29539999544,22608.663699995675,3720026.0,8309.661000000167,8414.40650000008,8137.663600000231,9832.70540000072,9947.815600002152,10308.095899999633,16494.622899999707,16680.186699999696,16276.6464999997,,,,3919.654200000124,3902.9214000001625,3735.54880000016,437265.0,432052.0,1265148.0,6435.275407002896,632976.0,626518.0,,16359.308699999794,154440.70929999082,154443.4513999904,154335.1476999872,77735.26079999634,78073.64220000658,78475.84610000673,35.0,96300755.05499998,,10095910673.489977,3338400445.3349967,119001760.06499998,867402.9449999995,198.0,26026.0,-33036692.0,14736728.0,-17179855.0,-18668011.0,-17.0,0.0,,225000.0,4158.0,0.0,0.0,0.0,0.0,-1054.0,806.0,-104.0,-107.0,350860788.85500115,4994159924.880002,5603556047.625004,81783504.98999998,4994159924.880002,361250.0,-25008428.0,5824597312.0,258154214.0,1318008072.0,571865987.0,1385300122.0,359938.0,5619.0,1021.7523144648044,8280943.0,2983160.0,1838806.0,-5995025.0,1942221.0,246338.0,3931376139.630021,3981126545.460007,-240333141.0,-238326792.0,4237697.5,198241.5,,,,,,,,,,,,,,,,,,,,,1469862.0,14872262.0,3237699.0,8570435.0,11626951.0,1418277.0,1062063085.7070012,,72226946498.42212,21710202848.50512,583602840.1619987,5792665.7475,689.5,94245.0,-277376028.5,21991749.5,-123978680.0,-219053651.0,-2027051.5,,,,,,,,,,,,,,,,,,,,,4280205.0,2483441.5,-9018626.0,921848.5,37582.5,3739979598.029957,3664629535.432457,-261063978.5,-257746334.5,2530552.0,269670.0,3932540392.882453,33305315612.49092,36738996450.41264,1732734773.52755,48161844032.06322,3994492.0,-247988738.0,103258231683.0,1057000006.5,17298727262.5,3509651610.0,18913488918.0,3678086.0,72053.5,20906.458410685864,89897882.5,-51.738523573200986,3.26924,5.620503597122302,148.93564600374498,18.374775179856115,486.9063713412832,75000.0,0.6234898018587334,-0.7818314824680299,0.0,0.0,0.0,0.0,0.0,0.0,1.0,0.0,1.0,0.0,0.0,0.0,0.0,0.0,0.0,1.0,0.0,0.0,0.0,0.0,1.0,0.0,0.0,0.0,0.0,1.0,0.0,0.0,0.0,0.0,0.0,0.0,0.0,1.0,0.0,0.0,0.0,0.0,0.0,0.0,0.0,0.0,0.0,0.0,0.0,0.0,0.0,0.0,0.0,0.0,0.0,0.0,0.0,0.0,0.0,0.0,0.0,0.0,0.0,0.0,0.0,0.0,0.0,0.0,0.0,0.0,0.0,0.0,0.0,0.0,0.0,0.0,0.0,0.0,0.0,0.0,0.0,0.0,0.0,0.0,0.0,0.0,1.0,0.0,0.0,0.0,0.0,0.0,0.0,0.0,0.0,0.0,0.0,0.0,0.0,0.0,0.0,0.0,0.0,0.0,0.0,0.0,0.0,0.0,0.0,0.0,0.0,0.0,1.0,0.0,1.0,0.0,0.0,0.0,0.0,0.0,0.0,1.0,0.0,0.0
106116,0,0.0,0.0,0.0,1.0,1.0,180000.0,334152.0,17190.0,270000.0,0.030755,41.53424657534247,-1543.0,-2137.0,-4739.0,,3.0,2.0,2.0,11.0,,0.6096714235389783,0.3409064264152384,0.1443,0.6042,0.994,0.9388,,0.14,0.1207,0.375,0.4167,0.2147,0.1345,0.0925,,0.0499,0.1261,0.083,0.9921,0.9412,,0.1208,0.1034,0.375,0.4167,0.1273,0.1469,0.0751,,0.0039,0.1457,0.6042,0.994,0.9396,,0.14,0.1207,0.375,0.4167,0.2185,0.1368,0.0941,,0.051,0.1067,1.0,3.0,0.0,3.0,0.0,-1197.0,0.0,0.0,0.0,0.0,2.0,2.0,1.0,1.0,0.0,1.0,0.0,0.0,0.0,0.0,0.0,0.0,0.0,0.0,0.0,1.0,0.0,0.0,0.0,0.0,0.0,0.0,0.0,0.0,0.0,0.0,0.0,0.0,0.0,0.0,0.0,0.0,0.0,0.0,19.0,0.0,0.0,40824.0,0.0,0.0,0.0,0.0,0.0,-593.0,-672.5,-432.0,-716.0,694.0,-24.0,13.0,14123.16,0.0,0.0,,292500.0,36.0,-252.0,182494.5,-274.5,182502.0,182622.0,182503.5,13.0,0.5,,-1.0,5.0,12.0,10.0,-10.0,0.0,0.0,14.0,439.875,439.875,-220.5,-214.5,4.0,0.0,11.0,0.0,45000.0,0.0,0.0,0.0,0.0,0.0,439.875,439.875,0.0,0.0,0.0,0.0,0.0,0.0,0.0,1.0,-7.0,0.0,0.0,8360777776.5,184641865483.5,165800361654.0,52055675155.935,1863.0,1706.0,71128.0,71026.0,9141.0,506926.0,17838.119600002312,17900.45779999913,17351.161399997978,11315.5840000001,11253.2965000001,11200.251200000064,128625.0,663894.0,,,,13549353.29041056,-602884417.0,-923382470.0,-297003054.0,-1537668586.0416667,44104.0,30765.0,11366.473999999193,11242.359999998987,10726.284499997288,22926.08390000985,22847.73550000981,22232.44860000837,,158294.54197807153,126315.9640156225,35058.095100028055,34998.202500028485,34443.3032000289,22989.704399995862,22962.71209999544,22609.08039999568,3720037.0,8309.875700000168,8414.62500000008,8137.790900000231,9832.83990000072,9947.952400002152,10308.242799999627,16494.715399999706,16680.280799999695,16276.7215999997,,,,3919.704100000124,3902.9724000001625,3735.55270000016,437268.0,432055.0,,6435.306162002896,632978.0,626520.0,,16359.415399999794,154441.70329999086,154444.4453999904,154336.1397999872,77736.19959999634,78074.58180000658,78476.78730000673,20.0,96993182.65499996,33474897.81,10111425791.849976,3340824527.8349967,119449964.56499998,867402.9449999995,198.0,26026.0,-33086175.0,14743980.5,-17203689.0,-18697491.5,-9.5,0.0,0.0,31500.0,0.0,0.0,0.0,0.0,0.0,-1808.0,-1073.0,-998.0,-1695.0,351227428.8300013,5000161786.380002,5610774862.125004,,5000611786.380002,361732.0,-25026679.0,5828979318.0,258141314.0,1318912380.5,572406740.5,1386204520.5,360281.0,5622.0,,8286123.0,2985419.0,1840147.0,-6000041.0,1942469.0,246339.0,3936224018.362511,3986770277.6774993,-240540893.0,-238533850.0,4240332.0,198411.0,3662921246.89495,9905431500.0,306219599.505,469775551.3199998,13493165.040000005,149557049.05500016,207792477.6749989,517307120.5949946,477929630.4749976,3516450132.105005,3649656604.994936,3649839539.534935,15805.0,42194.0,203.0,26186.0,1203633.0,-2135855.0,841932.0,1987.0,1469881.0,14872956.0,3237710.0,8570440.0,11626965.0,1418290.0,1062063085.7070012,802317733.4249951,72226987322.42212,21710202848.50512,583602840.1619987,5792665.7475,689.5,94245.0,-277376621.5,21991077.0,-123979112.0,-219054367.0,-2027075.5,5930164032.749963,18755865000.0,198923232.825,448654573.88999766,1948107.735,257292184.56750083,309482737.78499866,637366768.6949978,459708468.1874992,5715073869.322536,5893398100.664999,5893641283.41,13396.0,80986.0,44.0,70485.5,972659.0,-1701235.5,177364.0,6755.0,4280217.0,2483451.5,-9018636.0,921848.5,37582.5,3739980037.904957,3664629975.307457,-261064199.0,-257746549.0,2530556.0,269670.0,3932554516.042453,33305315612.49092,36738996450.41264,,48162136532.06322,3994528.0,-247988990.0,103258414177.5,1056999732.0,17298909764.5,3509834232.0,18913671421.5,3678099.0,72054.0,,89897881.5,-37.15006596306069,1.8564,10.471204188481677,434.9135767051567,19.43874345549738,807.3735637954527,60000.0,-0.9009688679024191,-0.433883739117558,0.0,0.0,0.0,0.0,0.0,0.0,1.0,0.0,1.0,0.0,0.0,0.0,0.0,0.0,0.0,0.0,0.0,0.0,1.0,0.0,1.0,0.0,0.0,0.0,0.0,1.0,0.0,0.0,0.0,0.0,0.0,0.0,0.0,0.0,0.0,0.0,0.0,0.0,0.0,0.0,1.0,0.0,0.0,0.0,0.0,0.0,0.0,0.0,0.0,0.0,0.0,0.0,0.0,0.0,0.0,0.0,0.0,0.0,0.0,0.0,0.0,0.0,0.0,0.0,0.0,0.0,0.0,0.0,0.0,0.0,0.0,0.0,0.0,0.0,0.0,0.0,0.0,0.0,0.0,0.0,0.0,1.0,0.0,0.0,0.0,0.0,0.0,0.0,0.0,0.0,0.0,0.0,0.0,0.0,0.0,0.0,0.0,0.0,0.0,0.0,0.0,0.0,0.0,0.0,0.0,0.0,0.0,1.0,0.0,0.0,1.0,0.0,0.0,0.0,0.0,0.0,0.0,1.0,0.0,0.0
106150,0,0.0,1.0,1.0,1.0,0.0,247500.0,824544.0,46170.0,720000.0,0.006296,58.871232876712334,-7895.0,-11996.0,-4850.0,2.0,2.0,3.0,3.0,12.0,0.7220054192037435,0.7604247327044054,0.6127042441012546,0.0082,0.0,0.9722,,,0.0,0.069,0.0417,,0.0054,,0.0059,,0.0,0.0084,0.0,0.9722,,,0.0,0.069,0.0417,,0.0056,,0.0061,,0.0,0.0083,0.0,0.9722,,,0.0,0.069,0.0417,,0.0055,,0.006,,0.0,0.0071,1.0,1.0,1.0,1.0,0.0,-1040.0,0.0,0.0,0.0,0.0,1.0,0.0,1.0,1.0,0.0,1.0,1.0,0.0,0.0,0.0,0.0,0.0,0.0,0.0,0.0,1.0,0.0,0.0,0.0,0.0,0.0,0.0,0.0,0.0,0.0,0.0,0.0,0.0,0.0,0.0,0.0,0.0,0.0,0.0,4.0,36630.0,0.0,119139.75,0.0,0.0,0.0,0.0,0.0,-1157.0,-980.0,-549.0,-1366.0,151.0,-19.0,1.0,26130.69,134550.0,127489.5,13455.0,134550.0,6.0,-1040.0,365243.0,-1009.0,-859.0,-859.0,-851.0,10.0,0.0,0.1039680028792764,55.0,7.0,6.0,3.0,-31.0,0.0,0.0,6.0,26130.69,26130.69,-948.5,-934.0,3.5,1.0,0.0,,,,,,,,,,,,,,,,,,,,,8360823946.5,184642690027.5,165801081654.0,52055922655.935,1863.0,1706.0,71128.0,71027.0,9141.0,506926.0,17838.127800002312,17900.466099999132,17351.169799997977,11315.5840000001,11253.2965000001,11200.251200000064,128625.0,663896.0,,,,13549412.161643438,-602892312.0,-923387320.0,-297004094.0,-1537680582.0416667,44105.0,30765.0,11366.473999999193,11242.359999998987,10726.284499997288,22926.152900009845,22847.80450000981,22232.51760000837,67603.03719163276,158295.30240280426,126316.5767198666,35058.136800028056,34998.244200028494,34443.344900028904,,,,3720049.0,8309.881100000168,8414.63050000008,8137.7965000002305,,,,16494.721299999706,16680.286799999696,16276.7276999997,,,,3919.704100000124,3902.9724000001625,3735.55270000016,437269.0,432056.0,1265150.0,6435.312458002894,632981.0,626523.0,,16359.422499999797,154442.67549999082,154445.41759999038,154337.11199998722,,,,38.5,97405043.35499996,33552640.305000003,10167598342.16998,3354638401.3949966,120746292.52499998,867402.9449999995,199.0,26026.0,-33313603.5,14708500.5,-17329715.5,-18840998.0,-19.0,36630.0,0.0,83817.0,0.0,0.0,0.0,0.0,0.0,-1492.0,-1309.0,-567.0,-1366.0,353490878.4750015,5029640786.205003,5644593158.625004,82204339.81499998,5029640786.205003,363760.0,-25182955.0,5865126931.0,259850068.0,1328507764.0,577634624.0,1396166883.0,362654.0,5652.0,1027.401138508546,8401099.0,3001488.0,1849698.0,-6035290.0,1942501.0,246371.0,3961507410.9450016,4011785788.499992,-242237280.0,-240214751.5,4284180.5,199500.5,,,,,,,,,,,,,,,,,,,,,1469885.0,14873107.0,3237710.0,8570447.0,11626971.0,1418291.0,1062099715.7070012,802317733.4249951,72227106462.17212,21710202848.50512,583602840.1619987,5792665.7475,689.5,94245.0,-277377778.5,21990097.0,-123979661.0,-219055733.0,-2027094.5,,,,,,,,,,,,,,,,,,,,,4280223.0,2483454.5,-9018667.0,921848.5,37582.5,3740006168.594957,3664656105.997457,-261065147.5,-257747483.0,2530559.5,269671.0,3932580646.732453,33305450162.49092,36739123939.91264,1732748228.52755,48162271082.06322,3994534.0,-247990030.0,103258779420.5,1056998723.0,17298908905.5,3509833373.0,18913670570.5,3678109.0,72054.0,20906.562378688745,89897936.5,-134.10624534623977,3.3314909090909093,5.360623781676413,315.5865310155144,17.8588693957115,1051.3736591097224,123750.0,-0.9009688679024191,0.4338837391175582,0.0,0.0,0.0,0.0,0.0,0.0,1.0,0.0,0.0,0.0,0.0,0.0,0.0,1.0,0.0,1.0,0.0,0.0,0.0,0.0,1.0,0.0,0.0,0.0,0.0,1.0,0.0,0.0,0.0,0.0,0.0,0.0,0.0,0.0,0.0,0.0,0.0,0.0,0.0,0.0,1.0,0.0,0.0,0.0,0.0,0.0,0.0,0.0,1.0,0.0,0.0,0.0,0.0,0.0,0.0,0.0,0.0,0.0,0.0,0.0,0.0,0.0,0.0,0.0,0.0,0.0,0.0,0.0,0.0,0.0,0.0,0.0,0.0,0.0,0.0,0.0,0.0,0.0,0.0,0.0,0.0,0.0,0.0,0.0,0.0,0.0,0.0,0.0,0.0,0.0,0.0,0.0,0.0,0.0,0.0,0.0,0.0,0.0,0.0,0.0,0.0,0.0,0.0,0.0,0.0,0.0,0.0,0.0,0.0,0.0,1.0,0.0,0.0,1.0,0.0,0.0,0.0,0.0,0.0,0.0
106155,0,0.0,1.0,0.0,0.0,0.0,90000.0,245002.5,26514.0,211500.0,0.0096569999999999,24.58082191780822,-1334.0,-1519.0,-1652.0,,1.0,2.0,2.0,16.0,,0.4713321578109526,0.4188542886233217,,,,,,,,,,,,,,,,,,,,,,,,,,,,,,,,,,,,,,,,,,,,,0.0,0.0,0.0,0.0,-704.0,0.0,0.0,0.0,0.0,1.0,1.0,1.0,1.0,0.0,1.0,0.0,0.0,0.0,0.0,0.0,0.0,1.0,1.0,0.0,1.0,0.0,0.0,0.0,0.0,0.0,0.0,0.0,0.0,0.0,0.0,0.0,0.0,0.0,0.0,0.0,0.0,0.0,0.0,1.0,,0.0,54382.32,0.0,0.0,0.0,0.0,0.0,-269.0,-86.0,-85.0,-86.0,9.0,-4.0,1.0,10287.36,58860.0,50031.0,8829.0,58860.0,6.0,-704.0,365243.0,-667.0,-547.0,-517.0,-542.0,16.0,0.0,0.1633636363636363,8.0,7.0,6.0,3.0,-20.0,0.0,0.0,5.0,10287.36,10287.36,-621.0,-607.0,3.0,1.0,0.0,,,,,,,,,,,,,,,,,,,,,8360850460.5,184642935030.0,165801293154.0,52056012655.935,1863.0,1706.0,71128.0,71028.0,9141.0,506927.0,,,,,,,128625.0,663897.0,,,,13549436.742465356,-602893646.0,-923388972.0,-297004798.0,-1537682101.0416667,44105.0,30765.0,,,,,,,,158295.77373496207,126316.99557415524,,,,,,,3720065.0,,,,,,,,,,,,,,,,437269.0,432056.0,,6435.322115002894,632983.0,626525.0,,,,,,,,,9.0,,33552640.305000003,10172927844.80998,3357222094.214997,120746292.52499998,867402.9449999995,199.0,26026.0,-33335404.0,14698575.0,-17341634.0,-18854172.0,-4.0,,0.0,54382.32,0.0,0.0,0.0,0.0,0.0,-269.0,-86.0,-85.0,-86.0,353930419.7100015,5034649038.705003,5649737450.625004,82317811.81499998,5034649038.705003,363972.0,-25212559.0,5872797034.0,260190685.0,1329218357.0,577980641.0,1396877575.0,362998.0,5661.0,1029.0733494129022,8409977.0,3003822.0,1850903.0,-6042416.0,1942528.0,246371.0,3965233976.640002,4015391055.254994,-242444099.0,-240419329.0,4285352.0,199708.0,,,,,,,,,,,,,,,,,,,,,1469886.0,14873116.0,3237710.0,8570454.0,11626976.0,1418292.0,,802317733.4249951,72227160844.49213,21710202848.50512,583602840.1619987,5792665.7475,689.5,94245.0,-277378047.5,21990011.0,-123979746.0,-219055819.0,-2027098.5,,,,,,,,,,,,,,,,,,,,,4280229.0,2483457.5,-9018687.0,921848.5,37582.5,3740016455.954958,3664666393.357457,-261065768.5,-257748090.0,2530562.5,269672.0,3932590934.092453,33305509022.49092,36739173970.91264,1732757057.52755,48162329942.06322,3994540.0,-247990734.0,103259144663.5,1056998056.0,17298908358.5,3509832856.0,18913670028.5,3678125.0,72054.0,20906.725742325107,89897944.5,-54.26995095853768,2.72225,3.3944331296673456,83.43795627226145,9.240495587236932,227.1389764621637,90000.0,-0.2225209339563143,0.9749279121818236,0.0,1.0,0.0,0.0,0.0,0.0,0.0,0.0,0.0,0.0,0.0,0.0,0.0,1.0,0.0,0.0,0.0,0.0,1.0,0.0,0.0,0.0,1.0,0.0,0.0,0.0,0.0,0.0,0.0,1.0,0.0,0.0,0.0,0.0,0.0,0.0,0.0,0.0,1.0,0.0,0.0,0.0,0.0,0.0,0.0,0.0,0.0,0.0,0.0,0.0,0.0,0.0,0.0,0.0,0.0,0.0,0.0,0.0,0.0,0.0,0.0,0.0,0.0,0.0,0.0,0.0,0.0,0.0,0.0,0.0,0.0,0.0,0.0,0.0,0.0,0.0,0.0,0.0,0.0,0.0,0.0,0.0,0.0,0.0,0.0,0.0,0.0,0.0,0.0,0.0,1.0,0.0,0.0,0.0,0.0,0.0,0.0,0.0,0.0,0.0,0.0,0.0,0.0,0.0,0.0,0.0,0.0,0.0,0.0,0.0,0.0,0.0,0.0,0.0,0.0,0.0,0.0,0.0,0.0,0.0
106166,0,0.0,0.0,0.0,0.0,0.0,247500.0,495000.0,50719.5,495000.0,0.035792,39.10958904109589,-2256.0,-3175.0,-2692.0,,1.0,2.0,2.0,14.0,,0.7718787708956645,0.6658549219640212,,,,,,,,,,,,,,,,,,,,,,,,,,,,,,,,,,,,,,,,,,,,,5.0,0.0,5.0,0.0,-990.0,0.0,0.0,0.0,0.0,0.0,0.0,1.0,1.0,0.0,1.0,1.0,0.0,0.0,0.0,0.0,0.0,0.0,0.0,0.0,1.0,0.0,0.0,0.0,0.0,0.0,0.0,0.0,0.0,0.0,0.0,0.0,0.0,0.0,0.0,0.0,0.0,0.0,0.0,7.0,5301.855,278.19,72450.0,0.0,0.0,0.0,0.0,0.0,-1689.0,-1386.0,-440.0,-651.0,356.0,-30.0,1.0,9232.695,47205.0,49698.0,0.0,47205.0,6.0,-990.0,365243.0,-959.0,-809.0,-809.0,-800.0,12.0,0.0,0.0,314.0,7.0,6.0,3.0,-30.0,0.0,0.0,6.0,9232.695,9232.695,-896.0,-884.0,3.5,1.0,0.0,,,,,,,,,,,,,,,,,,,,,8360901180.0,184643430030.0,165801788154.0,52056260155.935,1863.0,1706.0,71128.0,71028.0,9141.0,506927.0,,,,,,,128625.0,663898.0,,,,13549475.852054397,-602895902.0,-923391664.0,-297005788.0,-1537685276.0416667,44105.0,30765.0,,,,,,,,158296.54561373295,126317.6614290772,,,,,,,3720079.0,,,,,,,,,,,,,,,,437274.0,432061.0,,6435.357907002895,632985.0,626527.0,,,,,,,,,56.0,97479433.70999998,33576401.99250001,10184723211.689983,3360261898.349997,120746292.52499998,867402.9449999995,199.0,26026.0,-33383141.0,14708201.0,-17368157.0,-18882838.0,-27.5,5301.855,5735.745,66825.0,0.0,0.0,0.0,0.0,0.0,-1951.0,-1770.0,-440.0,-1415.0,354460982.0400014,5042656115.955003,5658109135.875004,82472395.81499998,5042656115.955003,364468.0,-25247322.0,5883389081.0,261262378.0,1331391687.0,579063254.0,1399051048.0,363497.0,5668.0,1030.965968366329,8416083.0,3008105.0,1853728.0,-6049524.0,1942537.0,246372.0,3971368656.067512,4022110748.9474993,-242648444.5,-240620616.5,4286982.5,199968.5,,,,,,,,,,,,,,,,,,,,,1469893.0,14873472.0,3237710.0,8570461.0,11626982.0,1418293.0,1062105017.5620012,802318011.6149951,72227233294.49213,21710202848.50512,583602840.1619987,5792665.7475,689.5,94245.0,-277379736.5,21988625.0,-123980186.0,-219056470.0,-2027128.5,,,,,,,,,,,,,,,,,,,,,4280235.0,2483460.5,-9018717.0,921848.5,37582.5,3740025688.6499577,3664675626.052457,-261066664.5,-257748974.0,2530566.0,269673.0,3932600166.787453,33305556227.49092,36739223668.91264,1732757057.52755,48162377147.06322,3994546.0,-247991724.0,103259509906.5,1056997097.0,17298907549.5,3509832047.0,18913669228.5,3678137.0,72054.0,20906.725742325107,89898258.5,-57.68406304728547,2.0,4.879779966285157,190.8461890923853,9.759559932570314,381.6923781847705,247500.0,1.0,0.0,0.0,0.0,0.0,0.0,0.0,1.0,0.0,0.0,0.0,0.0,0.0,0.0,0.0,1.0,0.0,0.0,0.0,0.0,1.0,0.0,0.0,0.0,1.0,0.0,0.0,1.0,0.0,0.0,0.0,0.0,0.0,0.0,0.0,0.0,0.0,0.0,1.0,0.0,0.0,0.0,0.0,0.0,0.0,0.0,0.0,0.0,0.0,0.0,0.0,0.0,0.0,0.0,0.0,0.0,0.0,0.0,0.0,0.0,0.0,0.0,0.0,0.0,0.0,0.0,0.0,0.0,0.0,0.0,0.0,0.0,0.0,0.0,0.0,0.0,0.0,0.0,0.0,0.0,0.0,0.0,0.0,1.0,0.0,0.0,0.0,0.0,0.0,0.0,0.0,0.0,0.0,0.0,0.0,0.0,0.0,0.0,0.0,0.0,0.0,0.0,0.0,0.0,0.0,0.0,0.0,0.0,0.0,0.0,0.0,0.0,0.0,0.0,0.0,0.0,0.0,0.0,0.0,0.0,0.0,0.0
106176,0,0.0,0.0,0.0,1.0,2.0,112500.0,315000.0,25015.5,315000.0,0.028663,28.74794520547945,-487.0,-4722.0,-1427.0,,4.0,2.0,2.0,14.0,,0.46707329099822,,0.0928,0.0561,0.9886,,,0.12,0.1034,0.3333,,,,0.1235,,0.0,0.0756,0.0582,0.9886,,,0.0806,0.069,0.3333,,,,0.1286,,0.0,0.0937,0.0561,0.9886,,,0.12,0.1034,0.3333,,,,0.1257,,0.0,0.19,1.0,0.0,0.0,0.0,0.0,-229.0,,,,,,,1.0,1.0,0.0,1.0,0.0,0.0,0.0,0.0,0.0,0.0,0.0,0.0,0.0,1.0,0.0,0.0,0.0,0.0,0.0,0.0,0.0,0.0,0.0,0.0,0.0,0.0,0.0,0.0,0.0,0.0,0.0,0.0,0.0,,,,,,,,,,,,,0.0,,6.0,10212.795,72087.75,79942.5,5724.0,106806.15,15.0,-203.0,365243.0,-469.0,182491.0,-49.0,182494.0,10.0,0.0,0.048179472214195,4.5,26.0,18.0,9.0,-14.5,0.0,0.0,28.0,8521.695,8521.695,-395.0,-396.0,7.5,1.0,0.0,,,,,,,,,,,,,,,,,,,,,8360926195.5,184643745030.0,165802103154.0,52056372655.935,,,,,,,17838.22060000231,17900.55979999913,17351.245399997977,11315.6401000001,11253.3526000001,11200.309400000064,128627.0,663902.0,,,,13549504.599999605,-602896389.0,-923393091.0,-297006017.0,-1537689998.0416667,44105.0,30765.0,11366.593999999192,11242.479999998986,10726.365099997289,22926.256300009845,22847.90790000981,22232.58660000837,,158297.01268702393,,35058.470100028055,34998.577500028485,34443.6782000289,,,,3720093.0,,,,,,,16494.844799999708,16680.412499999697,16276.8562999997,,,,3919.704100000124,3902.9724000001625,3735.55270000016,437274.0,432061.0,,6435.386570002895,632987.0,626529.0,,16359.612499999796,154443.66409999086,154446.4061999904,154338.1005999872,,,,,,,,,,,,,,,,,,,,,,,,,,,,,,355269667.4775015,5056765433.010001,5674417944.030004,82541332.21499999,5056837520.760001,365603.0,-25287186.0,5894161523.5,261232286.5,1333928044.5,579784918.5,1401953504.5,364144.5,5685.0,1031.6751670080305,8430027.0,3016653.0,1859599.0,-6058059.0,1942550.0,246385.0,3981175480.867511,4032501688.1924977,-242968201.5,-240935478.5,4293667.0,200332.5,,,,,,,,,,,,,,,,,,,,,1469893.0,14873472.0,3237710.0,8570487.0,11627010.0,1418299.0,,,,,,,,,,,,,,,,,,,,,,,,,,,,,,,,,,4280253.0,2483469.5,-9018731.5,921848.5,37582.5,3740034210.344958,3664684147.747458,-261067059.5,-257749370.0,2530573.5,269674.0,3932610379.582453,33305628315.24092,36739303611.41264,1732762781.52755,48162483953.21322,3994561.0,-247991927.0,103259875149.5,1056996628.0,17299090040.5,3509831998.0,18913851722.5,3678147.0,72054.0,20906.77392179732,89898263.0,-16.940341179834174,2.8,4.497211728728188,129.28559635491752,12.592192840438928,361.999669793769,28125.0,-0.2225209339563143,0.9749279121818236,0.0,1.0,0.0,0.0,0.0,0.0,0.0,0.0,0.0,0.0,0.0,0.0,0.0,1.0,0.0,0.0,0.0,0.0,1.0,0.0,1.0,0.0,0.0,0.0,0.0,1.0,0.0,0.0,0.0,0.0,0.0,0.0,0.0,0.0,0.0,0.0,0.0,0.0,0.0,0.0,0.0,1.0,0.0,0.0,0.0,0.0,0.0,0.0,0.0,0.0,0.0,0.0,0.0,0.0,0.0,0.0,0.0,0.0,0.0,0.0,0.0,0.0,0.0,0.0,0.0,0.0,0.0,0.0,0.0,0.0,0.0,0.0,0.0,0.0,0.0,0.0,0.0,0.0,1.0,0.0,0.0,0.0,0.0,0.0,0.0,0.0,0.0,0.0,0.0,0.0,0.0,0.0,0.0,0.0,0.0,0.0,0.0,0.0,0.0,0.0,0.0,0.0,0.0,0.0,0.0,0.0,0.0,0.0,0.0,0.0,1.0,0.0,0.0,0.0,1.0,0.0,0.0,0.0,0.0,0.0
106189,0,0.0,0.0,0.0,1.0,2.0,90000.0,286704.0,18450.0,247500.0,0.025164,34.28767123287671,-659.0,-1064.0,-3265.0,,4.0,2.0,2.0,8.0,0.4643847594678778,0.5559606696617281,0.622922000268356,0.0948,0.1051,0.9881,0.8368,0.0181,0.04,0.1379,0.25,0.2083,0.021,0.0765,0.0963,0.0039,0.0317,0.0872,0.0829,0.9876,0.8367,0.0149,0.0,0.1034,0.1667,0.2083,0.019,0.0753,0.091,0.0039,0.0079,0.0958,0.1051,0.9881,0.8390000000000001,0.0182,0.04,0.1379,0.25,0.2083,0.0213,0.0778,0.0981,0.0039,0.0324,0.0703,1.0,6.0,0.0,6.0,0.0,-1997.0,0.0,0.0,0.0,0.0,1.0,3.0,1.0,1.0,0.0,1.0,0.0,0.0,0.0,0.0,0.0,0.0,0.0,0.0,0.0,1.0,0.0,0.0,0.0,0.0,0.0,0.0,0.0,0.0,0.0,0.0,0.0,0.0,0.0,0.0,0.0,0.0,0.0,0.0,4.0,0.0,,99218.25,0.0,0.0,0.0,0.0,0.0,-762.0,-505.0,-457.0,-509.5,111.0,-18.0,11.0,9000.0,43578.0,39078.0,4500.0,180000.0,12.0,-423.0,365243.0,-421.0,-406.0,539.0,-400.5,13.0,0.0,0.1124629191543689,-1.0,11.0,4.0,2.0,-16.0,0.0,0.0,7.0,7926.21,7926.21,-2353.0,-2340.0,2.0,1.0,13.0,0.0,90000.0,,0.0,,,0.0,,0.0,0.0,0.0,0.0,,0.0,,,0.0,-8.0,0.0,0.0,8360944645.5,184644031734.0,165802350654.0,52056462655.935,1863.0,1706.0,71128.0,71029.0,9141.0,506930.0,17838.31540000231,17900.655599999132,17351.332599997982,11315.7452000001,11253.4577000001,11200.392300000063,128629.0,663906.0,4144.467700000115,4142.044500000012,3952.499800000093,13549538.887670835,-602897048.0,-923396356.0,-297008014.0,-1537691062.0416667,44105.0,30765.0,11366.633999999194,11242.519999998987,10726.365099997289,22926.394200009847,22848.045800009808,22232.69000000837,67603.50157639223,158297.56864769358,126318.28435107748,35058.720100028055,34998.827500028485,34443.844900028904,22989.91269999586,22962.92039999544,22609.288699995675,3720101.0,8309.902100000169,8414.65180000008,8137.815500000232,9832.91640000072,9948.030200002151,10308.31809999963,16494.94109999971,16680.510599999696,16276.9472999997,830.0434000001773,815.2216000000461,761.1412000000131,3919.735800000124,3903.0048000001625,3735.56060000016,437280.0,432067.0,,6435.411734002893,632989.0,626531.0,,16359.682799999797,154444.6521999908,154447.39429999038,154339.0881999872,77737.03639999634,78075.42080000657,78477.62400000673,25.5,97659684.22499998,,10249996513.454985,3366932986.349997,120963881.15999998,867402.9449999995,200.0,26026.0,-33542816.5,14796031.0,-17457091.5,-18975432.5,-12.25,0.0,,71739.0,0.0,0.0,0.0,0.0,0.0,-1275.0,-940.0,-869.0,-968.0,356377236.1650015,5076361422.81,5695422724.530004,82713454.51499999,5076541422.81,366908.0,-25363611.0,5910962545.5,262098816.5,1336997390.5,581047158.0,1405023075.0,365277.0,5701.0,1034.4065592862028,8465465.0,3026329.0,1866136.0,-6073598.0,1942622.0,246388.0,3998085805.3500056,4050332826.6150007,-243433630.0,-241396643.0,4297092.0,200875.0,3717830690.279953,10023966000.0,,475596029.5199998,,,210956135.579999,,484376017.229997,3569035443.4800096,3704396465.159941,3704579399.6999407,,42714.0,,,1218627.0,-2156652.0,841946.0,2001.0,1469897.0,14873583.0,3237723.0,8570498.0,11627017.0,1418310.0,1062105017.5620012,,72227332512.74213,21710202848.50512,583602840.1619987,5792665.7475,689.5,94245.0,-277380498.5,21988120.0,-123980643.0,-219056979.5,-2027146.5,5930164032.749963,18755955000.0,,448654573.88999766,,,309482737.78499866,,459708468.1874992,5715073869.322536,5893398100.664999,5893641283.41,,80986.0,,,972659.0,-1701243.5,177364.0,6755.0,4280257.0,2483471.5,-9018747.5,921848.5,37582.5,3740042136.554958,3664692073.957458,-261069412.5,-257751710.0,2530575.5,269675.0,3932619379.582453,33305671893.24092,36739342689.41264,1732767281.52755,48162663953.21322,3994573.0,-247992350.0,103260240392.5,1056996207.0,17299089634.5,3509832537.0,18913851322.0,3678160.0,72054.0,20906.88638471648,89898262.0,-19.21973631642029,3.1856,4.878048780487805,167.25693284330103,15.539512195121947,532.8136852656197,22500.0,-0.9009688679024191,-0.433883739117558,0.0,0.0,0.0,0.0,0.0,0.0,1.0,0.0,0.0,0.0,0.0,0.0,0.0,1.0,0.0,1.0,0.0,0.0,0.0,0.0,1.0,0.0,0.0,0.0,0.0,1.0,0.0,0.0,0.0,0.0,0.0,0.0,0.0,0.0,0.0,0.0,0.0,0.0,0.0,0.0,0.0,0.0,0.0,0.0,0.0,0.0,0.0,0.0,0.0,0.0,0.0,0.0,0.0,0.0,0.0,0.0,0.0,0.0,0.0,0.0,0.0,0.0,0.0,0.0,0.0,0.0,0.0,0.0,0.0,0.0,0.0,0.0,0.0,0.0,0.0,0.0,0.0,0.0,0.0,0.0,0.0,0.0,0.0,0.0,0.0,0.0,0.0,1.0,0.0,0.0,0.0,0.0,0.0,0.0,0.0,0.0,0.0,0.0,0.0,0.0,0.0,0.0,0.0,0.0,0.0,0.0,0.0,0.0,1.0,0.0,1.0,0.0,0.0,1.0,0.0,0.0,0.0,0.0,0.0,0.0
106199,0,0.0,1.0,0.0,1.0,0.0,135000.0,400500.0,25722.0,400500.0,0.026392,54.95342465753425,-945.0,-996.0,-469.0,,2.0,2.0,2.0,13.0,0.6835904748365103,0.5492785284297838,,,,,,,,,,,,,,,,,,,,,,,,,,,,,,,,,,,,,,,,,,,,,,1.0,1.0,1.0,1.0,-484.0,0.0,0.0,0.0,0.0,1.0,2.0,1.0,1.0,0.0,1.0,1.0,0.0,0.0,0.0,0.0,0.0,0.0,0.0,0.0,1.0,0.0,0.0,0.0,0.0,0.0,0.0,0.0,0.0,0.0,0.0,0.0,0.0,0.0,0.0,0.0,0.0,0.0,0.0,2.0,0.0,,31216.5,0.0,,0.0,0.0,0.0,-714.5,-640.0,-653.5,-654.0,48.0,-11.5,3.0,8262.855,17910.0,17910.0,0.0,65492.3475,8.0,-414.0,365243.0,-303.0,182470.0,-93.0,182472.5,19.0,0.0,0.0,10.0,14.0,6.0,5.0,-8.5,0.0,0.0,13.0,3682.665,3682.665,-328.0,-303.0,4.0,1.0,0.0,,,,,,,,,,,,,,,,,,,,,8360970367.5,184644432234.0,165802751154.0,52056597655.935,1863.0,1706.0,71128.0,71030.0,9141.0,506932.0,,,,,,,128629.0,663908.0,,,,13549593.841095492,-602897993.0,-923396825.0,-297008498.0,-1537692058.0416667,44106.0,30766.0,,,,,,,67604.18516686706,158298.11792622204,,,,,,,,3720114.0,,,,,,,,,,,,,,,,437281.0,432068.0,,6435.438126002893,632991.0,626533.0,,,,,,,,,24.0,97686945.22499998,,10259437314.329985,3368502802.349997,,867402.9449999995,200.0,26026.0,-33594630.0,14805969.5,-17484123.0,-19002184.5,-11.5,0.0,,33228.0,0.0,,0.0,0.0,0.0,-787.0,-757.0,-757.0,-757.0,356569543.5075016,5079281544.81,5698547196.030004,82761366.01499999,5079338082.1575,367167.0,-25385769.0,5916803860.5,262263593.5,1337713362.5,581585034.5,1406106118.5,365601.0,5702.0,1035.1696734795798,8471918.0,3027593.0,1866953.0,-6077417.0,1942622.0,246388.0,4000816099.6200094,4053059438.220004,-243659737.0,-241620185.0,4302356.0,200984.0,,,,,,,,,,,,,,,,,,,,,1469899.0,14873631.0,3237723.0,8570512.0,11627030.0,1418313.0,1062105017.5620012,,72227363729.24213,21710202848.50512,,5792665.7475,689.5,94245.0,-277381213.0,21987480.0,-123981296.5,-219057633.5,-2027158.0,,,,,,,,,,,,,,,,,,,,,4280263.0,2483476.5,-9018756.0,921848.5,37582.5,3740045819.219958,3664695756.622458,-261069740.5,-257752013.0,2530579.5,269676.0,3932627642.437453,33305689803.24092,36739360599.41264,1732767281.52755,48162729445.56072,3994581.0,-247992764.0,103260605635.5,1056995904.0,17299272104.5,3509832444.0,18914033794.5,3678179.0,72054.0,20906.88638471648,89898272.0,-17.196380496559975,2.966666666666667,5.248425472358292,288.41895376592504,15.570328901329598,855.6428961722443,67500.0,-0.9009688679024191,0.4338837391175582,0.0,0.0,0.0,0.0,0.0,0.0,1.0,0.0,0.0,0.0,0.0,0.0,0.0,1.0,0.0,0.0,0.0,0.0,1.0,0.0,1.0,0.0,0.0,0.0,0.0,0.0,0.0,0.0,1.0,0.0,0.0,0.0,0.0,0.0,0.0,0.0,0.0,0.0,0.0,0.0,0.0,0.0,0.0,0.0,1.0,0.0,0.0,0.0,0.0,0.0,0.0,0.0,0.0,0.0,0.0,1.0,0.0,0.0,0.0,0.0,0.0,0.0,0.0,0.0,0.0,0.0,0.0,0.0,0.0,0.0,0.0,0.0,0.0,0.0,0.0,0.0,0.0,0.0,0.0,0.0,0.0,0.0,0.0,0.0,0.0,0.0,0.0,0.0,0.0,0.0,0.0,0.0,0.0,0.0,0.0,0.0,0.0,0.0,0.0,0.0,0.0,0.0,0.0,0.0,0.0,0.0,0.0,0.0,0.0,0.0,0.0,0.0,0.0,0.0,0.0,0.0,0.0,0.0,0.0,0.0
106205,0,0.0,0.0,0.0,0.0,0.0,135000.0,358344.0,28440.0,283500.0,0.019101,23.035616438356165,-1551.0,-8394.0,-5.0,,1.0,2.0,2.0,13.0,0.2310263873712685,0.5838091588946659,,,,,,,,,,,,,,,,,,,,,,,,,,,,,,,,,,,,,,,,,,,,,,3.0,2.0,3.0,1.0,-451.0,,,,,,,1.0,1.0,0.0,1.0,0.0,1.0,0.0,0.0,0.0,0.0,1.0,1.0,0.0,0.0,0.0,0.0,0.0,0.0,1.0,0.0,0.0,0.0,0.0,0.0,0.0,0.0,0.0,0.0,0.0,0.0,0.0,0.0,0.0,,,,,,,,,,,,,0.0,,2.0,9268.177500000002,110265.75,136984.5,0.0,110265.75,24.0,-321.5,365243.0,-288.5,182576.0,401.5,182578.5,16.5,0.5,0.0,55.0,19.0,12.0,9.0,-6.0,0.0,0.0,18.0,9689.94,9689.94,-175.5,-168.5,5.0,1.0,0.0,,,,,,,,,,,,,,,,,,,,,8360998807.5,184644790578.0,165803034654.0,52056732655.935,,,,,,,,,,,,,128629.0,663909.0,,,,13549616.876711931,-602899544.0,-923396830.0,-297008949.0,-1537700452.0416667,44108.0,30767.0,,,,,,,67604.41619325442,158298.70173538092,,,,,,,,3720127.0,,,,,,,,,,,,,,,,437284.0,432071.0,,6435.457227002893,632993.0,626535.0,,,,,,,,,,,,,,,,,,,,,,,,,,,,,,,,,,,356687544.01500165,5080439587.005,5699759881.725003,82792078.51499999,5080439587.005,367322.0,-25397702.5,5921186776.5,262252849.5,1338618490.5,581578580.5,1407011320.0,365768.0,5704.5,1035.6139679119858,8484727.0,3028996.0,1867827.0,-6080647.0,1942622.0,246388.0,4001946627.060004,4054298742.18,-243752292.0,-241711044.5,4302999.5,201318.5,,,,,,,,,,,,,,,,,,,,,1469899.0,14873631.0,3237723.0,8570531.0,11627048.0,1418315.0,,,,,,,,,,,,,,,,,,,,,,,,,,,,,,,,,,4280275.0,2483485.5,-9018762.0,921848.5,37582.5,3740055509.159958,3664705446.562458,-261069916.0,-257752181.5,2530584.5,269677.0,3932636910.614953,33305800068.99092,36739497583.91264,1732767281.52755,48162839711.31072,3994605.0,-247993085.5,103260970878.5,1056995615.5,17299454680.5,3509832845.5,18914216373.0,3678195.5,72054.5,20906.88638471648,89898327.0,-67.33051855375831,2.6544,4.746835443037975,109.34628056181722,12.6,290.2487671232877,135000.0,0.6234898018587336,0.7818314824680298,0.0,0.0,0.0,0.0,0.0,0.0,1.0,0.0,1.0,0.0,0.0,0.0,0.0,0.0,0.0,1.0,0.0,0.0,0.0,0.0,0.0,0.0,1.0,0.0,0.0,1.0,0.0,0.0,0.0,0.0,0.0,0.0,0.0,0.0,0.0,0.0,0.0,0.0,1.0,0.0,0.0,0.0,0.0,0.0,0.0,0.0,0.0,0.0,0.0,0.0,0.0,0.0,0.0,1.0,0.0,0.0,0.0,0.0,0.0,0.0,0.0,0.0,0.0,0.0,0.0,0.0,0.0,0.0,0.0,0.0,0.0,0.0,0.0,0.0,0.0,0.0,0.0,0.0,0.0,0.0,0.0,0.0,0.0,0.0,0.0,0.0,0.0,0.0,0.0,0.0,0.0,0.0,0.0,0.0,0.0,0.0,0.0,0.0,0.0,0.0,0.0,0.0,0.0,0.0,0.0,0.0,0.0,0.0,0.0,0.0,0.0,0.0,0.0,0.0,0.0,0.0,0.0,0.0,0.0,0.0
106206,0,0.0,0.0,0.0,0.0,2.0,270000.0,790830.0,,675000.0,0.010643,31.079452054794523,-1582.0,-678.0,-434.0,,4.0,2.0,2.0,17.0,0.3464793883298728,0.6922968581184059,0.2340151665320674,0.0165,,0.9771,,,0.0,0.069,0.0417,,0.0242,,0.0157,,0.0036,0.0168,,0.9772,,,0.0,0.069,0.0417,,0.0248,,0.0163,,0.0038,0.0167,,0.9771,,,0.0,0.069,0.0417,,0.0246,,0.0159,,0.0037,0.0131,1.0,0.0,0.0,0.0,0.0,-615.0,0.0,0.0,0.0,0.0,0.0,2.0,1.0,1.0,1.0,1.0,0.0,0.0,1.0,1.0,1.0,1.0,1.0,1.0,0.0,0.0,0.0,1.0,0.0,0.0,0.0,0.0,0.0,0.0,0.0,0.0,0.0,0.0,0.0,0.0,0.0,0.0,0.0,0.0,3.0,,,112500.0,105457.5,2716.425,0.0,0.0,0.0,-206.0,823.0,-19.0,,34.0,-5.0,4.0,10360.3275,87522.75,94389.75,0.0,87522.75,10.0,-444.0,365243.0,-218.0,365243.0,127.0,365243.0,13.0,1.0,0.0,1455.0,12.0,12.0,7.5,-8.5,0.0,0.0,36.0,5551.717500000002,5551.717500000002,-159.5,-154.5,8.0,0.0,14.0,48838.365,112500.0,0.0,1860.75,0.0,2838.15,2327.04,7138.8675,5906.07,43954.8525,44451.0225,44451.0225,0.0,2.0,0.0,4.0,0.5,-7.5,0.0,0.0,,184645581408.0,165803709654.0,52057002655.935,1863.0,1706.0,71128.0,71030.0,9141.0,506934.0,17838.33190000231,17900.672299999133,17351.34939999798,,,,128631.0,663913.0,,,,13549647.956163986,-602901126.0,-923397264.0,-297009564.0,-1537701130.0416667,44108.0,30767.0,11366.633999999194,11242.519999998987,10726.365099997289,22926.46320000985,22848.11480000981,22232.75900000837,67604.76267264277,158299.39403223904,126318.518366244,35058.761800028056,34998.869200028494,34443.886600028905,,,,3720144.0,8309.926300000168,8414.676400000079,8137.840300000232,,,,16494.95679999971,16680.526499999694,16276.9635999997,,,,3919.739400000124,3903.008500000162,3735.56440000016,437284.0,432071.0,,6435.4678700028935,632995.0,626537.0,,16359.695899999797,154445.6292999908,154448.37139999034,154340.06539998722,,,,7.0,,,10271916496.619984,3372192130.4999976,121251058.69499998,867402.9449999995,200.0,26026.0,-33626789.0,14826419.0,-17498794.0,,-3.0,,,112500.0,105457.5,0.0,0.0,0.0,0.0,-581.0,731.0,-161.0,,356714234.6400016,5080659556.005,5700005973.225003,82792078.51499999,5080659556.005,367348.0,-25398707.0,5921734641.0,262252338.0,1339348727.0,581943821.0,1407741565.0,365808.5,5706.0,1035.6139679119858,8487224.5,3029170.0,1867927.0,-6080759.0,1942622.0,246388.0,4002306878.970004,4054658994.089999,-243756712.5,-241715286.5,4303275.5,201330.0,3720566551.094953,10036206000.0,310736924.505,475838392.7249998,13652636.040000005,151019294.08500025,211103149.81499895,524256113.0474947,484636208.12999696,3571663871.025009,3707116257.6899424,3707299192.229941,16063.5,42739.0,206.0,26486.5,1220632.0,-2160771.5,841947.0,2002.0,1469902.0,14873665.0,3237737.0,8570543.0,11627084.0,1418319.0,,,72227476229.24213,21710308306.00512,583605556.5869987,5792665.7475,689.5,94245.0,-277381419.0,21988303.0,-123981315.5,,-2027163.0,5930212871.114964,18756067500.0,198923232.825,448656434.63999766,1948107.735,257295022.71750084,309485064.8249987,637373907.5624977,459714374.2574992,5715117824.175035,5893442551.687499,5893685734.4325,13396.0,80988.0,44.0,70489.5,972659.5,-1701251.0,177364.0,6755.0,4280287.0,2483493.0,-9018770.5,921848.5,37582.5,3740061060.8774576,3664710998.279958,-261070075.5,-257752336.0,2530592.5,269677.0,3932647270.942453,33305887591.74092,36739591973.66264,1732767281.52755,48162927234.06072,3994615.0,-247993529.5,103261336121.5,1056995397.5,17299819923.5,3509832972.5,18914581616.0,3678208.5,72055.5,20906.88638471648,89899782.0,-50.90179830747532,2.929,,,,,67500.0,1.0,0.0,0.0,0.0,0.0,0.0,0.0,0.0,1.0,0.0,1.0,0.0,0.0,0.0,0.0,0.0,0.0,1.0,0.0,0.0,0.0,0.0,1.0,0.0,0.0,0.0,0.0,0.0,0.0,0.0,1.0,0.0,0.0,0.0,0.0,0.0,0.0,0.0,0.0,0.0,0.0,0.0,0.0,0.0,0.0,0.0,0.0,0.0,0.0,0.0,0.0,0.0,0.0,1.0,0.0,0.0,0.0,0.0,0.0,0.0,0.0,0.0,0.0,0.0,0.0,0.0,0.0,0.0,0.0,0.0,0.0,0.0,0.0,0.0,0.0,0.0,0.0,0.0,0.0,0.0,0.0,0.0,0.0,0.0,0.0,0.0,0.0,0.0,0.0,0.0,0.0,0.0,0.0,0.0,0.0,0.0,0.0,0.0,0.0,0.0,0.0,0.0,0.0,0.0,0.0,0.0,0.0,0.0,0.0,0.0,0.0,0.0,1.0,0.0,0.0,0.0,0.0,0.0,0.0,0.0,1.0,0.0
106211,0,0.0,0.0,0.0,1.0,0.0,90000.0,90000.0,6961.5,90000.0,0.010147,36.35890410958904,-5012.0,-11724.0,-4955.0,,1.0,2.0,2.0,15.0,0.4166061858742375,0.7835206854385793,0.3859146722745145,0.0619,0.0685,0.9791,0.7144,0.0372,0.0,0.1379,0.1667,0.2083,0.025,0.0504,0.079,0.0,0.0,0.063,0.0711,0.9791,0.7256,0.0376,0.0,0.1379,0.1667,0.2083,0.0256,0.0551,0.0823,0.0,0.0,0.0625,0.0685,0.9791,0.7182,0.0374,0.0,0.1379,0.1667,0.2083,0.0254,0.0513,0.0804,0.0,0.0,0.0825,1.0,0.0,0.0,0.0,0.0,-2165.0,0.0,0.0,0.0,0.0,0.0,2.0,1.0,1.0,0.0,1.0,1.0,0.0,0.0,0.0,0.0,0.0,0.0,0.0,0.0,1.0,0.0,0.0,0.0,0.0,0.0,0.0,0.0,0.0,0.0,0.0,0.0,0.0,0.0,0.0,0.0,0.0,0.0,0.0,7.0,21037.5,0.0,29290.5,0.0,0.0,0.0,0.0,0.0,-950.0,-813.5,-11.0,-1238.0,257.0,-20.0,1.0,2670.03,20331.0,19575.0,2250.0,20331.0,10.0,-2165.0,365243.0,-2129.0,-1859.0,-1859.0,-1856.0,9.0,0.0,0.1122774133083411,34.0,11.0,10.0,5.0,-66.0,0.0,0.0,10.0,2670.03,2670.03,-2004.0,-1994.0,5.5,1.0,0.0,,,,,,,,,,,,,,,,,,,,,8361005769.0,184645671408.0,165803799654.0,52057092655.935,1863.0,1706.0,71128.0,71030.0,9141.0,506936.0,17838.393800002308,17900.734799999133,17351.412399997982,11315.8137000001,11253.5262000001,11200.46340000006,128631.0,663914.0,4144.5049000001145,4142.081900000012,3952.537400000093,13549684.315068096,-602906138.0,-923402219.0,-297011729.0,-1537712854.0416667,44108.0,30767.0,11366.633999999194,11242.519999998987,10726.365099997289,22926.601100009848,22848.25270000981,22232.89690000837,67605.17927882863,158300.1775529245,126318.90428091623,35058.92850002806,34999.03590002849,34444.053300028914,22990.12099999586,22963.12869999544,22609.496999995677,3720159.0,8309.951300000168,8414.701800000079,8137.865900000232,9832.96680000072,9948.08150000215,10308.373199999627,16495.03579999971,16680.606899999693,16277.0458999997,830.0434000001773,815.2216000000461,761.1412000000131,3919.739400000124,3903.008500000162,3735.56440000016,437284.0,432071.0,,6435.4780170028935,632997.0,626539.0,,16359.778399999796,154446.6083999908,154449.35049999034,154341.04449998715,77737.75079999634,78076.13900000659,78478.34960000672,32.0,97782179.39999998,33702955.74,10280895454.934984,3375894457.1249976,121671808.69499998,867402.9449999995,200.0,26026.0,-33654115.0,14822635.0,-17508867.0,-19028614.0,-15.5,0.0,0.0,29290.5,0.0,0.0,0.0,0.0,0.0,-1568.0,-1259.0,-50.0,-1259.0,356843014.38000154,5082274970.505,5701689886.725003,82803774.01499999,5082274970.505,367484.0,-25406944.0,5924656317.0,262245300.0,1340074769.0,581940347.0,1408467628.0,365957.0,5708.0,1035.8215708671055,8493609.0,3030608.0,1868819.0,-6082514.0,1942622.0,246388.0,4004283028.2300014,4056504274.754997,-243940063.0,-241897573.5,4306199.0,201421.5,,,,,,,,,,,,,,,,,,,,,1469909.0,14873922.0,3237737.0,8570554.0,11627094.0,1418320.0,1062126055.0620012,802318011.6149951,72227505519.74213,21710308306.00512,583605556.5869987,5792665.7475,689.5,94245.0,-277382369.0,21987489.5,-123981326.5,-219058871.5,-2027183.0,,,,,,,,,,,,,,,,,,,,,4280297.0,2483498.0,-9018836.5,921848.5,37582.5,3740063730.907458,3664713668.309958,-261072079.5,-257754330.0,2530598.0,269678.0,3932649940.972453,33305907922.74092,36739611548.66264,1732769531.52755,48162947565.06072,3994625.0,-247995694.5,103261701364.5,1056993268.5,17299818064.5,3509831113.5,18914579760.0,3678217.5,72055.5,20906.998662129787,89899816.0,-137.84793911536434,1.0,12.928248222365868,470.0569374219656,12.928248222365868,470.0569374219656,90000.0,1.0,0.0,0.0,0.0,0.0,0.0,0.0,0.0,1.0,0.0,0.0,0.0,0.0,0.0,0.0,1.0,0.0,0.0,0.0,0.0,1.0,0.0,0.0,0.0,1.0,0.0,0.0,1.0,0.0,0.0,0.0,0.0,0.0,0.0,0.0,0.0,0.0,0.0,0.0,0.0,0.0,0.0,0.0,0.0,0.0,0.0,0.0,0.0,1.0,0.0,0.0,0.0,0.0,0.0,0.0,0.0,0.0,0.0,0.0,0.0,0.0,0.0,0.0,0.0,0.0,0.0,0.0,0.0,0.0,0.0,0.0,0.0,0.0,0.0,0.0,0.0,0.0,0.0,0.0,0.0,0.0,0.0,0.0,0.0,0.0,0.0,0.0,0.0,0.0,0.0,1.0,0.0,0.0,0.0,0.0,0.0,0.0,0.0,0.0,0.0,0.0,0.0,0.0,0.0,0.0,0.0,0.0,0.0,0.0,0.0,0.0,1.0,1.0,0.0,0.0,0.0,0.0,0.0,0.0,1.0,0.0,0.0
106214,0,0.0,0.0,0.0,1.0,1.0,90000.0,711747.0,45616.5,607500.0,0.009549,33.73698630136986,-307.0,-5715.0,-3525.0,,3.0,2.0,2.0,15.0,0.355694417441115,0.6841516117453261,0.7281412993111438,0.2216,0.0896,0.9791,0.7144,0.6381,0.16,0.1379,0.3333,0.375,0.1233,0.1807,0.1766,0.0154,0.1414,0.2258,0.093,0.9791,0.7256,0.6439,0.1611,0.1379,0.3333,0.375,0.1261,0.1974,0.184,0.0156,0.1497,0.2238,0.0896,0.9791,0.7182,0.6421,0.16,0.1379,0.3333,0.375,0.1255,0.1838,0.1798,0.0155,0.1443,0.1792,1.0,0.0,0.0,0.0,0.0,-626.0,0.0,0.0,0.0,0.0,0.0,2.0,1.0,1.0,0.0,1.0,0.0,1.0,0.0,0.0,0.0,0.0,0.0,0.0,0.0,1.0,0.0,0.0,0.0,0.0,0.0,0.0,0.0,0.0,0.0,0.0,0.0,0.0,0.0,0.0,0.0,0.0,0.0,0.0,4.0,0.0,0.0,165354.435,0.0,0.0,0.0,0.0,0.0,-1771.0,-829.5,-953.5,-1597.0,226.0,-28.5,3.0,9567.495,111780.0,124420.5,0.0,190890.0,12.0,-285.0,182479.0,-418.5,365243.0,182669.5,365243.0,11.0,0.0,0.0,-1.0,21.0,24.0,14.0,-11.0,0.0,0.0,39.0,5634.99,5634.99,-189.0,-189.0,10.0,1.0,10.0,241042.1625,270000.0,2250.0,3528.36,0.0,2013.3,12428.01,13500.0,1195.65,237513.15,241042.1625,241042.1625,0.5,2.5,0.0,1.5,3.5,-5.5,0.0,0.0,8361051385.5,184646383155.0,165804407154.0,52057182655.935,1863.0,1706.0,71128.0,71030.0,9141.0,506938.0,17838.615400002313,17900.958599999132,17351.638199997982,11315.903300000098,11253.6158000001,11200.556400000063,128632.0,663917.0,4145.143000000115,4142.724000000012,3953.181300000093,13549718.052054398,-602906445.0,-923405744.0,-297012355.0,-1537718569.0416667,44108.0,30767.0,11366.793999999194,11242.679999998987,10726.526199997286,22926.73900000985,22848.39060000981,22233.03480000837,67605.53497324606,158300.86170453625,126319.63242221557,35059.261800028056,34999.369200028494,34444.386600028905,22990.49599999586,22963.50369999544,22609.871999995677,3720174.0,8310.074600000167,8414.827300000079,8137.992000000232,9833.14750000072,9948.265300002153,10308.570599999628,16495.21239999971,16680.786699999695,16277.229899999696,830.0588000001773,815.2371000000461,761.1568000000129,3919.880800000124,3903.152800000162,3735.71410000016,437284.0,432071.0,,6435.487566002893,632999.0,626541.0,,16359.957599999798,154447.5874999908,154450.32959999036,154342.02359998718,77738.46519999634,78076.85720000659,78479.07520000673,59.0,97803216.89999998,33702955.74,10283461524.382484,3375894457.1249976,121671808.69499998,867402.9449999995,200.0,26026.0,-33679757.0,14803187.0,-17523909.5,-19048409.5,-29.0,0.0,0.0,53958.87,0.0,0.0,0.0,0.0,0.0,-1775.0,-1622.0,-1317.0,-1622.0,356920392.2400015,5083570138.005,5703010875.225003,82812616.51499999,5083514248.005,367544.0,-25410410.0,5925569139.5,262243831.0,1340987692.5,582305549.0,1409380558.5,366019.0,5708.0,1035.9255382027236,8496381.0,3031564.0,1869374.0,-6084381.0,1942622.0,246388.0,4005151946.009998,4057373192.534993,-243982695.0,-241939703.0,4306707.0,201462.0,3727009739.474953,10051371000.0,310964624.505,476275828.9049998,13652636.040000005,151134805.93500024,211557086.59499905,524930610.10499465,485322129.11249685,3577859246.1375084,3713519786.669943,3713702721.2099423,16093.0,42845.5,206.0,26546.5,1224899.5,-2165503.0,841993.0,2048.0,1469913.0,14874148.0,3237747.0,8570575.0,11627133.0,1418323.0,1062126055.0620012,802318011.6149951,72227670874.17712,21710308306.00512,583605556.5869987,5792665.7475,689.5,94245.0,-277384140.0,21986660.0,-123982280.0,-219060468.5,-2027211.5,5930453913.277463,18756337500.0,198925482.825,448659962.9999977,1948107.735,257297036.0175008,309497492.83499867,637387407.5624977,459715569.9074992,5715355337.325035,5893683593.849999,5893926776.595,13396.5,80990.5,44.0,70491.0,972663.0,-1701256.5,177364.0,6755.0,4280321.0,2483512.0,-9018847.5,921848.5,37582.5,3740069365.8974576,3664719303.2999578,-261072268.5,-257754519.0,2530608.0,269679.0,3932659508.467453,33306019702.74092,36739735969.16264,1732769531.52755,48163138455.06072,3994637.0,-247995979.5,103261883843.5,1056992850.0,17300183307.5,3510013783.0,18914945003.0,3678228.5,72055.5,20906.998662129787,89899815.0,-9.099805099886307,7.9083,1.972970306796883,66.56207221341592,15.602841077241788,526.3928356853571,30000.0,1.0,0.0,0.0,1.0,0.0,0.0,0.0,0.0,0.0,0.0,0.0,0.0,0.0,0.0,0.0,1.0,0.0,1.0,0.0,0.0,0.0,0.0,1.0,0.0,0.0,0.0,0.0,1.0,0.0,0.0,0.0,0.0,0.0,0.0,0.0,0.0,0.0,0.0,0.0,0.0,0.0,0.0,0.0,0.0,0.0,0.0,0.0,0.0,0.0,0.0,0.0,0.0,0.0,0.0,1.0,0.0,0.0,0.0,0.0,0.0,0.0,0.0,0.0,0.0,0.0,0.0,0.0,0.0,0.0,0.0,0.0,0.0,0.0,0.0,0.0,0.0,0.0,0.0,0.0,0.0,0.0,0.0,0.0,0.0,0.0,0.0,0.0,0.0,0.0,0.0,0.0,0.0,0.0,0.0,0.0,0.0,0.0,0.0,0.0,0.0,0.0,0.0,0.0,0.0,0.0,0.0,0.0,0.0,0.0,0.0,1.0,0.0,1.0,0.0,0.0,0.0,0.0,0.0,0.0,0.0,1.0,0.0
106216,0,0.0,1.0,1.0,1.0,0.0,202500.0,1434955.5,98550.0,1354500.0,0.010032,62.21917808219178,-759.0,-263.0,-562.0,19.0,2.0,2.0,2.0,7.0,,0.5273582119495329,0.5656079814115492,0.088,0.1109,0.9816,0.7484,,0.0,0.2069,0.1667,,0.0,,0.0517,,0.0246,0.083,0.1068,0.9801,0.7387,,0.0,0.2069,0.1667,,0.0,,0.0493,,0.0,0.0843,0.1144,0.9816,0.7518,,0.0,0.2069,0.1667,,0.0,,0.0519,,0.0128,0.0564,1.0,0.0,0.0,0.0,0.0,0.0,0.0,0.0,0.0,0.0,0.0,0.0,1.0,1.0,0.0,1.0,0.0,0.0,0.0,0.0,0.0,0.0,0.0,0.0,0.0,1.0,0.0,0.0,0.0,0.0,0.0,0.0,0.0,0.0,0.0,0.0,0.0,0.0,0.0,0.0,0.0,0.0,0.0,0.0,5.0,0.0,0.0,137754.0,0.0,0.0,0.0,0.0,0.0,-795.0,-449.0,-449.0,-494.5,119.0,-13.0,2.0,16849.237500000007,122400.0,125489.25,0.0,122400.0,9.0,-1172.5,365243.0,-1138.5,-898.5,-898.5,-891.0,4.0,0.0,0.0,34.0,20.0,12.0,4.5,-35.5,0.0,0.0,19.0,11936.52,11936.52,-1085.0,-1081.0,5.0,1.0,0.0,,,,,,,,,,,,,,,,,,,,,8361149935.5,184647818110.5,165805761654.0,52057385155.935,1863.0,1706.0,71128.0,71030.0,9141.0,506938.0,17838.703400002312,17901.04289999913,17351.721199997977,11316.014200000098,11253.7302000001,11200.663200000065,128632.0,663919.0,,,,13549780.27123248,-602907204.0,-923406306.0,-297012355.0,-1537718832.0416667,44108.0,30767.0,11366.793999999194,11242.679999998987,10726.526199997286,22926.94590000985,22848.597500009808,22233.241700008373,,158301.3890627482,126320.198030197,35059.42850002806,34999.53590002849,34444.553300028914,,,,3720181.0,8310.074600000167,8414.827300000079,8137.992000000232,,,,16495.26409999971,16680.838599999694,16277.2791999997,,,,3919.905400000124,3903.165600000162,3735.71410000016,437284.0,432071.0,1265169.0,6435.497598002893,633001.0,626543.0,,16360.013999999795,154448.5690999908,154451.31119999036,154343.00369998714,77739.21359999634,78077.60900000659,78479.81390000673,27.0,97803216.89999998,33702955.74,10284772968.314983,3376065717.449997,121671808.69499998,867402.9449999995,200.0,26026.0,-33687715.0,14800853.0,-17528273.0,-19052338.0,-13.0,0.0,1854.18,137754.0,0.0,0.0,0.0,0.0,0.0,-891.0,-526.0,-538.0,-540.0,356962054.8600015,5083883590.005,5703339753.225003,82812616.51499999,5083883590.005,367580.0,-25412952.5,5926664868.5,262241660.5,1341534270.5,582304368.5,1409927147.5,366064.5,5709.0,1035.9255382027236,8496513.5,3031996.0,1869600.0,-6084849.5,1942622.0,246388.0,4005526914.494992,4057720764.074989,-243999900.0,-241956592.0,4306991.0,201500.0,,,,,,,,,,,,,,,,,,,,,1469918.0,14874267.0,3237747.0,8570595.0,11627152.0,1418325.0,1062126055.0620012,802318011.6149951,72227808628.17712,21710308306.00512,583605556.5869987,5792665.7475,689.5,94245.0,-277384935.0,21986211.0,-123982729.0,-219060963.0,-2027224.5,,,,,,,,,,,,,,,,,,,,,4280333.0,2483516.5,-9018883.0,921848.5,37582.5,3740081302.4174576,3664731239.8199577,-261073353.5,-257755600.0,2530613.0,269680.0,3932676357.704953,33306142102.74092,36739861458.41264,1732769531.52755,48163260855.06072,3994646.0,-247997152.0,103262249086.5,1056991711.5,17300182409.0,3510012884.5,18914944112.0,3678232.5,72055.5,20906.998662129787,89899849.0,-12.198811096433287,7.0862,2.054794520547945,127.84762619628452,14.560684931506849,905.9538487521112,101250.0,-0.2225209339563146,-0.9749279121818236,0.0,0.0,0.0,0.0,0.0,0.0,1.0,0.0,0.0,0.0,0.0,0.0,0.0,1.0,0.0,1.0,0.0,0.0,0.0,0.0,1.0,0.0,0.0,0.0,0.0,1.0,0.0,0.0,0.0,0.0,0.0,0.0,0.0,0.0,0.0,0.0,0.0,0.0,1.0,0.0,0.0,0.0,0.0,0.0,0.0,0.0,0.0,0.0,0.0,0.0,0.0,0.0,0.0,0.0,0.0,0.0,0.0,0.0,0.0,0.0,0.0,0.0,0.0,0.0,0.0,0.0,0.0,0.0,0.0,0.0,0.0,0.0,0.0,0.0,0.0,0.0,1.0,0.0,0.0,0.0,0.0,0.0,0.0,0.0,0.0,0.0,0.0,0.0,0.0,0.0,0.0,0.0,0.0,0.0,0.0,0.0,0.0,0.0,0.0,0.0,0.0,0.0,0.0,0.0,0.0,0.0,0.0,0.0,1.0,0.0,1.0,0.0,0.0,0.0,0.0,0.0,0.0,0.0,1.0,0.0
106217,0,0.0,0.0,0.0,1.0,2.0,90000.0,853200.0,27652.5,675000.0,0.04622,33.88219178082193,-2824.0,-983.0,-1987.0,,4.0,1.0,1.0,10.0,0.5423155424063271,0.3618340926231869,0.6363761710860439,,,,,,,,,,,,,,,,,,,,,,,,,,,,,,,,,,,,,,,,,,,,,5.0,0.0,5.0,0.0,-1189.0,0.0,0.0,0.0,0.0,1.0,1.0,1.0,1.0,0.0,1.0,0.0,0.0,0.0,0.0,0.0,0.0,0.0,0.0,0.0,1.0,0.0,0.0,0.0,0.0,0.0,0.0,0.0,0.0,0.0,0.0,0.0,0.0,0.0,0.0,0.0,0.0,0.0,0.0,8.0,0.0,0.0,31005.0,0.0,0.0,0.0,0.0,0.0,-1348.0,-1211.5,-990.0,-1315.5,306.0,-20.0,1.0,22671.765,118530.0,124789.5,0.0,118530.0,6.0,-500.0,365243.0,-470.0,-350.0,-320.0,-345.0,16.0,1.0,0.0,144.0,6.0,6.0,3.5,-13.5,0.0,0.0,7.0,17862.39,17862.39,-435.0,-410.0,3.0,3.0,0.0,,,,,,,,,,,,,,,,,,,,,8361177588.0,184648671310.5,165806436654.0,52057475155.935,1863.0,1706.0,71128.0,71031.0,9141.0,506939.0,,,,,,,128634.0,663923.0,,,,13549814.15342426,-602910028.0,-923408293.0,-297013544.0,-1537719815.0416667,44108.0,30767.0,,,,,,,67606.07728878848,158301.75089684082,126320.83440636809,,,,,,,3720191.0,,,,,,,,,,,,,,,,437289.0,432076.0,,6435.543818002893,633002.0,626544.0,,,,,,,,,45.0,97821156.37499996,33704809.92,10285165918.079985,3376065717.449997,121671808.69499998,867402.9449999995,200.0,26026.0,-33695168.0,14812541.5,-17533445.5,-19057571.0,-22.0,0.0,0.0,31005.0,0.0,0.0,0.0,0.0,0.0,-1508.0,-1324.0,-994.0,-1328.0,356990694.88500154,5084066020.005,5703528442.725003,82812616.51499999,5084066020.005,367592.0,-25414144.0,5927212733.0,262240515.0,1341533410.0,582303538.0,1409926296.0,366082.0,5710.0,1035.9255382027236,8496668.0,3032130.0,1869672.0,-6085271.0,1942622.0,246388.0,4005710470.799991,4057908786.224989,-244012296.0,-241968891.0,4307062.0,201519.0,,,,,,,,,,,,,,,,,,,,,1469926.0,14874573.0,3237747.0,8570601.0,11627159.0,1418326.0,1062126055.0620012,802318011.6149951,72227839633.17712,21710308306.00512,583605556.5869987,5792665.7475,689.5,94245.0,-277386283.0,21984999.5,-123983719.0,-219062278.5,-2027244.5,,,,,,,,,,,,,,,,,,,,,4280339.0,2483520.0,-9018896.5,921848.5,37582.5,3740099164.807458,3664749102.2099576,-261073788.5,-257756010.0,2530616.0,269683.0,3932699029.469953,33306260632.74092,36739986247.91264,1732769531.52755,48163379385.06072,3994652.0,-247997652.0,103262614329.5,1056991241.5,17300182059.0,3510012564.5,18914943767.0,3678248.5,72056.5,20906.998662129787,89899993.0,-83.34761866256973,9.48,3.2546786004882016,110.27564452667836,30.85435313262815,1045.4131101129103,22500.0,0.6234898018587336,0.7818314824680298,0.0,0.0,0.0,0.0,0.0,0.0,1.0,0.0,0.0,0.0,0.0,0.0,0.0,1.0,0.0,0.0,0.0,0.0,1.0,0.0,1.0,0.0,0.0,0.0,0.0,1.0,0.0,0.0,0.0,0.0,0.0,0.0,0.0,0.0,0.0,0.0,0.0,0.0,0.0,0.0,0.0,0.0,0.0,0.0,0.0,0.0,0.0,0.0,0.0,0.0,0.0,0.0,0.0,1.0,0.0,0.0,0.0,0.0,0.0,0.0,0.0,0.0,0.0,0.0,0.0,0.0,0.0,0.0,0.0,0.0,0.0,0.0,0.0,0.0,0.0,0.0,0.0,0.0,0.0,0.0,0.0,0.0,0.0,0.0,0.0,0.0,0.0,0.0,0.0,0.0,0.0,0.0,0.0,0.0,0.0,0.0,0.0,0.0,0.0,0.0,0.0,0.0,0.0,0.0,0.0,0.0,0.0,0.0,0.0,0.0,0.0,0.0,0.0,0.0,0.0,0.0,0.0,0.0,0.0,0.0
106225,0,0.0,1.0,0.0,1.0,0.0,225000.0,509400.0,40374.0,450000.0,0.04622,26.35342465753425,-249.0,-561.0,-2281.0,,1.0,1.0,1.0,18.0,,0.4708090927947965,0.5673792367572691,0.2825,0.1065,0.9985,0.9796,0.1891,0.32,0.1379,0.6667,0.7083,0.1811,0.2286,0.3088,0.0077,0.0226,0.2878,0.1105,0.9985,0.9804,0.1908,0.3222,0.1379,0.6667,0.7083,0.1853,0.2498,0.3217,0.0078,0.0239,0.2852,0.1065,0.9985,0.9799,0.1903,0.32,0.1379,0.6667,0.7083,0.1843,0.2326,0.3143,0.0078,0.0231,0.3512,1.0,1.0,0.0,1.0,0.0,0.0,0.0,0.0,0.0,0.0,1.0,1.0,1.0,1.0,0.0,1.0,0.0,1.0,0.0,0.0,0.0,0.0,1.0,1.0,0.0,0.0,0.0,0.0,0.0,0.0,0.0,1.0,0.0,0.0,0.0,0.0,0.0,0.0,0.0,0.0,0.0,0.0,0.0,0.0,3.0,0.0,,51813.0,0.0,0.0,0.0,0.0,0.0,-1165.0,-7.0,-532.0,-1437.5,112.0,-24.0,1.0,53413.02,314991.0,314991.0,0.0,314991.0,6.0,-580.0,365243.0,-549.0,-399.0,-399.0,-397.0,14.0,0.0,0.0,111.0,7.0,6.0,3.0,-16.0,0.0,0.0,6.0,53413.02,53413.02,-477.5,-474.0,3.5,1.0,0.0,,,,,,,,,,,,,,,,,,,,,8361217962.0,184649180710.5,165806886654.0,52057700155.935,1863.0,1706.0,71128.0,71032.0,9141.0,506940.0,17838.985900002313,17901.32809999913,17352.008999997975,11316.120700000098,11253.8367000001,11200.773700000063,128634.0,663924.0,4145.332100000114,4142.914300000012,3953.372100000093,13549840.506848918,-602910277.0,-923410574.0,-297013544.0,-1537720376.0416667,44108.0,30767.0,11367.113999999194,11242.999999998989,10726.848399997289,22927.08380000985,22848.735400009813,22233.37960000837,,158302.22170593365,126321.40178560484,35060.09520002806,35000.202600028504,34445.22000002891,22991.20429999585,22964.21199999544,22610.580299995672,3720209.0,8310.255700000167,8415.011600000082,8138.177300000232,9833.376100000722,9948.49790000215,10308.820399999628,16495.572899999708,16681.15289999969,16277.6008999997,830.0665000001773,815.2449000000461,761.164600000013,3919.928000000124,3903.1887000001625,3735.73800000016,437290.0,432077.0,,6435.590038002893,633003.0,626545.0,,16360.365199999796,154449.56759999078,154452.30969999035,154344.00219998715,77740.19319999634,78078.5889000066,78480.79430000673,39.0,97846827.11999996,,10291285738.034985,3379258499.579997,121761808.69499998,867402.9449999995,200.0,26026.0,-33722280.0,14856452.5,-17545546.0,-19070235.0,-19.0,0.0,,0.0,0.0,0.0,0.0,0.0,0.0,-1996.0,-921.0,-1954.0,-1954.0,357293312.9100015,5086839451.005,5706892633.725003,82881727.51499999,5086839451.005,367928.0,-25440812.0,5934882836.0,262218068.0,1341880643.0,582288201.0,1410273663.0,366379.0,5721.0,1037.324159416608,8499823.0,3034647.0,1871284.0,-6091339.0,1942625.0,246388.0,4008436533.0899982,4060581348.8699937,-244359988.5,-242314347.5,4314910.5,201708.5,,,,,,,,,,,,,,,,,,,,,1469929.0,14874685.0,3237747.0,8570608.0,11627165.0,1418327.0,1062126055.0620012,,72227891446.17712,21710308306.00512,583605556.5869987,5792665.7475,689.5,94245.0,-277387448.0,21984992.5,-123984251.0,-219063716.0,-2027268.5,,,,,,,,,,,,,,,,,,,,,4280345.0,2483523.0,-9018912.5,921848.5,37582.5,3740152577.827458,3664802515.2299576,-261074266.0,-257756484.0,2530619.5,269684.0,3932752442.489953,33306575623.74092,36740301238.91264,1732769531.52755,48163694376.06072,3994658.0,-247998232.0,103262979572.5,1056990692.5,17300181660.0,3510012165.5,18914943370.0,3678262.5,72056.5,20906.998662129787,89900104.0,-9.44848736874935,2.264,5.572893446277306,146.8648275609354,12.617030762371824,332.5019695979578,225000.0,-0.9009688679024191,-0.433883739117558,0.0,1.0,0.0,0.0,0.0,0.0,0.0,0.0,1.0,0.0,0.0,0.0,0.0,0.0,0.0,1.0,0.0,0.0,0.0,0.0,0.0,0.0,1.0,0.0,0.0,1.0,0.0,0.0,0.0,0.0,0.0,0.0,0.0,0.0,0.0,0.0,0.0,0.0,0.0,0.0,0.0,0.0,0.0,0.0,1.0,0.0,0.0,0.0,0.0,0.0,0.0,0.0,0.0,0.0,0.0,0.0,0.0,0.0,0.0,0.0,0.0,0.0,0.0,0.0,0.0,0.0,0.0,0.0,0.0,0.0,0.0,0.0,0.0,0.0,0.0,0.0,0.0,0.0,0.0,0.0,0.0,0.0,0.0,0.0,0.0,0.0,0.0,0.0,0.0,0.0,1.0,0.0,0.0,0.0,0.0,0.0,0.0,0.0,0.0,0.0,0.0,0.0,0.0,0.0,0.0,0.0,0.0,0.0,1.0,0.0,1.0,0.0,0.0,0.0,0.0,1.0,0.0,0.0,0.0,0.0
106249,0,0.0,0.0,0.0,1.0,0.0,72000.0,675000.0,24376.5,675000.0,0.028663,62.8,,-17043.0,-1027.0,,1.0,2.0,2.0,9.0,,0.6272083707738779,0.5585066276769286,0.0866,0.0051,0.9737,0.6396,0.0353,0.0,0.1379,0.1667,0.2083,0.0553,0.067,0.0638,0.0164,0.0151,0.042,0.0,0.9737,0.6537,0.0184,0.0,0.069,0.1667,0.2083,0.03,0.0367,0.0333,0.0,0.0,0.0625,0.0,0.9737,0.6444,0.0257,0.0,0.1034,0.1667,0.2083,0.0566,0.0513,0.0488,0.0,0.0,0.0351,1.0,1.0,1.0,1.0,1.0,-1063.0,0.0,0.0,0.0,0.0,1.0,3.0,1.0,0.0,0.0,1.0,1.0,0.0,0.0,0.0,0.0,0.0,0.0,0.0,0.0,1.0,0.0,0.0,0.0,0.0,0.0,0.0,0.0,0.0,0.0,0.0,0.0,0.0,0.0,0.0,0.0,0.0,0.0,0.0,1.0,,,67500.0,0.0,0.0,0.0,0.0,0.0,-258.0,-6.0,-163.0,,9.0,-4.0,4.0,16906.59,168750.0,179887.5,,180000.0,12.0,-623.0,365243.0,-707.0,-508.0,-377.0,-500.0,10.0,1.0,,-1.0,19.0,12.0,8.0,-25.0,0.0,0.0,123.0,213.03,213.03,-1313.0,-1313.0,55.0,0.0,96.0,0.0,135000.0,0.0,0.0,0.0,0.0,0.0,213.03,0.0,0.0,0.0,0.0,0.0,0.0,0.0,0.0,23.0,-48.5,0.0,0.0,8361242338.5,184649855710.5,165807561654.0,52057772155.935,1863.0,1706.0,71128.0,71033.0,9141.0,506943.0,17839.072500002312,17901.39059999913,17352.050999997977,11316.125800000098,11253.8367000001,11200.773700000063,128634.0,663925.0,4145.367400000114,4142.940000000012,3953.3905000000927,13549903.30684892,,-923411601.0,-297014607.0,-1537737419.0416667,44109.0,30768.0,11367.113999999194,11242.999999998989,10726.848399997289,22927.221700009854,22848.838800009813,22233.44860000837,,158302.8489143044,126321.96029223251,35060.26190002806,35000.3693000285,34445.38670002891,22991.412599995856,22964.42029999544,22610.78859999567,3720218.0,8310.311000000167,8415.068200000082,8138.207300000232,9833.44310000072,9948.54920000215,10308.857099999628,16495.636699999708,16681.201699999692,16277.634199999697,830.0829000001773,815.2449000000461,761.164600000013,3919.943100000124,3903.1887000001625,3735.73800000016,437291.0,432078.0,,6435.618701002893,633005.0,626547.0,,16360.400299999796,154450.5412999908,154453.28339999035,154344.97589998716,77740.83279999634,78079.2333000066,78481.44800000673,9.0,,,10307336107.499989,3382408931.849997,121798026.67499998,867402.9449999995,200.0,26026.0,-33827693.0,14907042.0,-17596173.0,,-4.0,,,67500.0,0.0,0.0,0.0,0.0,0.0,-258.0,-6.0,-163.0,,358551801.49500173,5105341906.830001,5727701758.725003,,5105341906.830001,369229.0,-25521036.5,5956796116.0,262884210.0,1347310308.0,584443164.0,1416435494.0,367677.5,5746.0,,8518966.5,3045267.0,1877738.0,-6116969.0,1943822.0,246410.0,4022642246.309986,4074638512.229984,-245073712.0,-243021770.0,4323837.0,202510.0,3737832934.8149543,10084063500.0,313095824.505,478738721.5199998,13652636.040000005,151466498.55000025,212104287.9449991,526736533.09499454,486967959.3149968,3588155825.8050084,3724155988.6949406,3724338923.23494,16209.0,43091.0,206.0,26676.0,1228209.5,-2177606.0,841994.0,2049.0,1469930.0,14874694.0,3237843.0,8570627.0,11627288.0,1418331.0,,,72227958946.17712,21710308306.00512,583605556.5869987,5792665.7475,689.5,94245.0,-277387706.0,21984986.5,-123984414.0,,-2027272.5,5930453913.277463,18756472500.0,198925482.825,448659962.9999977,1948107.735,257297036.0175008,309497492.83499867,637387620.5924977,459715569.9074992,5715355337.325035,5893683593.849999,5893926776.595,13396.5,80990.5,44.0,70491.0,972686.0,-1701305.0,177364.0,6755.0,4280357.0,2483531.0,-9018937.5,921848.5,37582.5,3740152790.8574576,3664802728.259958,-261075579.0,-257757797.0,2530674.5,269684.0,3932769349.079953,33306744373.74092,36740481126.41264,,48163874376.06072,3994670.0,-247998855.0,103263344815.5,1056989985.5,17300181152.0,3510011788.5,18914942870.0,3678272.5,72057.5,,89900103.0,,9.375,2.9536643898836994,185.4901236846963,27.690603655159684,1738.969909544028,72000.0,-0.2225209339563143,0.9749279121818236,0.0,0.0,0.0,0.0,0.0,0.0,1.0,0.0,0.0,1.0,0.0,0.0,0.0,0.0,0.0,0.0,0.0,0.0,1.0,0.0,0.0,0.0,0.0,1.0,0.0,1.0,0.0,0.0,0.0,0.0,0.0,0.0,0.0,0.0,0.0,0.0,0.0,0.0,0.0,0.0,0.0,0.0,0.0,0.0,0.0,0.0,0.0,0.0,0.0,0.0,0.0,0.0,0.0,0.0,0.0,0.0,0.0,0.0,0.0,0.0,0.0,0.0,0.0,0.0,0.0,0.0,0.0,0.0,0.0,0.0,0.0,0.0,0.0,0.0,0.0,0.0,0.0,0.0,0.0,0.0,0.0,0.0,0.0,0.0,0.0,0.0,0.0,0.0,0.0,0.0,0.0,0.0,0.0,0.0,0.0,0.0,0.0,0.0,0.0,0.0,0.0,0.0,0.0,0.0,0.0,1.0,0.0,0.0,1.0,0.0,1.0,0.0,0.0,0.0,0.0,0.0,0.0,0.0,1.0,0.0
106256,0,0.0,0.0,0.0,1.0,0.0,157500.0,301464.0,19413.0,238500.0,0.031329,59.923287671232885,,-10402.0,-3826.0,,2.0,2.0,2.0,11.0,,0.1512429506205085,,,,,,,,,,,,,,,,,,,,,,,,,,,,,,,,,,,,,,,,,,,,,,2.0,1.0,2.0,0.0,-1688.0,,,,,,,1.0,0.0,0.0,1.0,0.0,0.0,0.0,0.0,0.0,0.0,0.0,0.0,0.0,0.0,0.0,0.0,1.0,0.0,0.0,0.0,0.0,0.0,0.0,0.0,0.0,0.0,0.0,0.0,0.0,0.0,0.0,0.0,0.0,,,,,,,,,,,,,0.0,,5.0,8566.605,45000.0,51070.5,0.0,45000.0,6.0,-483.0,365243.0,-453.0,-303.0,-303.0,-299.0,10.0,1.0,0.0,10.0,42.0,10.0,4.0,-29.5,0.0,0.0,40.0,8920.8675,9275.13,-913.0,-880.0,5.0,1.0,7.0,0.0,0.0,0.0,0.0,0.0,0.0,0.0,0.0,0.0,0.0,225.0,225.0,0.0,0.0,0.0,0.0,1.0,-5.0,59.0,0.0,8361261751.5,184650157174.5,165807800154.0,52057929655.935,,,,,,,,,,,,,128634.0,663927.0,,,,13549963.23013659,,-923415427.0,-297016295.0,-1537747821.0416667,44110.0,30768.0,,,,,,,,158303.000157255,,,,,,,,3720229.0,,,,,,,,,,,,,,,,437293.0,432080.0,,6435.650030002895,633007.0,626549.0,,,,,,,,,,,,,,,,,,,,,,,,,,,,,,,,,,,358983152.8200016,5110086382.830001,5732906562.225003,83222849.33999999,5110086382.830001,369642.0,-25552616.0,5965556729.0,263953724.0,1349480960.0,585528390.0,1419343509.0,368277.0,5756.0,1040.795788700045,8532917.0,3048456.5,1879832.0,-6123355.5,1944250.0,246476.0,4026889922.445019,4079002827.780016,-245791595.0,-243737705.0,4342054.5,202713.5,3740668304.444955,10097946000.0,313312274.505,478959511.5899998,13652636.040000005,151466498.55000025,212369335.10999903,527514187.7249927,487444817.3849968,3590859273.435009,3726956424.9149375,3727139359.4549375,16216.0,43098.0,206.0,26676.0,1232940.0,-2191679.0,842297.0,2056.0,1469930.0,14874694.0,3237850.0,8570669.0,11627328.0,1418336.0,,,,,,,,,,,,,,5930453913.277463,18756472500.0,198925482.825,448659962.9999977,1948107.735,257297036.0175008,309497492.83499867,637387620.5924977,459715569.9074992,5715355337.325035,5893683818.849999,5893927001.595,13396.5,80990.5,44.0,70491.0,972687.0,-1701310.0,177423.0,6755.0,4280367.0,2483535.0,-9018967.0,921848.5,37582.5,3740161711.724958,3664812003.389958,-261076492.0,-257758677.0,2530679.5,269685.0,3932777915.684953,33306789373.74092,36740532196.91264,1732769531.52755,48163919376.06072,3994676.0,-247999338.0,103263710058.5,1056989532.5,17300180849.0,3510011485.5,18914942571.0,3678282.5,72058.5,20906.998662129787,89900113.0,,1.914057142857143,8.113120074177099,486.1648281161685,15.528975428836349,930.5472618616674,78750.0,-0.9009688679024191,-0.433883739117558,0.0,1.0,0.0,0.0,0.0,0.0,0.0,0.0,0.0,1.0,0.0,0.0,0.0,0.0,0.0,0.0,0.0,0.0,1.0,0.0,1.0,0.0,0.0,0.0,0.0,1.0,0.0,0.0,0.0,0.0,0.0,0.0,0.0,0.0,0.0,0.0,0.0,0.0,0.0,0.0,0.0,0.0,0.0,0.0,0.0,0.0,0.0,0.0,0.0,0.0,0.0,0.0,0.0,0.0,0.0,0.0,0.0,0.0,0.0,0.0,0.0,0.0,0.0,0.0,0.0,0.0,0.0,0.0,0.0,0.0,0.0,0.0,0.0,0.0,0.0,0.0,0.0,0.0,0.0,0.0,0.0,0.0,0.0,0.0,0.0,0.0,0.0,0.0,0.0,0.0,0.0,0.0,0.0,0.0,0.0,0.0,0.0,0.0,0.0,0.0,0.0,0.0,0.0,0.0,0.0,1.0,0.0,0.0,0.0,0.0,0.0,0.0,0.0,0.0,0.0,0.0,0.0,0.0,0.0,0.0
106258,0,0.0,0.0,0.0,1.0,0.0,135000.0,675000.0,38880.0,675000.0,0.00733,59.38082191780822,,-9212.0,-4544.0,,2.0,2.0,2.0,15.0,,0.1684130312798711,0.722392890081304,0.1485,0.077,0.9816,0.7484,0.0181,0.16,0.1379,0.3333,0.375,0.1032,0.1194,0.1415,0.0077,0.0054,0.1513,0.0799,0.9816,0.7583,0.0183,0.1611,0.1379,0.3333,0.375,0.1055,0.1304,0.1475,0.0078,0.0057,0.1499,0.077,0.9816,0.7518,0.0182,0.16,0.1379,0.3333,0.375,0.105,0.1214,0.1441,0.0078,0.0055,0.1125,1.0,0.0,0.0,0.0,0.0,-379.0,0.0,0.0,0.0,0.0,2.0,0.0,1.0,0.0,0.0,1.0,0.0,0.0,0.0,0.0,0.0,0.0,0.0,0.0,0.0,1.0,0.0,0.0,0.0,0.0,0.0,0.0,0.0,0.0,0.0,0.0,0.0,0.0,0.0,0.0,0.0,0.0,0.0,0.0,3.0,0.0,0.0,67500.0,0.0,0.0,0.0,0.0,0.0,-376.0,-11.0,-43.0,-293.0,51.0,-8.0,1.0,11127.42,42300.0,42300.0,0.0,42300.0,4.0,-379.0,365243.0,-349.0,-289.0,-259.0,-282.0,18.0,0.0,0.0,88.0,4.0,4.0,2.5,-11.5,0.0,0.0,3.0,11127.42,11127.42,-356.0,-319.0,2.0,1.0,0.0,,,,,,,,,,,,,,,,,,,,,8361300631.5,184650832174.5,165808475154.0,52058064655.935,1863.0,1706.0,71128.0,71035.0,9141.0,506943.0,17839.221000002308,17901.54049999913,17352.202299997978,11316.202800000096,11253.9137000001,11200.853600000064,128634.0,663929.0,4145.385500000114,4142.958200000013,3953.408800000093,13550022.610958507,,-923419971.0,-297016674.0,-1537757033.0416667,44110.0,30768.0,11367.273999999194,11243.159999998988,10727.009499997286,22927.35960000985,22848.97670000981,22233.58650000837,,158303.1685702863,126322.6826851226,35060.59520002806,35000.702600028504,34445.72000002891,22991.787599995856,22964.79529999544,22611.16359999567,3720244.0,8310.414200000167,8415.173200000081,8138.312800000232,9833.56250000072,9948.67060000215,10308.987499999628,16495.77819999971,16681.345799999694,16277.781699999698,830.0906000001773,815.2527000000459,761.172400000013,3919.948500000124,3903.194200000162,3735.743700000161,437293.0,432080.0,,6435.657360002894,633009.0,626551.0,,16360.512799999797,154451.52289999078,154454.26499999035,154345.95749998715,77741.58119999633,78079.9851000066,78482.20630000673,13.0,98166228.20999998,33787539.585,10323473700.779991,3387953550.194997,121933026.67499998,867402.9449999995,200.0,26026.0,-33894991.0,14943689.0,-17625824.0,-19168145.5,-6.0,0.0,0.0,67500.0,0.0,0.0,0.0,0.0,0.0,-376.0,-11.0,-43.0,-575.0,359086388.22000164,5111987947.830001,5734901137.725003,83230679.33999999,5111987947.830001,369732.0,-25557275.0,5967017701.0,263950667.0,1349843770.0,585890226.0,1420069707.0,368353.0,5758.0,1040.8874328717163,8533320.0,3048999.5,1880171.0,-6125221.0,1944484.0,246476.0,4027439828.745017,4079541739.635015,-245839035.0,-243784131.0,4342225.0,202751.0,,,,,,,,,,,,,,,,,,,,,1469933.0,14874745.0,3237850.0,8570673.0,11627331.0,1418337.0,1062126055.0620012,802318011.6149951,72228026446.17712,21710308306.00512,583605556.5869987,5792665.7475,689.5,94245.0,-277388082.0,21984975.5,-123984457.0,-219064009.0,-2027280.5,,,,,,,,,,,,,,,,,,,,,4280371.0,2483537.5,-9018978.5,921848.5,37582.5,3740172839.144958,3664823130.809958,-261076848.0,-257758996.0,2530681.5,269686.0,3932789043.104954,33306831673.74092,36740574496.91264,1732769531.52755,48163961676.06072,3994680.0,-247999717.0,103264075301.5,1056989183.5,17300180560.0,3510011226.5,18914942289.0,3678300.5,72058.5,20906.998662129787,89900201.0,,5.0,3.4722222222222223,206.1834094368341,17.36111111111111,1030.9170471841703,67500.0,0.6234898018587336,0.7818314824680298,0.0,1.0,0.0,0.0,0.0,0.0,0.0,0.0,0.0,1.0,0.0,0.0,0.0,0.0,0.0,0.0,0.0,0.0,1.0,1.0,0.0,0.0,0.0,0.0,0.0,1.0,0.0,0.0,0.0,0.0,0.0,0.0,0.0,0.0,0.0,0.0,0.0,0.0,0.0,0.0,0.0,0.0,0.0,0.0,0.0,0.0,0.0,0.0,0.0,0.0,0.0,0.0,0.0,0.0,0.0,0.0,0.0,0.0,0.0,0.0,0.0,0.0,0.0,0.0,0.0,0.0,0.0,0.0,0.0,0.0,0.0,0.0,0.0,0.0,0.0,0.0,0.0,0.0,0.0,0.0,0.0,0.0,0.0,0.0,0.0,0.0,0.0,0.0,0.0,0.0,0.0,0.0,0.0,0.0,0.0,0.0,0.0,0.0,0.0,0.0,0.0,0.0,0.0,0.0,0.0,1.0,0.0,0.0,1.0,0.0,1.0,0.0,0.0,0.0,0.0,0.0,0.0,1.0,0.0,0.0
106261,0,0.0,1.0,1.0,0.0,2.0,166500.0,225000.0,16501.5,225000.0,0.020713,28.21643835616439,-1679.0,-2578.0,-2902.0,9.0,4.0,3.0,3.0,5.0,0.3798127809209666,0.7075880349306105,0.5884877883422673,0.1485,0.062,0.9861,0.8096,0.0276,0.04,0.0345,0.3333,0.375,0.0439,0.121,0.0976,0.0,0.0,0.1513,0.0643,0.9861,0.8171,0.0278,0.0403,0.0345,0.3333,0.375,0.0449,0.1322,0.1017,0.0,0.0,0.1499,0.062,0.9861,0.8121,0.0278,0.04,0.0345,0.3333,0.375,0.0446,0.1231,0.0994,0.0,0.0,0.0768,1.0,0.0,0.0,0.0,0.0,-456.0,0.0,0.0,0.0,0.0,1.0,0.0,1.0,1.0,1.0,1.0,0.0,0.0,0.0,0.0,0.0,0.0,0.0,0.0,0.0,1.0,0.0,0.0,0.0,0.0,0.0,0.0,0.0,0.0,0.0,0.0,0.0,0.0,0.0,0.0,0.0,0.0,0.0,0.0,3.0,28858.5,,1170000.0,456205.5,0.0,0.0,0.0,0.0,-1307.0,520.0,-319.0,-326.0,113.0,-18.0,1.0,5989.32,50796.0,50440.5,5175.0,50796.0,12.0,-456.0,365243.0,-420.0,-90.0,-90.0,365243.0,8.0,0.0,0.1013394728905692,30.0,12.0,12.0,6.5,-9.5,0.0,0.0,13.0,5989.32,5989.32,-244.0,-240.0,7.0,1.0,0.0,,,,,,,,,,,,,,,,,,,,,8361317133.0,184651057174.5,165808700154.0,52058231155.935,1863.0,1706.0,71128.0,71036.0,9141.0,506943.0,17839.36950000231,17901.69039999913,17352.35359999798,11316.264800000095,11253.9757000001,11200.917900000064,128636.0,663933.0,4145.413100000114,4142.986000000013,3953.4366000000928,13550050.827396864,-602911956.0,-923422873.0,-297017130.0,-1537759611.0416667,44110.0,30768.0,11367.313999999194,11243.199999998988,10727.049799997289,22927.394100009857,22849.01120000982,22233.621000008374,67606.45710156941,158303.87615832125,126323.27117291091,35060.92850002806,35001.03590002849,34446.053300028914,22992.162599995856,22965.17029999544,22611.53859999567,3720249.0,8310.458100000167,8415.217800000079,8138.35770000023,9833.68350000072,9948.79370000215,10309.119699999628,16495.87579999971,16681.445199999693,16277.883399999697,830.0906000001773,815.2527000000459,761.172400000013,3919.948500000124,3903.194200000162,3735.743700000161,437293.0,432080.0,1265178.0,6435.678073002894,633012.0,626554.0,,16360.589599999796,154452.5089999908,154455.25109999036,154346.9435999871,77742.39079999633,78080.79720000661,78483.02340000673,43.0,98209774.70999998,,10325777745.779991,3388409755.694997,121933026.67499998,867402.9449999995,200.0,26026.0,-33903873.0,14941347.0,-17630241.0,-19172250.0,-21.0,28858.5,,1170000.0,456205.5,0.0,0.0,0.0,0.0,-1307.0,520.0,-319.0,-326.0,359143140.01500154,5112430396.1100025,5735413786.725003,83252170.61999999,5112430396.1100025,369786.0,-25566627.0,5969209159.0,264309007.0,1350203370.0,586250036.0,1420794662.0,368437.0,5761.0,1041.2006096570178,8540639.0,3049532.0,1880448.0,-6128134.5,1944485.0,246477.0,4028068503.1350217,4080125655.180017,-245924914.0,-243869643.0,4342498.0,202807.0,,,,,,,,,,,,,,,,,,,,,1469936.0,14874858.0,3237850.0,8570685.0,11627344.0,1418338.0,1062154913.5620012,,72229196446.17712,21710764511.50512,583605556.5869987,5792665.7475,689.5,94245.0,-277389389.0,21985495.5,-123984776.0,-219064335.0,-2027298.5,,,,,,,,,,,,,,,,,,,,,4280383.0,2483544.0,-9018988.0,921848.5,37582.5,3740178828.4649577,3664829120.1299577,-261077092.0,-257759236.0,2530688.5,269687.0,3932795032.424954,33306882469.74092,36740624937.41264,1732774706.52755,48164012472.06072,3994692.0,-248000173.0,103264440544.5,1056988763.5,17300180470.0,3510011136.5,18915307532.0,3678308.5,72058.5,20907.10000160268,89900231.0,-59.504320807845424,1.351351351351351,10.089991818925553,284.7036321729158,13.635124079629126,384.734638071508,41625.0,0.6234898018587334,-0.7818314824680299,0.0,0.0,0.0,0.0,0.0,0.0,1.0,0.0,0.0,0.0,0.0,0.0,0.0,1.0,0.0,0.0,0.0,0.0,1.0,0.0,1.0,0.0,0.0,0.0,0.0,1.0,0.0,0.0,0.0,0.0,0.0,0.0,0.0,0.0,0.0,0.0,0.0,0.0,0.0,0.0,0.0,0.0,0.0,0.0,0.0,0.0,0.0,0.0,0.0,0.0,0.0,0.0,1.0,0.0,0.0,0.0,0.0,0.0,0.0,0.0,0.0,0.0,0.0,0.0,0.0,0.0,0.0,0.0,0.0,0.0,0.0,0.0,0.0,0.0,0.0,0.0,0.0,0.0,0.0,0.0,0.0,0.0,0.0,0.0,0.0,0.0,0.0,0.0,0.0,0.0,0.0,0.0,0.0,0.0,0.0,0.0,0.0,0.0,0.0,0.0,0.0,0.0,0.0,0.0,0.0,0.0,0.0,0.0,1.0,0.0,1.0,0.0,0.0,0.0,0.0,0.0,0.0,0.0,1.0,0.0
106262,0,0.0,1.0,1.0,0.0,1.0,112500.0,450000.0,22977.0,450000.0,0.028663,28.44383561643836,-1681.0,-4591.0,-2008.0,8.0,3.0,2.0,2.0,12.0,,0.3881071958967072,0.3328505641648731,0.0041,0.018,0.993,,,,0.1379,0.0417,,0.0187,,0.0044,,0.0009,0.0042,0.0187,0.993,,,,0.1379,0.0417,,0.0192,,0.0046,,0.001,0.0042,0.018,0.993,,,,0.1379,0.0417,,0.0191,,0.0045,,0.001,0.0053,1.0,1.0,0.0,1.0,0.0,-541.0,0.0,0.0,0.0,0.0,1.0,0.0,1.0,1.0,0.0,1.0,1.0,0.0,0.0,0.0,0.0,0.0,1.0,1.0,0.0,1.0,0.0,0.0,0.0,0.0,0.0,0.0,0.0,0.0,0.0,0.0,0.0,0.0,0.0,0.0,0.0,0.0,0.0,0.0,7.0,0.0,0.0,114116.085,0.0,0.0,0.0,0.0,0.0,-900.0,-614.0,-587.0,-614.0,210.0,-14.5,1.0,3925.62,37593.0,42057.0,0.0,37593.0,12.0,-541.0,365243.0,-503.0,-353.0,-173.0,-345.0,11.0,0.0,0.0,524.0,7.0,12.0,9.0,-15.0,0.0,0.0,6.0,3925.62,3925.62,-457.5,-428.0,3.5,1.0,0.0,,,,,,,,,,,,,,,,,,,,,8361340110.0,184651507174.5,165809150154.0,52058343655.935,1863.0,1706.0,71128.0,71037.0,9141.0,506943.0,17839.37360000231,17901.69459999913,17352.357799997983,11316.282800000095,11253.9937000001,11200.936600000065,128637.0,663936.0,,,,13550079.27123248,-602913637.0,-923424881.0,-297017671.0,-1537764202.0416667,44110.0,30768.0,,,,22927.532000009855,22849.149100009818,22233.75890000838,,158304.26426551715,126323.6040234751,35060.97020002806,35001.077600028504,34446.09500002891,,,,3720261.0,8310.476800000168,8415.23690000008,8138.37690000023,,,,16495.880199999712,16681.449699999688,16277.887999999695,,,,3919.949400000124,3903.195200000163,3735.744700000161,437294.0,432081.0,1265186.0,6435.706736002894,633014.0,626556.0,,16360.594899999796,154453.50199999078,154456.24409999035,154347.93659998715,,,,30.0,98238633.20999998,33787539.585,10327587701.039991,3389322918.194997,121933026.67499998,867402.9449999995,200.0,26026.0,-33908401.0,14940378.0,-17632460.0,-19173800.0,-14.5,0.0,0.0,114116.085,0.0,0.0,0.0,0.0,0.0,-999.0,-665.0,-587.0,-665.0,359147065.63500154,5112467989.1100025,5735455843.725003,83252170.61999999,5112467989.1100025,369798.0,-25567168.0,5969574402.0,264308504.0,1350203017.0,586249863.0,1420794317.0,368448.0,5761.0,1041.2006096570178,8541163.0,3049646.0,1880528.0,-6128255.0,1944485.0,246477.0,4028140576.800023,4080197728.845017,-245927814.0,-243872453.5,4342556.5,202819.5,,,,,,,,,,,,,,,,,,,,,1469943.0,14875068.0,3237850.0,8570692.0,11627350.0,1418339.0,1062154913.5620012,802318011.6149951,72229310562.26213,21710764511.50512,583605556.5869987,5792665.7475,689.5,94245.0,-277390289.0,21984881.5,-123985363.0,-219064949.0,-2027313.0,,,,,,,,,,,,,,,,,,,,,4280395.0,2483553.0,-9019003.0,921848.5,37582.5,3740182754.0849576,3664833045.749958,-261077549.5,-257759664.0,2530692.0,269688.0,3932798958.044954,33306920062.74092,36740666994.41264,1732774706.52755,48164050065.06072,3994704.0,-248000714.0,103264805787.5,1056988260.5,17300180117.0,3510010963.5,18915307187.0,3678319.5,72058.5,20907.10000160268,89900755.0,-59.09892120978617,4.0,4.896200548374462,139.2667235430785,19.584802193497847,557.066894172314,37500.0,-0.9009688679024191,0.4338837391175582,0.0,0.0,0.0,0.0,0.0,0.0,1.0,0.0,0.0,0.0,0.0,0.0,0.0,1.0,0.0,0.0,0.0,0.0,1.0,0.0,1.0,0.0,0.0,0.0,0.0,1.0,0.0,0.0,0.0,0.0,0.0,0.0,0.0,0.0,0.0,0.0,0.0,0.0,1.0,0.0,0.0,0.0,0.0,0.0,0.0,0.0,0.0,0.0,0.0,0.0,0.0,0.0,0.0,0.0,0.0,0.0,0.0,0.0,0.0,0.0,0.0,0.0,0.0,0.0,0.0,0.0,0.0,0.0,0.0,0.0,0.0,0.0,0.0,0.0,1.0,0.0,0.0,0.0,0.0,0.0,0.0,0.0,0.0,0.0,0.0,0.0,0.0,0.0,0.0,0.0,0.0,0.0,0.0,0.0,0.0,0.0,0.0,0.0,0.0,0.0,0.0,0.0,0.0,0.0,0.0,0.0,0.0,0.0,0.0,0.0,1.0,0.0,0.0,0.0,0.0,0.0,0.0,0.0,1.0,0.0
106264,0,0.0,0.0,1.0,1.0,1.0,540000.0,248760.0,26118.0,225000.0,0.072508,40.136986301369866,-994.0,-6564.0,-5330.0,3.0,3.0,1.0,1.0,14.0,,0.6481660964151966,0.7738956942145427,0.1946,0.0884,0.9906,0.8708,0.0988,0.26,0.0948,0.6354,0.6771,0.0,0.1574,0.216,0.0058,0.0186,0.1502,0.0735,0.9906,0.8759,0.0804,0.2417,0.069,0.4583,0.5,0.0,0.1543,0.1639999999999999,0.0039,0.0015,0.1764,0.0838,0.9906,0.8725,0.0927,0.24,0.0862,0.6042,0.6458,0.0,0.1437,0.2068,0.0058,0.0186,0.1837,1.0,0.0,0.0,0.0,0.0,-2197.0,0.0,0.0,0.0,0.0,0.0,1.0,1.0,1.0,1.0,1.0,0.0,0.0,0.0,0.0,0.0,0.0,0.0,0.0,0.0,1.0,0.0,0.0,0.0,0.0,0.0,0.0,0.0,0.0,0.0,0.0,0.0,0.0,0.0,0.0,0.0,0.0,0.0,0.0,14.0,19008.0,0.0,91329.345,0.0,0.0,0.0,0.0,0.0,-1254.0,-956.0,-510.5,-1254.5,613.0,-23.0,1.0,5400.405,44505.0,39105.0,5400.0,44505.0,10.0,-2197.0,365243.0,-2123.0,-1883.0,-1853.0,-1877.0,14.0,0.0,0.1321444985752366,25.0,11.0,9.0,4.0,-66.0,0.0,0.0,9.0,5400.405,5400.405,-2055.0,-2003.0,5.0,1.0,0.0,,,,,,,,,,,,,,,,,,,,,8361366228.0,184651755934.5,165809375154.0,52058883655.935,1863.0,1706.0,71128.0,71037.0,9141.0,506944.0,17839.568200002308,17901.87099999913,17352.507999997983,11316.371200000098,11254.0775000001,11201.010100000063,128638.0,663939.0,4145.511900000114,4143.078700000013,3953.5170000000926,13550119.408218782,-602914631.0,-923430211.0,-297019868.0,-1537770766.0416667,44110.0,30768.0,11367.573999999197,11243.439999998987,10727.291499997287,22927.626800009857,22849.235300009823,22233.82790000838,,158304.91243161354,126324.37791916932,35061.60560002806,35001.6818000285,34446.553300028914,22992.839699995853,22965.816099995434,22612.03859999567,3720275.0,8310.476800000168,8415.23690000008,8138.37690000023,9833.84090000072,9948.937400002147,10309.273999999628,16496.096199999713,16681.65649999969,16278.051999999698,830.0964000001773,815.2585000000461,761.1763000000129,3919.968000000124,3903.213800000163,3735.746200000161,437294.0,432081.0,1265189.0,6435.779244002894,633015.0,626557.0,,16360.778599999794,154454.49259999074,154457.23469999034,154348.92719998714,77743.26159999633,78081.66970000659,78483.89930000673,42.0,98410058.45999998,33802074.585,10334002225.499989,3392318613.194997,121944276.67499998,867402.9449999995,200.0,26026.0,-33928724.5,14928644.5,-17642627.0,-19187663.5,-20.5,18715.5,4.5,74314.35,0.0,0.0,0.0,0.0,0.0,-1808.0,-1636.0,-519.0,-1666.0,359306336.4300015,5115406030.1100025,5738333395.725003,83312659.61999999,5115406030.1100025,369940.0,-25571710.0,5970670131.0,264305171.0,1350200944.0,586247820.0,1420792260.0,368514.0,5761.0,1041.4416703640454,8541786.0,3050486.0,1880957.0,-6129194.0,1944485.0,246477.0,4029316811.370021,4081234398.390017,-245955086.0,-243899093.0,4343015.0,202880.0,,,,,,,,,,,,,,,,,,,,,1469957.0,14875681.0,3237850.0,8570703.0,11627359.0,1418340.0,1062173921.5620012,802318011.6149951,72229401891.60713,21710764511.50512,583605556.5869987,5792665.7475,689.5,94245.0,-277391543.0,21983925.5,-123985873.5,-219066203.5,-2027336.0,,,,,,,,,,,,,,,,,,,,,4280404.0,2483557.0,-9019069.0,921848.5,37582.5,3740188154.489959,3664838446.154959,-261079604.5,-257761667.0,2530697.0,269689.0,3932804358.449954,33306964567.74092,36740706099.41264,1732780106.52755,48164094570.06072,3994714.0,-248002911.0,103265171030.5,1056986137.5,17300178234.0,3510009110.5,18915305310.0,3678333.5,72058.5,20907.23214610125,89900780.0,-24.76518771331057,0.4606666666666666,20.67539627842867,829.8480972026849,9.52446588559614,382.2833567780369,180000.0,1.0,0.0,0.0,0.0,0.0,0.0,0.0,0.0,1.0,0.0,0.0,0.0,0.0,0.0,0.0,1.0,0.0,0.0,0.0,0.0,1.0,0.0,1.0,0.0,0.0,0.0,0.0,1.0,0.0,0.0,0.0,0.0,1.0,0.0,0.0,0.0,0.0,0.0,0.0,0.0,0.0,0.0,0.0,0.0,0.0,0.0,0.0,0.0,0.0,0.0,0.0,0.0,0.0,1.0,0.0,0.0,0.0,0.0,0.0,0.0,0.0,0.0,0.0,0.0,0.0,0.0,0.0,0.0,0.0,0.0,0.0,0.0,0.0,0.0,0.0,0.0,0.0,0.0,0.0,0.0,0.0,0.0,0.0,0.0,0.0,0.0,0.0,0.0,0.0,0.0,0.0,0.0,0.0,0.0,0.0,0.0,0.0,0.0,0.0,0.0,0.0,0.0,0.0,0.0,0.0,0.0,0.0,0.0,0.0,0.0,1.0,0.0,1.0,0.0,0.0,0.0,0.0,0.0,0.0,1.0,0.0,0.0
106271,0,0.0,0.0,0.0,1.0,0.0,90000.0,312678.0,23508.0,261000.0,0.008625,50.813698630136976,-3300.0,-5642.0,-1709.0,,1.0,2.0,2.0,14.0,,0.5489645088548795,0.633031641417419,0.0918,0.0778,0.9836,,,0.12,0.069,0.3333,,0.0248,,0.1184,,0.0,0.0935,0.0807,0.9836,,,0.1208,0.069,0.3333,,0.0254,,0.1234,,0.0,0.0926,0.0778,0.9836,,,0.12,0.069,0.3333,,0.0253,,0.1205,,0.0,0.1372,1.0,0.0,0.0,0.0,0.0,-969.0,0.0,0.0,0.0,0.0,2.0,1.0,1.0,1.0,0.0,1.0,0.0,0.0,0.0,0.0,0.0,0.0,1.0,1.0,0.0,1.0,0.0,0.0,0.0,0.0,0.0,0.0,0.0,0.0,0.0,0.0,0.0,0.0,0.0,0.0,0.0,0.0,0.0,0.0,1.0,0.0,,270000.0,0.0,,0.0,0.0,0.0,-805.0,-438.0,-403.0,-403.0,27.0,-13.0,4.0,11527.875,68004.0,70114.5,2560.5,84825.0,12.0,-388.0,365243.0,-666.0,-516.0,-516.0,-508.0,14.0,0.0,0.0497545345060399,199.5,16.0,9.0,6.5,-22.5,0.0,0.0,14.0,13650.9975,13650.9975,-666.5,-651.0,3.0,1.0,0.0,,,,,,,,,,,,,,,,,,,,,8361389736.0,184652068612.5,165809636154.0,52058973655.935,1863.0,1706.0,71128.0,71039.0,9141.0,506945.0,17839.660000002306,17901.96359999913,17352.601499997978,11316.449000000095,11254.1553000001,11201.090800000064,128638.0,663940.0,,,,13550170.221917411,-602917931.0,-923431920.0,-297020837.0,-1537776408.0416667,44110.0,30768.0,11367.693999999196,11243.559999998986,10727.412299997288,22927.695800009857,22849.304300009822,22233.89690000837,,158305.46139612244,126325.01095081074,35061.938900028064,35002.015100028504,34446.886600028905,,,,3720289.0,8310.501600000167,8415.26220000008,8138.402300000232,,,,16496.214599999712,16681.776999999693,16278.175399999698,,,,3919.968000000124,3903.213800000163,3735.746200000161,437294.0,432081.0,,6435.787869002896,633017.0,626559.0,,16360.915799999795,154455.47619999078,154458.21829999037,154349.91079998715,,,,27.0,98487627.20999998,,10351195180.829988,3400416318.194997,,867402.9449999995,200.0,26026.0,-33980210.0,14902422.0,-17674469.0,-19217940.0,-13.0,0.0,,270000.0,0.0,,0.0,0.0,0.0,-805.0,-438.0,-403.0,-403.0,359670320.19000137,5119843241.700003,5742904941.225003,83411547.21,5119843241.700003,370310.0,-25593084.5,5976879262.0,264285384.0,1350915883.0,586234584.0,1421872529.0,368849.0,5764.0,1042.99462697975,8550260.5,3052662.0,1882399.0,-6135571.5,1944618.0,246573.0,4033194447.690016,4084901826.885014,-246135101.5,-244076901.0,4344273.5,203055.5,,,,,,,,,,,,,,,,,,,,,1469958.0,14875708.0,3237850.0,8570719.0,11627373.0,1418344.0,1062173921.5620012,,72229671891.60713,21710764511.50512,,5792665.7475,689.5,94245.0,-277392348.0,21983487.5,-123986276.5,-219066606.5,-2027349.0,,,,,,,,,,,,,,,,,,,,,4280413.0,2483563.5,-9019091.5,921848.5,37582.5,3740201805.4874578,3664852097.1524577,-261080271.0,-257762318.0,2530700.0,269690.0,3932815886.324954,33307032571.74092,36740776213.91264,1732782667.02755,48164179395.06072,3994726.0,-248003299.0,103265536273.5,1056985471.5,17300177718.0,3510008594.5,18915304802.0,3678347.5,72058.5,20907.28190063576,89900979.5,-64.9431174853076,3.4742,3.828483920367536,194.5394281398813,13.300918836140887,675.8688812435754,90000.0,-0.9009688679024191,0.4338837391175582,0.0,0.0,0.0,0.0,0.0,0.0,1.0,0.0,0.0,0.0,0.0,0.0,0.0,1.0,0.0,0.0,0.0,0.0,1.0,0.0,0.0,0.0,1.0,0.0,0.0,1.0,0.0,0.0,0.0,0.0,0.0,0.0,0.0,0.0,0.0,0.0,0.0,0.0,1.0,0.0,0.0,0.0,0.0,0.0,0.0,0.0,0.0,0.0,0.0,0.0,0.0,0.0,0.0,0.0,0.0,0.0,0.0,0.0,0.0,0.0,0.0,0.0,0.0,0.0,0.0,0.0,0.0,0.0,0.0,0.0,0.0,0.0,0.0,0.0,0.0,0.0,0.0,0.0,0.0,0.0,0.0,0.0,0.0,0.0,0.0,0.0,0.0,0.0,0.0,0.0,1.0,0.0,0.0,0.0,0.0,0.0,0.0,0.0,0.0,0.0,0.0,0.0,0.0,0.0,0.0,0.0,0.0,0.0,0.0,0.0,1.0,0.0,0.0,0.0,0.0,0.0,0.0,1.0,0.0,0.0
106276,0,0.0,1.0,0.0,0.0,0.0,112500.0,450000.0,22977.0,450000.0,0.011703,56.824657534246576,-8149.0,-12179.0,-4270.0,,2.0,2.0,2.0,17.0,,0.6478418840867567,0.5673792367572691,0.0876,0.0636,0.9742,0.6464,,0.0,0.1379,0.1667,,0.0399,,0.0667,,0.003,0.0893,0.066,0.9742,0.6602,,0.0,0.1379,0.1667,,0.0408,,0.0695,,0.0032,0.0885,0.0636,0.9742,0.6511,,0.0,0.1379,0.1667,,0.0406,,0.0679,,0.0031,0.0575,1.0,0.0,0.0,0.0,0.0,-1614.0,0.0,0.0,0.0,0.0,0.0,3.0,1.0,1.0,1.0,1.0,1.0,0.0,0.0,0.0,0.0,0.0,0.0,0.0,0.0,1.0,0.0,0.0,0.0,0.0,0.0,0.0,0.0,0.0,0.0,0.0,0.0,0.0,0.0,0.0,0.0,0.0,0.0,0.0,10.0,0.0,0.0,112500.0,0.0,0.0,0.0,0.0,0.0,-997.0,-335.5,-369.0,-774.0,428.0,-27.0,4.0,2504.34,33747.75,33624.0,1125.0,45000.0,12.0,-555.0,365243.0,-524.0,-224.0,-194.0,-219.0,14.0,0.0,0.0500133591610446,1970.0,24.0,12.0,6.5,-30.0,0.0,0.0,22.0,7239.0375,7239.0375,-909.5,-903.5,6.0,1.0,17.0,0.0,225000.0,,0.0,,,0.0,,0.0,0.0,0.0,0.0,,0.0,,,0.0,-10.0,0.0,0.0,8361412713.0,184652518612.5,165810086154.0,52059086155.935,1863.0,1706.0,71128.0,71039.0,9141.0,506948.0,17839.747600002305,17902.05209999913,17352.690799997978,11316.512600000096,11254.218900000098,11201.156800000066,128638.0,663942.0,,,,13550227.046574945,-602926080.0,-923436190.0,-297022451.0,-1537788587.0416667,44110.0,30768.0,11367.693999999196,11243.559999998986,10727.412299997288,22927.833700009855,22849.442200009824,22234.03480000838,,158306.10923800652,126325.5783300475,35062.10560002806,35002.1818000285,34447.053300028914,,,,3720306.0,8310.541500000167,8415.30280000008,8138.4431000002305,,,,16496.281299999708,16681.84489999969,16278.244899999698,,,,3919.971000000124,3903.216900000162,3735.749400000161,437294.0,432081.0,,6435.799572002896,633019.0,626561.0,,16360.973299999794,154456.45039999078,154459.19249999034,154350.88499998717,77743.90799999633,78082.32080000661,78484.55950000673,32.5,98487627.20999998,33857950.5,10353824267.264988,3400705866.194997,122318248.545,867402.9449999995,200.0,26026.0,-33996094.0,14901126.0,-17681299.5,-19227612.0,-16.25,0.0,0.0,90000.0,0.0,0.0,0.0,0.0,0.0,-2499.0,-969.0,-892.0,-967.0,359802291.10500145,5121755477.595002,5744847609.225003,83454915.10499999,5121732977.595002,370469.0,-25605981.5,5980896935.0,264640290.0,1352368323.0,586593349.0,1423325078.0,369019.0,5765.0,1043.9399146669166,8557029.5,3054807.0,1883824.0,-6138713.5,1944651.0,246606.0,4035053884.590015,4086668762.775013,-246220919.5,-244161578.5,4345268.5,203155.5,3740668304.444955,10103661000.0,,479004511.5899998,,,212369335.10999903,,487489817.3849968,3590859273.435009,3726956717.4149375,3727139651.9549375,,43099.0,,,1232941.0,-2194629.0,842446.0,2056.0,1469968.0,14876136.0,3237867.0,8570743.0,11627395.0,1418348.0,1062173921.5620012,802318011.6149951,72229784391.60713,21710764511.50512,583605556.5869987,5792665.7475,689.5,94245.0,-277393345.0,21983152.0,-123986645.5,-219067380.5,-2027376.0,5930453913.277463,18756697500.0,,448659962.9999977,,,309497492.83499867,,459715569.9074992,5715355337.325035,5893683818.849999,5893927001.595,,80990.5,,,972687.0,-1701320.0,177423.0,6755.0,4280425.0,2483570.0,-9019121.5,921848.5,37582.5,3740209044.5249577,3664859336.1899576,-261081180.5,-257763221.5,2530706.0,269691.0,3932818390.6649537,33307066319.49092,36740809837.91264,1732783792.02755,48164224395.06072,3994738.0,-248003854.0,103265901516.5,1056984947.5,17300177494.0,3510008400.5,18915304583.0,3678361.5,72058.5,20907.33191399492,89902949.5,-143.40605563859023,4.0,4.896200548374462,278.2249193803691,19.584802193497847,1112.8996775214764,56250.0,1.0,0.0,0.0,0.0,0.0,0.0,0.0,0.0,1.0,0.0,0.0,0.0,0.0,0.0,0.0,1.0,0.0,1.0,0.0,0.0,0.0,0.0,1.0,0.0,0.0,0.0,0.0,1.0,0.0,0.0,0.0,0.0,0.0,0.0,0.0,0.0,0.0,0.0,0.0,0.0,0.0,0.0,0.0,0.0,0.0,0.0,0.0,0.0,0.0,0.0,0.0,0.0,0.0,0.0,0.0,0.0,0.0,0.0,0.0,0.0,0.0,0.0,0.0,0.0,0.0,0.0,0.0,0.0,0.0,0.0,0.0,0.0,0.0,0.0,0.0,0.0,0.0,0.0,0.0,0.0,0.0,0.0,0.0,0.0,0.0,0.0,0.0,0.0,0.0,0.0,0.0,0.0,0.0,0.0,0.0,0.0,0.0,0.0,0.0,0.0,0.0,0.0,0.0,1.0,0.0,0.0,0.0,0.0,1.0,0.0,0.0,0.0,1.0,0.0,0.0,0.0,0.0,0.0,0.0,0.0,1.0,0.0
106277,0,0.0,0.0,0.0,1.0,1.0,202500.0,746280.0,59094.0,675000.0,0.022625,36.59178082191781,-126.0,-398.0,-1784.0,,3.0,2.0,2.0,13.0,0.5471076678379471,0.2820074981184285,0.4740512892789932,0.0866,,0.9975,0.966,,0.0,0.1379,0.0833,0.125,,0.0706,0.0789,,,0.0882,,0.9975,0.9673,,0.0,0.1379,0.0833,0.125,,0.0771,0.0822,,,0.0874,,0.9975,0.9665,,0.0,0.1379,0.0833,0.125,,0.0718,0.0803,,,0.0708,1.0,0.0,0.0,0.0,0.0,-382.0,0.0,0.0,0.0,0.0,1.0,2.0,1.0,1.0,0.0,1.0,0.0,0.0,0.0,0.0,0.0,0.0,0.0,0.0,0.0,1.0,0.0,0.0,0.0,0.0,0.0,0.0,0.0,0.0,0.0,0.0,0.0,0.0,0.0,0.0,0.0,0.0,0.0,0.0,6.0,2065.5,0.0,91026.0,26421.75,0.0,0.0,0.0,0.0,-636.5,326.5,-183.0,-433.0,110.0,-10.0,5.0,33748.020000000004,200839.5,218070.0,0.0,662919.75,30.0,-382.0,365243.0,-615.0,-390.0,-375.0,-385.5,15.0,0.5,0.0,0.0,19.0,11.0,4.0,-11.0,0.0,0.0,17.0,22159.935,22159.935,-306.0,-292.0,5.0,1.0,0.0,,,,,,,,,,,,,,,,,,,,,8361471807.0,184653264892.5,165810761154.0,52059288655.935,1863.0,1706.0,71128.0,71040.0,9141.0,506950.0,17839.834200002304,17902.13949999913,17352.778999997976,,,,128639.0,663945.0,,,,13550263.63835577,-602926206.0,-923437974.0,-297022833.0,-1537788985.0416667,44110.0,30768.0,11367.693999999196,11243.559999998986,10727.412299997288,22927.97160000986,22849.580100009825,22234.172700008377,67607.00420923723,158306.39124550464,126326.05238133678,35062.188900028064,35002.265100028504,34447.136600028905,22992.964699995853,22965.941099995434,22612.16359999567,3720319.0,,,,9833.91150000072,9949.00920000215,10309.351099999629,16496.360199999708,16681.925199999692,16278.327099999697,,,,,,,437294.0,432081.0,,6435.822197002894,633021.0,626563.0,,16361.044099999795,154457.44789999074,154460.18999999034,154351.88249998714,77744.87399999633,78083.28730000659,78485.52680000673,21.5,98518917.95999998,33857950.5,10355038527.014988,3400820145.944997,122354248.545,867402.9449999995,201.0,26026.0,-34002988.0,14904813.0,-17683163.5,-19229755.0,-10.25,0.0,0.0,67500.0,0.0,0.0,0.0,0.0,0.0,-655.0,343.0,-337.0,-433.0,359860437.27000153,5123160922.095002,5746270284.225003,83456040.10499999,5122598422.095002,370511.0,-25608719.0,5981810042.5,265003159.0,1352731867.0,586956953.0,1423688636.5,369092.0,5766.0,1043.9899280260777,8558113.0,3055057.0,1883958.0,-6139337.0,1944651.0,246606.0,4035281897.025016,4086896775.210013,-246237993.0,-244178428.0,4345386.0,203183.0,,,,,,,,,,,,,,,,,,,,,1469974.0,14876246.0,3237867.0,8570762.0,11627412.0,1418353.0,1062175987.0620012,802318011.6149951,72229875417.60713,21710790933.25512,583605556.5869987,5792665.7475,689.5,94245.0,-277393981.5,21983478.5,-123986828.5,-219067813.5,-2027386.0,,,,,,,,,,,,,,,,,,,,,4280436.0,2483574.0,-9019132.5,921848.5,37582.5,3740231204.4599576,3664881496.124958,-261081486.5,-257763513.5,2530711.0,269692.0,3932852138.6849537,33307267158.99092,36741027907.91264,1732783792.02755,48164887314.81072,3994768.0,-248004236.0,103266266759.5,1056984332.5,17300177104.0,3510008025.5,18915304197.5,3678376.5,72059.0,20907.33191399492,89902949.5,-3.4433962264150937,3.685333333333333,3.4267438318611028,125.39065922832025,12.628693268352118,462.1063761427695,67500.0,-0.9009688679024191,0.4338837391175582,0.0,0.0,0.0,0.0,0.0,1.0,0.0,0.0,0.0,0.0,0.0,0.0,0.0,1.0,0.0,0.0,1.0,0.0,0.0,0.0,1.0,0.0,0.0,0.0,0.0,1.0,0.0,0.0,0.0,0.0,0.0,0.0,0.0,0.0,0.0,0.0,0.0,0.0,0.0,0.0,0.0,0.0,1.0,0.0,0.0,0.0,0.0,0.0,0.0,0.0,0.0,0.0,0.0,0.0,0.0,0.0,0.0,0.0,0.0,0.0,0.0,0.0,0.0,0.0,0.0,0.0,0.0,0.0,0.0,0.0,0.0,0.0,0.0,0.0,0.0,0.0,0.0,0.0,0.0,0.0,0.0,0.0,0.0,0.0,0.0,0.0,0.0,0.0,0.0,0.0,1.0,0.0,0.0,0.0,0.0,0.0,0.0,0.0,0.0,0.0,0.0,0.0,0.0,0.0,0.0,0.0,0.0,0.0,0.0,0.0,1.0,0.0,0.0,0.0,0.0,0.0,0.0,0.0,1.0,0.0
106286,0,0.0,0.0,0.0,0.0,0.0,315000.0,337500.0,14863.5,337500.0,0.001417,37.1013698630137,-1090.0,-1164.0,-778.0,,2.0,2.0,2.0,9.0,0.3492808194919361,0.4907420206199781,0.3572932680336494,,,0.9866,,,,,,,,,0.0038,,,,,0.9866,,,,,,,,,0.004,,,,,0.9866,,,,,,,,,0.0039,,,0.0035,1.0,0.0,0.0,0.0,0.0,-1836.0,0.0,0.0,0.0,0.0,1.0,4.0,1.0,1.0,0.0,1.0,1.0,0.0,0.0,0.0,0.0,0.0,1.0,1.0,0.0,1.0,0.0,0.0,0.0,0.0,0.0,0.0,0.0,0.0,0.0,0.0,0.0,0.0,0.0,0.0,0.0,0.0,0.0,0.0,8.0,0.0,0.0,76050.0,0.0,0.0,0.0,0.0,0.0,-922.0,-449.0,-447.0,-597.0,252.0,-16.0,11.0,5625.0,20205.0,15336.0,6705.0,87498.0,10.0,-1091.0,365243.0,-1981.5,-1682.5,-1682.5,-1676.0,11.0,0.0,0.3424958747457692,0.0,49.0,8.0,4.0,-61.0,0.0,0.0,168.0,2812.86,2812.86,-1641.0,-1623.5,40.5,0.0,95.0,80061.345,112500.0,0.0,0.0,0.0,0.0,3375.0,4500.0,4500.0,77045.67,80061.345,80061.345,0.0,0.0,0.0,0.0,42.0,-48.0,0.0,0.0,8361486670.5,184653602392.5,165811098654.0,52059603655.935,1863.0,1706.0,71128.0,71041.0,9141.0,506954.0,,,,,,,128639.0,663947.0,,,,13550300.739725633,-602927296.0,-923438752.0,-297024669.0,-1537790149.0416667,44110.0,30768.0,,,,,,,67607.35349005673,158306.88198752527,126326.40967460485,,,,,,,3720328.0,,,,,,,16496.36399999971,16681.929099999692,16278.3310999997,,,,,,,437294.0,432081.0,,6435.823614002896,633023.0,626565.0,,16361.047599999794,154458.43449999078,154461.17659999034,154352.86909998715,,,,30.5,98530737.20999998,33888302.325,10370659804.784988,3406639449.194997,122354248.545,867402.9449999995,201.0,26026.0,-34054029.5,14951856.0,-17705745.0,-19260570.5,-14.75,0.0,0.0,72000.0,0.0,0.0,0.0,0.0,0.0,-1168.0,-497.0,-493.0,-698.0,360336993.1200016,5129833292.595002,5753613865.725003,83607429.10499999,5130697839.345002,371299.0,-25655916.0,5990572304.5,264970151.5,1354899770.5,588031720.5,1426222392.5,369773.0,5772.0,1047.034485863196,8573151.0,3058576.0,1885989.0,-6149370.0,1944677.0,246628.0,4038659675.122507,4090541110.672504,-246608583.0,-244545670.0,4353648.5,203455.0,3748377449.609953,10117746000.0,313768574.505,479435303.3399998,13652636.040000005,151485990.30000025,212767982.95499903,528298886.1149928,488193659.8649968,3598195228.875008,3734617341.6449375,3734800276.184937,16244.0,43129.0,206.0,26679.0,1235010.0,-2197640.0,846406.0,2057.0,1469982.0,14876498.0,3237962.0,8570811.0,11627580.0,1418364.0,1062175987.0620012,802318011.6149951,72229951467.60713,21710790933.25512,583605556.5869987,5792665.7475,689.5,94245.0,-277394903.5,21983029.5,-123987275.5,-219068410.5,-2027402.0,5930533974.622463,18756810000.0,198925482.825,448659962.9999977,1948107.735,257297036.0175008,309500867.83499867,637392120.5924977,459720069.9074992,5715432382.995035,5893763880.195,5894007062.940001,13396.5,80990.5,44.0,70491.0,972729.0,-1701368.0,177423.0,6755.0,4280444.0,2483578.0,-9019193.5,921848.5,37582.5,3740234017.3199577,3664884308.9849577,-261083127.5,-257765137.0,2530751.5,269692.0,3932857763.6849537,33307287363.99092,36741043243.91264,1732790497.02755,48164974812.81072,3994778.0,-248005327.0,103266632002.5,1056982351.0,17300175421.5,3510006343.0,18915302521.5,3678387.5,72059.0,20907.674409869654,89902949.5,-29.37896913306749,1.0714285714285714,21.19285498032092,786.2839510780984,22.70663033605813,842.4470904408197,157500.0,1.0,0.0,0.0,0.0,0.0,0.0,0.0,0.0,1.0,0.0,0.0,0.0,0.0,0.0,0.0,1.0,0.0,0.0,0.0,0.0,1.0,0.0,1.0,0.0,0.0,0.0,0.0,1.0,0.0,0.0,0.0,0.0,0.0,0.0,0.0,0.0,0.0,0.0,0.0,0.0,0.0,0.0,0.0,0.0,0.0,0.0,1.0,0.0,0.0,0.0,0.0,0.0,0.0,0.0,0.0,0.0,0.0,0.0,0.0,0.0,0.0,0.0,0.0,0.0,0.0,0.0,0.0,0.0,0.0,0.0,0.0,0.0,0.0,0.0,0.0,0.0,0.0,0.0,0.0,0.0,0.0,0.0,0.0,0.0,0.0,0.0,0.0,0.0,0.0,0.0,0.0,0.0,1.0,0.0,0.0,0.0,0.0,0.0,0.0,0.0,0.0,0.0,0.0,0.0,0.0,0.0,0.0,0.0,0.0,0.0,0.0,0.0,0.0,0.0,0.0,0.0,0.0,0.0,0.0,0.0,0.0,0.0
106293,0,0.0,1.0,1.0,1.0,0.0,315000.0,635193.0,62955.0,585000.0,0.032561,46.77260273972602,-1261.0,-7487.0,-614.0,2.0,2.0,1.0,1.0,17.0,,0.6613434345168372,0.5971924268337128,0.4062,0.1862,0.9811,0.7416,0.0669,0.44,0.3793,0.3333,0.375,0.1143,0.3312,0.3307,0.0,0.0,0.4139,0.1932,0.9811,0.7517,0.0675,0.4431,0.3793,0.3333,0.375,0.1169,0.3618,0.2758,0.0,0.0,0.4101,0.1862,0.9811,0.7451,0.0673,0.44,0.3793,0.3333,0.375,0.1163,0.3369,0.3366,0.0,0.0,0.3124,1.0,2.0,0.0,1.0,0.0,-1904.0,0.0,0.0,0.0,0.0,0.0,2.0,1.0,1.0,0.0,1.0,0.0,0.0,0.0,0.0,0.0,0.0,0.0,0.0,0.0,1.0,0.0,0.0,0.0,0.0,0.0,0.0,0.0,0.0,0.0,0.0,0.0,0.0,0.0,0.0,0.0,0.0,0.0,0.0,3.0,85122.0,1217.25,837000.0,1668615.75,46519.515,0.0,0.0,0.0,-747.0,5011.0,-25.0,-1272.0,105.0,-19.0,3.0,24892.785,135000.0,218961.0,0.0,157500.0,6.0,-1904.0,365243.0,-1874.0,-1544.0,-1544.0,-1541.0,12.0,0.0,0.0,-1.0,23.0,12.0,4.0,-62.0,0.0,0.0,18.0,24892.785,24892.785,-1800.0,-1799.0,5.0,1.0,48.0,0.0,450000.0,,0.0,,,0.0,,0.0,0.0,0.0,0.0,,0.0,,,0.0,-27.5,0.0,0.0,8361549625.5,184654237585.5,165811683654.0,52059918655.935,1863.0,1706.0,71128.0,71041.0,9141.0,506956.0,17840.240400002305,17902.549599999133,17353.192899997975,11316.698800000097,11254.405100000098,11201.350000000066,128639.0,663949.0,4145.578800000114,4143.1460000000125,3953.5845000000927,13550347.512328371,-602928557.0,-923439366.0,-297026573.0,-1537797636.0416667,44110.0,30768.0,11368.133999999196,11243.999999998989,10727.855399997288,22928.35090000986,22849.959400009822,22234.552000008374,,158307.54333095974,126327.00686703164,35062.522200028056,35002.59840002849,34447.469900028904,22993.339699995853,22966.316099995434,22612.53859999567,3720345.0,8310.655800000166,8415.41910000008,8138.5600000002305,9834.24270000072,9949.346100002149,10309.71289999963,16496.69469999971,16682.26569999969,16278.6068999997,830.0964000001773,815.2585000000461,761.1763000000129,3919.971000000124,3903.216900000162,3735.749400000161,437296.0,432082.0,1265191.0,6435.856175002896,633024.0,626566.0,,16361.359999999797,154459.41559999078,154462.15769999035,154353.85019998715,77745.61559999632,78084.03240000659,78486.27850000672,25.0,98678310.88499998,34076500.92000001,10390117834.349989,3416040146.609997,122663712.645,867402.9449999995,201.0,26026.0,-34115976.0,14991680.5,-17735515.0,-19301904.0,-12.0,86544.0,2434.5,225000.0,2546752.5,46519.515,0.0,0.0,0.0,-2014.0,8943.0,-1272.0,-1272.0,361008014.98500174,5139056618.595002,5763462133.725003,83707086.10499999,5138989118.595002,371863.0,-25709655.0,5995501007.0,265316898.0,1355250894.0,588750267.0,1426939243.0,370204.0,5777.0,1048.1122702292027,8575218.0,3060655.0,1887243.0,-6155565.0,1944677.0,246628.0,4043442840.502506,4095301590.8325033,-246974709.5,-244908898.0,4360084.5,203630.5,3758078057.219953,10143688500.0,,480597842.3399998,,,213314502.41999903,,489382302.4199968,3607551381.465007,3744313118.324937,3744496052.864936,,43183.0,,,1238072.0,-2203705.5,846406.0,2057.0,1469985.0,14876603.0,3238010.0,8570834.0,11627598.0,1418367.0,1062261109.0620012,802319228.8649951,72230788467.60713,21712459549.00512,583652076.1019987,5792665.7475,689.5,94245.0,-277395650.5,21988040.5,-123987300.5,-219069682.5,-2027421.0,5930533974.622463,18757260000.0,,448659962.9999977,,,309500867.83499867,,459720069.9074992,5715432382.995035,5893763880.195,5894007062.940001,,80990.5,,,972729.0,-1701395.5,177423.0,6755.0,4280456.0,2483582.0,-9019255.5,921848.5,37582.5,3740258910.1049576,3664909201.769958,-261084927.5,-257766936.0,2530756.5,269693.0,3932882656.469954,33307422363.99092,36741262204.91264,1732790497.02755,48165132312.81072,3994784.0,-248007231.0,103266997245.5,1056980477.0,17300173877.5,3510004799.0,18915300980.5,3678399.5,72059.0,20907.674409869654,89902948.5,-26.960227272727277,2.0164857142857144,5.003573981415297,234.03017811156693,10.08963545389564,471.91851087371606,157500.0,1.0,0.0,0.0,0.0,0.0,0.0,0.0,0.0,0.0,0.0,0.0,0.0,0.0,0.0,0.0,1.0,0.0,1.0,0.0,0.0,0.0,0.0,1.0,0.0,0.0,0.0,0.0,1.0,0.0,0.0,0.0,0.0,0.0,0.0,0.0,0.0,0.0,0.0,0.0,0.0,0.0,0.0,1.0,0.0,0.0,0.0,0.0,0.0,0.0,0.0,0.0,0.0,0.0,0.0,0.0,1.0,0.0,0.0,0.0,0.0,0.0,0.0,0.0,0.0,0.0,0.0,0.0,0.0,0.0,0.0,0.0,0.0,0.0,0.0,0.0,0.0,0.0,0.0,0.0,0.0,0.0,0.0,0.0,0.0,0.0,0.0,0.0,0.0,0.0,0.0,0.0,0.0,0.0,0.0,0.0,0.0,0.0,0.0,0.0,0.0,0.0,0.0,0.0,0.0,0.0,0.0,0.0,0.0,0.0,0.0,1.0,0.0,1.0,0.0,0.0,0.0,0.0,0.0,0.0,1.0,0.0,0.0
106295,0,0.0,1.0,0.0,0.0,1.0,135000.0,339633.0,26410.5,283500.0,0.022625,39.39178082191781,-630.0,-8505.0,-4770.0,,3.0,2.0,2.0,14.0,,0.5246485203592784,0.3606125659189888,0.1278,0.0432,0.9876,,,0.08,0.0345,0.625,,0.1025,,0.1194,,0.0141,0.1303,0.0448,0.9876,,,0.0806,0.0345,0.625,,0.1048,,0.1244,,0.0149,0.1291,0.0432,0.9876,,,0.08,0.0345,0.625,,0.1043,,0.1215,,0.0144,0.1267,1.0,2.0,0.0,2.0,0.0,-931.0,0.0,0.0,0.0,0.0,0.0,1.0,1.0,1.0,0.0,1.0,1.0,0.0,0.0,0.0,0.0,0.0,0.0,0.0,0.0,1.0,0.0,0.0,0.0,0.0,0.0,0.0,0.0,0.0,0.0,0.0,0.0,0.0,0.0,0.0,0.0,0.0,0.0,0.0,2.0,27175.5,0.0,213498.1575,0.0,271746.315,0.0,0.0,0.0,-884.0,9442.0,-664.5,-1278.0,59.0,-20.0,2.0,31342.635,157500.0,167895.0,0.0,315000.0,12.0,-605.5,365243.0,-900.0,-570.0,-570.0,-561.0,11.0,0.0,0.0,7.5,13.0,12.0,6.0,-24.0,0.0,0.0,12.0,31342.635,31342.635,-739.5,-735.0,6.5,1.0,0.0,,,,,,,,,,,,,,,,,,,,,8361576036.0,184654577218.5,165811967154.0,52060053655.935,1863.0,1706.0,71128.0,71041.0,9141.0,506957.0,17840.368200002304,17902.67869999913,17353.323199997976,11316.742000000097,11254.448300000098,11201.394800000066,128640.0,663952.0,,,,13550386.904109191,-602929187.0,-923444136.0,-297027504.0,-1537806141.0416667,44110.0,30768.0,11368.213999999196,11244.079999998989,10727.935999997288,22928.385400009854,22849.993900009827,22234.586500008383,,158308.06797948017,126327.36747959755,35063.147200028056,35003.22340002849,34448.094900028904,,,,3720359.0,8310.758300000167,8415.52340000008,8138.66480000023,,,,16496.81409999971,16682.387199999688,16278.7312999997,,,,3919.985100000124,3903.231300000162,3735.764300000161,437298.0,432084.0,,6435.878800002894,633026.0,626568.0,,16361.486699999798,154460.40319999075,154463.14529999034,154354.83779998714,,,,29.5,98754090.88499998,34077718.17000001,10391265438.164988,3416525908.109997,122935458.96,867402.9449999995,201.0,26026.0,-34126631.0,15001637.0,-17740984.0,-19307750.0,-14.25,27175.5,0.0,155250.0,0.0,271746.315,0.0,0.0,0.0,-1516.0,9442.0,-1278.0,-1278.0,361098107.5500017,5140104083.595002,5764985127.225003,83712994.60499999,5140261583.595002,371975.0,-25718739.5,5997327222.0,265673694.0,1355609160.0,589108653.0,1427297569.0,370301.0,5779.0,1048.3225585820242,8576139.0,3061497.0,1887698.0,-6158384.0,1944697.0,246648.0,4044142401.81751,4096001152.147506,-247044933.5,-244978602.0,4360479.0,203683.5,,,,,,,,,,,,,,,,,,,,,1469987.0,14876662.0,3238010.0,8570847.0,11627610.0,1418369.0,1062288284.5620012,802319228.8649951,72231001965.76462,21712459549.00512,583923822.4169987,5792665.7475,689.5,94245.0,-277396534.5,21997482.5,-123987965.0,-219070960.5,-2027441.0,,,,,,,,,,,,,,,,,,,,,4280468.0,2483588.0,-9019279.5,921848.5,37582.5,3740290252.739959,3664940544.404959,-261085667.0,-257767671.0,2530763.0,269694.0,3932913999.104953,33307579863.99092,36741430099.91264,1732790497.02755,48165447312.81072,3994796.0,-248007836.5,103267362488.5,1056979577.0,17300173307.5,3510004229.0,18915300419.5,3678410.5,72059.0,20907.674409869654,89902956.0,-15.993184031158714,2.5158,5.111603339580848,201.3551584013519,12.8597716817175,506.56930750612105,45000.0,0.6234898018587336,0.7818314824680298,0.0,0.0,0.0,0.0,0.0,0.0,1.0,0.0,1.0,0.0,0.0,0.0,0.0,0.0,0.0,1.0,0.0,0.0,0.0,0.0,1.0,0.0,0.0,0.0,0.0,1.0,0.0,0.0,0.0,0.0,0.0,0.0,0.0,0.0,0.0,0.0,1.0,0.0,0.0,0.0,0.0,0.0,0.0,0.0,0.0,0.0,0.0,0.0,0.0,0.0,0.0,0.0,0.0,0.0,0.0,0.0,0.0,0.0,0.0,0.0,0.0,0.0,0.0,0.0,0.0,0.0,0.0,0.0,0.0,0.0,0.0,0.0,0.0,0.0,0.0,0.0,0.0,0.0,0.0,0.0,0.0,0.0,0.0,0.0,0.0,0.0,0.0,1.0,0.0,0.0,0.0,0.0,0.0,0.0,0.0,0.0,0.0,0.0,0.0,0.0,0.0,0.0,0.0,0.0,0.0,0.0,0.0,0.0,0.0,0.0,1.0,0.0,0.0,0.0,0.0,0.0,0.0,1.0,0.0,0.0
106296,0,0.0,0.0,0.0,1.0,0.0,67500.0,180000.0,7695.0,180000.0,0.026392,52.39452054794521,-1324.0,-574.0,-2553.0,,2.0,2.0,2.0,9.0,,0.7023897612985709,0.4902575124990026,,,,,,,,,,,,,,,,,,,,,,,,,,,,,,,,,,,,,,,,,,,,,0.0,0.0,0.0,0.0,-1372.0,0.0,0.0,0.0,0.0,1.0,3.0,1.0,1.0,0.0,1.0,1.0,0.0,0.0,0.0,0.0,0.0,0.0,0.0,0.0,1.0,0.0,0.0,0.0,0.0,0.0,0.0,0.0,0.0,0.0,0.0,0.0,0.0,0.0,0.0,0.0,0.0,0.0,0.0,12.0,0.0,0.0,83250.0,0.0,0.0,0.0,0.0,0.0,-1379.5,-797.0,-419.0,-831.5,548.0,-27.0,4.0,10122.3225,56891.25,56891.25,0.0,81000.0,15.0,-845.0,365243.0,-1214.5,-794.5,-794.5,-790.0,13.5,0.0,0.0,35.0,32.0,18.0,7.5,-33.5,0.0,0.0,30.0,5718.6,5718.6,-1013.0,-1004.5,8.0,1.0,0.0,,,,,,,,,,,,,,,,,,,,,8361583731.0,184654757218.5,165812147154.0,52060121155.935,1863.0,1706.0,71128.0,71042.0,9141.0,506960.0,,,,,,,128640.0,663954.0,,,,13550439.29862974,-602930511.0,-923446689.0,-297028876.0,-1537806715.0416667,44110.0,30768.0,,,,,,,,158308.77036924145,126327.85773711008,,,,,,,3720368.0,,,,,,,,,,,,,,,,437298.0,432084.0,,6435.905192002894,633028.0,626570.0,,,,,,,,,45.5,98754090.88499998,34077718.17000001,10392027200.864988,3416632098.029997,122935458.96,867402.9449999995,201.0,26026.0,-34135968.5,14996374.0,-17744957.5,-19311306.0,-22.75,0.0,0.0,83250.0,0.0,0.0,0.0,0.0,0.0,-1859.0,-1493.0,-588.0,-866.0,361111089.1725017,5140334866.095002,5765226304.725003,83712994.60499999,5140375366.095002,371999.0,-25720633.5,5997875086.5,265671935.0,1355608076.0,589107569.0,1427296490.5,370337.5,5779.0,1048.3225585820242,8576201.0,3061866.0,1887872.0,-6158981.5,1944697.0,246648.0,4044403351.777509,4096262102.107506,-247061847.5,-244995331.5,4360670.0,203704.5,,,,,,,,,,,,,,,,,,,,,1469999.0,14877210.0,3238010.0,8570879.0,11627640.0,1418373.0,1062288284.5620012,802319228.8649951,72231085215.76462,21712459549.00512,583923822.4169987,5792665.7475,689.5,94245.0,-277397914.0,21996685.5,-123988384.0,-219071792.0,-2027468.0,,,,,,,,,,,,,,,,,,,,,4280486.0,2483595.5,-9019313.0,921848.5,37582.5,3740295971.3399577,3664946263.0049577,-261086680.0,-257768675.5,2530771.0,269695.0,3932924121.4274554,33307636755.24092,36741486991.16264,1732790497.02755,48165528312.81072,3994811.0,-248008681.5,103267727731.5,1056978362.5,17300172513.0,3510003434.5,18915299629.5,3678424.0,72059.0,20907.674409869654,89902991.0,-25.2698180297009,2.6666666666666665,8.771929824561402,459.60105743811584,23.39181286549708,1225.6028198349754,33750.0,-0.2225209339563143,0.9749279121818236,0.0,0.0,0.0,0.0,0.0,0.0,1.0,0.0,0.0,0.0,0.0,0.0,0.0,1.0,0.0,0.0,0.0,0.0,1.0,1.0,0.0,0.0,0.0,0.0,0.0,1.0,0.0,0.0,0.0,0.0,0.0,0.0,1.0,0.0,0.0,0.0,0.0,0.0,0.0,0.0,0.0,0.0,0.0,0.0,0.0,0.0,0.0,0.0,0.0,0.0,0.0,0.0,0.0,0.0,0.0,0.0,0.0,0.0,0.0,0.0,0.0,0.0,0.0,0.0,0.0,0.0,0.0,0.0,0.0,0.0,0.0,0.0,0.0,0.0,0.0,0.0,0.0,0.0,0.0,0.0,0.0,0.0,0.0,0.0,0.0,0.0,0.0,1.0,0.0,0.0,0.0,0.0,0.0,0.0,0.0,0.0,0.0,0.0,0.0,0.0,0.0,0.0,0.0,0.0,0.0,0.0,0.0,0.0,0.0,0.0,0.0,0.0,0.0,0.0,0.0,0.0,0.0,0.0,0.0,0.0
106297,0,0.0,1.0,0.0,1.0,0.0,225000.0,420588.0,36099.0,360000.0,0.009334,24.72328767123288,-1455.0,-8972.0,-1446.0,,2.0,2.0,2.0,17.0,,0.5955071809231283,0.4241303111942548,0.0144,0.0154,0.9811,,,0.0,0.069,0.1667,,0.0377,,0.0734,,0.0,0.0147,0.0159,0.9811,,,0.0,0.069,0.1667,,0.0386,,0.0764,,0.0,0.0146,0.0154,0.9811,,,0.0,0.069,0.1667,,0.0384,,0.0747,,0.0,0.0577,1.0,1.0,0.0,1.0,0.0,-1045.0,0.0,0.0,0.0,0.0,0.0,1.0,1.0,1.0,1.0,1.0,1.0,0.0,0.0,0.0,0.0,0.0,0.0,0.0,0.0,1.0,0.0,0.0,0.0,0.0,0.0,0.0,0.0,0.0,0.0,0.0,0.0,0.0,0.0,0.0,0.0,0.0,0.0,0.0,2.0,,0.0,80118.81,0.0,0.0,0.0,0.0,0.0,-254.5,-41.0,-87.0,-87.0,18.0,-4.0,4.0,10671.975,69457.5,64962.0,0.0,93960.0,10.0,-426.0,365243.0,-655.0,-580.0,-445.0,-576.0,19.0,0.0,0.0,30.0,13.0,6.0,2.5,-28.0,0.0,0.0,7.0,7274.79,7274.79,-923.0,-830.0,3.0,1.0,0.0,,,,,,,,,,,,,,,,,,,,,8361619830.0,184655177806.5,165812507154.0,52060346155.935,1863.0,1706.0,71128.0,71042.0,9141.0,506961.0,17840.382600002304,17902.69329999913,17353.337899997976,11316.757400000097,11254.463700000098,11201.410700000066,128640.0,663956.0,,,,13550464.021917412,-602931966.0,-923448135.0,-297029921.0,-1537815687.0416667,44110.0,30768.0,11368.213999999196,11244.079999998989,10727.935999997288,22928.454400009858,22850.06290000983,22234.655500008383,,158309.36587642238,126328.28186742125,35063.313900028064,35003.390100028504,34448.261600028905,,,,3720385.0,8310.796000000168,8415.56180000008,8138.70340000023,,,,16496.88749999971,16682.461899999693,16278.8076999997,,,,3919.985100000124,3903.231300000162,3735.764300000161,437299.0,432085.0,,6435.914526002895,633030.0,626572.0,,16361.544399999795,154461.38429999078,154464.12639999035,154355.81889998715,,,,9.0,,34077718.17000001,10392950739.734991,3416867349.029997,122935458.96,867402.9449999995,201.0,26026.0,-34144218.0,14992537.0,-17749138.0,-19316002.0,-4.0,,0.0,46800.0,0.0,0.0,0.0,0.0,0.0,-290.0,-106.0,-106.0,-106.0,361136298.96000177,5140695586.095002,5765591331.225003,83721985.60499999,5140648606.095002,372021.0,-25724251.0,5998605572.5,265670150.0,1355606606.0,589106234.0,1427295030.5,370406.0,5779.0,1048.5403767638422,8576574.5,3062100.0,1887980.5,-6159751.0,1944697.0,246648.0,4044620727.58501,4096479477.915007,-247081904.0,-245014949.0,4360784.0,203723.0,,,,,,,,,,,,,,,,,,,,,1470001.0,14877228.0,3238010.0,8570892.0,11627647.0,1418377.0,,802319228.8649951,72231165334.57463,21712459549.00512,583923822.4169987,5792665.7475,689.5,94245.0,-277398168.5,21996644.5,-123988471.0,-219071879.0,-2027472.0,,,,,,,,,,,,,,,,,,,,,4280492.0,2483598.0,-9019341.0,921848.5,37582.5,3740303246.1299577,3664953537.7949576,-261087603.0,-257769505.5,2530774.0,269696.0,3932934793.402455,33307706212.74092,36741551953.16264,1732790497.02755,48165622272.81072,3994821.0,-248009107.5,103268092974.5,1056977707.5,17300171933.0,3510002989.5,18915299053.5,3678443.0,72059.0,20907.674409869654,89903021.0,-58.85139627659574,1.86928,6.232859636000997,154.0967817952685,11.650959860383944,288.0500322742595,112500.0,0.6234898018587336,0.7818314824680298,0.0,0.0,0.0,0.0,0.0,0.0,1.0,0.0,0.0,0.0,0.0,0.0,0.0,1.0,0.0,0.0,0.0,0.0,1.0,1.0,0.0,0.0,0.0,0.0,0.0,1.0,0.0,0.0,0.0,0.0,0.0,0.0,0.0,0.0,0.0,0.0,0.0,0.0,1.0,0.0,0.0,0.0,0.0,0.0,0.0,0.0,0.0,0.0,0.0,0.0,0.0,0.0,0.0,1.0,0.0,0.0,0.0,0.0,0.0,0.0,0.0,0.0,0.0,0.0,0.0,0.0,0.0,0.0,0.0,0.0,0.0,0.0,0.0,0.0,0.0,0.0,0.0,0.0,0.0,0.0,0.0,0.0,0.0,0.0,0.0,0.0,0.0,0.0,0.0,0.0,0.0,0.0,0.0,0.0,0.0,0.0,0.0,0.0,0.0,0.0,0.0,0.0,0.0,0.0,0.0,0.0,0.0,0.0,0.0,0.0,1.0,0.0,0.0,0.0,0.0,0.0,0.0,0.0,1.0,0.0
106298,0,0.0,0.0,0.0,0.0,0.0,225000.0,904500.0,32616.0,904500.0,0.018209,40.29041095890411,-207.0,-15.0,-2218.0,,2.0,3.0,3.0,11.0,0.5489971756401187,0.4858027061631276,0.7981372313187245,,,,,,,,,,,,,,,,,,,,,,,,,,,,,,,,,,,,,,,,,,,,,0.0,0.0,0.0,0.0,-2083.0,0.0,0.0,0.0,0.0,0.0,3.0,1.0,1.0,1.0,1.0,0.0,0.0,0.0,0.0,0.0,0.0,0.0,0.0,0.0,1.0,0.0,0.0,0.0,0.0,0.0,0.0,0.0,0.0,0.0,0.0,0.0,0.0,0.0,0.0,0.0,0.0,0.0,0.0,2.0,0.0,,459000.0,,,0.0,0.0,0.0,-1821.0,-1153.5,-1119.0,-1122.0,121.0,-30.0,3.0,22226.355,360000.0,426528.0,9000.0,360000.0,36.0,-1112.0,365243.0,-1082.0,-557.0,-32.0,-549.0,11.0,1.0,0.2844693506832726,-1.0,42.0,36.0,26.5,-25.0,0.0,0.0,39.0,44214.255,44214.255,-757.0,-752.0,8.0,1.0,0.0,,,,,,,,,,,,,,,,,,,,,8361652446.0,184656082306.5,165813411654.0,52060571155.935,1863.0,1706.0,71128.0,71042.0,9141.0,506964.0,,,,,,,128640.0,663958.0,,,,13550504.31232837,-602932173.0,-923450353.0,-297032004.0,-1537815702.0416667,44110.0,30768.0,,,,,,,67607.90248723236,158309.85167912857,126329.08000465258,,,,,,,3720396.0,,,,,,,,,,,,,,,,437299.0,432085.0,,6435.932735002894,633033.0,626575.0,,,,,,,,,60.5,98781090.88499998,,10393554639.734991,,,867402.9449999995,201.0,26026.0,-34147182.0,14990484.0,-17750908.0,-19317776.5,-29.75,0.0,,243000.0,,,0.0,0.0,0.0,-1996.0,-1693.0,-1196.0,-1199.0,361196335.0350018,5141675821.095002,5766642175.725003,83730985.60499999,5141675821.095002,372073.0,-25728069.0,5999518680.0,265666832.0,1355604068.0,589104283.0,1427292500.0,370453.0,5780.0,1048.8248461145256,8576622.0,3062711.0,1888338.5,-6160574.0,1944697.0,246648.0,4045468922.010012,4097327672.340008,-247103681.0,-245036385.0,4361016.0,203748.0,,,,,,,,,,,,,,,,,,,,,1470003.0,14877349.0,3238010.0,8570934.0,11627686.0,1418380.0,1062288284.5620012,,72231624334.57463,,,5792665.7475,689.5,94245.0,-277399989.5,21995491.0,-123989590.0,-219073001.0,-2027502.0,,,,,,,,,,,,,,,,,,,,,4280528.0,2483624.5,-9019366.0,921848.5,37582.5,3740347460.384959,3664997752.0499578,-261088360.0,-257770257.5,2530782.0,269697.0,3932957019.757455,33308066212.74092,36741978481.16264,1732799497.02755,48165982272.81072,3994857.0,-248010219.5,103268458217.5,1056976625.5,17300171376.0,3510002957.5,18915298504.5,3678454.0,72060.0,20907.95887922035,89903020.0,-5.1376988984088126,4.02,6.898454746136865,277.9415767032568,27.7317880794702,1117.3251383470924,112500.0,1.0,0.0,0.0,0.0,0.0,0.0,0.0,0.0,1.0,0.0,1.0,0.0,0.0,0.0,0.0,0.0,0.0,0.0,0.0,0.0,1.0,0.0,1.0,0.0,0.0,0.0,0.0,1.0,0.0,0.0,0.0,0.0,0.0,0.0,0.0,0.0,0.0,0.0,0.0,0.0,0.0,0.0,1.0,0.0,0.0,0.0,0.0,0.0,0.0,0.0,0.0,0.0,0.0,0.0,0.0,0.0,0.0,0.0,0.0,0.0,0.0,0.0,0.0,0.0,0.0,0.0,0.0,0.0,0.0,0.0,0.0,0.0,0.0,0.0,0.0,0.0,0.0,0.0,0.0,0.0,0.0,0.0,0.0,0.0,0.0,0.0,0.0,0.0,0.0,0.0,0.0,0.0,0.0,0.0,0.0,0.0,0.0,0.0,0.0,0.0,0.0,1.0,0.0,0.0,0.0,0.0,0.0,0.0,0.0,0.0,0.0,0.0,0.0,0.0,0.0,0.0,0.0,0.0,0.0,0.0,0.0,0.0
106311,0,0.0,0.0,1.0,1.0,0.0,157500.0,1572750.0,48946.5,1350000.0,0.010147,36.74794520547945,-388.0,-12797.0,-2045.0,22.0,2.0,2.0,2.0,17.0,0.6383063169456561,0.6863353475761392,0.5867400085415683,0.1866,,0.9821,,,0.2,0.1724,0.3333,,,,0.2009,,,0.1901,,0.9821,,,0.2014,0.1724,0.3333,,,,0.2093,,,0.1884,,0.9821,,,0.2,0.1724,0.3333,,,,0.2045,,,0.158,1.0,2.0,0.0,2.0,0.0,-1790.0,0.0,0.0,0.0,0.0,0.0,4.0,1.0,1.0,0.0,1.0,0.0,0.0,0.0,0.0,0.0,0.0,0.0,0.0,0.0,1.0,0.0,0.0,0.0,0.0,0.0,0.0,0.0,0.0,0.0,0.0,0.0,0.0,0.0,0.0,0.0,0.0,0.0,0.0,4.0,0.0,0.0,158287.5,159075.0,0.0,0.0,0.0,0.0,-801.0,108.5,-126.0,-1227.0,135.0,-17.0,4.0,20167.515,96651.0,275154.75,14022.0,106200.0,8.0,-1525.5,365243.0,-1457.0,-965.0,-290.0,-962.0,16.5,0.0,0.1543225618323342,74.5,22.0,10.0,4.5,-50.5,0.0,0.0,91.0,7416.09,7416.09,-849.0,-850.0,25.0,0.0,46.0,180.31500000000003,450000.0,0.0,0.0,0.0,0.0,2250.0,2482.695,775.8225,0.0,1.845,1.845,0.0,0.0,0.0,0.0,18.0,-23.5,0.0,0.0,8361701392.5,184657655056.5,165814761654.0,52060728655.935,1863.0,1706.0,71128.0,71042.0,9141.0,506968.0,17840.569200002305,17902.881699999132,17353.527999997976,,,,128640.0,663960.0,,,,13550541.060273577,-602932561.0,-923452398.0,-297033794.0,-1537828499.0416667,44110.0,30768.0,11368.413999999197,11244.279999998991,10728.137399997288,22928.626800009857,22850.235300009823,22234.827900008386,67608.54079354931,158310.5380144761,126329.66674466114,35063.647200028056,35003.72340002849,34448.594900028904,,,,3720413.0,,,,,,,16497.08839999971,16682.666399999693,16279.0169999997,,,,,,,437301.0,432087.0,1265213.0,6435.942882002894,633035.0,626577.0,,16361.702399999796,154462.36639999074,154465.10849999034,154356.80099998714,,,,27.0,98824151.20499995,34100713.30500001,10414078408.124989,3429772082.1899967,123217154.865,867402.9449999995,202.0,26026.0,-34198146.5,15002479.5,-17777247.0,-19348541.0,-13.0,0.0,0.0,136575.0,159075.0,0.0,0.0,0.0,0.0,-1052.0,37.0,-218.0,-1227.0,361911493.0125016,5152908478.095002,5778656808.975003,83868366.10499999,5152864927.095002,372914.0,-25779257.5,6013213508.5,265988083.0,1358492304.0,589807543.0,1430182701.5,371107.0,5791.0,1051.4233645631095,8589378.5,3069307.0,1892422.0,-6176550.0,1954560.0,246648.0,4055019878.025015,4106574214.200018,-247598067.0,-245527829.0,4367287.0,204160.0,3767462999.392453,10170126000.0,315438974.505,481548279.6899997,13652636.040000005,151928566.65000027,213786003.59999907,530468466.2999928,490364988.65999657,3616685865.247508,3753668677.2749376,3753851611.8149366,16324.0,43345.0,206.0,26815.0,1239081.0,-2205549.5,846414.0,2065.0,1470007.0,14877484.0,3238056.0,8570956.0,11627777.0,1418384.0,1062288284.5620012,802319228.8649951,72231782622.07463,21712618624.00512,583923822.4169987,5792665.7475,689.5,94245.0,-277400790.5,21995599.5,-123989716.0,-219074228.0,-2027519.0,5930534154.937463,18757710000.0,198925482.825,448659962.9999977,1948107.735,257297036.0175008,309503117.83499867,637394603.2874978,459720845.7299992,5715432382.995035,5893763882.04,5894007064.785001,13396.5,80990.5,44.0,70491.0,972747.0,-1701419.0,177423.0,6755.0,4280538.0,2483629.0,-9019416.5,921848.5,37582.5,3740354876.4749584,3665005168.1399584,-261089209.0,-257771107.5,2530807.0,269697.0,3932977187.272455,33308162863.74092,36742253635.91264,1732813519.02755,48166088472.81072,3994865.0,-248011745.0,103268823460.5,1056975168.5,17300170411.0,3510002667.5,18915297542.5,3678470.5,72060.0,20908.11320178218,89903094.5,-10.558413479460224,9.985714285714286,3.2177990254665807,118.24750227009108,32.13202169715914,1180.7857726684813,78750.0,-0.2225209339563143,0.9749279121818236,0.0,0.0,0.0,0.0,0.0,0.0,1.0,0.0,0.0,0.0,0.0,0.0,0.0,1.0,0.0,0.0,0.0,0.0,1.0,0.0,1.0,0.0,0.0,0.0,0.0,1.0,0.0,0.0,0.0,0.0,0.0,0.0,0.0,0.0,0.0,0.0,0.0,0.0,1.0,0.0,0.0,0.0,0.0,0.0,0.0,0.0,0.0,0.0,0.0,0.0,0.0,0.0,0.0,0.0,0.0,0.0,0.0,0.0,0.0,0.0,0.0,0.0,0.0,0.0,0.0,0.0,0.0,0.0,0.0,0.0,0.0,0.0,0.0,0.0,0.0,0.0,0.0,0.0,0.0,0.0,0.0,0.0,0.0,0.0,0.0,0.0,0.0,0.0,0.0,0.0,1.0,0.0,0.0,0.0,0.0,0.0,0.0,0.0,0.0,0.0,0.0,0.0,0.0,0.0,0.0,0.0,0.0,1.0,0.0,0.0,1.0,0.0,0.0,0.0,0.0,0.0,0.0,1.0,0.0,0.0
106314,0,0.0,1.0,0.0,1.0,1.0,378000.0,582804.0,29884.5,463500.0,0.009334,39.701369863013696,-6407.0,-453.0,-4312.0,,2.0,2.0,2.0,14.0,,0.8549996664047012,0.2512394458905693,,,,,,,,,,,,,,,,,,,,,,,,,,,,,,,,,,,,,,,,,,,,,5.0,0.0,5.0,0.0,-64.0,0.0,0.0,0.0,0.0,1.0,1.0,1.0,1.0,0.0,1.0,0.0,0.0,0.0,0.0,0.0,0.0,0.0,0.0,0.0,1.0,0.0,0.0,0.0,0.0,0.0,0.0,0.0,0.0,0.0,0.0,0.0,0.0,0.0,0.0,0.0,0.0,0.0,0.0,5.0,38007.0,,324000.0,0.0,0.0,0.0,0.0,0.0,-1700.0,-1159.0,-212.0,-1483.0,256.0,-25.0,3.0,23035.455,245245.5,236988.0,0.0,245245.5,10.0,-614.0,365243.0,-583.0,-73.0,-73.0,-66.0,18.0,0.0,0.0,1354.0,27.0,18.0,7.0,-14.0,0.0,0.0,30.0,23035.455,23035.455,-359.0,-358.0,7.5,1.0,0.0,,,,,,,,,,,,,,,,,,,,,8361731277.0,184658237860.5,165815225154.0,52061106655.935,1863.0,1706.0,71128.0,71043.0,9141.0,506969.0,,,,,,,128641.0,663962.0,,,,13550580.76164344,-602938968.0,-923456710.0,-297033858.0,-1537828952.0416667,44110.0,30768.0,,,,,,,,158311.3930141425,126329.917984107,,,,,,,3720427.0,,,,,,,,,,,,,,,,437306.0,432092.0,,6435.952216002896,633037.0,626579.0,,,,,,,,,56.0,98867850.70499995,,10417481840.564993,3430215147.6899967,123217154.865,867402.9449999995,202.0,26026.0,-34216719.0,14991231.0,-17786840.0,-19358683.0,-27.5,38007.0,,324000.0,0.0,0.0,0.0,0.0,0.0,-1700.0,-1159.0,-212.0,-1483.0,362025724.2750016,5153767699.095002,5779930648.725003,83922888.10499999,5153767699.095002,372981.0,-25787212.0,6015586918.0,265980446.0,1359217105.0,590167982.0,1431272294.0,371216.0,5792.0,1051.8455086811002,8592249.0,3069909.0,1892775.0,-6178602.0,1954560.0,246648.0,4056597659.767513,4108147519.477517,-247676488.5,-245605501.5,4369005.0,204206.5,,,,,,,,,,,,,,,,,,,,,1470012.0,14877740.0,3238056.0,8570983.0,11627807.0,1418387.0,1062326291.5620012,,72232106622.07463,21712618624.00512,583923822.4169987,5792665.7475,689.5,94245.0,-277402490.5,21994440.5,-123989928.0,-219075711.0,-2027544.0,,,,,,,,,,,,,,,,,,,,,4280556.0,2483636.0,-9019430.5,921848.5,37582.5,3740377911.929959,3665028203.594959,-261089568.0,-257771465.5,2530814.5,269698.0,3933000222.7274537,33308408109.24092,36742490623.91264,1732813519.02755,48166333718.31072,3994875.0,-248012359.0,103269188703.5,1056974585.5,17300170338.0,3510002594.5,18915297476.5,3678488.5,72060.0,20908.11320178218,89904448.5,-161.37982195845697,1.5418095238095235,12.648697485318475,502.17061715000006,19.5018822466496,774.2514400991762,189000.0,-0.2225209339563143,0.9749279121818236,0.0,0.0,0.0,0.0,0.0,0.0,1.0,0.0,0.0,0.0,1.0,0.0,0.0,0.0,0.0,0.0,0.0,0.0,1.0,0.0,0.0,1.0,0.0,0.0,0.0,1.0,0.0,0.0,0.0,0.0,0.0,0.0,0.0,0.0,0.0,0.0,0.0,0.0,1.0,0.0,0.0,0.0,0.0,0.0,0.0,0.0,0.0,0.0,0.0,0.0,0.0,0.0,0.0,0.0,0.0,0.0,0.0,0.0,0.0,0.0,0.0,0.0,0.0,0.0,0.0,0.0,0.0,0.0,0.0,0.0,0.0,0.0,0.0,0.0,0.0,0.0,0.0,0.0,0.0,1.0,0.0,0.0,0.0,0.0,0.0,0.0,0.0,0.0,0.0,0.0,0.0,0.0,0.0,0.0,0.0,0.0,0.0,0.0,0.0,0.0,0.0,0.0,0.0,0.0,0.0,0.0,0.0,0.0,0.0,0.0,0.0,0.0,0.0,0.0,0.0,0.0,0.0,0.0,0.0,0.0
106320,0,0.0,1.0,1.0,1.0,1.0,270000.0,454500.0,29173.5,454500.0,0.028663,42.21369863013699,-649.0,-4851.0,-287.0,4.0,3.0,2.0,2.0,15.0,0.6377898375172425,0.5931715677473456,0.4614823912998385,,,,,,,,,,,,,,,,,,,,,,,,,,,,,,,,,,,,,,,,,,,,,2.0,0.0,2.0,0.0,-1785.0,0.0,0.0,0.0,0.0,0.0,5.0,1.0,1.0,0.0,1.0,0.0,0.0,0.0,1.0,1.0,0.0,1.0,1.0,0.0,1.0,0.0,0.0,0.0,0.0,0.0,0.0,0.0,0.0,0.0,0.0,0.0,0.0,0.0,0.0,0.0,0.0,0.0,0.0,13.0,0.0,0.0,133254.0,0.0,0.0,0.0,0.0,0.0,-1084.0,-421.0,-497.0,-707.0,568.0,-24.0,20.0,17078.0175,176153.985,158739.75,0.0,189000.0,12.0,-1591.5,365243.0,-1699.0,-1309.0,-1309.0,-1304.0,9.0,1.0,0.0,-1.0,142.0,12.0,6.0,-57.5,0.0,0.0,145.0,16751.385,16751.385,-1673.0,-1665.0,6.0,1.0,0.0,,,,,,,,,,,,,,,,,,,,,8361760450.5,184658692360.5,165815679654.0,52061376655.935,1863.0,1706.0,71128.0,71043.0,9141.0,506974.0,,,,,,,128642.0,663965.0,,,,13550622.975342069,-602939617.0,-923456997.0,-297035643.0,-1537833803.0416667,44110.0,30768.0,,,,,,,67609.17858338682,158311.98618571027,126330.37946649831,,,,,,,3720442.0,,,,,,,,,,,,,,,,437308.0,432094.0,1265217.0,6435.980879002896,633039.0,626581.0,,,,,,,,,36.0,99075847.36499994,34112382.660000004,10434625430.129992,3432544140.6899967,123263471.205,867402.9449999995,202.0,26026.0,-34248965.0,14996847.5,-17804798.0,-19376392.0,-17.5,0.0,0.0,651843.0,0.0,0.0,0.0,0.0,0.0,-1819.0,-977.0,-893.0,-1093.0,362423328.1200016,5158499767.065002,5785369578.225003,84148602.07499999,5158135267.065002,373247.0,-25815401.5,6021795267.0,266327803.0,1360664217.0,590888119.0,1433085201.0,371514.5,5799.0,1053.2347873813133,8601139.5,3072403.0,1894443.0,-6185235.0,1954567.0,246648.0,4062433321.755008,4113645435.855014,-247901633.0,-245828510.0,4370754.0,204398.0,,,,,,,,,,,,,,,,,,,,,1470025.0,14878308.0,3238056.0,8571125.0,11627952.0,1418407.0,1062326291.5620012,802319228.8649951,72232239876.07463,21712618624.00512,583923822.4169987,5792665.7475,689.5,94245.0,-277403574.5,21994019.5,-123990425.0,-219076418.0,-2027568.0,,,,,,,,,,,,,,,,,,,,,4280568.0,2483642.0,-9019488.0,921848.5,37582.5,3740394663.31496,3665044954.97996,-261091241.0,-257773130.5,2530820.5,269699.0,3933017300.744954,33308584263.22592,36742649363.66264,1732813519.02755,48166522718.31072,3994887.0,-248013950.5,103269553946.5,1056972886.5,17300169029.0,3510001285.5,18915296172.5,3678497.5,72061.0,20908.11320178218,89904447.5,-15.374156282450675,1.6833333333333331,9.254974548819993,390.6867064334752,15.579207157180312,657.6559558296832,90000.0,0.6234898018587336,0.7818314824680298,0.0,0.0,0.0,0.0,0.0,0.0,1.0,0.0,0.0,0.0,0.0,0.0,0.0,1.0,0.0,0.0,0.0,0.0,1.0,0.0,1.0,0.0,0.0,0.0,0.0,1.0,0.0,0.0,0.0,0.0,0.0,0.0,0.0,0.0,0.0,0.0,0.0,0.0,1.0,0.0,0.0,0.0,0.0,0.0,0.0,0.0,0.0,0.0,0.0,0.0,0.0,0.0,1.0,0.0,0.0,0.0,0.0,0.0,0.0,0.0,0.0,0.0,0.0,0.0,0.0,0.0,0.0,0.0,0.0,0.0,0.0,0.0,0.0,0.0,0.0,0.0,0.0,0.0,0.0,0.0,0.0,0.0,0.0,0.0,0.0,0.0,0.0,0.0,0.0,0.0,0.0,0.0,0.0,0.0,0.0,0.0,0.0,0.0,0.0,0.0,0.0,0.0,0.0,0.0,0.0,0.0,0.0,0.0,0.0,0.0,0.0,0.0,0.0,0.0,0.0,0.0,0.0,0.0,0.0,0.0
106334,0,0.0,0.0,1.0,0.0,0.0,90000.0,495000.0,25272.0,495000.0,0.010147,47.12328767123286,-1550.0,-10268.0,-729.0,7.0,2.0,2.0,2.0,14.0,0.7725370363012994,0.3312461828249958,0.3723336657058204,,,,,,,,,,,,,,,,,,,,,,,,,,,,,,,,,,,,,,,,,,,,,2.0,0.0,2.0,0.0,-683.0,0.0,0.0,0.0,0.0,0.0,3.0,1.0,1.0,1.0,1.0,1.0,0.0,0.0,0.0,0.0,0.0,0.0,0.0,0.0,1.0,0.0,0.0,0.0,0.0,0.0,0.0,0.0,0.0,0.0,0.0,0.0,0.0,0.0,0.0,0.0,0.0,0.0,0.0,10.0,12892.5,0.0,130050.0,0.0,0.0,0.0,0.0,0.0,-558.5,63.0,-229.0,-650.0,286.0,-19.0,5.0,7542.405,33795.0,45000.0,1689.75,175950.0,15.0,-683.0,365243.0,-2432.0,-264.0,-114.0,-257.0,14.0,0.0,0.0544545454545454,15.0,28.0,13.0,8.0,-21.5,0.0,0.0,107.0,2250.0,2250.0,-1107.0,-1093.0,33.0,0.0,81.0,40047.03,45000.0,0.0,0.0,0.0,0.0,2250.0,2250.0,2250.0,38381.265,40047.03,40047.03,0.0,0.0,0.0,0.0,40.5,-41.0,0.0,0.0,8361785722.5,184659187360.5,165816174654.0,52061466655.935,1863.0,1706.0,71128.0,71043.0,9141.0,506977.0,,,,,,,128642.0,663967.0,,,,13550670.09862974,-602941167.0,-923457726.0,-297036326.0,-1537844071.0416667,44110.0,30768.0,,,,,,,67609.95112042314,158312.31743189305,126330.75180016404,,,,,,,3720456.0,,,,,,,,,,,,,,,,437310.0,432096.0,1265224.0,6435.991026002896,633041.0,626583.0,,,,,,,,,19.0,99229781.87999994,34205576.80500001,10462197839.129992,3443025244.9949965,123460881.03,867402.9449999995,203.0,26026.0,-34343815.0,15031573.0,-17859684.5,-19429280.0,-9.0,5121.0,0.0,102600.0,0.0,0.0,0.0,0.0,0.0,-2486.0,-1757.0,-1754.0,-1759.0,364097217.0375016,5181414963.165002,5810363829.225003,84331049.175,5182620963.165002,374499.0,-25896191.0,6042976161.0,267726604.0,1365732939.0,593410515.0,1438885461.0,372680.0,5825.0,1055.4927449908976,8680919.0,3080926.0,1899996.0,-6203345.0,1954593.0,246650.0,4079455733.115013,4135004711.145024,-248662852.0,-246583797.0,4384445.0,205194.0,3781404954.71995,10206594000.0,316776374.505,483560168.84999967,13666676.040000005,152589015.81000033,214603037.32499903,532895491.6199918,492630273.9899964,3630115958.670007,3767620558.679935,3767803493.2199335,16375.0,43451.0,207.0,26869.0,1244322.0,-2212297.0,846551.0,2070.0,1470035.0,14878594.0,3238137.0,8571153.0,11628059.0,1418412.0,1062339184.0620012,802319228.8649951,72232369926.07463,21712618624.00512,583923822.4169987,5792665.7475,689.5,94245.0,-277404133.0,21994082.5,-123990654.0,-219077068.0,-2027587.0,5930574201.967464,18757755000.0,198925482.825,448659962.9999977,1948107.735,257297036.0175008,309505367.83499867,637396853.2874978,459723095.7299992,5715470764.260036,5893803929.07,5894047111.815001,13396.5,80990.5,44.0,70491.0,972787.5,-1701460.0,177423.0,6755.0,4280581.0,2483650.0,-9019509.5,921848.5,37582.5,3740396913.31496,3665047204.97996,-261092348.0,-257774223.5,2530853.5,269699.0,3933024843.149953,33308618058.22592,36742694363.66264,1732815208.77755,48166698668.31072,3994902.0,-248014633.5,103269919189.5,1056970454.5,17300168765.0,3510001171.5,18915295915.5,3678511.5,72061.0,20908.16765632764,89904462.5,-32.89244186046512,5.5,3.5612535612535607,167.8179760371541,19.586894586894587,922.9988682043476,45000.0,0.6234898018587336,0.7818314824680298,0.0,0.0,0.0,0.0,0.0,0.0,1.0,0.0,0.0,0.0,0.0,0.0,0.0,1.0,0.0,0.0,0.0,0.0,1.0,0.0,1.0,0.0,0.0,0.0,0.0,1.0,0.0,0.0,0.0,0.0,0.0,0.0,0.0,0.0,0.0,0.0,0.0,0.0,0.0,0.0,0.0,0.0,0.0,0.0,0.0,0.0,0.0,0.0,0.0,0.0,0.0,0.0,0.0,1.0,0.0,0.0,0.0,0.0,0.0,0.0,0.0,0.0,0.0,0.0,0.0,0.0,0.0,0.0,0.0,0.0,0.0,0.0,0.0,0.0,0.0,0.0,0.0,0.0,0.0,0.0,0.0,0.0,0.0,0.0,0.0,0.0,0.0,0.0,0.0,0.0,0.0,0.0,0.0,0.0,0.0,0.0,0.0,0.0,0.0,0.0,0.0,0.0,0.0,0.0,0.0,0.0,0.0,0.0,0.0,0.0,0.0,0.0,0.0,0.0,0.0,0.0,0.0,0.0,0.0,0.0
106346,0,0.0,0.0,0.0,1.0,0.0,112500.0,539100.0,22968.0,450000.0,0.025164,55.77260273972602,,-14503.0,-3743.0,,2.0,2.0,2.0,14.0,,0.0472136510722133,0.4066174366275036,0.1237,0.1091,0.9747,0.6532,0.0123,0.0,0.2069,0.1667,0.2083,0.0233,0.0975,0.0995,0.0154,0.0105,0.1261,0.1132,0.9747,0.6668,0.0124,0.0,0.2069,0.1667,0.2083,0.0238,0.1065,0.1036,0.0156,0.0111,0.1249,0.1091,0.9747,0.6578,0.0124,0.0,0.2069,0.1667,0.2083,0.0237,0.0992,0.1013,0.0155,0.0107,0.0805,1.0,3.0,0.0,3.0,0.0,-977.0,0.0,0.0,0.0,0.0,1.0,5.0,1.0,0.0,0.0,1.0,0.0,0.0,0.0,0.0,0.0,0.0,0.0,0.0,0.0,0.0,0.0,0.0,1.0,0.0,0.0,0.0,0.0,0.0,0.0,0.0,0.0,0.0,0.0,0.0,0.0,0.0,0.0,0.0,26.0,0.0,0.0,112500.0,0.0,0.0,0.0,0.0,0.0,-1692.0,-1065.5,-961.5,-1213.0,1251.0,-27.0,11.0,14756.94,69030.0,69030.0,6750.0,128475.0,12.0,-977.0,365243.0,-1283.5,-1058.5,-1043.5,-1052.5,14.0,0.5,0.1672972041597824,6.0,67.0,12.0,5.0,-42.0,0.0,0.0,59.0,14756.94,14756.94,-1311.0,-1280.0,6.0,1.0,0.0,,,,,,,,,,,,,,,,,,,,,8361808690.5,184659726460.5,165816624654.0,52061579155.935,1863.0,1706.0,71128.0,71044.0,9141.0,506982.0,17840.692900002305,17903.006599999128,17353.654099997977,11316.866500000096,11254.572800000098,11201.523900000066,128642.0,663969.0,4145.591100000114,4143.158400000012,3953.596900000093,13550725.871232478,,-923461469.0,-297037303.0,-1537858574.0416667,44110.0,30768.0,11368.413999999197,11244.279999998991,10728.137399997288,22928.833700009855,22850.442200009828,22235.034800008383,,158312.36464554412,126331.15841760064,35063.813900028064,35003.890100028504,34448.761600028905,22993.547999995848,22966.524399995436,22612.74689999567,3720470.0,8310.819300000168,8415.58550000008,8138.72720000023,9834.34020000072,9949.445300002151,10309.81939999963,16497.18789999971,16682.76769999969,16279.1205999997,830.1118000001773,815.2740000000459,761.191900000013,3919.995600000124,3903.2420000001625,3735.775400000161,437313.0,432099.0,,6436.016190002894,633043.0,626585.0,,16361.782899999796,154463.34109999074,154466.08319999033,154357.77569998713,77746.26879999632,78084.69020000659,78486.94530000673,56.0,99891225.62999994,34213951.30500001,10477477323.404997,3446426378.6549964,123658896.78,867402.9449999995,203.0,26026.0,-34401445.0,15048176.0,-17887018.0,-19463885.0,-27.5,0.0,0.0,135000.0,0.0,0.0,0.0,0.0,0.0,-1753.0,-1353.0,-1028.0,-1234.0,364633929.4500016,5189973508.665002,5819757768.225003,84470841.675,5189904377.415002,375093.0,-25932279.0,6051188304.5,267701833.0,1368274941.0,594130444.0,1441427812.0,373249.0,5834.0,1056.8502130891632,8686840.0,3086094.0,1903261.0,-6210098.0,1954593.0,246650.0,4087781350.065025,4143229899.570036,-249269396.0,-247185236.0,4403562.0,205470.0,,,,,,,,,,,,,,,,,,,,,1470061.0,14879845.0,3238137.0,8571220.0,11628118.0,1418423.0,1062339184.0620012,802319228.8649951,72232482426.07463,21712618624.00512,583923822.4169987,5792665.7475,689.5,94245.0,-277405825.0,21993017.0,-123991615.5,-219078281.0,-2027614.0,,,,,,,,,,,,,,,,,,,,,4280593.0,2483655.0,-9019551.5,921848.5,37582.5,3740411670.25496,3665061961.91996,-261093659.0,-257775503.5,2530859.5,269700.0,3933039600.089953,33308687088.22592,36742763393.66264,1732821958.77755,48166827143.31072,3994914.0,-248015610.5,103270284432.5,1056969171.0,17300167706.5,3510000128.0,18915294863.0,3678525.5,72061.5,20908.3349535318,89904468.5,,4.792,4.898119122257054,273.1808519774981,23.4717868338558,1309.0826426761712,56250.0,-0.2225209339563143,0.9749279121818236,0.0,0.0,0.0,0.0,0.0,0.0,1.0,0.0,0.0,1.0,0.0,0.0,0.0,0.0,0.0,0.0,0.0,0.0,1.0,0.0,1.0,0.0,0.0,0.0,0.0,1.0,0.0,0.0,0.0,0.0,0.0,0.0,0.0,0.0,0.0,0.0,0.0,0.0,0.0,0.0,0.0,0.0,0.0,0.0,0.0,0.0,0.0,0.0,0.0,0.0,0.0,0.0,0.0,0.0,0.0,0.0,0.0,0.0,0.0,0.0,0.0,0.0,0.0,0.0,0.0,0.0,0.0,0.0,0.0,0.0,0.0,0.0,0.0,0.0,0.0,0.0,0.0,0.0,0.0,0.0,0.0,0.0,0.0,0.0,0.0,0.0,0.0,0.0,0.0,0.0,0.0,0.0,0.0,0.0,0.0,0.0,0.0,0.0,0.0,0.0,0.0,0.0,0.0,0.0,0.0,1.0,0.0,0.0,1.0,0.0,1.0,0.0,0.0,0.0,0.0,0.0,0.0,1.0,0.0,0.0
106347,0,0.0,0.0,0.0,0.0,0.0,180000.0,675000.0,21775.5,675000.0,0.018634,53.254794520547954,-4118.0,-9331.0,-2975.0,,1.0,2.0,2.0,16.0,0.6156325245673266,0.6314931875647597,0.5937175866150576,0.1856,0.1085,0.9866,,,0.2,0.1724,0.3333,,0.0916,,0.2005,,0.0,0.1891,0.1126,0.9866,,,0.2014,0.1724,0.3333,,0.0937,,0.2089,,0.0,0.1874,0.1085,0.9866,,,0.2,0.1724,0.3333,,0.0932,,0.2041,,0.0,0.1577,1.0,0.0,0.0,0.0,0.0,-2108.0,0.0,0.0,0.0,0.0,0.0,0.0,1.0,1.0,0.0,1.0,1.0,0.0,0.0,0.0,0.0,0.0,0.0,0.0,0.0,1.0,0.0,0.0,0.0,0.0,0.0,0.0,0.0,0.0,0.0,0.0,0.0,0.0,0.0,0.0,0.0,0.0,0.0,0.0,4.0,18000.0,0.0,101983.5,0.0,90000.0,0.0,0.0,0.0,-743.0,-444.0,-563.0,-615.5,92.0,-12.5,1.0,19401.435,180000.0,243936.0,0.0,180000.0,24.0,-2109.0,365243.0,-2078.0,-1388.0,-1388.0,-1382.0,12.0,0.0,0.0,-1.0,24.0,24.0,11.5,-57.5,0.0,0.0,24.0,19401.435,19401.435,-1735.5,-1733.0,12.5,1.0,0.0,,,,,,,,,,,,,,,,,,,,,8361830466.0,184660401460.5,165817299654.0,52061759155.935,1863.0,1706.0,71128.0,71044.0,9141.0,506982.0,17840.878500002305,17903.193999999126,17353.843199997977,11316.975000000097,11254.681300000098,11201.636500000066,128642.0,663970.0,,,,13550779.126027,-602945285.0,-923464444.0,-297039411.0,-1537867905.0416667,44110.0,30768.0,11368.613999999196,11244.479999998992,10728.338799997287,22929.006100009858,22850.61460000983,22235.207200008383,67610.56675294769,158312.9961387317,126331.75213518729,35064.147200028056,35004.22340002849,34449.094900028904,,,,3720486.0,8310.910900000168,8415.678700000079,8138.820900000232,,,,16497.38839999971,16682.97179999969,16279.3294999997,,,,3919.995600000124,3903.2420000001625,3735.775400000161,437313.0,432099.0,,6436.034824002894,633045.0,626587.0,,16361.940599999794,154464.32769999074,154467.06979999036,154358.76229998714,,,,25.0,99974210.12999994,34213951.30500001,10480334276.654997,3447932398.1549964,123838896.78,867402.9449999995,203.0,26026.0,-34422535.5,15032549.0,-17899798.0,-19478868.5,-12.0,18000.0,0.0,23967.0,0.0,0.0,0.0,0.0,0.0,-743.0,-510.0,-616.0,-721.0,364693485.1950016,5190699179.565002,5820574684.725003,84485485.575,5190699179.565002,375157.0,-25938434.0,6052466655.0,267696012.0,1368270410.0,594125928.0,1441423298.0,373323.0,5834.0,1057.2300146438315,8686993.0,3086771.0,1903551.5,-6212404.5,1954593.0,246650.0,4088324903.647529,4143773453.1525393,-249335009.5,-247250111.0,4403924.5,205512.5,,,,,,,,,,,,,,,,,,,,,1470065.0,14879937.0,3238137.0,8571244.0,11628142.0,1418424.0,1062357184.0620012,802319228.8649951,72232584409.57463,21712618624.00512,584013822.4169987,5792665.7475,689.5,94245.0,-277406568.0,21992573.0,-123992178.5,-219078896.5,-2027626.5,,,,,,,,,,,,,,,,,,,,,4280617.0,2483666.5,-9019609.0,921848.5,37582.5,3740431071.68996,3665081363.35496,-261095394.5,-257777236.5,2530872.0,269701.0,3933059001.524953,33308867088.22592,36743007329.66264,1732821958.77755,48167007143.31072,3994938.0,-248017719.5,103270649675.5,1056967093.0,17300166318.5,3509998740.0,18915293481.0,3678537.5,72061.5,20908.3349535318,89904467.5,-77.32637102582571,3.75,8.266170696424881,440.2132219098818,30.998140111593305,1650.7995821620566,180000.0,0.6234898018587336,0.7818314824680298,0.0,0.0,0.0,0.0,0.0,0.0,1.0,0.0,1.0,0.0,0.0,0.0,0.0,0.0,0.0,0.0,0.0,0.0,1.0,0.0,0.0,0.0,0.0,1.0,0.0,1.0,0.0,0.0,0.0,0.0,0.0,0.0,0.0,0.0,0.0,0.0,0.0,0.0,1.0,0.0,0.0,0.0,0.0,0.0,0.0,0.0,0.0,0.0,0.0,0.0,0.0,0.0,0.0,0.0,0.0,0.0,0.0,0.0,0.0,1.0,0.0,0.0,0.0,0.0,0.0,0.0,0.0,0.0,0.0,0.0,0.0,0.0,0.0,0.0,0.0,0.0,0.0,0.0,0.0,0.0,0.0,0.0,0.0,0.0,0.0,0.0,0.0,0.0,0.0,0.0,0.0,0.0,0.0,0.0,0.0,0.0,0.0,0.0,0.0,0.0,0.0,0.0,0.0,0.0,0.0,0.0,0.0,0.0,0.0,0.0,1.0,0.0,0.0,0.0,0.0,0.0,0.0,0.0,1.0,0.0
106349,0,0.0,0.0,0.0,1.0,0.0,202500.0,819072.0,26550.0,648000.0,0.0060079999999999,52.6109589041096,,-11365.0,-2367.0,,2.0,2.0,2.0,16.0,0.8039794516556125,0.5477026258271636,0.4686596550493113,,,,,,,,,,,,,,,,,,,,,,,,,,,,,,,,,,,,,,,,,,,,,3.0,0.0,3.0,0.0,-494.0,0.0,0.0,0.0,0.0,0.0,2.0,1.0,0.0,0.0,1.0,0.0,0.0,0.0,0.0,0.0,0.0,0.0,0.0,0.0,1.0,0.0,0.0,0.0,0.0,0.0,0.0,0.0,0.0,0.0,0.0,0.0,0.0,0.0,0.0,0.0,0.0,0.0,0.0,4.0,9009.0,8523.81,259983.0,93795.75,0.0,0.0,0.0,0.0,-363.0,578.0,-94.0,-267.0,70.0,-8.0,3.0,14661.855,213840.0,241362.0,0.0,241920.0,9.0,-293.0,182484.5,-356.0,182495.0,182645.0,182497.5,17.0,0.0,0.0,-1.0,9.0,18.0,14.0,-12.0,0.0,0.0,29.0,2250.0,2250.0,-128.0,-128.0,8.0,0.0,10.0,69030.5175,270000.0,0.0,15998.67,0.0,5049.135,2250.0,2330.01,75.51,64333.395,66617.955,66617.955,0.0,4.0,0.0,2.0,3.5,-5.5,0.0,0.0,8361857016.0,184661220532.5,165817947654.0,52061961655.935,1863.0,1706.0,71128.0,71044.0,9141.0,506984.0,,,,,,,128642.0,663972.0,,,,13550831.736985903,,-923466811.0,-297039905.0,-1537879270.0416667,44110.0,30768.0,,,,,,,67611.37073239936,158313.54384135752,126332.22079484232,,,,,,,3720502.0,,,,,,,,,,,,,,,,437316.0,432102.0,,6436.040832002896,633047.0,626589.0,,,,,,,,,12.5,100008023.12999994,34222475.11500001,10481066606.654997,3448175092.1549964,123838896.78,867402.9449999995,203.0,26026.0,-34426035.5,15032866.5,-17901233.0,-19479496.0,-5.75,0.0,8523.81,303750.0,0.0,0.0,0.0,0.0,0.0,-1077.0,-267.0,-253.0,-267.0,364743166.5900015,5191049459.565002,5820944242.725003,84507985.575,5191184459.565002,375185.0,-25942492.0,6053562247.0,267692218.5,1368449812.5,594305630.5,1441602723.5,373382.0,5835.0,1057.7576749680034,8687032.0,3087179.0,1903810.0,-6213720.0,1954593.0,246650.0,4089061984.140029,4144429391.670039,-249375438.0,-247290178.0,4404206.0,205547.0,3802865919.299949,10240231500.0,317941199.505,484772384.7449997,13666676.040000005,152614964.7450003,215898563.4749992,534508192.07999015,494067709.3949964,3650564907.9225054,3788983592.482433,3789166527.022432,16445.0,43537.5,207.0,26882.0,1253416.5,-2222967.0,846570.0,2087.0,1470069.0,14880007.0,3238147.0,8571253.0,11628171.0,1418427.0,1062366193.0620012,802327752.6749951,72232844392.57463,21712712419.75512,584013822.4169987,5792665.7475,689.5,94245.0,-277406931.0,21993151.0,-123992272.5,-219079163.5,-2027634.5,5930643232.4849615,18758025000.0,198925482.825,448675961.6699976,1948107.735,257302085.15250084,309507617.83499867,637399183.2974977,459723171.2399992,5715535097.655036,5893870547.025,5894113729.77,13396.5,80994.5,44.0,70493.0,972791.0,-1701465.5,177423.0,6755.0,4280635.0,2483680.5,-9019621.0,921848.5,37582.5,3740433321.68996,3665083613.35496,-261095522.5,-257777364.5,2530880.0,269701.0,3933073663.379953,33309080928.22592,36743248691.66264,1732821958.77755,48167249063.31072,3994947.0,-248018012.5,103270832160.0,1056966737.0,17300348813.5,3510181385.0,18915475978.5,3678554.5,72061.5,20908.3349535318,89904466.5,,4.0448,7.627118644067798,401.2700255398189,30.850169491525428,1623.0569993034594,101250.0,-0.2225209339563143,0.9749279121818236,0.0,0.0,0.0,0.0,0.0,0.0,1.0,0.0,0.0,1.0,0.0,0.0,0.0,0.0,0.0,0.0,0.0,0.0,1.0,1.0,0.0,0.0,0.0,0.0,0.0,1.0,0.0,0.0,0.0,0.0,0.0,0.0,0.0,0.0,0.0,0.0,0.0,0.0,0.0,0.0,0.0,0.0,0.0,0.0,0.0,0.0,0.0,0.0,0.0,0.0,0.0,0.0,0.0,0.0,0.0,0.0,0.0,0.0,0.0,0.0,0.0,0.0,0.0,0.0,0.0,0.0,0.0,0.0,0.0,0.0,0.0,0.0,0.0,0.0,0.0,0.0,0.0,0.0,0.0,0.0,0.0,0.0,0.0,0.0,0.0,0.0,0.0,0.0,0.0,0.0,0.0,0.0,0.0,0.0,0.0,0.0,0.0,0.0,0.0,0.0,0.0,0.0,0.0,0.0,0.0,1.0,0.0,0.0,0.0,0.0,0.0,0.0,0.0,0.0,0.0,0.0,0.0,0.0,0.0,0.0
106354,0,0.0,0.0,0.0,1.0,0.0,144000.0,190764.0,13878.0,157500.0,0.030755,42.347945205479455,-217.0,-4277.0,-1263.0,,2.0,2.0,2.0,10.0,,0.7712080932991467,0.5136937663039473,,,,,,,,,,,,,,,,,,,,,,,,,,,,,,,,,,,,,,,,,,,,,0.0,0.0,0.0,0.0,-538.0,0.0,0.0,0.0,0.0,0.0,3.0,1.0,1.0,1.0,1.0,0.0,0.0,0.0,0.0,0.0,0.0,1.0,1.0,0.0,1.0,0.0,0.0,0.0,0.0,0.0,0.0,0.0,0.0,0.0,0.0,0.0,0.0,0.0,0.0,0.0,0.0,0.0,0.0,2.0,7430.265,0.0,172413.0,97316.1675,0.0,0.0,0.0,0.0,-363.0,291.0,-42.0,,25.0,-6.0,8.0,12751.4025,90000.0,90000.0,0.0,270688.5,24.0,-407.0,365243.0,-318.0,365243.0,552.0,365243.0,14.0,0.0,0.0,-1.0,22.0,24.0,18.5,-7.5,0.0,0.0,23.0,16134.075,16134.075,-201.0,-176.0,7.0,1.0,0.0,,,,,,,,,,,,,,,,,,,,,8361870894.0,184661411296.5,165818105154.0,52062105655.935,1863.0,1706.0,71128.0,71044.0,9141.0,506987.0,,,,,,,128642.0,663974.0,,,,13550874.08493111,-602945502.0,-923468074.0,-297040443.0,-1537883547.0416667,44110.0,30768.0,,,,,,,,158314.31504945082,126332.73448860864,,,,,,,3720512.0,,,,,,,,,,,,,,,,437316.0,432102.0,,6436.071587002894,633049.0,626591.0,,,,,,,,,12.5,100024462.39499994,34222475.11500001,10483082128.394997,3448894007.2949963,123973896.78,867402.9449999995,204.0,26026.0,-34440711.5,15025258.5,-17910473.0,,-5.75,7430.265,0.0,178326.0,68877.0,0.0,0.0,0.0,0.0,-521.0,209.0,-34.0,,365122196.6850016,5198227229.565002,5828406214.725003,84656017.575,5198429729.565002,375631.0,-25961628.5,6059223376.5,267676700.0,1370264843.5,594484513.0,1443417830.5,373672.0,5840.0,1059.3845969892334,8748180.5,3091444.0,1907139.5,-6218111.5,1954593.0,246650.0,4094692913.3400183,4150319292.5850296,-249501957.0,-247413156.0,4405380.0,205721.0,,,,,,,,,,,,,,,,,,,,,1470071.0,14880032.0,3238147.0,8571275.0,11628194.0,1418435.0,1062373623.3270012,802327752.6749951,72233016805.57463,21712809735.92262,584013822.4169987,5792665.7475,689.5,94245.0,-277407294.0,21993442.0,-123992314.5,,-2027640.5,,,,,,,,,,,,,,,,,,,,,4280659.0,2483699.0,-9019628.5,921848.5,37582.5,3740449455.7649584,3665099747.429959,-261095723.5,-257777540.5,2530887.0,269702.0,3933086414.782455,33309170928.22592,36743338691.66264,1732821958.77755,48167519751.81072,3994971.0,-248018419.5,103271197403.0,1056966419.0,17300714056.5,3510181937.0,18915841221.5,3678568.5,72061.5,20908.3349535318,89904465.5,-5.124215565763084,1.32475,10.376134889753567,439.4079917559477,13.745784695201037,582.1057370786916,72000.0,-0.2225209339563143,0.9749279121818236,0.0,0.0,0.0,0.0,0.0,0.0,1.0,0.0,0.0,0.0,1.0,0.0,0.0,0.0,0.0,0.0,0.0,0.0,1.0,1.0,0.0,0.0,0.0,0.0,0.0,1.0,0.0,0.0,0.0,0.0,0.0,0.0,1.0,0.0,0.0,0.0,0.0,0.0,0.0,0.0,0.0,0.0,0.0,0.0,0.0,0.0,0.0,0.0,0.0,0.0,0.0,0.0,0.0,1.0,0.0,0.0,0.0,0.0,0.0,0.0,0.0,0.0,0.0,0.0,0.0,0.0,0.0,0.0,0.0,0.0,0.0,0.0,0.0,0.0,0.0,0.0,0.0,0.0,0.0,0.0,0.0,0.0,0.0,0.0,0.0,0.0,0.0,0.0,0.0,0.0,0.0,0.0,0.0,0.0,0.0,0.0,0.0,0.0,0.0,0.0,0.0,0.0,0.0,0.0,0.0,0.0,0.0,0.0,0.0,0.0,0.0,0.0,0.0,0.0,0.0,0.0,0.0,0.0,0.0,0.0
106360,0,1.0,0.0,0.0,0.0,0.0,202500.0,270000.0,13500.0,270000.0,0.0116569999999999,38.936986301369856,-856.0,-7219.0,-5335.0,,2.0,1.0,1.0,10.0,0.4870425775371387,0.5887684218991628,0.3979463219016906,0.0619,0.0805,0.9846,,0.0129,0.0,0.1379,0.1667,0.2083,0.0905,0.0504,0.0381,,,0.063,0.0836,0.9846,,0.013,0.0,0.1379,0.1667,0.2083,0.0926,0.0551,0.0397,,,0.0625,0.0805,0.9846,,0.0129,0.0,0.1379,0.1667,0.2083,0.0921,0.0513,0.0388,,,0.0727,1.0,0.0,0.0,0.0,0.0,-1867.0,0.0,0.0,0.0,0.0,0.0,3.0,1.0,1.0,0.0,1.0,0.0,0.0,0.0,0.0,0.0,0.0,1.0,1.0,0.0,0.0,0.0,0.0,0.0,0.0,0.0,0.0,0.0,0.0,0.0,0.0,0.0,0.0,0.0,0.0,0.0,0.0,0.0,0.0,5.0,0.0,0.045,157500.0,0.0,0.0,0.0,0.0,0.0,-383.0,-200.0,-241.0,-1051.0,136.0,-17.0,6.0,9374.5125,68087.25,69081.75,0.0,75919.5,11.0,-1338.5,365243.0,-1376.0,-1166.0,-1166.0,-1155.5,16.0,0.5,0.0,86.0,44.0,10.0,5.5,-54.5,0.0,0.0,38.0,7125.075,9090.7875,-1306.0,-1301.0,5.0,1.0,0.0,,,,,,,,,,,,,,,,,,,,,8361884394.0,184661681296.5,165818375154.0,52062308155.935,1863.0,1706.0,71128.0,71044.0,9141.0,506990.0,17840.940400002306,17903.256499999126,17353.906199997975,11317.055500000097,11254.761800000098,11201.720100000066,128642.0,663976.0,4145.604000000114,4143.171300000012,3953.6099000000927,13550913.02191741,-602946358.0,-923473409.0,-297042310.0,-1537890766.0416667,44110.0,30768.0,11368.613999999196,11244.479999998992,10728.338799997287,22929.144000009863,22850.75250000983,22235.345100008384,67611.8577749769,158314.90381787272,126333.13243493052,35064.313900028064,35004.390100028504,34449.261600028905,22993.75629999585,22966.73269999543,22612.955199995667,3720522.0,8311.001400000168,8415.770800000078,8138.913500000232,9834.39060000072,9949.49660000215,10309.874499999629,16497.42649999971,16683.01059999969,16279.3691999997,,,,,,,437316.0,432102.0,,6436.083244002894,633050.0,626592.0,,16362.013299999797,154465.31229999074,154468.05439999033,154359.74689998713,,,,13.0,100024462.39499994,34226301.15000001,10493213576.894997,3451857589.889996,123973896.78,867402.9449999995,204.0,26026.0,-34456688.0,15023896.0,-17917314.0,-19496065.0,-6.0,0.0,0.045,157500.0,0.0,0.0,0.0,0.0,0.0,-1408.0,-1042.0,-1046.0,-1051.0,365360563.3725015,5200590391.065002,5831092471.725003,84749613.075,5200526378.565002,375754.0,-25982645.0,6062142470.5,268031190.0,1371535524.0,595574420.0,1445055196.5,373940.5,5844.0,1060.0566147018176,8753270.5,3092341.0,1907633.0,-6221184.0,1954594.0,246651.0,4096746097.13252,4152352146.0525312,-249783186.0,-247693157.0,4413148.5,205803.5,,,,,,,,,,,,,,,,,,,,,1470076.0,14880168.0,3238147.0,8571319.0,11628232.0,1418441.0,1062373623.3270012,802327752.719995,72233174305.57463,21712809735.92262,584013822.4169987,5792665.7475,689.5,94245.0,-277407677.0,21993242.0,-123992555.5,-219080214.5,-2027657.5,,,,,,,,,,,,,,,,,,,,,4280669.0,2483704.5,-9019683.0,921848.5,37582.5,3740456580.8399577,3665108838.217458,-261097029.5,-257778841.5,2530892.0,269703.0,3933095789.294953,33309239015.47592,36743407773.41264,1732821958.77755,48167595671.31072,3994982.0,-248019758.0,103271562646.0,1056965043.0,17300712890.5,3510180771.0,18915840066.0,3678584.5,72062.0,20908.3349535318,89904551.5,-21.98423867154517,1.3333333333333333,15.0,584.0547945205481,20.0,778.7397260273973,101250.0,-0.9009688679024191,0.4338837391175582,0.0,0.0,0.0,0.0,0.0,0.0,1.0,0.0,0.0,0.0,1.0,0.0,0.0,0.0,0.0,1.0,0.0,0.0,0.0,0.0,1.0,0.0,0.0,0.0,0.0,1.0,0.0,0.0,0.0,0.0,0.0,0.0,0.0,0.0,0.0,0.0,0.0,0.0,0.0,0.0,0.0,0.0,0.0,0.0,0.0,0.0,0.0,0.0,0.0,0.0,0.0,0.0,0.0,0.0,0.0,0.0,0.0,0.0,0.0,0.0,0.0,0.0,0.0,0.0,0.0,0.0,0.0,0.0,0.0,0.0,0.0,0.0,0.0,0.0,0.0,0.0,0.0,0.0,0.0,0.0,0.0,1.0,0.0,0.0,0.0,0.0,0.0,0.0,0.0,0.0,0.0,0.0,0.0,0.0,0.0,0.0,0.0,0.0,0.0,0.0,0.0,0.0,0.0,0.0,0.0,0.0,0.0,0.0,1.0,0.0,1.0,0.0,0.0,0.0,0.0,0.0,0.0,1.0,0.0,0.0
106373,0,0.0,1.0,1.0,1.0,0.0,315000.0,685386.0,43933.5,585000.0,0.02461,42.293150684931504,-229.0,-2438.0,-4615.0,32.0,2.0,2.0,2.0,10.0,0.5622769513461038,0.5716251173061899,0.2009260877159708,,0.2211,0.9851,0.7959999999999999,0.0851,0.4,0.3448,0.3333,0.375,0.1478,0.3009,0.3732,0.0193,0.0134,,0.2295,0.9851,0.804,0.0859,0.4028,0.3448,0.3333,0.375,0.1512,0.3287,0.3889,0.0195,0.0142,,0.2211,0.9851,0.7987,0.0857,0.4,0.3448,0.3333,0.375,0.1504,0.3061,0.3799,0.0194,0.0137,0.343,1.0,0.0,0.0,0.0,0.0,-2153.0,0.0,0.0,0.0,0.0,0.0,5.0,1.0,1.0,0.0,1.0,0.0,0.0,0.0,0.0,0.0,0.0,0.0,0.0,0.0,1.0,0.0,0.0,0.0,0.0,0.0,0.0,0.0,0.0,0.0,0.0,0.0,0.0,0.0,0.0,0.0,0.0,0.0,0.0,12.0,8665.0875,0.0,265050.0,0.0,0.0,0.0,0.0,0.0,-1297.0,-723.5,-469.0,-1008.0,535.0,-23.0,9.0,6363.3600000000015,48060.0,48060.0,4432.5,70065.0,12.0,-1657.0,365243.0,-2122.0,-1792.0,-1792.0,-1789.0,15.0,1.0,0.1007458502497236,44.0,52.0,12.0,6.0,-68.5,0.0,0.0,49.0,7060.5,7060.5,-2081.0,-2062.0,6.0,1.0,0.0,,,,,,,,,,,,,,,,,,,,,8361928327.5,184662366682.5,165818960154.0,52062623155.935,1863.0,1706.0,71128.0,71044.0,9141.0,506995.0,,,,11317.276600000096,11254.9829000001,11201.949600000064,128642.0,663978.0,4145.689100000114,4143.257000000011,3953.6958000000927,13550955.315068096,-602946587.0,-923478024.0,-297044463.0,-1537893204.0416667,44110.0,30768.0,11369.013999999195,11244.879999998991,10728.741599997287,22929.488800009854,22851.097300009827,22235.689900008383,67612.42005192825,158315.47544299002,126333.33336101825,35064.647200028056,35004.72340002849,34449.594900028904,22994.13129999585,22967.10769999543,22613.330199995667,3720532.0,8311.149200000169,8415.921200000079,8139.064700000232,9834.69150000072,9949.80270000215,10310.203199999629,16497.799699999712,16683.39049999969,16279.7580999997,830.1311000001773,815.2934000000461,761.211400000013,3920.009000000124,3903.2557000001625,3735.789600000161,437316.0,432102.0,1265256.0,6436.107854002896,633052.0,626594.0,,16362.356299999798,154466.29739999076,154469.03949999032,154360.73199998713,77747.06479999633,78085.48890000659,78487.74930000673,43.0,101509745.89499994,34246438.65000001,10516807452.374994,3461130549.224996,124426001.52,867402.9449999995,206.0,26026.0,-34552835.0,15045597.0,-17961750.5,-19549205.5,-21.0,0.0,0.0,91782.0,0.0,0.0,0.0,0.0,0.0,-1789.0,-1144.0,-771.0,-1213.0,365751295.31250143,5204164741.065002,5835028068.225003,85057093.575,5204164741.065002,376055.0,-26018846.0,6072186653.0,268004182.0,1372974962.0,595555311.0,1446494786.0,374516.0,5851.0,1063.2779053876784,8767313.0,3095144.0,1909311.0,-6228103.0,1954625.0,246662.0,4100016362.490015,4155442087.4100256,-250111880.0,-248019173.0,4418053.0,206045.0,,,,,,,,,,,,,,,,,,,,,1470088.0,14880703.0,3238147.0,8571371.0,11628281.0,1418450.0,1062382288.4145012,802327752.719995,72233439355.57463,21712809735.92262,584013822.4169987,5792665.7475,689.5,94245.0,-277408974.0,21992518.5,-123993024.5,-219081222.5,-2027680.5,,,,,,,,,,,,,,,,,,,,,4280681.0,2483710.5,-9019751.5,921848.5,37582.5,3740463641.3399577,3665115898.717458,-261099110.5,-257780903.5,2530898.0,269704.0,3933102152.654953,33309287075.47592,36743455833.41264,1732826391.27755,48167665736.31072,3994994.0,-248021415.0,103271927889.0,1056962921.0,17300711098.5,3510178979.0,18915838277.0,3678599.5,72063.0,20908.435699382044,89904595.5,-5.414588326747426,2.1758285714285712,7.169927276451911,303.2388147029812,15.600532623169109,659.7956769968807,157500.0,-0.9009688679024191,0.4338837391175582,0.0,0.0,0.0,0.0,0.0,0.0,1.0,0.0,1.0,0.0,0.0,0.0,0.0,0.0,0.0,0.0,0.0,0.0,1.0,0.0,1.0,0.0,0.0,0.0,0.0,1.0,0.0,0.0,0.0,0.0,0.0,0.0,0.0,0.0,0.0,0.0,0.0,0.0,0.0,0.0,0.0,0.0,0.0,0.0,1.0,0.0,0.0,0.0,0.0,0.0,0.0,0.0,0.0,0.0,0.0,0.0,0.0,0.0,0.0,0.0,0.0,0.0,0.0,0.0,0.0,0.0,0.0,0.0,0.0,0.0,0.0,0.0,0.0,0.0,0.0,0.0,0.0,0.0,0.0,0.0,0.0,0.0,0.0,0.0,0.0,0.0,0.0,0.0,0.0,0.0,0.0,0.0,0.0,0.0,0.0,0.0,0.0,0.0,0.0,0.0,0.0,0.0,0.0,1.0,0.0,0.0,0.0,0.0,1.0,0.0,1.0,0.0,0.0,0.0,0.0,0.0,0.0,1.0,0.0,0.0
106377,0,0.0,0.0,0.0,1.0,0.0,135000.0,165915.0,9391.5,126000.0,0.035792,62.14794520547945,,-11473.0,-4741.0,,2.0,2.0,2.0,16.0,,0.135827869978368,0.4365064990977374,,,,,,,,,,,,,,,,,,,,,,,,,,,,,,,,,,,,,,,,,,,,,0.0,0.0,0.0,0.0,-180.0,0.0,0.0,0.0,0.0,0.0,1.0,1.0,0.0,0.0,1.0,1.0,0.0,0.0,0.0,0.0,0.0,0.0,0.0,0.0,1.0,0.0,0.0,0.0,0.0,0.0,0.0,0.0,0.0,0.0,0.0,0.0,0.0,0.0,0.0,0.0,0.0,0.0,0.0,9.0,0.0,,69975.0,0.0,0.0,0.0,0.0,0.0,-849.0,-484.0,-434.0,-992.0,326.0,-19.0,5.0,10928.61,48807.0,53100.0,0.0,99846.0,10.0,-180.0,365243.0,-947.0,-677.0,-677.0,-675.0,10.0,0.0,0.0,-1.0,27.0,10.0,6.0,-30.0,0.0,0.0,26.0,5987.07,5987.07,-895.5,-872.0,4.5,1.0,0.0,,,,,,,,,,,,,,,,,,,,,8361937719.0,184662532597.5,165819086154.0,52062758155.935,1863.0,1706.0,71128.0,71044.0,9141.0,506996.0,,,,,,,128642.0,663980.0,,,,13551017.4630133,,-923482765.0,-297044643.0,-1537904677.0416667,44110.0,30768.0,,,,,,,,158315.61127086,126333.76986751732,,,,,,,3720548.0,,,,,,,,,,,,,,,,437316.0,432102.0,,6436.143646002895,633054.0,626596.0,,,,,,,,,28.0,101648169.58499992,,10523143610.189993,3464416641.914996,124426001.52,867402.9449999995,206.0,26026.0,-34565189.0,15040991.0,-17967542.0,-19556994.0,-13.5,0.0,,67500.0,0.0,0.0,0.0,0.0,0.0,-1708.0,-1343.0,-1005.0,-1344.0,366010683.6600016,5208696482.940002,5839981802.100003,85081618.575,5208696482.940002,376369.0,-26033382.0,6076204192.0,268359485.0,1374428425.0,596280209.0,1447948290.0,374796.0,5854.0,1063.76151355706,8770550.0,3096738.0,1910330.0,-6231612.0,1954625.0,246662.0,4102360799.940012,4158474217.155023,-250211754.0,-248118213.5,4418709.0,206149.5,,,,,,,,,,,,,,,,,,,,,1470097.0,14881029.0,3238147.0,8571398.0,11628307.0,1418455.0,1062382288.4145012,,72233509330.57463,21712809735.92262,584013822.4169987,5792665.7475,689.5,94245.0,-277409823.0,21992034.5,-123993458.5,-219082214.5,-2027699.5,,,,,,,,,,,,,,,,,,,,,4280691.0,2483716.5,-9019781.5,921848.5,37582.5,3740469628.4099584,3665121885.787458,-261100006.0,-257781775.5,2530902.5,269705.0,3933113081.2649546,33309335882.47592,36743508933.41264,1732826391.27755,48167765582.31072,3995004.0,-248021595.0,103272293132.0,1056961974.0,17300710421.5,3510178302.0,18915837602.0,3678609.5,72063.0,20908.435699382044,89904594.5,,1.229,14.374700527072353,893.3581007016693,17.66650694777192,1097.9371057623514,67500.0,-0.2225209339563143,0.9749279121818236,0.0,0.0,0.0,0.0,0.0,0.0,1.0,0.0,0.0,1.0,0.0,0.0,0.0,0.0,0.0,1.0,0.0,0.0,0.0,0.0,1.0,0.0,0.0,0.0,0.0,1.0,0.0,0.0,0.0,0.0,0.0,0.0,0.0,0.0,0.0,0.0,0.0,0.0,0.0,0.0,0.0,0.0,0.0,0.0,0.0,0.0,0.0,0.0,0.0,0.0,0.0,0.0,0.0,0.0,0.0,0.0,0.0,0.0,0.0,0.0,0.0,0.0,0.0,0.0,0.0,0.0,0.0,0.0,0.0,0.0,0.0,0.0,0.0,0.0,0.0,0.0,0.0,0.0,0.0,0.0,0.0,0.0,0.0,0.0,0.0,0.0,0.0,0.0,0.0,0.0,0.0,0.0,0.0,0.0,0.0,0.0,0.0,0.0,0.0,0.0,0.0,0.0,0.0,0.0,0.0,1.0,0.0,0.0,0.0,0.0,0.0,0.0,0.0,0.0,0.0,0.0,0.0,0.0,0.0,0.0
106386,0,0.0,1.0,0.0,0.0,1.0,121500.0,540000.0,27702.0,540000.0,0.025164,32.66575342465753,-2392.0,-715.0,-2887.0,,3.0,2.0,2.0,7.0,0.2110224839137779,0.2508400644847299,,0.1299,0.0843,0.9881,0.8368,0.0159,0.06,0.1552,0.25,0.2083,0.0227,0.0756,0.121,0.0,0.0399,0.0945,0.0875,0.9881,0.8432,0.016,0.0,0.1034,0.1667,0.2083,0.0232,0.0826,0.0867,0.0,0.0423,0.1312,0.0843,0.9881,0.8390000000000001,0.016,0.06,0.1552,0.25,0.2083,0.0231,0.077,0.1231,0.0,0.0408,0.1027,1.0,3.0,0.0,3.0,0.0,-304.0,,,,,,,1.0,1.0,0.0,1.0,0.0,0.0,0.0,0.0,0.0,0.0,0.0,0.0,0.0,1.0,0.0,0.0,0.0,0.0,0.0,0.0,0.0,0.0,0.0,0.0,0.0,0.0,0.0,0.0,0.0,0.0,0.0,0.0,0.0,,,,,,,,,,,,,0.0,,3.0,8329.68,45000.0,45000.0,0.0,87160.5,6.0,-545.0,365243.0,182364.5,182469.5,182529.5,182471.5,15.0,0.0,0.0,765.0,9.0,12.0,8.0,-14.0,0.0,0.0,8.0,14409.36,14409.36,-419.5,-409.0,4.5,1.0,16.0,0.0,135000.0,,0.0,,,0.0,,0.0,0.0,0.0,0.0,,0.0,,,0.0,-10.5,0.0,0.0,8361965421.0,184663072597.5,165819626154.0,52062879655.935,,,,,,,17841.070300002306,17903.387699999126,17354.000699997974,11317.360900000098,11255.0672000001,11202.037100000063,128643.0,663983.0,4145.7050000001145,4143.273000000011,3953.711800000093,13551050.128766725,-602948979.0,-923485652.0,-297044947.0,-1537905392.0416667,44110.0,30768.0,11369.073999999197,11244.939999998993,10728.741599997287,22929.644000009863,22851.25250000983,22235.793300008383,67612.63107441216,158315.8621109245,,35064.897200028056,35004.97340002849,34449.761600028905,22994.33959999585,22967.31599999543,22613.538499995662,3720555.0,8311.171900000169,8415.94430000008,8139.08790000023,9834.76710000072,9949.87970000215,10310.285799999629,16497.920699999708,16683.51359999969,16279.8447999997,830.1311000001773,815.2934000000461,761.211400000013,3920.048900000124,3903.296500000162,3735.831900000161,437319.0,432105.0,,6436.168810002894,633056.0,626598.0,,16362.458999999795,154467.28549999074,154470.02759999028,154361.7200999871,77747.90159999633,78086.3279000066,78488.59250000674,,,,,,,,,,,,,,,,,,,,,,,,,,,366609422.5200017,5216326101.090001,5850461721.600003,85137723.22500001,5216261440.590001,376939.0,-26077470.0,6085514424.5,269791079.0,1376598262.0,598457166.0,1449754245.0,375291.0,5863.0,1064.4182228851612,8787358.0,3101542.0,1913513.0,-6241739.0,1954723.0,246662.0,4109835473.369996,4166268009.885007,-250657038.0,-248560592.0,4427650.5,206410.5,3823127486.999952,10297804500.0,,487940566.1849996,,,216996750.67499915,,497394844.2899965,3670114415.445009,3809162192.3549376,3809345126.8949366,,43772.0,,,1260289.0,-2236735.5,846985.0,2106.0,1470097.0,14881029.0,3238163.0,8571407.0,11628315.0,1418458.0,,,,,,,,,,,,,,5930643232.4849615,18758160000.0,,448675961.6699976,,,309507617.83499867,,459723171.2399992,5715535097.655036,5893870547.025,5894113729.77,,80994.5,,,972791.0,-1701476.0,177423.0,6755.0,4280703.0,2483724.5,-9019795.5,921848.5,37582.5,3740484037.76996,3665136295.1474586,-261100425.5,-257782184.5,2530907.0,269706.0,3933121410.944953,33309380882.47592,36743553933.41264,1732826391.27755,48167852742.81072,3995010.0,-248022140.0,103272658375.0,1057144338.5,17300892891.0,3510360831.5,18916020073.5,3678624.5,72063.0,20908.435699382044,89905359.5,-73.22653694539966,4.4444444444444455,4.385964912280701,143.27084835376112,19.49317738791423,636.759326016716,40500.0,-0.9009688679024191,0.4338837391175582,0.0,0.0,0.0,0.0,0.0,0.0,1.0,0.0,1.0,0.0,0.0,0.0,0.0,0.0,0.0,0.0,0.0,0.0,1.0,0.0,1.0,0.0,0.0,0.0,0.0,1.0,0.0,0.0,0.0,0.0,0.0,0.0,0.0,1.0,0.0,0.0,0.0,0.0,0.0,0.0,0.0,0.0,0.0,0.0,0.0,0.0,0.0,0.0,0.0,0.0,0.0,0.0,0.0,0.0,0.0,0.0,0.0,0.0,0.0,0.0,0.0,0.0,0.0,0.0,0.0,0.0,0.0,0.0,0.0,0.0,0.0,0.0,0.0,0.0,0.0,0.0,0.0,0.0,0.0,0.0,0.0,0.0,0.0,0.0,0.0,0.0,0.0,0.0,0.0,0.0,1.0,0.0,0.0,0.0,0.0,0.0,0.0,0.0,0.0,0.0,0.0,0.0,0.0,0.0,0.0,0.0,0.0,0.0,1.0,0.0,1.0,0.0,0.0,1.0,0.0,0.0,0.0,0.0,0.0,0.0
106387,0,0.0,0.0,0.0,1.0,1.0,112500.0,269982.0,28480.5,238500.0,0.0096569999999999,34.843835616438355,-1056.0,-4073.0,-4161.0,,3.0,2.0,2.0,9.0,0.3316146500875408,0.7209130208053204,0.5549467685334323,,,0.9776,,,0.0,0.1724,0.1667,,,,0.0956,,,,,0.9777,,,0.0,0.1724,0.1667,,,,0.0996,,,,,0.9776,,,0.0,0.1724,0.1667,,,,0.0974,,,0.0752,1.0,1.0,0.0,1.0,0.0,-535.0,0.0,0.0,0.0,0.0,1.0,0.0,1.0,1.0,0.0,1.0,0.0,0.0,0.0,0.0,0.0,0.0,1.0,1.0,0.0,1.0,0.0,0.0,0.0,0.0,0.0,0.0,0.0,0.0,0.0,0.0,0.0,0.0,0.0,0.0,0.0,0.0,0.0,0.0,1.0,0.0,,139437.0,,,0.0,0.0,0.0,-652.0,-319.0,-287.0,-294.0,22.0,-10.5,2.0,7034.8725,43807.5,48519.0,0.0,43807.5,9.0,-290.0,365243.0,-255.0,182539.0,-15.0,182540.0,13.0,0.5,0.0,91.0,14.0,12.0,6.0,-10.5,0.0,0.0,14.0,5336.955,5336.955,-348.5,-330.0,5.5,1.0,0.0,,,,,,,,,,,,,,,,,,,,,8361993901.5,184663342579.5,165819864654.0,52062992155.935,1863.0,1706.0,71128.0,71045.0,9141.0,506996.0,,,,,,,128644.0,663986.0,,,,13551084.97260234,-602950035.0,-923489813.0,-297045482.0,-1537909465.0416667,44110.0,30768.0,11369.073999999197,11244.939999998993,10728.741599997287,22929.816400009862,22851.424900009828,22235.965700008383,67612.96268906225,158316.5830239453,126334.32481428586,35065.063900028064,35005.140100028504,34449.928300028914,,,,3720564.0,,,,,,,16498.016299999712,16683.610999999688,16279.944399999697,,,,,,,437320.0,432106.0,,6436.178467002895,633058.0,626600.0,,16362.534199999796,154468.26309999076,154471.00519999032,154362.6977999871,,,,22.0,101726567.59499994,,10545080796.224993,,,867402.9449999995,206.0,26026.0,-34610151.0,15069538.0,-17988387.0,-19582998.0,-10.5,0.0,,139437.0,,,0.0,0.0,0.0,-652.0,-319.0,-287.0,-294.0,366626330.55000174,5216392386.090001,5850535388.850003,85137723.22500001,5216392386.090001,376960.0,-26078222.5,6086244910.5,269790319.5,1376780566.5,598456976.5,1449936553.5,375324.0,5863.5,1064.4182228851612,8787480.0,3101680.0,1913590.5,-6241878.0,1954723.0,246662.0,4109979416.827496,4166411953.342507,-250660731.0,-248564123.5,4427727.5,206422.5,,,,,,,,,,,,,,,,,,,,,1470098.0,14881051.0,3238163.0,8571421.0,11628329.0,1418460.0,1062382288.4145012,,72233648767.57463,,,5792665.7475,689.5,94245.0,-277410475.0,21991715.5,-123993745.5,-219082508.5,-2027710.0,,,,,,,,,,,,,,,,,,,,,4280715.0,2483730.5,-9019806.0,921848.5,37582.5,3740489374.7249584,3665141632.1024585,-261100774.0,-257782514.5,2530912.5,269707.0,3933128445.817455,33309424689.97592,36743602452.41264,1732826391.27755,48167896550.31072,3995019.0,-248022430.0,103273023618.0,1057144083.5,17301075430.0,3510360816.5,18916202613.5,3678637.5,72063.5,20908.435699382044,89905450.5,-30.306651989306488,2.39984,3.950071101279823,137.63562812623778,9.479538631695371,330.3034858024705,37500.0,0.6234898018587336,0.7818314824680298,0.0,0.0,0.0,0.0,0.0,0.0,1.0,0.0,0.0,0.0,0.0,0.0,0.0,1.0,0.0,0.0,0.0,0.0,1.0,1.0,0.0,0.0,0.0,0.0,0.0,0.0,0.0,0.0,0.0,1.0,0.0,0.0,0.0,0.0,0.0,0.0,0.0,0.0,0.0,0.0,1.0,0.0,0.0,0.0,0.0,0.0,0.0,0.0,0.0,0.0,0.0,0.0,0.0,0.0,0.0,0.0,0.0,0.0,0.0,0.0,0.0,0.0,0.0,0.0,0.0,0.0,0.0,0.0,0.0,0.0,0.0,0.0,0.0,0.0,0.0,0.0,0.0,0.0,0.0,0.0,0.0,0.0,0.0,0.0,0.0,0.0,0.0,0.0,0.0,0.0,1.0,0.0,0.0,0.0,0.0,0.0,0.0,0.0,0.0,0.0,0.0,0.0,0.0,0.0,0.0,0.0,0.0,0.0,0.0,0.0,1.0,0.0,0.0,0.0,0.0,0.0,0.0,1.0,0.0,0.0
106391,0,0.0,0.0,0.0,0.0,0.0,324000.0,1125000.0,40410.0,1125000.0,0.032561,44.70410958904109,-3356.0,-6328.0,-4193.0,,1.0,1.0,1.0,10.0,,0.7309577547452151,0.7662336700704004,0.3278,0.0834,0.9861,0.8096,0.87,0.48,0.2069,0.4583,0.0417,0.0895,0.2673,0.3659,0.0386,0.126,0.334,0.0865,0.9861,0.8171,0.8779,0.4834,0.2069,0.4583,0.0417,0.0915,0.292,0.3813,0.0389,0.1334,0.331,0.0834,0.9861,0.8121,0.8755,0.48,0.2069,0.4583,0.0417,0.091,0.2719,0.3725,0.0388,0.1286,0.3354,1.0,0.0,0.0,0.0,0.0,-1783.0,0.0,0.0,0.0,0.0,0.0,0.0,1.0,1.0,1.0,1.0,1.0,0.0,0.0,0.0,0.0,0.0,0.0,0.0,0.0,1.0,0.0,0.0,0.0,0.0,0.0,0.0,0.0,0.0,0.0,0.0,0.0,0.0,0.0,0.0,0.0,0.0,0.0,0.0,8.0,124452.0,0.0,503572.5,0.0,0.0,0.0,0.0,0.0,-1047.5,190.0,-450.5,-452.0,346.0,-24.0,2.0,20297.0925,240750.0,227641.5,23400.0,240750.0,15.0,-2556.5,365243.0,-2705.0,-2285.0,-2195.0,-2277.0,12.5,1.0,0.1089090909090909,74.5,16.0,15.0,7.5,-82.5,0.0,0.0,15.0,21312.585,21312.585,-2502.0,-2495.0,8.0,1.0,0.0,,,,,,,,,,,,,,,,,,,,,8362034311.5,184664467579.5,165820989654.0,52063316155.935,1863.0,1706.0,71128.0,71045.0,9141.0,506996.0,17841.398100002305,17903.718699999125,17354.33469999797,11317.444300000096,11255.1506000001,11202.123600000064,128644.0,663987.0,4146.575000000114,4144.148500000011,3954.5897000000928,13551129.67671193,-602953391.0,-923494006.0,-297047265.0,-1537915793.0416667,44110.0,30768.0,11369.553999999196,11245.419999998989,10729.224999997286,22930.023300009863,22851.63180000983,22236.172600008384,,158317.31398170005,126335.09104795595,35065.522200028056,35005.59840002849,34450.386600028905,22994.38129999585,22967.35769999543,22613.580199995667,3720574.0,8311.261400000169,8416.03530000008,8139.179400000232,9835.03440000072,9950.15160000215,10310.577799999628,16498.382199999713,16683.98349999969,16280.325699999696,830.1697000001773,815.3322000000461,761.250300000013,3920.174900000124,3903.425100000162,3735.965300000161,437320.0,432106.0,,6436.211028002895,633059.0,626601.0,,16362.869599999794,154469.24919999074,154471.99129999033,154363.6838999871,77748.71119999632,78087.14000000659,78489.40960000674,34.5,101853350.41499992,34343576.37000001,10552610998.394993,3470950838.654996,124748019.09,867402.9449999995,206.0,26026.0,-34629345.0,15098012.0,-17996571.5,-19589134.0,-17.25,124452.0,0.0,385920.0,0.0,0.0,0.0,0.0,0.0,-1909.0,-939.0,-572.0,-1723.0,366931172.79000175,5220004977.090001,5854395527.100003,85174623.22500001,5220004977.090001,377177.0,-26094386.0,6090444347.0,270146477.0,1378418212.0,599184479.0,1451574245.0,375649.5,5870.0,1064.7173533756843,8788253.5,3103376.5,1914851.0,-6244141.5,1954723.0,246662.0,4113461893.7699943,4170418396.2000046,-250754605.0,-248656416.0,4430837.0,206584.0,,,,,,,,,,,,,,,,,,,,,1470106.0,14881397.0,3238163.0,8571437.0,11628344.0,1418462.0,1062506740.4145012,802327752.719995,72234152340.07463,21712809735.92262,584013822.4169987,5792665.7475,689.5,94245.0,-277411522.5,21991905.5,-123994196.0,-219082960.5,-2027734.0,,,,,,,,,,,,,,,,,,,,,4280730.0,2483738.0,-9019888.5,921848.5,37582.5,3740510687.30996,3665162944.6874585,-261103276.0,-257785009.5,2530920.5,269708.0,3933148742.9099545,33309665439.97592,36743830093.91264,1732849791.27755,48168137300.31072,3995034.0,-248024986.5,103273388861.0,1057141378.5,17301073145.0,3510358621.5,18916200336.5,3678650.0,72064.5,20908.544608472952,89905525.0,-75.07139792854079,3.4722222222222223,8.017817371937639,358.4293864600177,27.83964365256125,1244.5464807639505,324000.0,-0.2225209339563143,0.9749279121818236,0.0,0.0,0.0,0.0,0.0,0.0,1.0,0.0,1.0,0.0,0.0,0.0,0.0,0.0,0.0,1.0,0.0,0.0,0.0,0.0,0.0,1.0,0.0,0.0,0.0,1.0,0.0,0.0,0.0,0.0,0.0,0.0,0.0,0.0,0.0,0.0,0.0,0.0,0.0,0.0,0.0,0.0,0.0,0.0,0.0,0.0,0.0,0.0,0.0,0.0,0.0,0.0,0.0,1.0,0.0,0.0,0.0,0.0,0.0,0.0,0.0,0.0,0.0,0.0,0.0,0.0,0.0,0.0,0.0,0.0,0.0,0.0,0.0,0.0,0.0,0.0,0.0,0.0,0.0,0.0,0.0,0.0,0.0,0.0,0.0,0.0,0.0,0.0,0.0,0.0,0.0,0.0,0.0,0.0,0.0,0.0,0.0,0.0,0.0,0.0,0.0,0.0,0.0,0.0,0.0,0.0,0.0,0.0,1.0,0.0,1.0,0.0,0.0,0.0,0.0,0.0,0.0,1.0,0.0,0.0
106401,0,0.0,0.0,0.0,0.0,0.0,76500.0,296280.0,16069.5,225000.0,0.018029,23.44383561643836,-248.0,-2593.0,-903.0,,2.0,3.0,3.0,12.0,,0.3371188933251929,,,,,,,,,,,,,,,,,,,,,,,,,,,,,,,,,,,,,,,,,,,,,,0.0,0.0,0.0,0.0,-580.0,,,,,,,1.0,1.0,1.0,1.0,0.0,0.0,0.0,0.0,0.0,0.0,1.0,1.0,0.0,1.0,0.0,0.0,0.0,0.0,0.0,0.0,0.0,0.0,0.0,0.0,0.0,0.0,0.0,0.0,0.0,0.0,0.0,0.0,0.0,,,,,,,,,,,,,0.0,,1.0,8627.58,41701.5,42304.5,4171.5,41701.5,6.0,-580.0,365243.0,-546.0,-396.0,-396.0,-389.0,6.0,0.0,0.0977524470107738,29.0,7.0,6.0,3.0,-16.0,0.0,0.0,8.0,8627.58,8437.95,-472.0,-456.0,4.0,1.0,0.0,,,,,,,,,,,,,,,,,,,,,8362050381.0,184664763859.5,165821214654.0,52063392655.935,,,,,,,,,,,,,128644.0,663989.0,,,,13551153.120547544,-602953639.0,-923494909.0,-297047845.0,-1537918386.0416667,44110.0,30768.0,,,,,,,,158317.6511005934,,,,,,,,3720586.0,,,,,,,,,,,,,,,,437320.0,432106.0,,6436.229057002895,633062.0,626604.0,,,,,,,,,,,,,,,,,,,,,,,,,,,,,,,,,,,367791267.7800018,5237426128.590001,5872701918.600003,85463221.72500001,5237426128.590001,378028.0,-26130069.0,6099574263.0,270487545.0,1379496668.0,599904729.0,1453018773.0,376262.0,5876.0,1067.1322353894798,8792635.0,3109246.0,1918926.0,-6252952.0,1956248.0,246687.0,4122076945.769989,4179839859.0900025,-251272761.5,-249171725.0,4447705.5,206955.5,,,,,,,,,,,,,,,,,,,,,1470106.0,14881397.0,3238163.0,8571444.0,11628352.0,1418463.0,,,,,,,,,,,,,,,,,,,,,,,,,,,,,,,,,,4280736.0,2483741.0,-9019904.5,921848.5,37582.5,3740519314.8899584,3665171382.637458,-261103748.0,-257785465.5,2530924.5,269709.0,3933157370.4899545,33309707141.47592,36743872398.41264,1732853962.77755,48168179001.81072,3995040.0,-248025566.5,103273754104.0,1057140832.5,17301072749.0,3510358225.5,18916199947.5,3678656.0,72064.5,20908.642360919963,89905554.0,-10.578473764169686,3.872941176470588,4.760571268552226,111.6060502602778,18.43741248949874,432.243667596276,38250.0,-0.2225209339563143,0.9749279121818236,0.0,1.0,0.0,0.0,0.0,0.0,0.0,0.0,0.0,0.0,0.0,0.0,0.0,1.0,0.0,0.0,0.0,0.0,1.0,0.0,1.0,0.0,0.0,0.0,0.0,1.0,0.0,0.0,0.0,0.0,0.0,0.0,1.0,0.0,0.0,0.0,0.0,0.0,0.0,0.0,0.0,0.0,0.0,0.0,0.0,0.0,0.0,0.0,0.0,0.0,0.0,0.0,0.0,0.0,0.0,0.0,0.0,0.0,0.0,0.0,0.0,0.0,0.0,0.0,0.0,0.0,0.0,0.0,0.0,0.0,0.0,0.0,0.0,0.0,0.0,0.0,0.0,0.0,0.0,0.0,0.0,0.0,0.0,0.0,0.0,0.0,1.0,0.0,0.0,0.0,0.0,0.0,0.0,0.0,0.0,0.0,0.0,0.0,0.0,0.0,0.0,0.0,0.0,0.0,0.0,0.0,0.0,0.0,0.0,0.0,0.0,0.0,0.0,0.0,0.0,0.0,0.0,0.0,0.0,0.0
106411,0,0.0,0.0,0.0,0.0,0.0,139500.0,270000.0,13932.0,270000.0,0.018801,44.65753424657535,-1729.0,-1625.0,-1633.0,,1.0,2.0,2.0,12.0,0.5025154294394306,0.2897797450956406,0.3706496323299817,,,,,,,,,,,,,,,,,,,,,,,,,,,,,,,,,,,,,,,,,,,,,2.0,0.0,2.0,0.0,-668.0,0.0,0.0,0.0,0.0,1.0,1.0,1.0,1.0,0.0,1.0,0.0,0.0,1.0,1.0,0.0,1.0,1.0,0.0,0.0,1.0,0.0,0.0,0.0,0.0,0.0,0.0,0.0,0.0,0.0,0.0,0.0,0.0,0.0,0.0,0.0,0.0,0.0,0.0,7.0,14850.0,0.0,310050.0,0.0,0.0,0.0,0.0,0.0,-1073.0,489.0,-297.0,-677.0,220.0,-18.0,1.0,10922.13,96805.485,119263.5,1.485,96805.485,12.0,-668.0,365243.0,-637.0,-307.0,-307.0,-304.0,13.0,0.0,1.3560560125840787e-05,1000.0,13.0,12.0,6.0,-16.0,0.0,0.0,13.0,10922.13,10922.13,-485.0,-487.0,6.0,1.0,0.0,,,,,,,,,,,,,,,,,,,,,8362064313.0,184665033859.5,165821484654.0,52063532155.935,1863.0,1706.0,71128.0,71046.0,9141.0,506997.0,,,,,,,128644.0,663990.0,,,,13551197.778081791,-602955368.0,-923496542.0,-297048513.0,-1537920011.0416667,44110.0,30768.0,,,,,,,67613.46520449169,158317.9408803385,126335.46169758828,,,,,,,3720598.0,,,,,,,,,,,,,,,,437322.0,432108.0,,6436.247858002895,633064.0,626606.0,,,,,,,,,36.0,102392552.20499992,34407026.59500001,10593611629.559992,3483754342.3799963,125057649.2625,867402.9449999995,207.0,26026.0,-34728094.0,15118787.0,-18052299.0,-19645388.0,-17.5,14850.0,0.0,310050.0,0.0,0.0,0.0,0.0,0.0,-1224.0,-677.0,-675.0,-677.0,368181795.24000174,5242722445.575001,5878297511.100003,85577068.71000001,5242722445.575001,378395.0,-26168043.0,6109069620.0,271189417.0,1382031389.0,601346455.0,1455553655.0,376804.0,5883.0,1069.1173993829725,8794967.0,3112917.0,1921048.0,-6261047.0,1956266.0,246692.0,4126721414.624982,4184964568.709996,-251526043.0,-249420778.0,4449928.0,207241.0,,,,,,,,,,,,,,,,,,,,,1470113.0,14881617.0,3238163.0,8571457.0,11628365.0,1418464.0,1062521590.4145012,802327752.719995,72234462390.07463,21712809735.92262,584013822.4169987,5792665.7475,689.5,94245.0,-277412595.5,21992394.5,-123994493.0,-219083637.5,-2027752.0,,,,,,,,,,,,,,,,,,,,,4280748.0,2483747.0,-9019920.5,921848.5,37582.5,3740530237.01996,3665182304.767458,-261104233.0,-257785952.5,2530930.5,269710.0,3933168292.6199546,33309803946.96092,36743991661.91264,1732853964.26255,48168275807.29572,3995052.0,-248026234.5,103274119347.0,1057140195.5,17301072442.0,3510357918.5,18916199643.5,3678669.0,72064.5,20908.64237448052,89906554.0,-38.71687116564417,1.935483870967742,10.012919896640827,447.1523131924534,19.37984496124031,865.4560900499098,139500.0,0.6234898018587336,0.7818314824680298,0.0,0.0,0.0,0.0,0.0,0.0,1.0,0.0,0.0,0.0,0.0,0.0,0.0,1.0,0.0,1.0,0.0,0.0,0.0,0.0,0.0,0.0,1.0,0.0,0.0,1.0,0.0,0.0,0.0,0.0,0.0,0.0,0.0,0.0,0.0,0.0,0.0,0.0,0.0,0.0,0.0,0.0,0.0,0.0,0.0,0.0,0.0,0.0,0.0,0.0,0.0,0.0,0.0,1.0,0.0,0.0,0.0,0.0,0.0,0.0,0.0,0.0,0.0,0.0,0.0,0.0,0.0,0.0,0.0,0.0,0.0,0.0,0.0,0.0,0.0,0.0,0.0,0.0,0.0,0.0,0.0,0.0,0.0,0.0,0.0,0.0,0.0,0.0,0.0,0.0,0.0,0.0,0.0,0.0,0.0,0.0,0.0,0.0,0.0,0.0,0.0,0.0,0.0,0.0,0.0,0.0,0.0,0.0,0.0,0.0,0.0,0.0,0.0,0.0,0.0,0.0,0.0,0.0,0.0,0.0
106413,0,0.0,1.0,1.0,1.0,0.0,225000.0,440784.0,34825.5,360000.0,0.030755,33.14794520547945,-3742.0,-4988.0,-2814.0,8.0,2.0,2.0,2.0,16.0,0.3395393724666378,0.4301411769592132,0.0444355655900398,,,,,,,,,,,,,,,,,,,,,,,,,,,,,,,,,,,,,,,,,,,,,1.0,0.0,1.0,0.0,0.0,0.0,0.0,0.0,0.0,2.0,2.0,1.0,1.0,0.0,1.0,1.0,0.0,0.0,0.0,0.0,0.0,0.0,0.0,0.0,0.0,0.0,0.0,0.0,0.0,1.0,0.0,0.0,0.0,0.0,0.0,0.0,0.0,0.0,0.0,0.0,0.0,0.0,0.0,7.0,4500.0,4253.13,103716.0,59985.0,0.0,0.0,0.0,0.0,-497.0,-254.0,-19.0,-1026.0,223.0,-16.0,2.0,8390.97,33950.52,36938.52,0.0,67901.04,10.0,-209.5,365243.0,-305.0,-35.0,-35.0,-30.0,12.5,0.0,0.0,21.5,11.0,10.0,5.0,-6.0,0.0,0.0,15.0,8390.97,7972.65,-161.0,-185.0,5.0,1.0,0.0,,,,,,,,,,,,,,,,,,,,,8362099138.5,184665474643.5,165821844654.0,52063757155.935,1863.0,1706.0,71128.0,71048.0,9141.0,506999.0,,,,,,,128644.0,663992.0,,,,13551230.926026998,-602959110.0,-923499356.0,-297048513.0,-1537924999.0416667,44110.0,30768.0,,,,,,,67613.80474386415,158318.37102151546,126335.50613315385,,,,,,,3720614.0,,,,,,,,,,,,,,,,437323.0,432109.0,1265264.0,6436.278613002894,633066.0,626608.0,,,,,,,,,17.0,102430352.20499992,34411279.72500002,10595479839.794992,3484678830.0749965,125161111.21500002,867402.9449999995,207.0,26026.0,-34739689.0,15129753.5,-18056376.0,-19649609.0,-8.0,0.0,4253.13,155268.0,0.0,0.0,0.0,0.0,0.0,-1152.0,-1029.0,-19.0,-2409.0,368206754.22000176,5242886743.095001,5878475619.120003,85577068.71000001,5242920693.615001,378423.0,-26170355.0,6110165349.0,271187103.0,1382029675.0,601344891.0,1455551963.0,376845.5,5883.0,1069.1173993829725,8796311.5,3113207.0,1921193.0,-6261697.0,1956292.0,246699.0,4127033869.334981,4185239862.644996,-251545083.0,-249439662.0,4450278.0,207277.0,,,,,,,,,,,,,,,,,,,,,1470120.0,14881840.0,3238163.0,8571468.0,11628380.0,1418466.0,1062526090.4145012,802332005.849995,72234566106.07463,21712869720.92262,584013822.4169987,5792665.7475,689.5,94245.0,-277413092.5,21992140.5,-123994512.0,-219084663.5,-2027768.0,,,,,,,,,,,,,,,,,,,,,4280758.0,2483752.0,-9019926.5,921848.5,37582.5,3740538627.989959,3665190277.4174585,-261104394.0,-257786137.5,2530935.5,269711.0,3933176683.589953,33309837897.480927,36744028600.43264,1732853964.26255,48168343708.33573,3995062.0,-248026444.0,103274484590.0,1057139890.5,17301072407.0,3510357883.5,18916199613.5,3678681.5,72064.5,20908.64237448052,89906575.5,-112.8878419704108,1.95904,6.460783046905285,214.16168242330696,12.65693242020933,419.55130233455526,112500.0,0.6234898018587336,0.7818314824680298,0.0,0.0,0.0,0.0,0.0,0.0,1.0,0.0,0.0,0.0,0.0,0.0,0.0,1.0,0.0,0.0,0.0,0.0,1.0,0.0,1.0,0.0,0.0,0.0,0.0,1.0,0.0,0.0,0.0,0.0,0.0,0.0,0.0,0.0,0.0,0.0,0.0,0.0,1.0,0.0,0.0,0.0,0.0,0.0,0.0,0.0,0.0,0.0,0.0,0.0,0.0,0.0,1.0,0.0,0.0,0.0,0.0,0.0,0.0,0.0,0.0,0.0,0.0,0.0,0.0,0.0,0.0,0.0,0.0,0.0,0.0,0.0,0.0,0.0,0.0,0.0,0.0,0.0,0.0,0.0,0.0,0.0,0.0,0.0,0.0,0.0,0.0,0.0,0.0,0.0,0.0,0.0,0.0,0.0,0.0,0.0,0.0,0.0,0.0,0.0,0.0,0.0,0.0,0.0,0.0,0.0,0.0,0.0,0.0,0.0,0.0,0.0,0.0,0.0,0.0,0.0,0.0,0.0,0.0,0.0
106426,0,0.0,1.0,1.0,1.0,1.0,360000.0,781920.0,42547.5,675000.0,0.010556,45.7890410958904,-2266.0,-5456.0,-255.0,7.0,2.0,3.0,3.0,17.0,0.6706220225690968,0.5760315933003037,0.2512394458905693,,,,,,,,,,,,,,,,,,,,,,,,,,,,,,,,,,,,,,,,,,,,,0.0,0.0,0.0,0.0,-519.0,0.0,0.0,0.0,0.0,1.0,3.0,1.0,1.0,0.0,1.0,0.0,0.0,0.0,0.0,0.0,0.0,1.0,1.0,0.0,0.0,0.0,0.0,0.0,0.0,1.0,0.0,0.0,0.0,0.0,0.0,0.0,0.0,0.0,0.0,0.0,0.0,0.0,0.0,2.0,48458.25,117688.5,984413.25,114993.0,0.0,0.0,0.0,0.0,-214.5,5822.5,-20.0,,16.0,-4.5,4.0,15017.85,122640.75,125147.25,8136.0,162711.0,12.0,-375.0,365243.0,-487.0,-157.0,-157.0,-152.0,18.0,0.0,0.0505539502859143,49.5,13.0,12.0,6.0,-11.0,0.0,0.0,13.0,8521.155,8521.155,-314.0,-307.0,7.0,1.0,0.0,,,,,,,,,,,,,,,,,,,,,8362141686.0,184666256563.5,165822519654.0,52064117155.935,1863.0,1706.0,71128.0,71049.0,9141.0,507002.0,,,,,,,128645.0,663994.0,,,,13551276.715068094,-602961376.0,-923499611.0,-297049032.0,-1537930455.0416667,44110.0,30768.0,,,,,,,67614.47536588673,158318.94705310874,126335.75737259976,,,,,,,3720631.0,,,,,,,,,,,,,,,,437323.0,432109.0,1265271.0,6436.289169002895,633069.0,626611.0,,,,,,,,,8.0,102584717.59499992,34604639.460000016,10622528174.114992,3496720452.4799967,125245222.69500002,867680.1899999995,207.0,26038.0,-34798256.0,15274436.0,-18084773.0,,-3.5,89716.5,117688.5,1856326.5,114993.0,0.0,0.0,0.0,0.0,-366.0,10594.0,-22.0,,369102524.2200017,5257824573.375,5895078846.390003,85698509.22000001,5257865858.625,379487.0,-26224428.5,6125867828.0,271875908.0,1387115145.0,603148311.0,1460272211.0,377716.0,5897.0,1071.3470834267573,8805560.5,3120746.0,1925714.0,-6276308.0,1956292.0,246699.0,4135982387.174997,4193995812.435011,-252039621.0,-249928949.0,4460278.0,207736.0,,,,,,,,,,,,,,,,,,,,,1470122.0,14881856.0,3238163.0,8571481.0,11628393.0,1418470.0,1062574548.6645012,802449694.349995,72235550519.32463,21712984713.92262,584013822.4169987,5792665.7475,689.5,94245.0,-277413307.0,21997963.0,-123994532.0,,-2027772.5,,,,,,,,,,,,,,,,,,,,,4280770.0,2483758.0,-9019937.5,921848.5,37582.5,3740547149.14496,3665198798.5724583,-261104708.0,-257786444.5,2530942.5,269712.0,3933191701.439953,33309960538.230927,36744153747.68264,1732862100.26255,48168506419.33573,3995074.0,-248026819.0,103274849833.0,1057139403.5,17301072250.0,3510357726.5,18916199461.5,3678699.5,72064.5,20908.69292843081,89906625.0,-49.48782384969785,2.172,8.461131676361713,387.42710604666667,18.377578001057643,841.4916743333598,180000.0,-0.9009688679024191,-0.433883739117558,0.0,0.0,0.0,0.0,0.0,0.0,1.0,0.0,1.0,0.0,0.0,0.0,0.0,0.0,0.0,1.0,0.0,0.0,0.0,0.0,0.0,1.0,0.0,0.0,0.0,1.0,0.0,0.0,0.0,0.0,0.0,0.0,0.0,0.0,0.0,0.0,0.0,0.0,0.0,0.0,1.0,0.0,0.0,0.0,0.0,0.0,0.0,0.0,0.0,0.0,0.0,0.0,0.0,0.0,0.0,1.0,0.0,0.0,0.0,0.0,0.0,0.0,0.0,0.0,0.0,0.0,0.0,0.0,0.0,0.0,0.0,0.0,0.0,0.0,0.0,0.0,0.0,0.0,0.0,0.0,0.0,0.0,0.0,0.0,0.0,0.0,0.0,0.0,0.0,0.0,0.0,0.0,0.0,0.0,0.0,0.0,0.0,0.0,0.0,0.0,0.0,0.0,0.0,0.0,0.0,0.0,0.0,0.0,0.0,0.0,0.0,0.0,0.0,0.0,0.0,0.0,0.0,0.0,0.0,0.0
106427,0,0.0,0.0,0.0,1.0,0.0,225000.0,409500.0,30748.5,409500.0,0.00963,61.58904109589041,,-5192.0,-42.0,,2.0,2.0,2.0,12.0,,0.6015341668422965,0.4436153084085652,0.0165,,0.9737,,,0.0,0.069,0.0417,,0.0236,,0.0127,,0.0,0.0168,,0.9737,,,0.0,0.069,0.0417,,0.0241,,0.0133,,0.0,0.0167,,0.9737,,,0.0,0.069,0.0417,,0.024,,0.013,,0.0,0.01,1.0,0.0,0.0,0.0,0.0,-566.0,0.0,0.0,0.0,0.0,1.0,2.0,1.0,0.0,0.0,1.0,0.0,0.0,0.0,0.0,0.0,0.0,0.0,0.0,0.0,1.0,0.0,0.0,0.0,0.0,0.0,0.0,0.0,0.0,0.0,0.0,0.0,0.0,0.0,0.0,0.0,0.0,0.0,0.0,11.0,0.0,0.0,90000.0,30019.5,0.0,0.0,0.0,0.0,-752.0,-313.0,-491.0,-491.0,350.0,-20.0,11.0,6636.87,90000.0,98910.0,0.0,101268.0,24.0,-336.0,365243.0,-411.0,182384.0,459.0,182385.5,11.0,0.5,0.0,10.0,15.0,48.0,41.0,-8.0,0.0,0.0,13.0,9332.1,9332.1,-245.0,-197.0,4.0,1.0,0.0,,,,,,,,,,,,,,,,,,,,,8362172434.5,184666666063.5,165822929154.0,52064342155.935,1863.0,1706.0,71128.0,71050.0,9141.0,507004.0,17841.414600002307,17903.735399999125,17354.351499997974,,,,128645.0,663996.0,,,,13551338.30410919,,-923499653.0,-297049598.0,-1537935647.0416667,44110.0,30768.0,11369.553999999196,11245.419999998989,10729.224999997286,22930.092300009863,22851.70080000983,22236.241600008383,,158319.5485872756,126336.20098790816,35065.563900028064,35005.640100028504,34450.428300028914,,,,3720643.0,8311.285000000169,8416.059300000079,8139.20350000023,,,,16498.394899999712,16683.99649999969,16280.338999999698,,,,3920.174900000124,3903.425100000162,3735.965300000161,437323.0,432109.0,,6436.298799002893,633071.0,626613.0,,16362.879599999796,154470.22289999074,154472.96499999033,154364.6575999871,,,,25.0,102635272.84499992,34604639.460000016,10623989920.364992,3496868524.9799967,125245222.69500002,867693.6899999995,207.0,26158.0,-34806497.0,15275803.0,-18088011.0,-19683132.0,-12.0,0.0,0.0,78750.0,0.0,0.0,0.0,0.0,0.0,-1163.0,-1447.0,-592.0,-770.0,369149560.2000017,5258381837.625,5895661711.140003,85706645.22000001,5258503337.625,379583.0,-26227383.0,6126415692.5,271875229.5,1387297291.5,603148667.5,1460454360.5,377810.0,5897.5,1071.397637377043,8807457.0,3121004.0,1925909.0,-6276470.0,1956292.0,246699.0,4136140479.464998,4194153904.725011,-252043650.0,-249932764.0,4460353.0,207750.0,,,,,,,,,,,,,,,,,,,,,1470133.0,14882206.0,3238163.0,8571496.0,11628406.0,1418481.0,1062574548.6645012,802449694.349995,72235640519.32463,21713014733.42262,584013822.4169987,5792665.7475,689.5,94245.0,-277414059.0,21997650.0,-123995023.0,-219085154.5,-2027792.5,,,,,,,,,,,,,,,,,,,,,4280818.0,2483799.0,-9019945.5,921848.5,37582.5,3740556481.2449584,3665208130.672458,-261104953.0,-257786641.5,2530946.5,269713.0,3933198338.3099537,33310050538.230927,36744252657.68264,1732862100.26255,48168607687.33573,3995098.0,-248027155.0,103275215076.0,1057138992.5,17301254634.0,3510358185.5,18916381847.0,3678710.5,72065.0,20908.69292843081,89906635.0,,1.82,7.317430118542367,450.67350428721215,13.317722815747109,820.2257778027259,112500.0,-0.2225209339563143,0.9749279121818236,0.0,0.0,0.0,0.0,0.0,0.0,1.0,0.0,0.0,1.0,0.0,0.0,0.0,0.0,0.0,0.0,0.0,0.0,1.0,0.0,1.0,0.0,0.0,0.0,0.0,1.0,0.0,0.0,0.0,0.0,0.0,0.0,0.0,0.0,0.0,0.0,0.0,0.0,0.0,0.0,0.0,0.0,0.0,0.0,0.0,0.0,0.0,0.0,0.0,0.0,0.0,0.0,0.0,0.0,0.0,0.0,0.0,0.0,0.0,0.0,0.0,0.0,0.0,0.0,0.0,0.0,0.0,0.0,0.0,0.0,0.0,0.0,0.0,0.0,0.0,0.0,0.0,0.0,0.0,0.0,0.0,0.0,0.0,0.0,0.0,0.0,0.0,0.0,0.0,0.0,0.0,0.0,0.0,0.0,0.0,0.0,0.0,0.0,0.0,0.0,0.0,0.0,0.0,0.0,0.0,1.0,0.0,0.0,0.0,0.0,1.0,0.0,0.0,0.0,0.0,0.0,0.0,0.0,1.0,0.0
106428,0,0.0,1.0,0.0,1.0,0.0,270000.0,360000.0,23004.0,360000.0,0.018634,53.61643835616438,-329.0,-1876.0,-3112.0,,2.0,2.0,2.0,11.0,0.4614947433622899,0.6519367684419135,0.4276573700350293,,,,,,,,,,,,,,,,,,,,,,,,,,,,,,,,,,,,,,,,,,,,,0.0,0.0,0.0,0.0,0.0,0.0,0.0,0.0,0.0,1.0,1.0,1.0,1.0,1.0,1.0,0.0,0.0,1.0,1.0,1.0,1.0,1.0,1.0,0.0,0.0,0.0,0.0,0.0,0.0,1.0,0.0,0.0,0.0,0.0,0.0,0.0,0.0,0.0,0.0,0.0,0.0,0.0,0.0,4.0,7947.0,4277.07,73485.0,23503.275,9907.605,0.0,0.0,0.0,-963.5,-563.0,-48.5,-1653.0,155.0,-35.0,2.0,3375.0,29025.0,62775.0,0.0,58050.0,0.0,-2358.0,-2876.0,-2825.0,-2217.0,365243.0,365243.0,14.0,0.0,0.0,30.0,0.0,,,,,,116.0,64.53,64.53,-1774.5,-1774.5,57.5,0.0,94.0,0.0,0.0,0.0,0.0,0.0,0.0,0.0,64.53,0.0,0.0,0.0,0.0,0.0,0.0,0.0,0.0,21.0,-47.5,0.0,0.0,8362195438.5,184667026063.5,165823289154.0,52064612155.935,1863.0,1706.0,71128.0,71051.0,9141.0,507005.0,,,,,,,128645.0,663998.0,,,,13551391.920547543,-602961705.0,-923502765.0,-297049598.0,-1537937523.0416667,44110.0,30768.0,,,,,,,67614.93686063008,158320.20052404405,126336.6286452782,,,,,,,3720654.0,,,,,,,,,,,,,,,,437323.0,432109.0,,6436.317433002893,633073.0,626615.0,,,,,,,,,32.5,102670152.34499992,34608916.530000016,10625036129.864992,3497256325.754997,125265037.90500002,867693.6899999995,207.0,26158.0,-34810814.0,15274205.5,-18089896.5,-19685566.0,-15.75,7947.0,8554.14,79470.0,0.0,0.0,0.0,0.0,0.0,-2661.0,-2357.0,-90.0,-1653.0,369172922.49000174,5258843033.625,5896315997.640003,85706645.22000001,5258872058.625,379679.0,-26233160.0,6126595438.0,271872261.0,1387477696.0,603514472.0,1461002225.0,377889.5,5898.0,1071.397637377043,8807602.5,,,,,,4136264145.4500046,4194277406.145017,-252147384.0,-250036085.0,4463502.0,207756.0,3855545945.459951,10363113000.0,322975349.505,492061298.2199997,13842806.040000005,154714050.22500026,218737420.9199992,542556280.1699889,501666415.0649963,3701259864.225008,3841460962.964936,3841643897.5049353,16685.0,44284.0,208.0,27391.0,1267729.0,-2247154.5,846989.0,2110.0,1470137.0,14882361.0,3238257.0,8571496.0,11628522.0,1418483.0,1062582495.6645012,802453971.4199951,72235714004.32463,21713038236.69762,584023730.0219988,5792665.7475,689.5,94245.0,-277415022.5,21997087.0,-123995071.5,-219086807.5,-2027827.5,5930643232.4849615,18758160000.0,198925482.825,448675961.6699976,1948107.735,257302085.15250084,309507617.83499867,637399247.8274977,459723171.2399992,5715535097.655036,5893870547.025,5894113729.77,13396.5,80994.5,44.0,70493.0,972812.0,-1701523.5,177423.0,6755.0,,,,,,3740556545.77496,3665208195.2024593,-261106727.5,-257788416.0,2531004.0,269713.0,3933201713.3099537,33310079563.230927,36744315432.68264,1732862100.26255,48168665737.33573,3995098.0,-248029513.0,103275212200.0,1057136167.5,17301252417.0,3510723428.5,18916747090.0,3678724.5,72065.0,20908.69292843081,89906665.0,-6.136177823198774,1.3333333333333333,11.737089201877936,629.3009196732909,15.64945226917058,839.0678928977211,135000.0,0.6234898018587336,0.7818314824680298,0.0,0.0,0.0,0.0,0.0,0.0,1.0,0.0,0.0,0.0,0.0,0.0,0.0,1.0,0.0,0.0,0.0,0.0,1.0,0.0,1.0,0.0,0.0,0.0,0.0,1.0,0.0,0.0,0.0,0.0,0.0,0.0,0.0,0.0,0.0,0.0,0.0,0.0,1.0,0.0,0.0,0.0,0.0,0.0,0.0,0.0,0.0,0.0,0.0,0.0,0.0,0.0,0.0,1.0,0.0,0.0,0.0,0.0,0.0,0.0,0.0,0.0,0.0,0.0,0.0,0.0,0.0,0.0,0.0,0.0,0.0,0.0,0.0,0.0,0.0,0.0,0.0,0.0,0.0,0.0,0.0,0.0,0.0,0.0,0.0,0.0,0.0,0.0,0.0,0.0,0.0,0.0,0.0,0.0,0.0,0.0,0.0,0.0,0.0,0.0,0.0,0.0,0.0,0.0,0.0,0.0,0.0,0.0,0.0,0.0,0.0,0.0,0.0,0.0,0.0,0.0,0.0,0.0,0.0,0.0
106434,0,0.0,1.0,0.0,1.0,0.0,180000.0,296280.0,12226.5,225000.0,0.008019,29.531506849315072,-1368.0,-2330.0,-2729.0,,2.0,2.0,2.0,10.0,,0.6347490508329036,,,,,,,,,,,,,,,,,,,,,,,,,,,,,,,,,,,,,,,,,,,,,,0.0,0.0,0.0,0.0,-183.0,,,,,,,1.0,1.0,1.0,1.0,0.0,0.0,1.0,1.0,0.0,1.0,1.0,0.0,0.0,0.0,0.0,0.0,0.0,0.0,0.0,0.0,0.0,0.0,0.0,0.0,0.0,0.0,0.0,0.0,0.0,0.0,0.0,0.0,0.0,,,,,,,,,,,,,0.0,,0.0,,,,,,,,,,,,,,,,,0.0,,,,,,0.0,,,,,,,0.0,,,,,,,,,,,,,,,,,,,,,8362207665.0,184667322343.5,165823514154.0,52064792155.935,,,,,,,,,,,,,128645.0,664000.0,,,,13551421.452054394,-602963073.0,-923505494.0,-297049781.0,-1537939853.0416667,44110.0,30768.0,,,,,,,,158320.83527309488,,,,,,,,3720664.0,,,,,,,,,,,,,,,,437323.0,432109.0,,6436.325452002893,633075.0,626617.0,,,,,,,,,,,,,,,,,,,,,,,,,,,,,,,,,,,,,,,,,,,,,,,,,,,,,,,,,,,,,,,,,,,,,,,,,,,,,,,,,,1470137.0,14882361.0,3238257.0,8571496.0,11628522.0,1418483.0,,,,,,,,,,,,,,,,,,,,,,,,,,,,,,,,,,,,,,,,,,,,,,,,,,,,,,,,,,,,,-46.3234066239911,1.646,14.722119985277882,434.766387181672,24.232609495767388,715.6254733010321,90000.0,0.6234898018587336,0.7818314824680298,0.0,0.0,0.0,0.0,0.0,0.0,1.0,0.0,1.0,0.0,0.0,0.0,0.0,0.0,0.0,1.0,0.0,0.0,0.0,0.0,1.0,0.0,0.0,0.0,0.0,1.0,0.0,0.0,0.0,0.0,0.0,0.0,0.0,0.0,0.0,0.0,1.0,0.0,0.0,0.0,0.0,0.0,0.0,0.0,0.0,0.0,0.0,0.0,0.0,0.0,0.0,0.0,0.0,0.0,0.0,0.0,0.0,0.0,0.0,0.0,0.0,0.0,0.0,0.0,0.0,0.0,0.0,0.0,0.0,0.0,0.0,0.0,0.0,0.0,0.0,0.0,0.0,0.0,0.0,0.0,0.0,0.0,0.0,0.0,0.0,0.0,0.0,0.0,0.0,0.0,0.0,0.0,0.0,0.0,0.0,1.0,0.0,0.0,0.0,0.0,0.0,0.0,0.0,0.0,0.0,0.0,0.0,0.0,0.0,0.0,0.0,0.0,0.0,0.0,0.0,0.0,0.0,0.0,0.0,0.0
106438,0,0.0,0.0,0.0,0.0,0.0,202500.0,1350000.0,55714.5,1350000.0,0.009549,43.630136986301366,-2339.0,-2971.0,-4828.0,,2.0,2.0,2.0,18.0,0.7086912623814907,0.5354606703432122,0.4083588531230431,0.0124,0.0327,0.9767,0.6804,0.002,0.0,0.1034,0.0417,0.0417,0.0184,0.0092,0.0091,0.0039,0.0022,0.0126,0.034,0.9767,0.6929,0.002,0.0,0.1034,0.0417,0.0417,0.0188,0.0101,0.0094,0.0039,0.0023,0.0125,0.0327,0.9767,0.6847,0.002,0.0,0.1034,0.0417,0.0417,0.0187,0.0094,0.0092,0.0039,0.0022,0.0076,1.0,7.0,0.0,7.0,0.0,-439.0,0.0,0.0,0.0,0.0,0.0,9.0,1.0,1.0,1.0,1.0,0.0,0.0,0.0,0.0,0.0,0.0,1.0,1.0,0.0,1.0,0.0,0.0,0.0,0.0,0.0,0.0,0.0,0.0,0.0,0.0,0.0,0.0,0.0,0.0,0.0,0.0,0.0,0.0,5.0,0.0,201.915,38250.0,0.0,0.0,0.0,0.0,0.0,-1240.0,-869.5,-994.0,-1168.0,203.0,-20.0,13.0,14818.1625,133633.8,118467.0,10305.0,174890.25,12.0,-515.0,365243.0,-703.0,-328.0,-298.0,-323.0,13.0,0.0,0.1738434732946709,12.0,68.0,12.0,6.0,-20.5,0.0,0.0,64.0,16672.68,16672.68,-563.5,-553.0,5.0,1.0,14.0,0.0,270000.0,,0.0,,,0.0,,0.0,0.0,0.0,0.0,,0.0,,,0.0,-7.5,0.0,0.0,8362263379.5,184668672343.5,165824864154.0,52064994655.935,1863.0,1706.0,71128.0,71051.0,9141.0,507014.0,17841.427000002306,17903.74789999912,17354.364099997973,11317.477000000095,11255.1833000001,11202.157600000064,128645.0,664002.0,4146.577000000115,4144.1505000000125,3954.5917000000927,13551465.082191382,-602965412.0,-923510322.0,-297050220.0,-1537942824.0416667,44110.0,30768.0,11369.553999999196,11245.419999998989,10729.224999997286,22930.195700009863,22851.80420000983,22236.345000008383,67615.64555189246,158321.37073376524,126337.03700413131,35065.60560002806,35005.6818000285,34450.47000002891,22994.422999995848,22967.399399995436,22613.62189999567,3720682.0,8311.303400000172,8416.07800000008,8139.2223000002305,9835.04360000072,9950.16100000215,10310.587899999628,16498.40399999971,16684.00569999969,16280.3483999997,830.1736000001773,815.336100000046,761.2542000000129,3920.177100000124,3903.427300000162,3735.967600000162,437330.0,432116.0,,6436.335001002894,633077.0,626619.0,,16362.887199999795,154471.19959999074,154473.94169999033,154365.6342999871,77749.39159999632,78087.82470000659,78490.10250000673,41.0,102994478.63999993,34686042.34500001,10655455975.379992,3506472058.949997,125274015.90000002,867895.7849999996,207.0,26164.0,-34883906.0,15289993.0,-18128679.0,-19723497.0,-20.0,0.0,0.0,38250.0,0.0,0.0,0.0,0.0,0.0,-1240.0,-927.0,-994.0,-1168.0,369850497.84000194,5269167707.4,5908010107.140003,85850185.99500002,5269777457.4,380462.0,-26270352.0,6137003569.5,272206338.0,1389463363.0,604230080.0,1463354237.0,378495.0,5911.0,1073.1282778501254,8824558.0,3126065.0,1929652.0,-6283194.0,1956307.0,246714.0,4143880743.120001,4202276303.1150174,-252461603.5,-250347812.0,4469808.0,208048.5,3859550395.559952,10380955500.0,,492556298.2199997,,,218939436.0899992,,502308137.654997,3705139963.620008,3845451699.944936,3845634634.4849353,,44295.0,,,1269006.0,-2250230.5,846989.0,2110.0,1470142.0,14882564.0,3238271.0,8571564.0,11628586.0,1418496.0,1062582495.6645012,802454173.334995,72235752254.32463,21713038236.69762,584023730.0219988,5792665.7475,689.5,94245.0,-277416262.5,21996217.5,-123996065.5,-219087975.5,-2027847.5,5930643232.4849615,18758430000.0,,448675961.6699976,,,309507617.83499867,,459723171.2399992,5715535097.655036,5893870547.025,5894113729.77,,80994.5,,,972812.0,-1701531.0,177423.0,6755.0,4280830.0,2483805.0,-9019966.0,921848.5,37582.5,3740573218.4549584,3665224867.882458,-261107291.0,-257788969.0,2531009.0,269714.0,3933216531.472454,33310213197.03092,36744433899.68264,1732872405.26255,48168840627.58573,3995110.0,-248030028.0,103275577443.0,1057135464.5,17301252089.0,3510723130.5,18916746767.0,3678737.5,72065.0,20908.8667719041,89906677.0,-53.60973312401883,6.666666666666668,3.63460140537921,158.57815720729843,24.2306760358614,1057.1877147153227,101250.0,-0.9009688679024191,0.4338837391175582,0.0,0.0,0.0,0.0,0.0,0.0,1.0,0.0,1.0,0.0,0.0,0.0,0.0,0.0,0.0,0.0,0.0,0.0,1.0,0.0,1.0,0.0,0.0,0.0,0.0,1.0,0.0,0.0,0.0,0.0,0.0,0.0,0.0,0.0,0.0,0.0,0.0,0.0,1.0,0.0,0.0,0.0,0.0,0.0,0.0,0.0,0.0,0.0,0.0,0.0,0.0,0.0,0.0,0.0,0.0,0.0,0.0,0.0,0.0,0.0,0.0,0.0,0.0,0.0,1.0,0.0,0.0,0.0,0.0,0.0,0.0,0.0,0.0,0.0,0.0,0.0,0.0,0.0,0.0,0.0,0.0,0.0,0.0,0.0,0.0,0.0,0.0,0.0,0.0,0.0,0.0,0.0,0.0,0.0,0.0,0.0,0.0,0.0,0.0,0.0,0.0,0.0,0.0,0.0,0.0,0.0,0.0,0.0,1.0,0.0,1.0,0.0,0.0,0.0,0.0,0.0,0.0,0.0,1.0,0.0
106440,0,0.0,0.0,0.0,0.0,2.0,67500.0,67500.0,4509.0,67500.0,0.035792,33.484931506849314,-665.0,-5766.0,-4062.0,,4.0,2.0,2.0,9.0,,0.6269373399883886,0.4956658291397297,,,,,,,,,,,,,,,,,,,,,,,,,,,,,,,,,,,,,,,,,,,,,2.0,0.0,2.0,0.0,-2089.0,0.0,0.0,0.0,0.0,1.0,2.0,1.0,1.0,1.0,1.0,1.0,0.0,0.0,0.0,0.0,0.0,0.0,0.0,0.0,1.0,0.0,0.0,0.0,0.0,0.0,0.0,0.0,0.0,0.0,0.0,0.0,0.0,0.0,0.0,0.0,0.0,0.0,0.0,9.0,3716.145,0.0,89185.5,0.0,0.0,0.0,0.0,0.0,-656.0,-186.5,-21.0,-781.0,258.0,-15.5,5.0,3827.025,31725.0,31378.5,1122.75,32098.5,10.0,-555.0,365243.0,-840.0,-510.0,-510.0,-508.0,13.0,0.0,0.0500005920102299,100.0,39.0,10.0,5.0,-24.0,0.0,0.0,36.0,3965.895,3965.895,-744.0,-735.0,5.5,1.0,0.0,,,,,,,,,,,,,,,,,,,,,8362267888.5,184668739843.5,165824931654.0,52065062155.935,1863.0,1706.0,71128.0,71052.0,9141.0,507016.0,,,,,,,128647.0,664006.0,,,,13551498.567122888,-602966077.0,-923514384.0,-297052309.0,-1537948590.0416667,44110.0,30768.0,,,,,,,,158321.9976711052,126337.53266996043,,,,,,,3720691.0,,,,,,,,,,,,,,,,437332.0,432118.0,,6436.370793002893,633079.0,626621.0,,,,,,,,,22.0,103003208.63999993,34686042.34500001,10656313336.934992,3506739840.449997,125274015.90000002,867895.7849999996,207.0,26164.0,-34889850.0,15287945.0,-18131977.0,-19726590.0,-10.5,0.0,2933.145,42909.75,0.0,0.0,0.0,0.0,0.0,-1112.0,-1189.5,-781.0,-1582.0,369976496.6475018,5271287303.7,5910127051.140003,85884579.04500002,5271303166.2,380556.0,-26278218.0,6139377649.0,272203835.0,1389642919.0,604228672.0,1463533815.0,378626.0,5911.0,1073.611888417026,8832086.0,3126720.0,1930011.0,-6285301.0,1956307.0,246714.0,4144635972.337494,4203031532.3325095,-252518082.0,-250403759.5,4470115.5,208108.5,,,,,,,,,,,,,,,,,,,,,1470151.0,14882822.0,3238271.0,8571603.0,11628622.0,1418501.0,1062586211.8095012,802454173.334995,72235841439.82463,21713038236.69762,584023730.0219988,5792665.7475,689.5,94245.0,-277416918.5,21996031.0,-123996086.5,-219088756.5,-2027863.0,,,,,,,,,,,,,,,,,,,,,4280840.0,2483810.0,-9019990.0,921848.5,37582.5,3740577184.3499584,3665228833.777458,-261108035.0,-257789704.0,2531014.5,269715.0,3933220358.4974537,33310244922.03092,36744465278.18264,1732873528.01255,48168872726.08573,3995120.0,-248030583.0,103275942686.0,1057134624.5,17301251579.0,3510722620.5,18916746259.0,3678750.5,72065.0,20908.916772496108,89906777.0,-19.859679266895768,1.0,14.97005988023952,501.2714297432533,14.97005988023952,501.2714297432533,16875.0,-0.9009688679024191,0.4338837391175582,0.0,0.0,0.0,0.0,0.0,0.0,1.0,0.0,0.0,0.0,0.0,0.0,0.0,1.0,0.0,0.0,0.0,0.0,1.0,0.0,1.0,0.0,0.0,0.0,0.0,1.0,0.0,0.0,0.0,0.0,0.0,0.0,0.0,0.0,0.0,0.0,0.0,0.0,0.0,0.0,0.0,0.0,0.0,0.0,1.0,0.0,0.0,0.0,0.0,0.0,0.0,0.0,0.0,0.0,0.0,0.0,0.0,0.0,0.0,0.0,0.0,0.0,0.0,0.0,0.0,0.0,0.0,0.0,0.0,0.0,0.0,0.0,0.0,0.0,0.0,0.0,0.0,0.0,0.0,0.0,0.0,0.0,0.0,0.0,0.0,0.0,0.0,0.0,0.0,0.0,1.0,0.0,0.0,0.0,0.0,0.0,0.0,0.0,0.0,0.0,0.0,0.0,0.0,0.0,0.0,0.0,0.0,0.0,0.0,0.0,0.0,0.0,0.0,0.0,0.0,0.0,0.0,0.0,0.0,0.0
106441,0,0.0,0.0,0.0,0.0,0.0,157500.0,495000.0,31635.0,495000.0,0.072508,26.304109589041094,-752.0,-4402.0,-790.0,,2.0,1.0,1.0,14.0,0.6699245897234408,0.6810341404494202,,0.3062,0.2154,0.9851,0.7959999999999999,0.1547,0.64,0.2759,0.5417,0.0417,0.0,0.2467,0.4762,0.0135,0.0097,0.3036,0.1696,0.9851,0.804,0.1172,0.4834,0.2069,0.5417,0.0417,0.0,0.2608,0.3723,0.0078,0.0077,0.3092,0.2154,0.9851,0.7987,0.1557,0.64,0.2759,0.5417,0.0417,0.0,0.251,0.4848,0.0136,0.0099,0.2826,1.0,0.0,0.0,0.0,0.0,-521.0,0.0,0.0,0.0,0.0,0.0,0.0,1.0,1.0,1.0,1.0,1.0,0.0,0.0,0.0,0.0,0.0,0.0,0.0,0.0,1.0,0.0,0.0,0.0,0.0,0.0,0.0,0.0,0.0,0.0,0.0,0.0,0.0,0.0,0.0,0.0,0.0,0.0,0.0,2.0,46881.0,0.0,1707750.0,1365259.0499999998,0.0,0.0,0.0,0.0,-524.5,1153.0,-51.0,,35.0,-8.0,6.0,28791.36,0.0,0.0,8847.0,836235.0,35.0,-420.0,365243.0,-488.0,-248.0,-218.0,-240.0,10.0,0.0,0.1089090909090909,-1.0,10.0,10.0,5.5,-12.5,0.0,0.0,9.0,8847.72,8847.72,-379.0,-368.0,5.0,1.0,0.0,,,,,,,,,,,,,,,,,,,,,8362299523.5,184669234843.5,165825426654.0,52065219655.935,1863.0,1706.0,71128.0,71052.0,9141.0,507016.0,17841.733200002305,17904.057099999125,17354.667699997968,11317.692400000094,11255.398700000098,11202.327200000063,128647.0,664008.0,4146.731700000115,4144.306200000012,3954.708900000093,13551524.871232474,-602966829.0,-923515174.0,-297052830.0,-1537952992.0416667,44110.0,30768.0,11370.193999999196,11246.059999998986,10729.708399997286,22930.471600009863,22852.08010000983,22236.551900008384,67616.31547648218,158322.67870524563,,35066.14730002806,35006.2235000285,34451.01170002891,22994.464699995853,22967.441099995434,22613.66359999567,3720705.0,8311.303400000172,8416.07800000008,8139.2223000002305,9835.29030000072,9950.41200000215,10310.848699999628,16498.880199999712,16684.490499999687,16280.7206999997,830.1871000001773,815.349700000046,761.262000000013,3920.186800000124,3903.437200000162,3735.975300000162,437332.0,432118.0,,6436.443301002893,633080.0,626622.0,,16363.169799999798,154472.18469999073,154474.92679999032,154366.6193999871,77750.18759999632,78088.62340000659,78490.90650000673,17.5,103086365.53499992,34700055.70500002,10659132926.684992,3508712004.1049967,125274015.90000002,867895.7849999996,207.0,26164.0,-34894855.5,15287219.0,-18134874.5,,-8.25,50242.5,0.0,1957500.0,1516708.89,0.0,0.0,0.0,0.0,-635.0,1208.0,-41.0,,370034349.2550018,5272969718.7,5911992301.140003,85897257.79500002,5272969718.7,380636.0,-26282348.5,6140108135.0,272201290.0,1389640884.0,604226667.0,1463531807.0,378694.5,5911.0,1073.87217029984,8832942.5,3126964.5,1930126.0,-6286149.0,1956307.0,246714.0,4144735829.4749937,4203128666.1600094,-252543367.0,-250428868.0,4470243.0,208131.0,,,,,,,,,,,,,,,,,,,,,1470153.0,14882857.0,3238271.0,8571613.0,11628631.0,1418507.0,1062633092.8095012,802454173.334995,72237549189.82463,21714403495.74762,584023730.0219988,5792665.7475,689.5,94245.0,-277417443.0,21997184.0,-123996137.5,,-2027871.0,,,,,,,,,,,,,,,,,,,,,4280850.0,2483815.5,-9020002.5,921848.5,37582.5,3740586032.0699577,3665237681.4974585,-261108414.0,-257790072.0,2531019.5,269716.0,3933249149.857455,33310244922.03092,36744465278.18264,1732882375.01255,48169708961.08573,3995155.0,-248031003.0,103276307929.0,1057134136.5,17301251331.0,3510722402.5,18916746019.0,3678760.5,72065.0,20909.02568158702,89906776.0,-28.58868867826268,3.1428571428571432,4.978662873399715,130.95929382879638,15.647226173541965,411.58635203336,78750.0,0.6234898018587336,0.7818314824680298,0.0,0.0,0.0,0.0,0.0,0.0,1.0,0.0,1.0,0.0,0.0,0.0,0.0,0.0,0.0,0.0,0.0,0.0,1.0,0.0,1.0,0.0,0.0,0.0,0.0,0.0,1.0,0.0,0.0,0.0,0.0,0.0,0.0,1.0,0.0,0.0,0.0,0.0,0.0,0.0,0.0,0.0,0.0,0.0,0.0,0.0,0.0,0.0,0.0,0.0,0.0,0.0,0.0,0.0,0.0,0.0,0.0,0.0,0.0,0.0,0.0,0.0,0.0,0.0,0.0,0.0,0.0,0.0,0.0,0.0,0.0,0.0,0.0,0.0,0.0,0.0,0.0,0.0,0.0,0.0,0.0,1.0,0.0,0.0,0.0,0.0,0.0,0.0,0.0,0.0,0.0,0.0,0.0,0.0,0.0,0.0,0.0,0.0,0.0,0.0,0.0,0.0,0.0,0.0,0.0,0.0,0.0,0.0,1.0,0.0,1.0,0.0,0.0,0.0,0.0,0.0,0.0,1.0,0.0,0.0
106452,0,0.0,1.0,0.0,1.0,0.0,135000.0,495000.0,30411.0,495000.0,0.026392,23.55342465753425,-1106.0,-8567.0,-1022.0,,1.0,2.0,2.0,14.0,0.2440736621523076,0.4959728685665044,0.4436153084085652,0.0351,0.0243,0.9816,,,0.04,0.0345,0.3333,,0.0483,,0.0324,,0.0085,0.0357,0.0252,0.9816,,,0.0403,0.0345,0.3333,,0.0494,,0.0338,,0.0091,0.0354,0.0243,0.9816,,,0.04,0.0345,0.3333,,0.0491,,0.033,,0.0087,0.0587,1.0,1.0,1.0,1.0,1.0,-524.0,0.0,0.0,0.0,0.0,1.0,1.0,1.0,1.0,1.0,1.0,1.0,1.0,0.0,0.0,0.0,0.0,0.0,0.0,0.0,1.0,0.0,0.0,0.0,0.0,0.0,0.0,0.0,0.0,0.0,0.0,0.0,0.0,0.0,0.0,0.0,0.0,0.0,0.0,5.0,0.0,,13500.0,0.0,0.0,0.0,0.0,0.0,-157.0,872.0,-144.0,-144.0,28.0,-2.0,1.0,4071.96,50152.5,40122.0,10030.5,50152.5,12.0,-524.0,365243.0,-487.0,-397.0,-157.0,-394.0,13.0,0.0,0.2178181818181818,10.0,5.0,12.0,10.0,-15.0,0.0,0.0,5.0,4071.96,10440.0,-474.0,-457.0,2.0,3.0,0.0,,,,,,,,,,,,,,,,,,,,,8362329934.5,184669729843.5,165825921654.0,52065354655.935,1863.0,1706.0,71128.0,71053.0,9141.0,507017.0,17841.768300002306,17904.092499999126,17354.703399997972,11317.716700000095,11255.423000000095,11202.352400000063,128647.0,664009.0,,,,13551548.424657134,-602967935.0,-923516196.0,-297053354.0,-1537961559.0416667,44111.0,30769.0,11370.233999999196,11246.099999998987,10729.748699997286,22930.506100009865,22852.11460000983,22236.586400008386,67616.55955014433,158323.17467811427,126337.97628526884,35066.48060002806,35006.5568000285,34451.34500002891,,,,3720719.0,8311.35170000017,8416.12710000008,8139.27170000023,,,,16498.912599999712,16684.523499999686,16280.7544999997,,,,3920.195300000124,3903.4459000001625,3735.9844000001617,437333.0,432119.0,,6436.469693002893,633082.0,626624.0,,16363.228499999796,154473.16629999076,154475.90839999032,154367.6009999871,,,,6.0,103745538.22499992,,10689620970.014994,3519815889.599997,125667742.54500005,867895.7849999996,208.0,26164.0,-34965267.0,15302421.0,-18175088.0,-19772006.0,-2.5,0.0,,13500.0,0.0,0.0,0.0,0.0,0.0,-157.0,872.0,-144.0,-144.0,370707499.5750018,5285206958.67,5925931613.640003,85999784.26500002,5285206958.67,381419.0,-26325680.0,6149599108.0,272901719.0,1392175815.0,605675313.0,1466068548.0,379315.0,5919.0,1075.8484866070312,8855393.0,3131474.0,1933306.0,-6293925.0,1956307.0,246714.0,4152728860.334986,4211273901.330002,-253402557.0,-251281930.0,4489106.0,208434.0,,,,,,,,,,,,,,,,,,,,,1470158.0,14882885.0,3238271.0,8571618.0,11628636.0,1418508.0,1062633092.8095012,,72237562689.82463,21714403495.74762,584023730.0219988,5792665.7475,689.5,94245.0,-277417600.0,21998056.0,-123996281.5,-219088900.5,-2027873.0,,,,,,,,,,,,,,,,,,,,,4280862.0,2483825.5,-9020017.5,921848.5,37582.5,3740590104.029959,3665248121.4974585,-261108888.0,-257790529.0,2531021.5,269719.0,3933253221.817455,33310295074.53092,36744505400.18264,1732892405.51255,48169759113.58573,3995167.0,-248031527.0,103276673172.0,1057133649.5,17301250934.0,3510722245.5,18916745625.0,3678773.5,72065.0,20909.24349976884,89906786.0,-46.95707805048273,3.6666666666666665,4.439183190292986,104.55796681355837,16.277005031074278,383.379211649714,135000.0,0.6234898018587336,0.7818314824680298,0.0,0.0,0.0,0.0,0.0,0.0,1.0,0.0,0.0,0.0,0.0,0.0,0.0,1.0,0.0,0.0,1.0,0.0,0.0,0.0,0.0,0.0,1.0,0.0,0.0,1.0,0.0,0.0,0.0,0.0,0.0,0.0,0.0,0.0,0.0,0.0,0.0,0.0,1.0,0.0,0.0,0.0,0.0,0.0,0.0,0.0,0.0,0.0,0.0,0.0,0.0,0.0,1.0,0.0,0.0,0.0,0.0,0.0,0.0,0.0,0.0,0.0,0.0,0.0,0.0,0.0,0.0,0.0,0.0,0.0,0.0,0.0,0.0,0.0,0.0,0.0,0.0,0.0,0.0,0.0,0.0,0.0,0.0,0.0,0.0,0.0,0.0,0.0,0.0,0.0,0.0,0.0,0.0,0.0,0.0,0.0,0.0,0.0,0.0,0.0,0.0,0.0,0.0,0.0,0.0,0.0,0.0,0.0,0.0,0.0,1.0,0.0,0.0,0.0,0.0,0.0,0.0,0.0,1.0,0.0
106453,0,0.0,0.0,0.0,1.0,1.0,90000.0,149256.0,15799.5,135000.0,0.00712,29.46575342465753,-2262.0,-510.0,-562.0,,3.0,2.0,2.0,14.0,0.3468978294149734,0.6404133467427977,0.221335206354466,,,,,,,,,,,,,,,,,,,,,,,,,,,,,,,,,,,,,,,,,,,,,0.0,0.0,0.0,0.0,-649.0,0.0,0.0,0.0,0.0,0.0,0.0,1.0,1.0,0.0,1.0,0.0,0.0,0.0,0.0,0.0,0.0,0.0,0.0,0.0,1.0,0.0,0.0,0.0,0.0,0.0,0.0,0.0,0.0,0.0,0.0,0.0,0.0,0.0,0.0,0.0,0.0,0.0,0.0,2.0,22313.835,14391.54,721575.0,507262.95,0.0,0.0,0.0,0.0,-1444.0,-74.0,-60.5,,96.0,-23.5,11.0,20123.865,225000.0,254700.0,8280.0,225000.0,12.0,-649.0,365243.0,-1113.0,-843.0,-843.0,-830.0,12.0,0.0,0.0799982554758674,-1.0,34.0,10.0,4.5,-35.5,0.0,0.0,32.0,15072.12,15005.0475,-1040.0,-1038.0,6.0,1.0,0.0,,,,,,,,,,,,,,,,,,,,,8362345734.0,184669879099.5,165826056654.0,52065444655.935,1863.0,1706.0,71128.0,71053.0,9141.0,507017.0,,,,,,,128648.0,664012.0,,,,13551577.89041056,-602970197.0,-923516758.0,-297054003.0,-1537962069.0416667,44111.0,30769.0,,,,,,,67616.90644797374,158323.81509146094,126338.1976204752,,,,,,,3720733.0,,,,,,,,,,,,,,,,437333.0,432119.0,,6436.476813002893,633084.0,626626.0,,,,,,,,,48.0,103782403.39499992,34746163.155000016,10691049045.014994,3520842128.9999967,125667742.54500005,867895.7849999996,208.0,26164.0,-34967483.0,15303102.0,-18175272.0,,-23.5,15525.0,16781.4,93150.0,0.0,0.0,0.0,0.0,0.0,-1842.0,-1658.0,-106.0,,370822874.0400018,5286467498.67,5927319224.640003,86015601.76500002,5286437708.67,381501.0,-26330652.0,6150329594.0,272899889.0,1392174435.0,605674083.0,1466067189.0,379376.0,5920.0,1075.9829394079616,8856473.0,3131679.0,1933391.0,-6294751.5,1956385.0,246714.0,4152970311.592485,4211470573.492501,-253427885.5,-251307196.5,4489235.0,208457.5,,,,,,,,,,,,,,,,,,,,,1470160.0,14882981.0,3238271.0,8571652.0,11628668.0,1418519.0,1062655406.6445012,802468564.874995,72238284264.82463,21714910758.69762,584023730.0219988,5792665.7475,689.5,94245.0,-277419044.0,21997982.0,-123996342.0,,-2027896.5,,,,,,,,,,,,,,,,,,,,,4280872.0,2483830.0,-9020053.0,921848.5,37582.5,3740605176.1499577,3665263126.54496,-261109928.0,-257791567.0,2531027.5,269720.0,3933273345.682454,33310520074.53092,36744760100.18264,1732900685.51255,48169984113.58573,3995179.0,-248032176.0,103277038415.0,1057132536.5,17301250091.0,3510721402.5,18916744795.0,3678785.5,72065.0,20909.32349802432,89906785.0,-76.76708507670851,1.6584,5.696382796923952,167.84821090662226,9.446881230418684,278.3594729675424,30000.0,-0.9009688679024191,0.4338837391175582,0.0,0.0,0.0,0.0,0.0,0.0,1.0,0.0,1.0,0.0,0.0,0.0,0.0,0.0,0.0,1.0,0.0,0.0,0.0,0.0,1.0,0.0,0.0,0.0,0.0,1.0,0.0,0.0,0.0,0.0,0.0,0.0,0.0,0.0,0.0,0.0,1.0,0.0,0.0,0.0,0.0,0.0,0.0,0.0,0.0,0.0,0.0,0.0,0.0,0.0,0.0,0.0,0.0,0.0,0.0,0.0,0.0,0.0,0.0,0.0,0.0,0.0,1.0,0.0,0.0,0.0,0.0,0.0,0.0,0.0,0.0,0.0,0.0,0.0,0.0,0.0,0.0,0.0,0.0,0.0,0.0,0.0,0.0,0.0,0.0,0.0,0.0,0.0,0.0,0.0,0.0,0.0,0.0,0.0,0.0,0.0,0.0,0.0,0.0,0.0,0.0,0.0,0.0,0.0,0.0,0.0,0.0,0.0,0.0,0.0,0.0,0.0,0.0,0.0,0.0,0.0,0.0,0.0,0.0,0.0
106454,0,0.0,1.0,1.0,0.0,0.0,225000.0,378000.0,25258.5,378000.0,0.01885,27.03013698630137,-708.0,-858.0,-2288.0,7.0,2.0,2.0,2.0,12.0,0.2455870420484649,0.5206768177180782,0.5388627065779676,,,,,,,,,,,,,,,,,,,,,,,,,,,,,,,,,,,,,,,,,,,,,2.0,0.0,2.0,0.0,-557.0,0.0,0.0,0.0,0.0,0.0,3.0,1.0,1.0,0.0,1.0,1.0,0.0,0.0,0.0,0.0,1.0,1.0,0.0,0.0,1.0,0.0,0.0,0.0,0.0,0.0,0.0,0.0,0.0,0.0,0.0,0.0,0.0,0.0,0.0,0.0,0.0,0.0,0.0,2.0,17268.75,,609750.0,482276.25,0.0,0.0,0.0,0.0,-458.0,1185.5,-44.5,,31.0,-7.0,3.0,3506.31,43425.0,34740.0,3271.5,43425.0,12.0,-346.0,365243.0,-313.0,-193.0,17.0,-191.0,16.0,0.0,0.1090140563003016,50.0,26.0,12.0,10.5,-9.5,0.0,0.0,23.0,3506.31,3506.31,-270.0,-253.0,4.0,1.0,0.0,,,,,,,,,,,,,,,,,,,,,8362370992.5,184670257099.5,165826434654.0,52065669655.935,1863.0,1706.0,71128.0,71053.0,9141.0,507020.0,,,,,,,128648.0,664014.0,,,,13551604.920547543,-602970905.0,-923519046.0,-297054560.0,-1537962927.0416667,44111.0,30769.0,,,,,,,67617.1520350158,158324.3357682787,126338.7364831818,,,,,,,3720745.0,,,,,,,,,,,,,,,,437335.0,432121.0,1265278.0,6436.495663002895,633086.0,626628.0,,,,,,,,,15.5,103814279.14499992,,10691950620.014994,3521545208.9999967,125667742.54500005,867895.7849999996,208.0,26164.0,-34969037.0,15304196.5,-18175390.5,,-7.25,20848.5,,729000.0,522945.0,0.0,0.0,0.0,0.0,-566.0,895.0,-47.0,,370950347.8800018,5287565107.17,5928527776.140003,86028300.76500002,5287565107.17,381581.0,-26333218.0,6151425323.0,272897570.0,1392172968.0,605672826.0,1466065741.0,379470.0,5920.0,1076.335315356101,8856573.0,3131990.0,1933590.0,-6295510.0,1956385.0,246714.0,4153550110.289983,4212050372.189999,-253449015.0,-251328115.0,4489355.0,208488.0,,,,,,,,,,,,,,,,,,,,,1470162.0,14883012.0,3238271.0,8571678.0,11628691.0,1418522.0,1062672675.3945012,,72238894014.82463,21715393034.94762,584023730.0219988,5792665.7475,689.5,94245.0,-277419502.0,21999167.5,-123996386.5,,-2027903.5,,,,,,,,,,,,,,,,,,,,,4280884.0,2483840.5,-9020062.5,921848.5,37582.5,3740608682.4599576,3665266632.85496,-261110198.0,-257791820.0,2531031.5,269721.0,3933276851.992454,33310563499.53092,36744794840.18264,1732903957.01255,48170027538.58573,3995191.0,-248032522.0,103277403658.0,1057132223.5,17301249898.0,3510721419.5,18916744604.0,3678801.5,72065.0,20909.432512080613,89906835.0,-26.192986012568426,1.68,8.907892392659896,240.78155163282884,14.965259219668624,404.51300674315246,112500.0,-0.9009688679024191,-0.433883739117558,0.0,0.0,0.0,0.0,0.0,0.0,1.0,0.0,0.0,0.0,1.0,0.0,0.0,0.0,0.0,1.0,0.0,0.0,0.0,0.0,1.0,0.0,0.0,0.0,0.0,0.0,0.0,1.0,0.0,0.0,0.0,0.0,0.0,1.0,0.0,0.0,0.0,0.0,0.0,0.0,0.0,0.0,0.0,0.0,0.0,0.0,0.0,0.0,0.0,0.0,0.0,0.0,0.0,0.0,0.0,0.0,0.0,0.0,0.0,0.0,0.0,0.0,0.0,0.0,0.0,0.0,0.0,0.0,0.0,0.0,0.0,0.0,0.0,0.0,0.0,0.0,0.0,0.0,0.0,1.0,0.0,0.0,0.0,0.0,0.0,0.0,0.0,0.0,0.0,0.0,0.0,0.0,0.0,0.0,0.0,0.0,0.0,0.0,0.0,0.0,0.0,0.0,0.0,0.0,0.0,0.0,0.0,0.0,0.0,0.0,0.0,0.0,0.0,0.0,0.0,0.0,0.0,0.0,0.0,0.0
106457,0,0.0,0.0,0.0,1.0,2.0,225000.0,781920.0,40054.5,675000.0,0.018029,39.630136986301366,-503.0,-27.0,-2639.0,,3.0,3.0,3.0,7.0,0.4592021443712606,0.4005468823680547,0.5136937663039473,0.0361,,0.9871,,,0.04,0.0345,0.3333,,,,0.0412,,0.0014,0.0368,,0.9871,,,0.0403,0.0345,0.3333,,,,0.043,,0.0014,0.0364,,0.9871,,,0.04,0.0345,0.3333,,,,0.042,,0.0014,0.0327,1.0,7.0,2.0,7.0,1.0,-1731.0,0.0,0.0,0.0,0.0,0.0,3.0,1.0,1.0,0.0,1.0,0.0,0.0,0.0,0.0,0.0,0.0,0.0,0.0,0.0,1.0,0.0,0.0,0.0,0.0,0.0,0.0,0.0,0.0,0.0,0.0,0.0,0.0,0.0,0.0,0.0,0.0,0.0,0.0,7.0,0.0,,90000.0,0.0,0.0,0.0,0.0,0.0,-718.0,1017.0,-206.0,-500.0,221.0,-16.0,2.0,16601.4675,130927.5,152235.0,3685.5,130927.5,10.0,-1221.5,365243.0,-1191.0,-996.0,-921.0,-988.5,7.0,0.5,0.1089090909090909,32.0,17.0,8.0,6.0,-49.0,0.0,0.0,15.0,4700.115,4700.115,-1505.0,-1490.0,4.0,1.0,0.0,,,,,,,,,,,,,,,,,,,,,8362411047.0,184671039019.5,165827109654.0,52065894655.935,1863.0,1706.0,71128.0,71053.0,9141.0,507023.0,17841.804400002307,17904.12889999913,17354.740199997974,,,,128650.0,664017.0,,,,13551644.550684532,-602971408.0,-923521685.0,-297056291.0,-1537962954.0416667,44113.0,30770.0,11370.273999999195,11246.139999998992,10729.788999997289,22930.540600009863,22852.149100009832,22236.620900008387,67617.61123716016,158324.73631516105,126339.2501769481,35066.813900028064,35006.890100028504,34451.678300028914,,,,3720752.0,,,,,,,16498.953799999712,16684.565499999688,16280.7974999997,,,,3920.196700000124,3903.447300000162,3735.985800000162,437342.0,432128.0,,6436.513692002895,633089.0,626631.0,,16363.261199999795,154474.15339999076,154476.89549999032,154368.5880999871,,,,24.0,103824703.39499992,,10699395163.244991,3523383809.9999967,125667742.54500005,867895.7849999996,208.0,26164.0,-34984590.0,15316450.5,-18183024.0,-19782830.0,-11.5,0.0,,241650.0,0.0,0.0,0.0,0.0,0.0,-1205.0,-991.0,-480.0,-1019.0,371104878.0150018,5291114131.17,5932237047.390003,86108207.26500002,5291114131.17,381763.0,-26345469.0,6154162380.5,272886033.0,1393261024.0,606031984.0,1467153834.5,379643.0,5920.5,1077.083566892416,8859083.5,3133376.0,1934495.0,-6298109.0,1956385.0,246714.0,4155334700.489981,4213806416.594997,-253609640.0,-251486557.0,4492951.0,208562.0,,,,,,,,,,,,,,,,,,,,,1470169.0,14883233.0,3238271.0,8571695.0,11628706.0,1418524.0,1062672675.3945012,,72238984014.82463,21715393034.94762,584023730.0219988,5792665.7475,689.5,94245.0,-277420220.0,22000184.5,-123996592.5,-219089400.5,-2027919.5,,,,,,,,,,,,,,,,,,,,,4280892.0,2483846.5,-9020111.5,921848.5,37582.5,3740613382.574958,3665271332.969959,-261111703.0,-257793310.0,2531035.5,269722.0,3933293453.459953,33310694427.03092,36744947075.18264,1732907642.51255,48170158466.08573,3995201.0,-248033743.5,103277768901.0,1057131032.5,17301248902.0,3510720498.5,18916743615.5,3678808.5,72065.5,20909.54142117152,89906867.0,-12.692360871068097,3.4752,5.617346365576903,222.6162059673148,19.52140208965285,773.6358389776123,75000.0,-0.9009688679024191,-0.433883739117558,0.0,0.0,0.0,0.0,0.0,0.0,1.0,0.0,1.0,0.0,0.0,0.0,0.0,0.0,0.0,0.0,0.0,0.0,1.0,0.0,0.0,1.0,0.0,0.0,0.0,1.0,0.0,0.0,0.0,0.0,0.0,0.0,0.0,0.0,0.0,0.0,0.0,0.0,0.0,0.0,0.0,0.0,0.0,0.0,0.0,0.0,0.0,0.0,0.0,0.0,0.0,0.0,0.0,1.0,0.0,0.0,0.0,0.0,0.0,0.0,0.0,0.0,0.0,0.0,0.0,0.0,0.0,0.0,0.0,0.0,0.0,0.0,0.0,0.0,0.0,0.0,0.0,0.0,0.0,0.0,0.0,0.0,0.0,0.0,0.0,0.0,0.0,0.0,0.0,0.0,0.0,0.0,0.0,0.0,0.0,0.0,0.0,0.0,0.0,0.0,0.0,0.0,0.0,0.0,0.0,0.0,0.0,0.0,0.0,0.0,1.0,0.0,0.0,0.0,0.0,0.0,0.0,1.0,0.0,0.0
106484,0,0.0,0.0,0.0,1.0,0.0,103500.0,135000.0,5805.0,135000.0,0.026392,59.05205479452055,,-1741.0,-4379.0,,1.0,2.0,2.0,10.0,,0.650635572465693,0.4206109640437848,0.0227,0.0661,0.9836,,,0.0,0.1034,0.0417,,0.0164,,0.0175,,0.0019,0.0231,0.0685,0.9836,,,0.0,0.1034,0.0417,,0.0168,,0.0183,,0.0021,0.0229,0.0661,0.9836,,,0.0,0.1034,0.0417,,0.0167,,0.0179,,0.002,0.0142,1.0,0.0,0.0,0.0,0.0,-2627.0,0.0,0.0,0.0,0.0,0.0,1.0,1.0,0.0,0.0,1.0,0.0,0.0,0.0,0.0,0.0,0.0,0.0,0.0,0.0,1.0,0.0,0.0,0.0,0.0,0.0,0.0,0.0,0.0,0.0,0.0,0.0,0.0,0.0,0.0,0.0,0.0,0.0,0.0,5.0,13887.0,0.0,270000.0,255384.0,0.0,0.0,0.0,0.0,-762.0,100.0,-46.0,-171.0,118.0,-12.5,3.0,13438.665,134401.5,120960.0,13441.5,134401.5,12.0,-1522.0,365243.0,-1492.0,-1162.0,-1162.0,-1156.0,11.0,0.0,0.1089200303162201,-1.0,33.0,12.0,8.0,-43.0,0.0,0.0,32.0,8758.17,8758.17,-1307.5,-1297.0,5.5,1.0,0.0,,,,,,,,,,,,,,,,,,,,,8362416852.0,184671174019.5,165827244654.0,52065998155.935,1863.0,1706.0,71128.0,71053.0,9141.0,507024.0,17841.82710000231,17904.15179999913,17354.763299997972,11317.782800000095,11255.489100000095,11202.420900000065,128650.0,664018.0,,,,13551703.602739329,,-923526064.0,-297058918.0,-1537964695.0416667,44113.0,30770.0,11370.273999999195,11246.139999998992,10729.788999997289,22930.644000009863,22852.25250000984,22236.724300008387,,158325.38695073352,126339.67078791215,35066.85560002806,35006.9318000285,34451.72000002891,,,,3720762.0,8311.36810000017,8416.14380000008,8139.288500000232,,,,16498.971299999714,16684.583399999687,16280.815799999697,,,,3920.198600000124,3903.4493000001626,3735.9879000001615,437342.0,432128.0,,6436.540084002893,633091.0,626633.0,,16363.275399999797,154475.13699999073,154477.87909999033,154369.5716999871,,,,26.0,104397887.20499983,34962533.460000016,10740313596.59999,3537620259.4349976,126337075.56000005,867895.7849999996,209.0,26164.0,-35154588.0,15447164.0,-18280614.0,-19881169.0,-12.5,11848.5,0.0,450000.0,256527.0,0.0,0.0,0.0,0.0,-968.0,787.0,-35.0,-294.0,372461888.565002,5310912821.67,5954038564.140003,86370512.26500002,5310912821.67,383265.0,-26467165.0,6180635997.0,274260277.0,1400136038.0,608539456.0,1474031198.0,381327.0,5944.0,1081.9354456817116,8892877.0,3146798.0,1943299.0,-6326563.0,1956802.0,246773.0,4170087512.302481,4231010722.027489,-255027884.0,-252893514.5,4526626.0,209650.5,,,,,,,,,,,,,,,,,,,,,1470174.0,14883351.0,3238271.0,8571728.0,11628738.0,1418527.0,1062686562.3945012,802468564.874995,72239254014.82463,21715648418.94762,584023730.0219988,5792665.7475,689.5,94245.0,-277420982.0,22000284.5,-123996638.5,-219089571.5,-2027932.0,,,,,,,,,,,,,,,,,,,,,4280904.0,2483854.5,-9020154.5,921848.5,37582.5,3740622140.744958,3665280091.1399584,-261113010.5,-257794607.0,2531041.0,269723.0,3933306892.1249537,33310828828.53092,36745068035.18264,1732921084.01255,48170292867.58573,3995213.0,-248035265.5,103278134144.0,1057129540.5,17301247740.0,3510719336.5,18916742459.5,3678819.5,72065.5,20909.65034120184,89906866.0,,1.3043478260869563,17.829457364341085,1052.8660932356377,23.255813953488367,1373.3035998725709,103500.0,1.0,0.0,0.0,0.0,0.0,0.0,0.0,0.0,1.0,0.0,0.0,1.0,0.0,0.0,0.0,0.0,0.0,0.0,0.0,0.0,1.0,0.0,0.0,0.0,0.0,1.0,0.0,1.0,0.0,0.0,0.0,0.0,0.0,0.0,0.0,0.0,0.0,0.0,0.0,0.0,0.0,0.0,0.0,0.0,0.0,0.0,0.0,0.0,0.0,0.0,0.0,0.0,0.0,0.0,0.0,0.0,0.0,0.0,0.0,0.0,0.0,0.0,0.0,0.0,0.0,0.0,0.0,0.0,0.0,0.0,0.0,0.0,0.0,0.0,0.0,0.0,0.0,0.0,0.0,0.0,0.0,0.0,0.0,0.0,0.0,0.0,0.0,0.0,0.0,0.0,0.0,0.0,0.0,0.0,0.0,0.0,0.0,0.0,0.0,0.0,0.0,0.0,0.0,0.0,0.0,0.0,0.0,1.0,0.0,0.0,0.0,0.0,1.0,0.0,0.0,0.0,0.0,0.0,0.0,0.0,1.0,0.0
106488,0,0.0,1.0,0.0,0.0,1.0,450000.0,855000.0,43654.5,855000.0,0.010556,29.64931506849315,-366.0,-1111.0,-984.0,,2.0,3.0,3.0,14.0,0.4012160186910614,0.7364817902763745,0.2822484337007223,,,,,,,,,,,,,,,,,,,,,,,,,,,,,,,,,,,,,,,,,,,,,0.0,0.0,0.0,0.0,-1101.0,0.0,0.0,0.0,0.0,0.0,2.0,1.0,1.0,1.0,1.0,1.0,1.0,0.0,1.0,1.0,0.0,1.0,1.0,0.0,1.0,0.0,0.0,0.0,0.0,0.0,0.0,0.0,0.0,0.0,0.0,0.0,0.0,0.0,0.0,0.0,0.0,0.0,0.0,2.0,37499.985,0.0,742500.0,452191.5,0.0,0.0,0.0,0.0,-330.5,819.0,-53.5,,23.0,-5.0,6.0,22500.0,106866.0,243812.25,16897.5,219595.5,12.0,-748.0,365243.0,-822.0,-533.5,-428.5,-527.5,11.0,0.0,0.1508971969293038,-1.0,27.0,12.0,7.0,-25.0,0.0,0.0,83.0,10684.44,10684.44,-509.0,-504.0,16.0,0.0,26.0,63991.2825,450000.0,0.0,0.0,0.0,0.0,2676.105,22275.0,22275.0,62292.7575,63991.2825,63991.2825,0.0,0.0,0.0,0.0,12.5,-14.5,0.0,0.0,8362460506.5,184672029019.5,165828099654.0,52066448155.935,1863.0,1706.0,71128.0,71053.0,9141.0,507026.0,,,,,,,128651.0,664020.0,,,,13551733.252054395,-602971774.0,-923527048.0,-297060019.0,-1537965806.0416667,44113.0,30770.0,,,,,,,67618.01245317886,158326.1234325238,126339.95303634586,,,,,,,3720776.0,,,,,,,,,,,,,,,,437342.0,432128.0,,6436.550640002894,633094.0,626636.0,,,,,,,,,11.5,104569349.93999983,34962533.460000016,10748853162.314993,3538999427.9849977,126453045.51000004,867895.7849999996,209.0,26164.0,-35191320.5,15432243.5,-18302574.0,,-5.25,37499.985,0.0,1350000.0,904383.0,0.0,0.0,0.0,0.0,-491.0,605.0,-32.0,,372717710.460002,5312713074.57,5956399089.540003,86406579.76500002,5312757845.07,383393.0,-26479911.0,6184285632.5,274614992.5,1401223647.0,609447852.0,1475669031.5,381548.5,5948.0,1082.3503040997407,8898178.5,3147979.0,1943939.0,-6329000.0,1956802.0,246773.0,4172003475.209994,4233043107.810001,-255219081.0,-253083577.0,4531418.0,209762.0,3900218477.5799537,10481292000.0,326535299.505,496640165.3549998,14320247.040000005,155151121.72500023,221400453.1724992,549256542.7049909,507738454.69499695,3744078068.2275095,3886028393.489936,3886215108.029936,16850.0,44539.0,214.0,27475.0,1290511.0,-2287976.5,847227.0,2159.0,1470176.0,14883374.0,3238297.0,8571755.0,11628821.0,1418533.0,1062724062.3795012,802468564.874995,72239996514.82463,21716100610.44762,584023730.0219988,5792665.7475,689.5,94245.0,-277421312.5,22001103.5,-123996692.0,,-2027937.0,5930707223.767464,18758880000.0,198925482.825,448675961.6699976,1948107.735,257302085.15250084,309510293.9399987,637421522.8274977,459745446.2399992,5715597390.412536,5893934538.3075,5894177721.052501,13396.5,80994.5,44.0,70493.0,972824.5,-1701545.5,177423.0,6755.0,4280916.0,2483861.5,-9020179.5,921848.5,37582.5,3740632825.184958,3665290775.5799584,-261113519.5,-257795111.0,2531057.0,269723.0,3933329392.1249537,33310935694.53092,36745311847.43264,1732937981.51255,48170512463.08573,3995225.0,-248036013.5,103278499387.0,1057128718.5,17301247206.5,3510718908.0,18916741932.0,3678830.5,72065.5,20909.80123839877,89906865.0,-12.344298650896322,1.9,10.308215647871354,305.631533537709,19.58560973095557,580.6999137216471,225000.0,-0.9009688679024191,0.4338837391175582,0.0,0.0,0.0,0.0,0.0,0.0,1.0,0.0,1.0,0.0,0.0,0.0,0.0,0.0,0.0,0.0,0.0,0.0,1.0,0.0,0.0,0.0,1.0,0.0,0.0,0.0,0.0,0.0,1.0,0.0,0.0,0.0,0.0,0.0,1.0,0.0,0.0,0.0,0.0,0.0,0.0,0.0,0.0,0.0,0.0,0.0,0.0,0.0,0.0,0.0,0.0,0.0,0.0,1.0,0.0,0.0,0.0,0.0,0.0,0.0,0.0,0.0,0.0,0.0,0.0,0.0,0.0,0.0,0.0,0.0,0.0,0.0,0.0,0.0,0.0,0.0,0.0,0.0,0.0,0.0,0.0,0.0,0.0,0.0,0.0,0.0,0.0,0.0,0.0,0.0,0.0,0.0,0.0,0.0,0.0,0.0,0.0,0.0,0.0,0.0,0.0,0.0,0.0,0.0,0.0,0.0,0.0,0.0,0.0,0.0,0.0,0.0,0.0,0.0,0.0,0.0,0.0,0.0,0.0,0.0
106491,0,0.0,0.0,0.0,1.0,0.0,175500.0,509400.0,32683.5,450000.0,0.0196889999999999,65.96164383561644,,-2511.0,-4860.0,,2.0,2.0,2.0,13.0,,0.3293017300493905,0.3077366963789207,,,,,,,,,,,,,,,,,,,,,,,,,,,,,,,,,,,,,,,,,,,,,0.0,0.0,0.0,0.0,-354.0,0.0,0.0,0.0,0.0,0.0,5.0,1.0,0.0,0.0,1.0,0.0,0.0,0.0,0.0,0.0,0.0,0.0,0.0,0.0,1.0,0.0,0.0,0.0,0.0,0.0,0.0,0.0,0.0,0.0,0.0,0.0,0.0,0.0,0.0,0.0,0.0,0.0,0.0,8.0,21737.25,0.0,90000.0,12037.5,0.0,0.0,0.0,0.0,-197.5,-27.0,-19.0,-390.0,120.0,-14.0,12.0,15981.7725,141750.0,162020.25,0.0,213750.0,15.0,-354.0,365243.0,-1482.0,-743.0,-752.0,-734.0,13.0,1.0,0.0,0.0,68.0,18.0,10.0,-44.5,0.0,0.0,90.0,14574.375,14574.375,-1192.0,-1187.5,10.0,1.5,11.0,235059.3,247500.0,0.0,7607.43,0.0,5087.25,12516.165,13162.5,12825.0,229827.96,235059.3,235059.3,0.0,4.0,0.0,4.0,5.0,-6.0,0.0,0.0,8362493190.0,184672538419.5,165828549654.0,52066623655.935,1863.0,1706.0,71128.0,71053.0,9141.0,507031.0,,,,,,,128651.0,664022.0,,,,13551799.21369823,,-923531908.0,-297060373.0,-1537968317.0416667,44113.0,30770.0,,,,,,,,158326.45273425383,126340.26077304225,,,,,,,3720789.0,,,,,,,,,,,,,,,,437342.0,432128.0,,6436.570329002893,633096.0,626638.0,,,,,,,,,7.0,104631431.93999983,34963013.29500002,10753880585.129992,3539833611.2099977,126505821.91500004,867895.7849999996,209.0,26164.0,-35230808.5,15470148.0,-18329299.5,-19928526.5,-8.5,19399.5,0.0,195444.0,0.0,0.0,0.0,0.0,0.0,-914.0,-367.0,-733.0,-1100.0,372957261.1425021,5315392523.07,5959527039.540003,86445414.76500002,5315133773.07,383524.0,-26498555.0,6187207171.0,274969963.0,1401944387.0,610351825.0,1476572555.0,381744.5,5952.0,1082.761713843342,8903386.0,3149841.0,1944886.5,-6332362.0,1956807.0,246778.0,4175020739.0475006,4235829471.337505,-255342579.5,-253206013.0,4533468.5,209930.0,3902833680.6149545,10489932000.0,326728799.505,497082220.3799998,14320247.040000005,155399676.7500002,221527194.9749992,549753056.7749909,508219087.45499694,3746611691.9550095,3888636738.5249367,3888823453.064936,16857.0,44671.0,214.0,27600.0,1290645.0,-2288875.0,847234.0,2159.0,1470184.0,14883494.0,3238308.0,8571823.0,11628911.0,1418545.0,1062745799.6295012,802468564.874995,72240086514.82463,21716112647.94762,584023730.0219988,5792665.7475,689.5,94245.0,-277421510.0,22001076.5,-123996711.0,-219089961.5,-2027951.0,5930942283.067463,18759127500.0,198925482.825,448683569.0999976,1948107.735,257307172.40250084,309522810.1049987,637434685.3274977,459758271.2399992,5715827218.372536,5894169597.6075,5894412780.352501,13396.5,80998.5,44.0,70497.0,972829.5,-1701551.5,177423.0,6755.0,4280934.0,2483871.5,-9020224.0,921848.5,37582.5,3740647399.559958,3665305349.9549584,-261114711.5,-257796298.5,2531067.0,269724.5,3933345373.897455,33311077444.53092,36745473867.68264,1732937981.51255,48170726213.08573,3995240.0,-248036367.5,103278864630.0,1057127236.5,17301246463.5,3510718156.0,18916741198.0,3678843.5,72066.5,20909.80123839877,89906865.0,,2.9025641025641025,5.3696819496076005,354.19304827055504,15.585846069117446,1028.0680272878674,87750.0,-0.2225209339563146,-0.9749279121818236,0.0,1.0,0.0,0.0,0.0,0.0,0.0,0.0,0.0,1.0,0.0,0.0,0.0,0.0,0.0,0.0,0.0,0.0,1.0,0.0,1.0,0.0,0.0,0.0,0.0,1.0,0.0,0.0,0.0,0.0,0.0,0.0,0.0,0.0,0.0,0.0,0.0,0.0,0.0,0.0,0.0,0.0,0.0,0.0,0.0,0.0,0.0,0.0,0.0,0.0,0.0,0.0,0.0,0.0,0.0,0.0,0.0,0.0,0.0,0.0,0.0,0.0,0.0,0.0,0.0,0.0,0.0,0.0,0.0,0.0,0.0,0.0,0.0,0.0,0.0,0.0,0.0,0.0,0.0,0.0,0.0,0.0,0.0,0.0,0.0,0.0,0.0,0.0,0.0,0.0,0.0,0.0,0.0,0.0,0.0,0.0,0.0,0.0,0.0,0.0,0.0,0.0,0.0,0.0,0.0,1.0,0.0,0.0,0.0,0.0,0.0,0.0,0.0,0.0,0.0,0.0,0.0,0.0,0.0,0.0
106514,0,0.0,0.0,0.0,1.0,2.0,162000.0,781920.0,34443.0,675000.0,0.006852,42.92602739726028,-3385.0,-2665.0,-1215.0,,4.0,3.0,3.0,9.0,0.6894495960874195,0.0316602915474743,0.4812493411434029,0.0773,0.0614,0.995,,,0.08,0.069,0.4167,,0.0107,,0.1188,,0.0698,0.0788,0.0637,0.995,,,0.0806,0.069,0.4167,,0.0109,,0.1237,,0.0739,0.0781,0.0614,0.995,,,0.08,0.069,0.4167,,0.0109,,0.1209,,0.0712,0.1086,1.0,1.0,0.0,1.0,0.0,-723.0,0.0,0.0,0.0,0.0,2.0,1.0,1.0,1.0,0.0,1.0,0.0,0.0,0.0,0.0,0.0,0.0,0.0,0.0,0.0,1.0,0.0,0.0,0.0,0.0,0.0,0.0,0.0,0.0,0.0,0.0,0.0,0.0,0.0,0.0,0.0,0.0,0.0,0.0,11.0,0.0,0.0,408915.0,0.0,0.0,0.0,0.0,0.0,-628.0,137.0,-281.0,-408.0,235.0,-11.0,4.0,17419.725,45283.5,139806.0,9441.0,139682.25,12.0,-724.0,365243.0,-693.0,-243.0,-3.0,-238.0,10.0,0.0,0.0544610350917108,163.0,24.0,24.0,12.5,-19.5,0.0,0.0,69.0,6514.875,6514.875,-423.0,-420.0,14.0,0.0,23.0,98348.58,450000.0,0.0,59724.18,0.0,59724.18,2250.0,16689.33,12001.05,97597.08,98348.58,98348.58,0.0,9.0,0.0,9.0,7.0,-13.0,0.0,0.0,8362527633.0,184673320339.5,165829224654.0,52066785655.935,1863.0,1706.0,71128.0,71055.0,9141.0,507032.0,17841.90440000231,17904.229899999125,17354.842099997968,11317.844200000096,11255.550500000098,11202.484600000063,128653.0,664026.0,,,,13551842.139725627,-602975159.0,-923533123.0,-297061096.0,-1537970982.0416667,44113.0,30770.0,11370.353999999195,11246.219999998992,10729.869599997286,22930.713000009862,22852.321500009828,22236.79330000839,67618.70190277495,158326.4843945454,126340.74202238338,35067.27230002806,35007.3485000285,34452.13670002891,,,,3720798.0,8311.378800000171,8416.15470000008,8139.299400000232,,,,16499.090099999714,16684.70429999969,16280.939499999697,,,,3920.268400000125,3903.5205000001615,3736.061800000162,437343.0,432129.0,,6436.577181002895,633099.0,626641.0,,16363.383999999794,154476.13199999073,154478.87409999032,154370.5666999871,,,,21.0,104797981.43999983,34979163.79500002,10779829691.129988,3549621222.179997,126728324.73000003,867895.7849999996,209.0,26164.0,-35358688.0,15613840.0,-18399347.0,-20004847.0,-10.0,0.0,0.0,697500.0,0.0,0.0,0.0,0.0,0.0,-773.0,137.0,-302.0,-408.0,374147900.6850025,5331565921.32,5976773255.790003,86678541.76500002,5331565921.32,384885.0,-26600779.0,6212039948.0,275621706.0,1405541166.0,611767945.0,1480169722.0,383206.0,5975.0,1086.8797292062688,8945651.5,3160731.0,1951520.0,-6357946.0,1956809.0,246780.0,4191403685.535,4252695564.690007,-256716405.0,-254568326.0,4581759.0,210924.0,3918061108.934954,10535539500.0,327826799.505,501017011.42499965,14320247.040000005,158236467.79500026,222820765.82999903,553792450.7024899,512175820.724997,3761234960.9850063,3903830377.1099367,3904017091.649936,16906.0,45080.0,214.0,27960.0,1301122.0,-2301645.0,847236.0,2161.0,1470195.0,14883729.0,3238331.0,8571847.0,11628980.0,1418549.0,1062745799.6295012,802468564.874995,72240495429.82463,21716112647.94762,584023730.0219988,5792665.7475,689.5,94245.0,-277422138.0,22001213.5,-123996992.0,-219090369.5,-2027962.0,5931040631.647463,18759577500.0,198925482.825,448743293.2799977,1948107.735,257366896.5825008,309525060.1049987,637451374.6574978,459770272.2899993,5715924815.452536,5894267946.1875,5894511128.932501,13396.5,81007.5,44.0,70506.0,972836.5,-1701564.5,177423.0,6755.0,4280958.0,2483884.0,-9020243.5,921848.5,37582.5,3740653914.434958,3665311864.8299584,-261115134.5,-257796718.5,2531081.0,269724.5,3933362793.6224537,33311122728.03092,36745613673.68264,1732947422.51255,48170865895.33573,3995252.0,-248037091.5,103279229873.0,1057126543.5,17301246220.5,3510718153.0,18916740960.0,3678853.5,72066.5,20909.85569943386,89907028.0,-78.8565866734746,4.826666666666667,4.7034230467729286,201.89926656668013,22.70185523909068,974.5004599618428,40500.0,0.6234898018587334,-0.7818314824680299,0.0,1.0,0.0,0.0,0.0,0.0,0.0,0.0,0.0,0.0,0.0,0.0,0.0,1.0,0.0,1.0,0.0,0.0,0.0,0.0,1.0,0.0,0.0,0.0,0.0,1.0,0.0,0.0,0.0,0.0,1.0,0.0,0.0,0.0,0.0,0.0,0.0,0.0,0.0,0.0,0.0,0.0,0.0,0.0,0.0,0.0,0.0,0.0,0.0,0.0,0.0,0.0,0.0,0.0,0.0,0.0,0.0,0.0,0.0,0.0,0.0,0.0,0.0,0.0,0.0,0.0,0.0,0.0,0.0,0.0,0.0,0.0,0.0,0.0,0.0,0.0,0.0,0.0,0.0,0.0,0.0,0.0,0.0,0.0,0.0,0.0,0.0,0.0,0.0,0.0,1.0,0.0,0.0,0.0,0.0,0.0,0.0,0.0,0.0,0.0,0.0,0.0,0.0,0.0,0.0,0.0,0.0,0.0,0.0,0.0,1.0,0.0,0.0,0.0,0.0,0.0,0.0,1.0,0.0,0.0
106527,0,0.0,0.0,0.0,1.0,0.0,315000.0,1885536.0,103455.0,1800000.0,0.007114,55.01369863013698,-2347.0,-3619.0,-3634.0,,1.0,2.0,2.0,10.0,0.1233111841382379,0.6735832821070913,0.4578995512067301,0.0619,0.0624,0.9786,0.7076,0.0,0.0,0.1379,0.1667,0.2083,0.053,0.0504,0.052,0.0,0.0,0.063,0.0648,0.9786,0.7190000000000001,0.0,0.0,0.1379,0.1667,0.2083,0.0542,0.0551,0.0542,0.0,0.0,0.0625,0.0624,0.9786,0.7115,0.0,0.0,0.1379,0.1667,0.2083,0.0539,0.0513,0.0529,0.0,0.0,0.0409,1.0,0.0,0.0,0.0,0.0,-1454.0,0.0,0.0,0.0,0.0,0.0,0.0,1.0,1.0,0.0,1.0,1.0,0.0,0.0,0.0,0.0,0.0,1.0,1.0,0.0,1.0,0.0,0.0,0.0,0.0,0.0,0.0,0.0,0.0,0.0,0.0,0.0,0.0,0.0,0.0,0.0,0.0,0.0,0.0,2.0,0.0,,86017.5,,,0.0,0.0,0.0,-2057.5,-1849.5,-1175.0,-1178.0,136.0,-33.5,3.0,19951.56,99450.0,104701.5,13500.0,99450.0,6.0,-1135.0,365243.0,-1263.5,-1143.5,-1113.5,-1140.5,16.0,0.0,0.1510249018800372,199.0,12.0,6.0,3.5,-42.5,0.0,0.0,10.0,13302.5175,13302.5175,-1292.0,-1288.0,3.0,1.0,0.0,,,,,,,,,,,,,,,,,,,,,8362631088.0,184675205875.5,165831024654.0,52067100655.935,1863.0,1706.0,71128.0,71055.0,9141.0,507032.0,17841.96630000231,17904.292399999125,17354.90509999797,11317.906600000097,11255.612900000098,11202.549400000064,128653.0,664027.0,4146.731700000115,4144.306200000012,3954.708900000093,13551897.153424256,-602977506.0,-923536757.0,-297062550.0,-1537974601.0416667,44113.0,30770.0,11370.353999999195,11246.219999998992,10729.869599997286,22930.850900009867,22852.459400009837,22236.93120000839,67618.82521395909,158327.1579778275,126341.1999219346,35067.43900002806,35007.5152000285,34452.30340002891,22994.672999995848,22967.649399995436,22613.87189999567,3720808.0,8311.431800000171,8416.20860000008,8139.3536000002305,9835.34070000072,9950.46330000215,10310.903799999627,16499.142099999714,16684.757199999687,16280.9936999997,830.1871000001773,815.349700000046,761.262000000013,3920.268400000125,3903.5205000001615,3736.061800000162,437343.0,432129.0,,6436.584295002895,633101.0,626643.0,,16363.424899999794,154477.11059999073,154479.85269999033,154371.5452999871,77750.89519999633,78089.33490000661,78491.62550000673,68.0,104939621.90999985,,10801205528.129988,,,867895.7849999996,209.0,27930.0,-35387883.5,15615306.5,-18411088.5,-20018737.0,-33.5,0.0,,120825.0,,,0.0,0.0,0.0,-2290.0,-2112.0,-1175.0,-1178.0,374788033.2450025,5339731834.799999,5985706068.540003,86825412.49500002,5339731834.799999,385435.0,-26628776.0,6220257915.5,275601745.0,1407718570.0,612123246.0,1482347229.5,383741.0,5981.0,1088.5607619165294,8949513.0,3165318.0,1954635.0,-6363948.0,1956929.0,246790.0,4198149020.7900057,4259336007.015012,-256905366.5,-254754493.5,4584230.5,211246.5,,,,,,,,,,,,,,,,,,,,,1470197.0,14883865.0,3238331.0,8571859.0,11628990.0,1418552.0,1062745799.6295012,,72240581447.32463,,,5792665.7475,689.5,94245.0,-277424195.5,21999364.0,-123998167.0,-219091547.5,-2027995.5,,,,,,,,,,,,,,,,,,,,,4280964.0,2483887.5,-9020286.0,921848.5,37582.5,3740667216.952458,3665325167.347458,-261116426.5,-257798006.5,2531084.0,269725.5,3933382745.182454,33311222178.03092,36745718375.18264,1732960922.51255,48170965345.33573,3995258.0,-248038226.5,103279595116.0,1057125280.0,17301245077.0,3510717039.5,18916739819.5,3678869.5,72066.5,20910.00672433574,89907227.0,-42.6621015936255,5.985828571428572,3.0448020878642885,167.50582445017787,18.225663331883432,1002.6611498745732,315000.0,-0.2225209339563143,0.9749279121818236,0.0,0.0,0.0,0.0,0.0,0.0,1.0,0.0,0.0,0.0,0.0,0.0,0.0,1.0,0.0,0.0,0.0,0.0,1.0,0.0,0.0,0.0,0.0,1.0,0.0,1.0,0.0,0.0,0.0,0.0,0.0,0.0,1.0,0.0,0.0,0.0,0.0,0.0,0.0,0.0,0.0,0.0,0.0,0.0,0.0,0.0,0.0,0.0,0.0,0.0,0.0,0.0,0.0,0.0,0.0,0.0,0.0,0.0,0.0,0.0,0.0,0.0,0.0,0.0,0.0,0.0,0.0,0.0,0.0,0.0,0.0,0.0,0.0,0.0,0.0,0.0,0.0,0.0,0.0,0.0,0.0,0.0,0.0,0.0,0.0,0.0,0.0,0.0,0.0,0.0,0.0,0.0,0.0,0.0,0.0,0.0,0.0,0.0,0.0,0.0,0.0,0.0,0.0,1.0,0.0,0.0,0.0,0.0,0.0,1.0,1.0,0.0,0.0,0.0,0.0,0.0,0.0,1.0,0.0,0.0
106528,0,0.0,1.0,1.0,1.0,0.0,292500.0,761872.5,53154.0,675000.0,0.020246,41.030136986301365,-7935.0,-1250.0,-4520.0,21.0,2.0,3.0,3.0,10.0,0.3728027420907349,0.4464736599116829,0.4650692149562261,0.368,0.1323,0.9796,,,,0.8276,0.1667,,0.0721,,0.3488,,0.1352,0.375,0.1373,0.9796,,,,0.8276,0.1667,,0.0737,,0.3634,,0.1431,0.3716,0.1323,0.9796,,,,0.8276,0.1667,,0.0734,,0.355,,0.138,0.3292,1.0,0.0,0.0,0.0,0.0,-3142.0,0.0,0.0,0.0,0.0,0.0,1.0,1.0,1.0,0.0,1.0,0.0,0.0,0.0,0.0,0.0,0.0,0.0,0.0,0.0,0.0,0.0,0.0,0.0,0.0,1.0,0.0,0.0,0.0,0.0,0.0,0.0,0.0,0.0,0.0,0.0,0.0,0.0,0.0,10.0,13774.5,0.0,189033.0075,0.0,0.0,0.0,0.0,0.0,-470.5,-32.5,-250.5,-665.0,228.0,-17.0,6.0,17572.905,57213.0,54850.5,0.0,87052.5,6.0,-488.5,365243.0,-567.0,-567.0,-417.0,-561.0,13.0,0.0,0.0,44.5,18.0,6.0,2.0,-21.5,0.0,0.0,12.0,17572.905,17572.905,-572.0,-550.0,3.0,1.0,0.0,,,,,,,,,,,,,,,,,,,,,8362684242.0,184675967748.0,165831699654.0,52067393155.935,1863.0,1706.0,71128.0,71055.0,9141.0,507033.0,17842.33430000231,17904.663999999124,17355.28009999797,11318.038900000096,11255.745200000098,11202.686700000064,128653.0,664029.0,,,,13551938.183561243,-602985441.0,-923541277.0,-297065692.0,-1537975851.0416667,44113.0,30770.0,,,,22931.678500009868,22853.287000009837,22237.75880000839,67619.19801670118,158327.60445148742,126341.66499114956,35067.60570002806,35007.6819000285,34452.47010002891,,,,3720818.0,8311.50390000017,8416.28200000008,8139.42730000023,,,,16499.490899999713,16685.112199999687,16281.3570999997,,,,3920.403600000125,3903.658500000162,3736.2049000001616,437343.0,432129.0,1265299.0,6436.604541002895,633104.0,626646.0,,16363.754099999796,154478.09019999075,154480.83229999032,154372.5248999871,,,,16.0,104960245.40999985,34985364.25500002,10805655851.144987,3551527984.679997,126749258.46000004,867895.7849999996,209.0,27930.0,-35390073.5,15620530.5,-18412272.5,-20020766.0,-7.5,0.0,0.0,112455.0,0.0,0.0,0.0,0.0,0.0,-1859.0,-33.0,-757.0,-757.0,374845587.9525025,5340038820.299999,5986029299.040003,86825412.49500002,5340022105.049999,385456.0,-26632021.0,6221171023.0,275599798.0,1407716938.0,612121674.0,1482345607.0,383795.0,5981.0,1088.5607619165294,8951675.5,3165405.0,1954686.0,-6364363.0,1956929.0,246790.0,4198411863.787507,4259598850.012512,-256915097.0,-254764055.5,4584264.0,211259.5,,,,,,,,,,,,,,,,,,,,,1470207.0,14884093.0,3238331.0,8571877.0,11629002.0,1418558.0,1062759574.1295012,802468564.874995,72240770480.33214,21716112647.94762,584023730.0219988,5792665.7475,689.5,94245.0,-277424666.0,21999331.5,-123998417.5,-219092212.5,-2028012.5,,,,,,,,,,,,,,,,,,,,,4280970.0,2483889.5,-9020307.5,921848.5,37582.5,3740684789.8574576,3665342740.2524586,-261116998.5,-257798556.5,2531087.0,269726.5,3933400318.087455,33311279391.03092,36745773225.68264,1732960922.51255,48171052397.83573,3995264.0,-248038715.0,103279960359.0,1057124713.0,17301244510.0,3510716622.5,18916739258.5,3678882.5,72066.5,20910.00672433574,89907271.5,-193.3944310897436,2.604692307692308,5.502878428716558,225.78385574920327,14.333305113443954,588.0974722710595,146250.0,0.6234898018587336,0.7818314824680298,0.0,0.0,0.0,0.0,0.0,0.0,1.0,0.0,0.0,0.0,0.0,0.0,0.0,1.0,0.0,1.0,0.0,0.0,0.0,0.0,1.0,0.0,0.0,0.0,0.0,1.0,0.0,0.0,0.0,0.0,0.0,0.0,0.0,0.0,0.0,0.0,0.0,0.0,0.0,0.0,1.0,0.0,0.0,0.0,0.0,0.0,0.0,0.0,0.0,0.0,0.0,0.0,0.0,0.0,0.0,0.0,0.0,0.0,0.0,0.0,0.0,0.0,0.0,0.0,0.0,0.0,0.0,0.0,0.0,0.0,0.0,0.0,0.0,0.0,0.0,0.0,0.0,0.0,0.0,0.0,0.0,0.0,1.0,0.0,0.0,0.0,0.0,0.0,0.0,0.0,0.0,0.0,0.0,0.0,0.0,0.0,0.0,0.0,0.0,0.0,0.0,0.0,0.0,0.0,0.0,0.0,0.0,0.0,0.0,0.0,1.0,0.0,0.0,0.0,0.0,0.0,0.0,1.0,0.0,0.0
106529,0,0.0,0.0,1.0,1.0,2.0,270000.0,225000.0,26703.0,225000.0,0.04622,43.47945205479452,-2761.0,-6566.0,-4848.0,10.0,4.0,1.0,1.0,13.0,0.7817415892350065,0.7447152800264085,0.5744466170995097,,,,,,,,,,,,,,,,,,,,,,,,,,,,,,,,,,,,,,,,,,,,,0.0,0.0,0.0,0.0,-1620.0,0.0,0.0,0.0,0.0,0.0,0.0,1.0,1.0,1.0,1.0,0.0,0.0,0.0,0.0,0.0,0.0,0.0,0.0,0.0,0.0,0.0,0.0,0.0,0.0,1.0,0.0,0.0,0.0,0.0,0.0,0.0,0.0,0.0,0.0,0.0,0.0,0.0,0.0,2.0,,,1191885.75,0.0,,0.0,0.0,0.0,-2179.5,-1105.5,-20.0,-2590.0,145.0,-36.0,3.0,19779.255,65205.0,61591.5,6520.5,302602.5,3.0,-412.0,182416.0,-976.5,181902.0,181902.0,181907.0,14.0,0.0,0.1042608831443397,-1.0,7.0,6.0,3.0,-50.0,0.0,0.0,31.0,12558.51,12558.51,-250.0,-250.0,10.0,0.0,13.0,513990.225,540000.0,0.0,21701.205,0.0,21701.205,27306.72,27675.0,27450.0,502358.4,513990.225,513990.225,0.0,6.0,0.0,6.0,6.0,-7.0,0.0,0.0,8362710945.0,184676192748.0,165831924654.0,52067663155.935,1863.0,1706.0,71128.0,71055.0,9141.0,507033.0,,,,,,,128655.0,664033.0,,,,13551981.663013298,-602988202.0,-923546125.0,-297067312.0,-1537982417.0416667,44113.0,30770.0,,,,,,,67619.97975829041,158328.34916676744,126342.23943776664,,,,,,,3720831.0,,,,,,,,,,,,,,,,437343.0,432129.0,1265309.0,6436.650761002894,633105.0,626647.0,,,,,,,,,72.5,,,10812747509.144987,3551527984.679997,,867895.7849999996,209.0,27930.0,-35399260.0,15626986.0,-18416399.0,-20026449.0,-35.75,,,158296.5,0.0,,0.0,0.0,0.0,-2897.0,-2575.0,-12.0,-2590.0,374920215.30000246,5340554025.299999,5986540890.540003,86840932.99500002,5340824025.299999,385477.0,-26634617.0,6221901303.5,275597460.0,1407897553.5,612302439.5,1482526238.5,383853.0,5981.0,1088.9582226675136,8951688.0,3165470.0,1954705.0,-6364933.0,1956929.0,246790.0,4198755570.7500095,4259942556.975015,-256929035.0,-254777792.0,4584436.0,211272.0,3923204280.1649537,10544269500.0,327826799.505,502130458.7549997,14320247.040000005,159349915.12500027,223042261.09499907,554666827.1849898,513061445.20499694,3766285932.3900046,3908973226.5899367,3909159941.129936,16906.0,45399.0,214.0,28279.0,1301228.0,-2301859.0,847236.0,2161.0,1470209.0,14884238.0,3238344.0,8571884.0,11629033.0,1418561.0,,,72241962366.08214,21716112647.94762,,5792665.7475,689.5,94245.0,-277426845.5,21998226.0,-123998437.5,-219094802.5,-2028048.5,5931554621.872463,18760117500.0,198925482.825,448764994.4849976,1948107.735,257388597.78750083,309552366.82499874,637479049.6574978,459797722.2899993,5716427173.852535,5894781936.4125,5895025119.157501,13396.5,81013.5,44.0,70512.0,972842.5,-1701571.5,177423.0,6755.0,4280976.0,2483892.5,-9020357.5,921848.5,37582.5,3740697348.367458,3665355298.7624593,-261117248.5,-257798806.5,2531097.0,269726.5,3933420097.342455,33311344596.03092,36745834817.18264,1732967443.01255,48171355000.33573,3995267.0,-248039127.0,103280142775.0,1057123736.5,17301426412.0,3510898524.5,18916921165.5,3678896.5,72066.5,20910.11098521889,89907270.5,-63.50126023944549,0.8333333333333334,10.111223458038422,439.63045555909525,8.426019548365351,366.35871296591273,67500.0,0.6234898018587336,0.7818314824680298,0.0,1.0,0.0,0.0,0.0,0.0,0.0,0.0,1.0,0.0,0.0,0.0,0.0,0.0,0.0,1.0,0.0,0.0,0.0,0.0,1.0,0.0,0.0,0.0,0.0,1.0,0.0,0.0,0.0,0.0,1.0,0.0,0.0,0.0,0.0,0.0,0.0,0.0,0.0,0.0,0.0,0.0,0.0,0.0,0.0,0.0,0.0,0.0,0.0,0.0,0.0,0.0,0.0,0.0,0.0,0.0,0.0,0.0,0.0,0.0,0.0,0.0,1.0,0.0,0.0,0.0,0.0,0.0,0.0,0.0,0.0,0.0,0.0,0.0,0.0,0.0,0.0,0.0,0.0,0.0,0.0,0.0,0.0,0.0,0.0,0.0,0.0,0.0,0.0,0.0,0.0,0.0,0.0,0.0,0.0,0.0,0.0,0.0,0.0,0.0,0.0,0.0,0.0,0.0,0.0,0.0,0.0,0.0,0.0,0.0,0.0,0.0,0.0,0.0,0.0,0.0,0.0,0.0,0.0,0.0
106534,0,0.0,0.0,0.0,1.0,0.0,202500.0,450000.0,23008.5,450000.0,0.0145199999999999,49.58356164383562,-8420.0,-5346.0,-1652.0,,2.0,2.0,2.0,10.0,,0.2190446308236475,0.3706496323299817,,,,,,,,,,,,,,,,,,,,,,,,,,,,,,,,,,,,,,,,,,,,,0.0,0.0,0.0,0.0,-1386.0,0.0,0.0,0.0,0.0,2.0,3.0,1.0,1.0,0.0,1.0,0.0,0.0,0.0,0.0,0.0,0.0,0.0,0.0,0.0,1.0,0.0,0.0,0.0,0.0,0.0,0.0,0.0,0.0,0.0,0.0,0.0,0.0,0.0,0.0,0.0,0.0,0.0,0.0,19.0,0.0,0.0,108000.0,0.0,0.0,0.0,0.0,0.0,-660.0,573.0,-86.0,-680.0,437.0,-13.0,13.0,12311.325,67500.0,67500.0,6878.25,137556.0,18.0,-549.0,365243.0,-518.0,-488.0,-217.0,-480.0,8.0,0.0,0.0544581083010158,-1.0,7.0,6.0,5.0,-22.0,0.0,0.0,27.0,5023.215,4569.93,-303.0,-291.0,8.0,0.0,12.0,102.1725,135000.0,0.0,0.0,0.0,0.0,102.1725,2250.0,1126.9125,0.0,0.0,0.0,0.0,0.0,0.0,0.0,3.5,-7.5,0.0,0.0,8362733953.5,184676642748.0,165832374654.0,52067865655.935,1863.0,1706.0,71128.0,71057.0,9141.0,507036.0,,,,,,,128655.0,664035.0,,,,13552031.246574942,-602996622.0,-923547777.0,-297068698.0,-1537987763.0416667,44113.0,30770.0,,,,,,,,158328.56821139823,126342.61008739898,,,,,,,3720841.0,,,,,,,,,,,,,,,,437343.0,432129.0,,6436.665281002895,633107.0,626649.0,,,,,,,,,22.0,105052877.90999985,36294378.25500002,10820526659.144987,3553160226.1649976,126759071.47500004,867895.7849999996,209.0,27930.0,-35424547.0,15625412.5,-18426400.0,-20039286.5,-10.5,0.0,0.0,67500.0,0.0,0.0,0.0,0.0,0.0,-982.0,163.0,-167.0,-765.0,375076826.8200025,5343255501.299999,5989229712.540003,86888430.49500002,5343210501.299999,385663.0,-26639468.0,6223727288.0,275960004.0,1409174382.0,613214813.0,1483803101.0,384001.0,5981.0,1089.4940562703018,8968962.0,3165937.0,1955036.0,-6365486.0,1956929.0,246790.0,4199521455.0900064,4260760432.335012,-256945641.0,-254793813.0,4584875.0,211314.0,3925493044.8749537,10548297000.0,327997799.505,502778358.04499966,14320247.040000005,159826814.41500032,223136079.02999908,554821385.3549899,513202299.029997,3768528164.8500047,3911256834.299937,3911443548.839936,16910.0,45515.0,214.0,28391.0,1301270.0,-2301964.5,847236.0,2161.0,1470228.0,14884675.0,3238356.0,8571891.0,11629060.0,1418574.0,1062759574.1295012,802468564.874995,72242070366.08214,21716112647.94762,584023730.0219988,5792665.7475,689.5,94245.0,-277427505.5,21998799.0,-123998523.5,-219095482.5,-2028061.5,5931554724.044963,18760252500.0,198925482.825,448764994.4849976,1948107.735,257388597.78750083,309552468.99749875,637481299.6574978,459798849.2024992,5716427173.852535,5894781936.4125,5895025119.157501,13396.5,81013.5,44.0,70512.0,972846.0,-1701579.0,177423.0,6755.0,4280982.0,2483897.5,-9020379.5,921848.5,37582.5,3740702371.5824585,3665359868.6924586,-261117551.5,-257799097.5,2531105.0,269726.5,3933432408.667455,33311412096.03092,36745902317.18264,1732974321.26255,48171492556.33573,3995285.0,-248039676.0,103280508018.0,1057123218.5,17301425924.0,3510898307.5,18916920685.5,3678904.5,72066.5,20910.165443327187,89907269.5,-169.8143441264228,2.2222222222222223,8.801095247408568,436.3896487331513,19.557989438685706,969.7547749625584,101250.0,-0.9009688679024191,0.4338837391175582,0.0,0.0,0.0,0.0,0.0,0.0,1.0,0.0,0.0,0.0,0.0,0.0,0.0,1.0,0.0,0.0,0.0,0.0,1.0,1.0,0.0,0.0,0.0,0.0,0.0,1.0,0.0,0.0,0.0,0.0,0.0,0.0,0.0,0.0,0.0,0.0,0.0,0.0,0.0,0.0,0.0,1.0,0.0,0.0,0.0,0.0,0.0,0.0,0.0,0.0,0.0,0.0,0.0,0.0,0.0,0.0,0.0,0.0,0.0,0.0,0.0,0.0,0.0,0.0,0.0,0.0,0.0,0.0,0.0,0.0,0.0,0.0,0.0,0.0,0.0,0.0,0.0,0.0,0.0,0.0,0.0,1.0,0.0,0.0,0.0,0.0,0.0,0.0,0.0,0.0,0.0,0.0,0.0,0.0,0.0,0.0,0.0,0.0,0.0,0.0,0.0,0.0,0.0,0.0,0.0,0.0,0.0,0.0,0.0,0.0,0.0,0.0,0.0,0.0,0.0,0.0,0.0,0.0,0.0,0.0
106550,0,0.0,0.0,0.0,1.0,2.0,81000.0,200493.0,18517.5,162000.0,0.003813,32.78082191780822,-2520.0,-4555.0,-3966.0,,4.0,2.0,2.0,5.0,0.6453877391308753,0.0231374915653375,0.2750003523983893,0.2186,0.1071,0.9831,,,0.16,0.1379,0.3333,,0.1101,,0.2032,,0.0281,0.2227,0.1111,0.9831,,,0.1611,0.1379,0.3333,,0.1126,,0.2117,,0.0298,0.2207,0.1071,0.9831,,,0.16,0.1379,0.3333,,0.112,,0.2068,,0.0287,0.1659,1.0,0.0,0.0,0.0,0.0,0.0,0.0,0.0,0.0,0.0,1.0,1.0,1.0,1.0,0.0,1.0,0.0,0.0,0.0,0.0,0.0,0.0,0.0,0.0,0.0,1.0,0.0,0.0,0.0,0.0,0.0,0.0,0.0,0.0,0.0,0.0,0.0,0.0,0.0,0.0,0.0,0.0,0.0,0.0,1.0,7015.5,0.0,70155.0,24903.0,45251.955,0.0,0.0,0.0,-282.0,,-19.0,,10.0,-4.5,1.0,4433.895,35392.5,35392.5,0.0,35392.5,12.0,-298.0,365243.0,-267.0,365243.0,63.0,365243.0,6.0,0.0,0.0,60.0,9.0,12.0,7.0,-5.0,0.0,0.0,9.0,4433.895,4433.895,-161.0,-147.0,5.0,1.0,0.0,,,,,,,,,,,,,,,,,,,,,8362752471.0,184676843241.0,165832536654.0,52067946655.935,1863.0,1706.0,71128.0,71058.0,9141.0,507037.0,17842.55290000231,17904.884699999126,17355.50279999797,11318.146000000095,11255.852300000097,11202.797800000064,128657.0,664039.0,,,,13552064.02739686,-602999142.0,-923551743.0,-297068698.0,-1537992318.0416667,44113.0,30770.0,11370.513999999195,11246.379999998991,10730.030699997284,22931.81640000987,22853.424900009835,22237.89670000839,67620.62514602955,158328.59134888984,126342.88508775136,35067.93900002806,35008.0152000285,34452.80340002891,,,,3720846.0,8311.61400000017,8416.394000000078,8139.539900000232,,,,16499.694099999713,16685.318999999687,16281.5687999997,,,,3920.431700000125,3903.6872000001617,3736.234700000162,437343.0,432129.0,,6436.669094002894,633109.0,626651.0,,16363.919999999796,154479.07329999073,154481.81539999033,154373.5079999871,,,,10.0,105229875.82499982,36347248.665000014,10855509619.184984,3569770991.699997,126904652.55000004,867895.7849999996,209.0,27930.0,-35533192.0,,-18480815.0,,-4.5,7015.5,0.0,70155.0,24903.0,45251.955,0.0,0.0,0.0,-282.0,,-19.0,,375938378.3700024,5353347310.289999,6001013157.030004,87065302.99500002,5353347310.289999,386465.0,-26693181.0,6239431584.0,277018374.0,1412798558.0,615018970.0,1487427809.0,385003.0,5991.0,1091.7554614463015,9014605.0,3171165.0,1958313.0,-6376209.0,1956939.0,246791.0,4206431265.614996,4267993650.930001,-257259702.0,-255104563.0,4587451.0,211744.0,,,,,,,,,,,,,,,,,,,,,1470229.0,14884685.0,3238356.0,8571900.0,11629069.0,1418575.0,1062766589.6295012,802468564.874995,72242140521.08214,21716137550.94762,584068981.9769987,5792665.7475,689.5,94245.0,-277427787.5,,-123998542.5,,-2028066.0,,,,,,,,,,,,,,,,,,,,,4280994.0,2483904.5,-9020384.5,921848.5,37582.5,3740706805.4774585,3665364302.5874586,-261117712.5,-257799244.5,2531110.0,269727.5,3933436842.5624537,33311447488.53092,36745937709.68264,1732974321.26255,48171527948.83573,3995297.0,-248039974.0,103280873261.0,1057122951.5,17301791167.0,3510898370.5,18917285928.5,3678910.5,72066.5,20910.165443327187,89907329.5,-76.87421646468867,2.4752222222222224,4.374240583232078,143.3912015845803,10.827217496962335,354.9250886332995,20250.0,0.6234898018587336,0.7818314824680298,0.0,0.0,0.0,0.0,0.0,0.0,1.0,0.0,0.0,0.0,0.0,0.0,0.0,1.0,0.0,0.0,0.0,0.0,1.0,0.0,1.0,0.0,0.0,0.0,0.0,1.0,0.0,0.0,0.0,0.0,0.0,0.0,0.0,0.0,0.0,0.0,0.0,0.0,0.0,0.0,0.0,0.0,0.0,0.0,1.0,0.0,0.0,0.0,0.0,0.0,0.0,0.0,0.0,0.0,0.0,0.0,0.0,0.0,0.0,0.0,0.0,0.0,0.0,0.0,0.0,0.0,0.0,0.0,0.0,0.0,0.0,0.0,0.0,0.0,0.0,0.0,0.0,0.0,0.0,0.0,0.0,0.0,0.0,0.0,0.0,0.0,0.0,0.0,0.0,0.0,1.0,0.0,0.0,0.0,0.0,0.0,0.0,0.0,0.0,0.0,0.0,0.0,0.0,0.0,0.0,0.0,0.0,0.0,0.0,0.0,1.0,0.0,0.0,0.0,0.0,0.0,0.0,1.0,0.0,0.0
106577,0,0.0,1.0,1.0,1.0,0.0,202500.0,288000.0,30370.5,288000.0,0.015221,45.36986301369864,-3741.0,-1592.0,-105.0,4.0,2.0,2.0,2.0,10.0,,0.4916601743968197,,0.0619,0.0491,0.9776,0.6940000000000001,0.0079,0.0,0.1379,0.1667,0.2083,0.0112,0.0504,0.053,0.0,0.0,0.063,0.0509,0.9777,0.706,0.008,0.0,0.1379,0.1667,0.2083,0.0115,0.0551,0.0552,0.0,0.0,0.0625,0.0491,0.9776,0.6981,0.0079,0.0,0.1379,0.1667,0.2083,0.0114,0.0513,0.0539,0.0,0.0,0.0553,1.0,3.0,0.0,3.0,0.0,-408.0,0.0,0.0,0.0,0.0,0.0,0.0,1.0,1.0,0.0,1.0,0.0,0.0,0.0,0.0,0.0,0.0,0.0,0.0,0.0,0.0,0.0,0.0,0.0,0.0,1.0,0.0,0.0,0.0,0.0,0.0,0.0,0.0,0.0,0.0,0.0,0.0,0.0,0.0,4.0,5431.5,,333587.25,0.0,,0.0,0.0,0.0,-981.5,-476.5,-457.0,-663.0,134.0,-17.5,6.0,11800.125,105216.75,110137.5,0.0,125910.0,16.0,-354.0,365243.0,-377.0,-107.0,-107.0,-99.0,11.0,0.0,0.0,45.5,37.0,16.0,9.0,-12.0,0.0,0.0,42.0,10551.33,10284.75,-336.0,-332.0,7.0,1.0,0.0,,,,,,,,,,,,,,,,,,,,,8362782841.5,184677131241.0,165832824654.0,52068149155.935,1863.0,1706.0,71128.0,71058.0,9141.0,507037.0,17842.61480000231,17904.947199999126,17355.56579999797,11318.195100000095,11255.901400000095,11202.848700000064,128657.0,664041.0,4146.7396000001145,4144.314100000011,3954.7169000000927,13552109.397259872,-603002883.0,-923551848.0,-297069106.0,-1537993910.0416667,44113.0,30770.0,11370.513999999195,11246.379999998991,10730.030699997284,22931.954300009867,22853.56280000984,22238.034600008392,,158329.08300906426,,35068.10570002806,35008.1819000285,34452.97010002891,22994.88129999585,22967.85769999543,22614.080199995667,3720856.0,8311.625200000171,8416.405400000078,8139.55140000023,9835.39110000072,9950.514600002149,10310.958899999629,16499.747099999713,16685.372899999686,16281.6239999997,830.1871000001773,815.349700000046,761.262000000013,3920.431700000125,3903.6872000001617,3736.234700000162,437346.0,432132.0,1265313.0,6436.684315002894,633111.0,626653.0,,16363.975299999796,154480.05089999078,154482.79299999034,154374.4856999871,77751.58919999634,78090.03300000659,78492.33150000674,33.0,105746831.23499988,,10962300364.559986,3587253748.2899976,,867895.7849999996,210.0,27930.0,-35701698.5,15863664.0,-18567934.5,-20191359.0,-16.0,10863.0,,176175.0,0.0,,0.0,0.0,0.0,-1372.0,-663.0,-663.0,-663.0,377975701.3950023,5378541614.549999,6030006595.605002,87404166.18,5378541614.549999,388166.0,-26837024.0,6269741696.0,278381025.0,1419297315.0,618247858.0,1493562420.0,386892.5,6029.0,1095.7868655805496,9062435.5,3186863.0,1968478.0,-6407375.0,1957037.0,246828.0,4233070135.147553,4295436941.407559,-259160970.0,-256992847.5,4627358.0,212797.5,,,,,,,,,,,,,,,,,,,,,1470233.0,14884819.0,3238356.0,8571937.0,11629111.0,1418581.0,1062772021.1295012,,72242474108.33214,21716137550.94762,,5792665.7475,689.5,94245.0,-277428769.0,21998322.5,-123998999.5,-219096145.5,-2028083.5,,,,,,,,,,,,,,,,,,,,,4281010.0,2483913.5,-9020396.5,921848.5,37582.5,3740717356.807458,3665374587.3374586,-261118048.5,-257799576.5,2531117.0,269728.5,3933448642.6874537,33311552705.28092,36746047847.18264,1732974321.26255,48171653858.83573,3995313.0,-248040328.0,103281238504.0,1057122574.5,17301791060.0,3510898263.5,18917285829.5,3678921.5,72066.5,20910.165443327187,89907375.0,-82.455615942029,1.4222222222222225,6.667654467328492,302.51056980536936,9.482886353533855,430.2372548343032,101250.0,1.0,0.0,0.0,0.0,0.0,0.0,0.0,0.0,1.0,0.0,0.0,0.0,1.0,0.0,0.0,0.0,0.0,0.0,0.0,0.0,1.0,0.0,1.0,0.0,0.0,0.0,0.0,0.0,0.0,1.0,0.0,0.0,0.0,0.0,0.0,0.0,0.0,0.0,0.0,0.0,0.0,0.0,1.0,0.0,0.0,0.0,0.0,0.0,0.0,0.0,0.0,0.0,0.0,0.0,0.0,0.0,0.0,0.0,0.0,0.0,0.0,0.0,0.0,0.0,0.0,0.0,0.0,0.0,0.0,0.0,0.0,0.0,0.0,0.0,0.0,0.0,0.0,0.0,0.0,0.0,0.0,0.0,0.0,1.0,0.0,0.0,0.0,0.0,0.0,0.0,0.0,0.0,0.0,0.0,0.0,0.0,0.0,0.0,0.0,0.0,0.0,0.0,0.0,0.0,0.0,0.0,0.0,0.0,0.0,0.0,1.0,0.0,1.0,0.0,0.0,0.0,0.0,0.0,0.0,1.0,0.0,0.0
106585,0,0.0,1.0,0.0,0.0,1.0,135000.0,611577.0,40999.5,522000.0,0.002134,26.43835616438357,-626.0,-6812.0,-1610.0,,3.0,3.0,3.0,10.0,0.1855333747507632,0.6139301129478277,0.5744466170995097,,,,,,,,,,,,,,,,,,,,,,,,,,,,,,,,,,,,,,,,,,,,,0.0,0.0,0.0,0.0,-1330.0,0.0,0.0,0.0,0.0,0.0,3.0,1.0,1.0,0.0,1.0,0.0,0.0,0.0,0.0,0.0,1.0,1.0,0.0,0.0,1.0,0.0,0.0,0.0,0.0,0.0,0.0,0.0,0.0,0.0,0.0,0.0,0.0,0.0,0.0,0.0,0.0,0.0,0.0,1.0,41521.5,,1125000.0,846328.5,0.0,0.0,0.0,0.0,-359.0,737.0,-1.0,,12.0,-5.5,3.0,11250.0,112500.0,119925.0,3375.0,112500.0,12.0,-597.0,365243.0,-929.0,-659.0,-599.0,-650.5,14.0,0.5,0.1002723031939825,-1.0,24.0,12.0,7.0,-32.5,0.0,0.0,20.0,3991.23,3991.23,-1019.5,-1006.0,5.5,1.0,0.0,,,,,,,,,,,,,,,,,,,,,8362823841.0,184677742818.0,165833346654.0,52068284155.935,1863.0,1706.0,71128.0,71058.0,9141.0,507040.0,,,,,,,128658.0,664044.0,,,,13552135.835616035,-603003509.0,-923553458.0,-297070436.0,-1538000722.0416667,44113.0,30770.0,,,,,,,67620.8106794043,158329.69693917714,126343.45953436848,,,,,,,3720866.0,,,,,,,,,,,,,,,,437346.0,432132.0,,6436.686449002895,633114.0,626656.0,,,,,,,,,12.0,105806577.73499988,,10970369428.859983,3590563048.2899976,129444865.60500003,867895.7849999996,210.0,27930.0,-35752334.0,15841445.0,-18594729.0,,-5.5,41521.5,,1125000.0,846328.5,0.0,0.0,0.0,0.0,-359.0,737.0,-1.0,,378281428.78500247,5383034414.549999,6034919317.605002,87431287.68,5383034414.549999,388544.0,-26858053.0,6276133448.5,278731067.5,1420746604.5,618605218.5,1495011818.0,387325.0,6038.0,1096.3967768858583,9075057.0,3189209.0,1970111.0,-6411768.5,1957039.0,246830.0,4235844715.020047,4299133362.3450575,-259284164.5,-257114596.5,4628122.5,212974.5,,,,,,,,,,,,,,,,,,,,,1470234.0,14884831.0,3238356.0,8571961.0,11629131.0,1418584.0,1062813542.6295012,,72243599108.33214,21716983879.44762,584068981.9769987,5792665.7475,689.5,94245.0,-277429128.0,21999059.5,-123999000.5,,-2028089.0,,,,,,,,,,,,,,,,,,,,,4281022.0,2483920.5,-9020429.0,921848.5,37582.5,3740721348.037458,3665378578.5674586,-261119068.0,-257800582.5,2531122.5,269729.5,3933459892.6874537,33311665205.28092,36746167772.18264,1732977696.26255,48171766358.83573,3995325.0,-248040925.0,103281603747.0,1057121645.5,17301790401.0,3510897664.5,18917285179.0,3678935.5,72067.0,20910.26571563038,89907374.0,-23.677720207253884,4.5302,3.2927230819888047,87.05418559230677,14.916694106025686,394.3728715702681,45000.0,-0.2225209339563143,0.9749279121818236,0.0,0.0,0.0,0.0,0.0,0.0,1.0,0.0,0.0,0.0,1.0,0.0,0.0,0.0,0.0,0.0,0.0,0.0,1.0,0.0,1.0,0.0,0.0,0.0,0.0,1.0,0.0,0.0,0.0,0.0,0.0,0.0,0.0,0.0,0.0,0.0,0.0,0.0,1.0,0.0,0.0,0.0,0.0,0.0,0.0,0.0,0.0,0.0,0.0,0.0,0.0,0.0,0.0,0.0,0.0,0.0,0.0,0.0,0.0,0.0,0.0,0.0,0.0,0.0,0.0,0.0,0.0,0.0,0.0,0.0,0.0,0.0,0.0,0.0,0.0,0.0,0.0,0.0,0.0,1.0,0.0,0.0,0.0,0.0,0.0,0.0,0.0,0.0,0.0,0.0,0.0,0.0,0.0,0.0,0.0,0.0,0.0,0.0,0.0,0.0,0.0,0.0,0.0,0.0,0.0,0.0,0.0,0.0,0.0,0.0,0.0,0.0,0.0,0.0,0.0,0.0,0.0,0.0,0.0,0.0
106590,0,0.0,0.0,0.0,1.0,0.0,360000.0,512446.5,29416.5,463500.0,0.04622,58.95616438356164,,-9846.0,-5037.0,,2.0,1.0,1.0,10.0,,0.7344780124567138,0.6313545365850379,,,,,,,,,,,,,,,,,,,,,,,,,,,,,,,,,,,,,,,,,,,,,0.0,0.0,0.0,0.0,-763.0,0.0,0.0,0.0,0.0,2.0,5.0,1.0,0.0,0.0,1.0,0.0,0.0,0.0,0.0,0.0,0.0,0.0,0.0,0.0,0.0,0.0,0.0,1.0,0.0,0.0,0.0,0.0,0.0,0.0,0.0,0.0,0.0,0.0,0.0,0.0,0.0,0.0,0.0,6.0,0.0,288.0,217926.0,0.0,0.0,0.0,0.0,0.0,-1284.0,-1010.0,-528.0,-713.0,265.0,-24.0,13.0,68785.98749999999,0.0,0.0,0.0,679500.0,9.0,-468.0,365243.0,-491.5,-281.5,-251.5,-278.5,10.0,1.0,0.0,-1.0,29.0,12.0,4.0,-14.0,0.0,0.0,28.0,52678.125,52678.125,-395.0,-393.0,3.0,3.0,0.0,,,,,,,,,,,,,,,,,,,,,8362853257.5,184678255264.5,165833810154.0,52068644155.935,1863.0,1706.0,71128.0,71060.0,9141.0,507045.0,,,,,,,128658.0,664046.0,,,,13552194.791780423,,-923558495.0,-297071199.0,-1538010568.0416667,44113.0,30770.0,,,,,,,,158330.43141718963,126344.09088890506,,,,,,,3720876.0,,,,,,,,,,,,,,,,437346.0,432132.0,,6436.732669002894,633115.0,626657.0,,,,,,,,,42.5,105806577.73499988,36479029.59000001,10978193267.819984,3591731207.474997,129662049.42000005,867895.7849999996,210.0,27930.0,-35795857.5,15817895.0,-18618764.5,-20247167.0,-20.75,0.0,576.0,157500.0,0.0,0.0,0.0,0.0,0.0,-1873.0,-1506.0,-713.0,-713.0,378634978.0575025,5387551700.759999,6040049209.605002,87474453.39,5387433794.009999,388706.0,-26870823.0,6279785199.5,278724236.0,1421837518.0,618968795.0,1496468280.0,387553.0,6043.0,1096.8070232088955,9082835.0,3190209.0,1970830.0,-6413217.0,1957039.0,246830.0,4240419111.652548,4304768861.002547,-259334555.5,-257164193.0,4629072.0,213065.5,,,,,,,,,,,,,,,,,,,,,1470240.0,14885096.0,3238356.0,8571990.0,11629159.0,1418597.0,1062813542.6295012,802468852.874995,72243817034.33214,21716983879.44762,584068981.9769987,5792665.7475,689.5,94245.0,-277430412.0,21998049.5,-123999528.5,-219096858.5,-2028113.0,,,,,,,,,,,,,,,,,,,,,4281034.0,2483924.5,-9020443.0,921848.5,37582.5,3740774026.162458,3665431256.6924586,-261119463.0,-257800975.5,2531125.5,269732.5,3933528678.674953,33311665205.28092,36746167772.18264,1732977696.26255,48172445858.83573,3995334.0,-248041393.0,103281968990.0,1057121154.0,17301790119.5,3510897413.0,18917284900.5,3678945.5,72068.0,20910.26571563038,89907373.0,,1.4234625,12.238029677221968,721.507289381204,17.420376319412576,1027.0385699107924,180000.0,0.6234898018587336,0.7818314824680298,0.0,1.0,0.0,0.0,0.0,0.0,0.0,0.0,0.0,1.0,0.0,0.0,0.0,0.0,0.0,0.0,0.0,0.0,1.0,0.0,1.0,0.0,0.0,0.0,0.0,1.0,0.0,0.0,0.0,0.0,0.0,0.0,0.0,0.0,0.0,0.0,0.0,0.0,0.0,0.0,0.0,0.0,0.0,0.0,0.0,0.0,0.0,0.0,0.0,0.0,0.0,0.0,0.0,0.0,0.0,0.0,0.0,0.0,0.0,0.0,0.0,0.0,0.0,0.0,0.0,0.0,0.0,0.0,0.0,0.0,0.0,0.0,0.0,0.0,0.0,0.0,0.0,0.0,0.0,0.0,0.0,0.0,0.0,0.0,0.0,0.0,0.0,0.0,0.0,0.0,0.0,0.0,0.0,0.0,0.0,0.0,0.0,0.0,0.0,0.0,0.0,0.0,0.0,0.0,0.0,1.0,0.0,0.0,0.0,0.0,0.0,0.0,0.0,0.0,0.0,0.0,0.0,0.0,0.0,0.0
106607,0,0.0,0.0,0.0,1.0,0.0,121500.0,906660.0,34308.0,675000.0,0.006207,59.89315068493151,,-7845.0,-5162.0,,2.0,2.0,2.0,9.0,0.5146037476960051,0.6524476883654644,0.4848514754962666,,,,,,,,,,,,,,,,,,,,,,,,,,,,,,,,,,,,,,,,,,,,,0.0,0.0,0.0,0.0,0.0,0.0,0.0,0.0,0.0,0.0,0.0,1.0,0.0,0.0,1.0,0.0,0.0,0.0,0.0,0.0,0.0,0.0,0.0,0.0,1.0,0.0,0.0,0.0,0.0,0.0,0.0,0.0,0.0,0.0,0.0,0.0,0.0,0.0,0.0,0.0,0.0,0.0,0.0,9.0,0.0,,243000.0,0.0,0.0,0.0,0.0,0.0,-2038.0,-1123.0,-227.0,-1834.0,541.0,-34.0,0.0,,,,,,,,,,,,,,,,,0.0,,,,,,0.0,,,,,,,0.0,,,,,,,,,,,,,,,,,,,,,8362887565.5,184679161924.5,165834485154.0,52068765655.935,1863.0,1706.0,71128.0,71060.0,9141.0,507045.0,,,,,,,128658.0,664048.0,,,,13552254.684931109,,-923563657.0,-297071199.0,-1538018413.0416667,44113.0,30770.0,,,,,,,67621.32528315201,158331.08386487802,126344.57574038056,,,,,,,3720885.0,,,,,,,,,,,,,,,,437346.0,432132.0,,6436.738876002894,633117.0,626659.0,,,,,,,,,67.0,107115602.80499987,,11011564922.93998,3603146676.1649976,129708654.66000004,868255.7849999996,211.0,27942.0,-35939980.0,15830582.0,-18699048.0,-20339629.0,-34.0,0.0,,57343.5,0.0,0.0,0.0,0.0,0.0,-2219.0,-1826.0,-877.0,-1834.0,,,,,,,,,,,,,,,,,,,,,,,,,,,,,,,,,,,,,,,,,,,,,,,,1470249.0,14885637.0,3238356.0,8571990.0,11629159.0,1418597.0,1062813542.6295012,,72244060034.33214,21716983879.44762,584068981.9769987,5792665.7475,689.5,94245.0,-277432450.0,21996926.5,-123999755.5,-219098692.5,-2028147.0,,,,,,,,,,,,,,,,,,,,,,,,,,,,,,,,,,,,,,,,,,,,,,,,,7.4622222222222225,3.5414480587618047,212.1084822262789,26.42707240293809,1582.800629590766,60750.0,1.0,0.0,0.0,0.0,0.0,0.0,0.0,0.0,0.0,0.0,0.0,1.0,0.0,0.0,0.0,0.0,0.0,0.0,0.0,0.0,1.0,0.0,1.0,0.0,0.0,0.0,0.0,1.0,0.0,0.0,0.0,0.0,0.0,0.0,0.0,0.0,0.0,0.0,0.0,0.0,0.0,0.0,0.0,0.0,0.0,0.0,0.0,0.0,0.0,0.0,0.0,0.0,0.0,0.0,0.0,0.0,0.0,0.0,0.0,0.0,0.0,0.0,0.0,0.0,0.0,0.0,0.0,0.0,0.0,0.0,0.0,0.0,0.0,0.0,0.0,0.0,0.0,0.0,0.0,0.0,0.0,0.0,0.0,0.0,0.0,0.0,0.0,0.0,0.0,0.0,0.0,0.0,0.0,0.0,0.0,0.0,0.0,0.0,0.0,0.0,0.0,0.0,0.0,0.0,0.0,0.0,0.0,1.0,0.0,0.0,0.0,0.0,0.0,0.0,0.0,0.0,0.0,0.0,0.0,0.0,0.0,0.0
106610,0,0.0,0.0,0.0,0.0,2.0,135000.0,360000.0,28440.0,360000.0,0.016612,36.49315068493151,-403.0,-3708.0,-5950.0,,4.0,2.0,2.0,8.0,0.5895710936943527,0.5521569836360225,0.3457848024695955,,,,,,,,,,,,,,,,,,,,,,,,,,,,,,,,,,,,,,,,,,,,,0.0,0.0,0.0,0.0,-385.0,0.0,0.0,0.0,0.0,1.0,0.0,1.0,1.0,0.0,1.0,1.0,0.0,0.0,0.0,0.0,0.0,1.0,1.0,0.0,1.0,0.0,0.0,0.0,0.0,0.0,0.0,0.0,0.0,0.0,0.0,0.0,0.0,0.0,0.0,0.0,0.0,0.0,0.0,5.0,0.0,,229500.0,93959.28,0.0,0.0,0.0,0.0,-1403.0,-369.0,-335.0,-1211.0,197.0,-25.0,1.0,29688.885,125923.5,111721.5,18000.0,125923.5,4.0,-385.0,365243.0,-355.0,-265.0,-265.0,-260.0,9.0,1.0,0.1511209503716527,100.0,5.0,4.0,2.0,-11.0,0.0,0.0,5.0,29816.64,29688.885,-304.0,-295.0,3.0,2.0,0.0,,,,,,,,,,,,,,,,,,,,,8362916005.5,184679521924.5,165834845154.0,52068900655.935,1863.0,1706.0,71128.0,71061.0,9141.0,507045.0,,,,,,,128660.0,664052.0,,,,13552291.178081792,-603003912.0,-923569607.0,-297071584.0,-1538022121.0416667,44113.0,30770.0,,,,,,,67621.91485424567,158331.63602186163,126344.92152518305,,,,,,,3720893.0,,,,,,,,,,,,,,,,437346.0,432132.0,,6436.755488002896,633119.0,626661.0,,,,,,,,,46.0,107147125.30499987,,11014168735.43998,3604385664.2249975,129708654.66000004,868255.7849999996,211.0,27942.0,-35949165.0,15828129.0,-18703300.0,-20346135.0,-23.5,0.0,,103387.5,0.0,0.0,0.0,0.0,0.0,-1770.0,-1406.0,-1208.0,-1211.0,380006860.0950024,5408067610.259999,6062806479.105002,87935955.39,5408067610.259999,389864.0,-26961801.0,6296027410.0,278665488.0,1424355135.0,621130558.0,1500084609.0,388684.0,6061.0,1099.657069004395,9183793.0,3199822.0,1976670.0,-6430981.0,1957039.0,246830.0,4255277026.5900617,4319421091.200003,-260610030.0,-258432650.0,4662778.0,213657.0,,,,,,,,,,,,,,,,,,,,,1470254.0,14885834.0,3238356.0,8571995.0,11629164.0,1418598.0,1062813542.6295012,,72244289534.33214,21717077838.72762,584068981.9769987,5792665.7475,689.5,94245.0,-277433853.0,21996557.5,-124000090.5,-219099903.5,-2028172.0,,,,,,,,,,,,,,,,,,,,,4281038.0,2483926.5,-9020454.0,921848.5,37582.5,3740803842.802458,3665460945.5774593,-261119767.0,-257801270.5,2531128.5,269734.5,3933558367.559954,33311791128.78092,36746279493.68264,1732995696.26255,48172571782.33573,3995338.0,-248041778.0,103282334233.0,1057120799.0,17301789854.5,3510897148.0,18917284640.5,3678954.5,72069.0,20910.41683658076,89907473.0,-11.043168168168169,2.6666666666666665,4.746835443037975,173.22698109935843,12.658227848101266,461.93861626495584,33750.0,0.6234898018587334,-0.7818314824680299,0.0,0.0,0.0,0.0,0.0,0.0,1.0,0.0,0.0,0.0,0.0,0.0,0.0,1.0,0.0,0.0,0.0,0.0,1.0,0.0,1.0,0.0,0.0,0.0,0.0,1.0,0.0,0.0,0.0,0.0,0.0,0.0,0.0,0.0,0.0,0.0,0.0,0.0,0.0,0.0,0.0,0.0,0.0,0.0,1.0,0.0,0.0,0.0,0.0,0.0,0.0,0.0,0.0,0.0,0.0,0.0,0.0,0.0,0.0,0.0,0.0,0.0,0.0,0.0,0.0,0.0,0.0,0.0,0.0,0.0,0.0,0.0,0.0,0.0,0.0,0.0,0.0,0.0,0.0,0.0,0.0,1.0,0.0,0.0,0.0,0.0,0.0,0.0,0.0,0.0,0.0,0.0,0.0,0.0,0.0,0.0,0.0,0.0,0.0,0.0,0.0,0.0,0.0,0.0,0.0,0.0,0.0,0.0,0.0,0.0,0.0,0.0,0.0,0.0,0.0,0.0,0.0,0.0,0.0,0.0
106611,0,0.0,0.0,1.0,0.0,0.0,78750.0,675000.0,28728.0,675000.0,0.020713,49.92876712328767,-7048.0,-8435.0,-1776.0,15.0,2.0,3.0,3.0,9.0,,0.5145670367196721,,,,,,,,,,,,,,,,,,,,,,,,,,,,,,,,,,,,,,,,,,,,,,0.0,0.0,0.0,0.0,-1499.0,,,,,,,1.0,1.0,1.0,1.0,0.0,0.0,0.0,0.0,0.0,0.0,1.0,1.0,0.0,1.0,0.0,0.0,0.0,0.0,0.0,0.0,0.0,0.0,0.0,0.0,0.0,0.0,0.0,0.0,0.0,0.0,0.0,0.0,0.0,,,,,,,,,,,,,0.0,,1.0,21748.95,117279.0,123084.0,0.0,117279.0,6.0,-1499.0,365243.0,-1460.0,-1310.0,-1310.0,-1306.0,10.0,0.0,0.0,270.0,7.0,6.0,3.0,-46.0,0.0,0.0,6.0,21748.95,21748.95,-1414.0,-1385.0,3.5,1.0,0.0,,,,,,,,,,,,,,,,,,,,,8362944733.5,184680196924.5,165835520154.0,52068979405.935,,,,,,,,,,,,,128660.0,664054.0,,,,13552341.106848914,-603010960.0,-923571383.0,-297073083.0,-1538030556.0416667,44113.0,30770.0,,,,,,,,158332.15058889837,,,,,,,,3720902.0,,,,,,,,,,,,,,,,437346.0,432132.0,1265328.0,6436.776201002896,633122.0,626664.0,,,,,,,,,,,,,,,,,,,,,,,,,,,,,,,,,,,380028609.0450024,5408184889.259999,6062929563.105002,87935955.39,5408184889.259999,389870.0,-26963300.0,6296392653.0,278664028.0,1424353825.0,621129248.0,1500083303.0,388694.0,6061.0,1099.657069004395,9184063.0,3199854.0,1976685.0,-6431186.0,1957054.0,246830.0,4255412786.685062,4319527031.91,-260615535.0,-258438080.0,4662796.5,213664.5,,,,,,,,,,,,,,,,,,,,,1470254.0,14885834.0,3238356.0,8572002.0,11629170.0,1418599.0,,,,,,,,,,,,,,,,,,,,,,,,,,,,,,,,,,4281044.0,2483929.5,-9020500.0,921848.5,37582.5,3740825591.7524576,3665482694.527458,-261121181.0,-257802655.5,2531132.0,269735.5,3933580116.5099545,33311908407.78092,36746402577.68264,1732995696.26255,48172689061.33573,3995344.0,-248043277.0,103282699476.0,1057119339.0,17301788544.5,3510895838.0,18917283334.5,3678964.5,72069.0,20910.41683658076,89907743.0,-141.1611062335382,8.571428571428571,2.7412280701754392,136.86613794760876,23.496240601503764,1173.138325265218,39375.0,-0.2225209339563143,0.9749279121818236,0.0,0.0,0.0,0.0,0.0,0.0,1.0,0.0,0.0,0.0,1.0,0.0,0.0,0.0,0.0,0.0,0.0,0.0,1.0,0.0,1.0,0.0,0.0,0.0,0.0,1.0,0.0,0.0,0.0,0.0,0.0,0.0,0.0,0.0,0.0,0.0,0.0,0.0,0.0,0.0,0.0,0.0,0.0,0.0,0.0,0.0,0.0,0.0,0.0,0.0,0.0,0.0,0.0,0.0,0.0,0.0,0.0,0.0,0.0,1.0,0.0,0.0,0.0,0.0,0.0,0.0,0.0,0.0,0.0,0.0,0.0,0.0,0.0,0.0,0.0,0.0,0.0,0.0,0.0,0.0,0.0,0.0,0.0,0.0,0.0,0.0,0.0,0.0,0.0,0.0,0.0,0.0,0.0,0.0,0.0,0.0,0.0,0.0,0.0,0.0,0.0,0.0,0.0,0.0,0.0,0.0,0.0,0.0,0.0,0.0,0.0,0.0,0.0,0.0,0.0,0.0,0.0,0.0,0.0,0.0
106612,0,0.0,1.0,0.0,0.0,0.0,292500.0,675000.0,49117.5,675000.0,0.030755,23.046575342465754,-1567.0,-6740.0,-1095.0,,1.0,2.0,2.0,14.0,0.7283909593360675,0.5274018159673388,0.3328505641648731,,,,,,,,,,,,,,,,,,,,,,,,,,,,,,,,,,,,,,,,,,,,,0.0,0.0,0.0,0.0,-438.0,0.0,0.0,0.0,0.0,2.0,2.0,1.0,1.0,1.0,1.0,0.0,0.0,0.0,0.0,0.0,0.0,0.0,0.0,0.0,1.0,0.0,0.0,0.0,0.0,0.0,0.0,0.0,0.0,0.0,0.0,0.0,0.0,0.0,0.0,0.0,0.0,0.0,0.0,1.0,19350.0,,249736.5,211950.0,,0.0,0.0,0.0,-157.0,30908.0,-15.0,,6.0,-2.5,2.0,10160.28,42747.75,47261.25,0.0,85495.5,12.0,-310.5,365243.0,-408.0,-78.0,-78.0,-71.0,17.0,1.0,0.0,1079.5,12.0,12.0,6.5,-8.5,0.0,0.0,12.0,10160.28,10160.28,-243.0,-243.0,6.5,1.0,0.0,,,,,,,,,,,,,,,,,,,,,8362993851.0,184680871924.5,165836195154.0,52069271905.935,1863.0,1706.0,71128.0,71063.0,9141.0,507047.0,,,,,,,128660.0,664055.0,,,,13552364.15342426,-603012527.0,-923572478.0,-297073521.0,-1538037296.0416667,44113.0,30770.0,,,,,,,67622.64324520504,158332.6779907143,126345.2543757472,,,,,,,3720916.0,,,,,,,,,,,,,,,,437346.0,432132.0,,6436.806956002894,633124.0,626666.0,,,,,,,,,6.0,107187238.30499987,,11015321846.93998,3604597614.2249975,,868255.7849999996,211.0,27942.0,-35951136.0,15859037.0,-18703678.0,,-2.5,19350.0,,249736.5,211950.0,,0.0,0.0,0.0,-157.0,30908.0,-15.0,,380038769.3250024,5408270384.759999,6063024085.605002,87935955.39,5408270384.759999,389882.0,-26963829.5,6296757896.0,278663620.0,1424353747.0,621129170.0,1500083232.0,388720.0,6062.0,1099.657069004395,9186222.5,3199950.0,1976732.0,-6431376.0,1957054.0,246830.0,4255533165.825063,4319647411.049997,-260620825.0,-258443212.0,4662844.5,213673.5,,,,,,,,,,,,,,,,,,,,,1470255.0,14885840.0,3238356.0,8572014.0,11629182.0,1418601.0,1062832892.6295012,,72244539270.83214,21717289788.72762,,5792665.7475,689.5,94245.0,-277434010.0,22027465.5,-124000105.5,,-2028174.5,,,,,,,,,,,,,,,,,,,,,4281056.0,2483936.0,-9020508.5,921848.5,37582.5,3740835752.032458,3665492854.8074594,-261121424.0,-257802898.5,2531138.5,269736.5,3933590276.789954,33311951155.53092,36746449838.93264,1732995696.26255,48172774556.83573,3995356.0,-248043587.5,103283064719.0,1057118931.0,17301788466.5,3510895760.0,18917283263.5,3678981.5,72070.0,20910.41683658076,89908822.5,-67.99274845458868,2.3076923076923075,5.955107650022904,137.24483712874704,13.742556115437472,316.7188549124932,292500.0,-0.9009688679024191,-0.433883739117558,0.0,0.0,0.0,0.0,0.0,0.0,1.0,0.0,0.0,0.0,0.0,0.0,0.0,1.0,0.0,1.0,0.0,0.0,0.0,0.0,0.0,0.0,1.0,0.0,0.0,1.0,0.0,0.0,0.0,0.0,0.0,0.0,0.0,0.0,0.0,0.0,0.0,0.0,0.0,0.0,0.0,0.0,0.0,0.0,0.0,0.0,0.0,0.0,0.0,0.0,0.0,0.0,0.0,1.0,0.0,0.0,0.0,0.0,0.0,0.0,0.0,0.0,0.0,0.0,0.0,0.0,0.0,0.0,0.0,0.0,0.0,0.0,0.0,0.0,0.0,0.0,0.0,0.0,0.0,0.0,0.0,0.0,0.0,0.0,0.0,0.0,0.0,0.0,0.0,0.0,0.0,0.0,0.0,0.0,0.0,0.0,0.0,0.0,0.0,0.0,0.0,0.0,0.0,0.0,0.0,0.0,0.0,0.0,0.0,0.0,0.0,0.0,0.0,0.0,0.0,0.0,0.0,0.0,0.0,0.0
106624,0,0.0,1.0,0.0,1.0,0.0,157500.0,479700.0,50503.5,450000.0,0.018029,65.44109589041096,,-3809.0,-3653.0,,2.0,3.0,2.0,10.0,,0.5876879009390755,0.5388627065779676,0.2021,0.1284,0.9896,0.8572,0.0944,0.2,0.1724,0.375,0.375,0.0958,0.1614,0.228,0.0154,0.0312,0.2059,0.1333,0.9896,0.8628,0.0952,0.2014,0.1724,0.375,0.375,0.0979,0.1763,0.2376,0.0156,0.033,0.204,0.1284,0.9896,0.8591,0.095,0.2,0.1724,0.375,0.375,0.0974,0.1642,0.2321,0.0155,0.0318,0.2377,1.0,2.0,0.0,2.0,0.0,-1179.0,0.0,0.0,0.0,0.0,2.0,1.0,1.0,0.0,0.0,1.0,0.0,0.0,0.0,0.0,0.0,0.0,0.0,0.0,0.0,1.0,0.0,0.0,0.0,0.0,0.0,0.0,0.0,0.0,0.0,0.0,0.0,0.0,0.0,0.0,0.0,0.0,0.0,0.0,1.0,29106.0,,688716.0,472671.0,,0.0,0.0,0.0,-460.0,636.0,-3.0,,16.0,-7.5,3.0,73116.27,810000.0,810000.0,17707.5,810000.0,12.0,-999.0,365243.0,-967.0,-457.0,-277.0,-450.0,6.0,0.0,0.0544545454545454,16.0,38.0,18.0,9.5,-21.5,0.0,0.0,38.0,73116.27,73116.27,-666.0,-652.0,6.5,1.0,0.0,,,,,,,,,,,,,,,,,,,,,8363044354.5,184681351624.5,165836645154.0,52069429405.935,1863.0,1706.0,71128.0,71065.0,9141.0,507048.0,17842.816900002308,17905.151199999127,17355.771699997968,11318.323500000097,11256.029800000097,11202.982000000064,128660.0,664057.0,4146.834000000114,4144.409100000013,3954.812100000093,13552429.59452015,,-923576131.0,-297074700.0,-1538041105.0416667,44113.0,30770.0,11370.7139999992,11246.579999998992,10730.232099997284,22932.126700009867,22853.73520000984,22238.207000008388,,158333.26567861522,126345.7932384538,35068.48070002806,35008.5569000285,34453.34510002891,22995.25629999585,22968.23269999543,22614.455199995667,3720926.0,8311.72100000017,8416.502800000078,8139.649300000231,9835.55250000072,9950.678800002148,10311.135199999626,16499.975099999712,16685.604999999687,16281.8615999997,830.2025000001773,815.3652000000461,761.277600000013,3920.462900000125,3903.719000000162,3736.267700000161,437348.0,432134.0,,6436.824985002894,633127.0,626668.0,,16364.212999999794,154481.04049999078,154483.78259999034,154375.4752999871,77752.44639999633,78090.89210000659,78493.19430000674,16.0,107318503.66499989,,11034367230.46498,3610550008.484997,,868255.7849999996,211.0,27942.0,-36018134.0,15893432.0,-18743808.0,,-7.5,29106.0,,688716.0,472671.0,,0.0,0.0,0.0,-460.0,636.0,-3.0,,381152857.0950024,5424918796.259999,6081878347.605002,88080949.89,5424918796.259999,391044.0,-27011877.0,6308444825.0,278995749.0,1427616197.0,622935367.0,1503346102.0,389559.0,6077.0,1101.2998557249098,9212647.0,3204732.0,1979641.0,-6442402.0,1957091.0,246849.0,4266193530.10507,4329778262.669995,-261093098.0,-258913251.5,4674748.0,214041.5,,,,,,,,,,,,,,,,,,,,,1470256.0,14885856.0,3238356.0,8572052.0,11629220.0,1418604.0,1062861998.6295012,,72245227986.83214,21717762459.72762,,5792665.7475,689.5,94245.0,-277434470.0,22028101.5,-124000108.5,,-2028182.0,,,,,,,,,,,,,,,,,,,,,4281074.0,2483945.5,-9020530.0,921848.5,37582.5,3740908868.302458,3665565971.0774593,-261122090.0,-257803550.5,2531145.0,269737.5,3933663393.059954,33312761155.53092,36747259838.93264,1733013403.76255,48173584556.83573,3995368.0,-248044586.5,103283429962.0,1057117964.0,17301788009.5,3510895483.0,18917282813.5,3678987.5,72070.0,20910.471291126207,89908838.5,,3.045714285714286,3.118595740889245,204.08432292296035,9.498351599394102,621.5825378167877,78750.0,0.6234898018587336,0.7818314824680298,0.0,0.0,0.0,0.0,0.0,1.0,0.0,0.0,0.0,1.0,0.0,0.0,0.0,0.0,0.0,1.0,0.0,0.0,0.0,0.0,1.0,0.0,0.0,0.0,0.0,1.0,0.0,0.0,0.0,0.0,0.0,0.0,0.0,0.0,0.0,0.0,0.0,0.0,0.0,0.0,0.0,0.0,0.0,0.0,0.0,0.0,0.0,0.0,0.0,0.0,0.0,0.0,0.0,0.0,0.0,0.0,0.0,0.0,0.0,0.0,0.0,0.0,0.0,0.0,0.0,0.0,0.0,0.0,0.0,0.0,0.0,0.0,0.0,0.0,0.0,0.0,0.0,0.0,0.0,0.0,0.0,0.0,0.0,0.0,0.0,0.0,0.0,0.0,0.0,0.0,0.0,0.0,0.0,0.0,0.0,0.0,0.0,0.0,0.0,0.0,0.0,0.0,0.0,0.0,0.0,1.0,0.0,0.0,1.0,0.0,1.0,0.0,0.0,0.0,0.0,0.0,0.0,1.0,0.0,0.0
106631,0,0.0,0.0,0.0,1.0,1.0,135000.0,260640.0,27499.5,225000.0,0.0084739999999999,37.56438356164384,-2861.0,-7717.0,-3595.0,,3.0,2.0,2.0,15.0,0.8321663398087628,0.6672197738473675,0.5531646987710016,0.1237,0.092,0.9886,,,0.12,0.1034,0.375,,0.0167,,0.1394,,,0.1261,0.0955,0.9886,,,0.1208,0.1034,0.375,,0.0171,,0.1452,,,0.1249,0.092,0.9886,,,0.12,0.1034,0.375,,0.017,,0.1419,,,0.1329,1.0,2.0,0.0,2.0,0.0,-1080.0,0.0,0.0,0.0,0.0,0.0,0.0,1.0,1.0,1.0,1.0,1.0,0.0,0.0,0.0,0.0,0.0,0.0,0.0,0.0,1.0,0.0,0.0,0.0,0.0,0.0,0.0,0.0,0.0,0.0,0.0,0.0,0.0,0.0,0.0,0.0,0.0,0.0,0.0,6.0,4746.3975,0.0,139254.75,0.0,0.0,0.0,0.0,0.0,-1032.0,-697.5,-669.0,-886.0,177.0,-17.0,4.0,12641.22,101871.0,101871.0,3053.925,101871.0,12.0,-869.5,365243.0,-860.5,-695.5,-530.5,-690.5,16.5,0.0,0.0544566092472152,35.0,15.0,12.0,9.0,-29.0,0.0,0.0,13.0,12641.22,12641.22,-903.0,-866.0,4.0,1.0,0.0,,,,,,,,,,,,,,,,,,,,,8363071854.0,184681612264.5,165836870154.0,52069564405.935,1863.0,1706.0,71128.0,71065.0,9141.0,507048.0,17842.94060000231,17905.276099999126,17355.89779999797,11318.415500000096,11256.121800000095,11203.077500000065,128661.0,664060.0,,,,13552467.15890371,-603015388.0,-923579726.0,-297075780.0,-1538048822.0416667,44113.0,30770.0,11370.8339999992,11246.699999998991,10730.352899997286,22932.230100009867,22853.83860000984,22238.310400008388,67623.47541154483,158333.93289838903,126346.34640315257,35068.85570002806,35008.9319000285,34453.72010002891,,,,3720941.0,8311.73770000017,8416.519800000078,8139.666400000231,,,,16500.114499999712,16685.746899999685,16282.0067999997,,,,,,,437350.0,432136.0,,6436.833459002894,633129.0,626670.0,,16364.345899999797,154482.0290999908,154484.77119999035,154376.4638999871,,,,34.5,107412611.06249988,36654364.80000001,11046654688.409985,3615950770.6049967,129802613.13000004,868255.7849999996,211.0,27942.0,-36063504.0,15968929.0,-18767245.0,-20409416.0,-16.75,0.0,0.0,170554.5,0.0,0.0,0.0,0.0,0.0,-1042.0,-738.0,-776.0,-886.0,381440557.1700024,5428064180.61,6084976048.605002,88159701.24,5428064180.61,391230.0,-27024230.0,6313375400.5,278985570.0,1429070484.0,623295406.0,1504800453.5,389858.0,6081.0,1101.9037252409855,9213502.5,3206790.0,1980896.0,-6445475.0,1957116.0,246849.0,4269140175.375072,4332668058.495001,-261185654.0,-259003342.0,4675661.0,214210.0,,,,,,,,,,,,,,,,,,,,,1470262.0,14886033.0,3238356.0,8572067.0,11629233.0,1418608.0,1062866745.0270011,802468852.874995,72245367241.58214,21717762459.72762,584068981.9769987,5792665.7475,689.5,94245.0,-277435502.0,22027404.0,-124000777.5,-219100789.5,-2028199.0,,,,,,,,,,,,,,,,,,,,,4281086.0,2483954.5,-9020559.0,921848.5,37582.5,3740921509.5224576,3665578612.297458,-261122993.0,-257804416.5,2531149.0,269738.5,3933676034.279953,33312863026.53092,36747361709.93264,1733016457.6875498,48173686427.83573,3995380.0,-248045456.0,103283795205.0,1057117103.5,17301787314.0,3510894952.5,18917282123.0,3679004.0,72070.0,20910.525747735453,89908873.5,-76.1625701991102,1.9306666666666668,4.909180166912126,184.4103267631018,9.477990508918344,356.03487087062854,45000.0,1.0,0.0,0.0,0.0,0.0,0.0,0.0,0.0,1.0,0.0,0.0,0.0,0.0,0.0,0.0,1.0,0.0,0.0,0.0,0.0,1.0,0.0,1.0,0.0,0.0,0.0,0.0,1.0,0.0,0.0,0.0,0.0,0.0,0.0,0.0,1.0,0.0,0.0,0.0,0.0,0.0,0.0,0.0,0.0,0.0,0.0,0.0,0.0,0.0,0.0,0.0,0.0,0.0,0.0,0.0,0.0,0.0,0.0,0.0,0.0,0.0,0.0,0.0,0.0,0.0,0.0,0.0,0.0,0.0,0.0,0.0,0.0,0.0,0.0,0.0,0.0,0.0,0.0,0.0,0.0,1.0,0.0,0.0,0.0,0.0,0.0,0.0,0.0,0.0,0.0,0.0,0.0,0.0,0.0,0.0,0.0,0.0,0.0,0.0,0.0,0.0,0.0,0.0,0.0,0.0,0.0,0.0,0.0,0.0,0.0,0.0,0.0,1.0,0.0,0.0,0.0,0.0,0.0,0.0,1.0,0.0,0.0
106647,0,0.0,1.0,0.0,1.0,0.0,202500.0,573408.0,29407.5,495000.0,0.010556,36.81643835616438,-135.0,-173.0,-3525.0,,2.0,3.0,3.0,12.0,0.0391544897623066,0.1311065302391449,0.6058362647264226,,,,,,,,,,,,,,,,,,,,,,,,,,,,,,,,,,,,,,,,,,,,,0.0,0.0,0.0,0.0,-116.0,0.0,0.0,0.0,0.0,1.0,5.0,1.0,1.0,0.0,1.0,0.0,0.0,0.0,0.0,0.0,0.0,1.0,1.0,0.0,1.0,0.0,0.0,0.0,0.0,0.0,0.0,0.0,0.0,0.0,0.0,0.0,0.0,0.0,0.0,0.0,0.0,0.0,0.0,2.0,0.0,0.0,86805.0,0.0,0.0,0.0,0.0,0.0,-1303.0,902.5,-600.0,-761.5,87.0,-21.0,10.0,19191.6675,101250.0,134955.0,38250.0,157500.0,12.0,-1312.0,365243.0,-1281.0,-933.0,-933.0,-926.5,15.0,0.0,0.1761764705882352,-1.0,82.0,12.0,8.5,-42.0,0.0,0.0,89.0,7941.69,7941.69,-1265.0,-1273.0,8.0,1.0,37.0,0.0,45000.0,0.0,0.0,0.0,1125.0,0.0,2250.0,0.0,0.0,0.0,0.0,0.0,0.0,0.0,0.5,0.0,-19.0,0.0,0.0,8363101261.5,184682185672.5,165837365154.0,52069766905.935,1863.0,1706.0,71128.0,71066.0,9141.0,507053.0,,,,,,,128661.0,664062.0,,,,13552503.975342069,-603015523.0,-923583251.0,-297075896.0,-1538048995.0416667,44113.0,30770.0,,,,,,,67623.51456603459,158334.0640049193,126346.95223941728,,,,,,,3720953.0,,,,,,,,,,,,,,,,437350.0,432136.0,,6436.844015002896,633132.0,626673.0,,,,,,,,,43.5,107644320.94499987,36672598.35000002,11095137142.10998,3638909482.5599976,130082726.56500004,868255.7849999996,212.0,27942.0,-36183814.0,15999364.0,-18832777.0,-20481122.0,-21.25,0.0,0.0,61110.0,0.0,0.0,0.0,0.0,0.0,-1464.0,2208.0,-832.0,-1146.0,382068833.53500223,5437731698.46,6095837267.955003,88426807.74,5438226698.46,392040.0,-27086001.0,6327979703.0,278934633.5,1431585508.5,624364816.5,1507684670.0,390645.5,6093.0,1104.9710947952394,9226442.5,3213075.0,1984731.0,-6462357.0,1957123.0,246856.0,4280207703.570058,4344044710.634996,-262195320.0,-260007517.0,4703840.0,214612.0,4011291050.129946,10759684500.0,335806649.505,513183138.92999977,15180147.540000005,161547724.98000032,227913099.0749989,566321557.4549872,524212081.7399981,3850807250.7900014,3996751052.429926,3996939656.969925,17215.0,46545.0,224.0,29106.0,1338647.0,-2367990.0,847368.0,2220.0,1470264.0,14886120.0,3238393.0,8572149.0,11629322.0,1418618.0,1062866745.0270011,802468852.874995,72245454046.58214,21717762459.72762,584068981.9769987,5792665.7475,689.5,94245.0,-277436805.0,22028306.5,-124001377.5,-219101551.0,-2028220.0,5931554724.044963,18760297500.0,198925482.825,448764994.4849976,1948107.735,257389722.78750083,309552468.99749875,637483549.6574978,459798849.2024992,5716427173.852535,5894781936.4125,5895025119.157501,13396.5,81013.5,44.0,70512.5,972846.0,-1701598.0,177423.0,6755.0,4281098.0,2483963.0,-9020601.0,921848.5,37582.5,3740929451.2124577,3665586553.987458,-261124258.0,-257805689.5,2531157.0,269739.5,3933695225.9474554,33312964276.53092,36747496664.93264,1733054707.6875498,48173843927.83573,3995392.0,-248046768.0,103284160448.0,1057115822.5,17301786381.0,3510894019.5,18917281196.5,3679019.0,72070.0,20910.70192420604,89908872.5,-3.6668403036166097,2.8316444444444446,6.885998469778117,253.5179381832283,19.498699311400152,717.8726612235486,101250.0,-0.2225209339563146,-0.9749279121818236,0.0,0.0,0.0,0.0,0.0,0.0,1.0,0.0,0.0,0.0,0.0,0.0,0.0,1.0,0.0,0.0,0.0,0.0,1.0,0.0,1.0,0.0,0.0,0.0,0.0,0.0,0.0,0.0,0.0,1.0,0.0,0.0,0.0,0.0,0.0,0.0,0.0,0.0,1.0,0.0,0.0,0.0,0.0,0.0,0.0,0.0,0.0,0.0,0.0,0.0,0.0,0.0,0.0,1.0,0.0,0.0,0.0,0.0,0.0,0.0,0.0,0.0,0.0,0.0,0.0,0.0,0.0,0.0,0.0,0.0,0.0,0.0,0.0,0.0,0.0,0.0,0.0,0.0,0.0,0.0,0.0,0.0,0.0,0.0,0.0,0.0,0.0,0.0,0.0,0.0,0.0,0.0,0.0,0.0,0.0,0.0,0.0,0.0,0.0,0.0,0.0,0.0,0.0,0.0,0.0,0.0,0.0,0.0,0.0,0.0,0.0,0.0,0.0,0.0,0.0,0.0,0.0,0.0,0.0,0.0
106660,0,0.0,1.0,1.0,1.0,1.0,180000.0,522396.0,38142.0,472500.0,0.010966,42.50410958904109,-750.0,-6281.0,-4423.0,15.0,2.0,2.0,2.0,9.0,,0.4335481390464437,0.2940831009471255,0.0907,0.0576,0.9896,,,0.0,0.2069,0.1667,,0.0527,,0.0827,,0.0815,0.0924,0.0598,0.9896,,,0.0,0.2069,0.1667,,0.0539,,0.0862,,0.0863,0.0916,0.0576,0.9896,,,0.0,0.2069,0.1667,,0.0537,,0.0842,,0.0832,0.0715,1.0,0.0,0.0,0.0,0.0,-705.0,0.0,0.0,0.0,0.0,1.0,3.0,1.0,1.0,0.0,1.0,0.0,0.0,0.0,0.0,0.0,0.0,0.0,0.0,0.0,1.0,0.0,0.0,0.0,0.0,0.0,0.0,0.0,0.0,0.0,0.0,0.0,0.0,0.0,0.0,0.0,0.0,0.0,0.0,8.0,6348.735,0.0,90151.9875,0.0,0.0,0.0,0.0,0.0,-744.0,-305.0,-339.0,-446.0,230.0,-15.0,7.0,7344.81,58990.5,67360.5,0.0,58990.5,10.0,-705.0,365243.0,-1679.0,-1559.0,-1289.0,-1551.0,11.0,0.0,0.0,15.0,18.0,10.0,4.0,-78.5,0.0,0.0,86.0,66.15,66.15,-2286.0,-2286.0,37.5,0.0,96.0,0.0,0.0,0.0,0.0,0.0,0.0,0.0,66.15,0.0,0.0,0.0,0.0,0.0,0.0,0.0,0.0,28.0,-48.5,0.0,0.0,8363139403.5,184682708068.5,165837837654.0,52069946905.935,1863.0,1706.0,71128.0,71067.0,9141.0,507056.0,17843.03130000231,17905.367699999126,17355.99019999797,11318.473100000096,11256.179400000095,11203.137300000064,128662.0,664064.0,,,,13552546.479451654,-603016273.0,-923587674.0,-297076601.0,-1538055276.0416667,44113.0,30770.0,11370.8339999992,11246.699999998991,10730.352899997286,22932.437000009868,22854.04550000984,22238.517300008392,,158334.49755305835,126347.24632251824,35069.022400028065,35009.098600028505,34453.886800028915,,,,3720962.0,8311.79040000017,8416.573500000079,8139.720300000231,,,,16500.197199999708,16685.831099999687,16282.0929999997,,,,3920.544400000125,3903.8022000001615,3736.354000000161,437350.0,432136.0,1265343.0,6436.854981002894,633134.0,626675.0,,16364.417399999797,154483.0186999908,154485.76079999036,154377.4534999871,,,,24.0,107689018.45499988,36743081.85000002,11128109626.39498,3656650037.759998,130321954.03500004,868255.7849999996,213.0,27942.0,-36236636.5,16137573.0,-18858129.5,-20509515.0,-12.5,6348.735,0.0,113756.7375,0.0,0.0,0.0,0.0,0.0,-1039.0,-305.0,-348.0,-960.0,382699258.24500215,5446892058.434999,6105960691.605002,88701136.065,5446892058.434999,392792.0,-27148527.0,6342769132.0,279988637.0,1434477927.0,625801804.0,1510577639.0,391374.0,6110.0,1108.353595752718,9237641.0,3220241.0,1989150.0,-6478818.5,2057278.0,246856.0,4287176851.275049,4351262060.204986,-262766961.5,-260575971.5,4713186.5,215123.0,4018619415.869943,10788304500.0,335851649.505,513382379.2199999,15180147.540000005,161701965.27000022,228356463.59999883,566850797.8199866,524739030.389998,3857839525.665,4004078428.439922,4004267032.979921,17217.0,46570.0,224.0,29129.0,1344015.0,-2376237.5,847368.0,2220.0,1470272.0,14886350.0,3238489.0,8572167.0,11629408.0,1418625.0,1062873093.7620012,802468852.874995,72245544198.56964,21717762459.72762,584068981.9769987,5792665.7475,689.5,94245.0,-277437549.0,22028001.5,-124001716.5,-219101997.0,-2028235.0,5931554724.044963,18760297500.0,198925482.825,448764994.4849976,1948107.735,257389722.78750083,309552468.99749875,637483615.8074977,459798849.2024992,5716427173.852535,5894781936.4125,5895025119.157501,13396.5,81013.5,44.0,70512.5,972874.0,-1701646.5,177423.0,6755.0,4281108.0,2483967.0,-9020679.5,921848.5,37582.5,3740929517.3624578,3665586620.1374593,-261126544.0,-257807975.5,2531194.5,269739.5,3933702570.757455,33313023267.03092,36747564025.43264,1733054707.6875498,48173902918.33573,3995402.0,-248047473.0,103284525691.0,1057114143.5,17301784822.0,3510892730.5,18917279645.5,3679030.0,72070.0,20910.70192420604,89908887.5,-17.64535258476215,2.9022,4.719207173194903,200.585698862865,13.696083058046248,582.1398152398067,90000.0,-0.9009688679024191,0.4338837391175582,0.0,0.0,0.0,0.0,0.0,0.0,1.0,0.0,0.0,0.0,0.0,0.0,0.0,1.0,0.0,0.0,0.0,0.0,1.0,0.0,0.0,0.0,1.0,0.0,0.0,1.0,0.0,0.0,0.0,0.0,0.0,0.0,0.0,0.0,0.0,0.0,0.0,0.0,1.0,0.0,0.0,0.0,0.0,0.0,0.0,0.0,0.0,0.0,0.0,0.0,0.0,0.0,0.0,1.0,0.0,0.0,0.0,0.0,0.0,0.0,0.0,0.0,0.0,0.0,0.0,0.0,0.0,0.0,0.0,0.0,0.0,0.0,0.0,0.0,0.0,0.0,0.0,0.0,0.0,0.0,0.0,0.0,0.0,0.0,0.0,0.0,0.0,0.0,0.0,0.0,0.0,0.0,0.0,0.0,0.0,0.0,0.0,0.0,0.0,0.0,0.0,0.0,0.0,0.0,0.0,0.0,0.0,0.0,0.0,0.0,1.0,0.0,0.0,0.0,0.0,0.0,0.0,0.0,1.0,0.0
106674,0,0.0,1.0,1.0,0.0,0.0,432000.0,315000.0,20259.0,315000.0,0.0035409999999999,34.06849315068493,-3490.0,-213.0,-4622.0,7.0,2.0,1.0,1.0,12.0,0.3679524223483409,0.5906096839837228,0.475849908720221,0.1072,,0.9871,,,,,0.2083,,,,0.1281,,,0.1092,,0.9871,,,,,0.2083,,,,0.1335,,,0.1083,,0.9871,,,,,0.2083,,,,0.1304,,,0.1123,1.0,0.0,0.0,0.0,0.0,-1955.0,0.0,0.0,0.0,0.0,3.0,2.0,1.0,1.0,1.0,1.0,0.0,0.0,1.0,0.0,1.0,1.0,0.0,1.0,0.0,1.0,0.0,0.0,0.0,0.0,0.0,0.0,0.0,0.0,0.0,0.0,0.0,0.0,0.0,0.0,0.0,0.0,0.0,0.0,9.0,0.0,2102.6925,450000.0,0.0,0.0,0.0,0.0,0.0,-1180.0,-3.0,-214.0,-229.0,404.0,-26.0,5.0,15110.415,103455.0,180000.0,22950.0,166371.75,12.0,-780.0,365243.0,-1170.5,-900.5,-152.0,182355.0,15.0,0.0,0.1002727510646903,29.0,30.0,12.0,5.0,-44.5,0.0,0.0,112.0,431.64,431.64,-1302.0,-1308.5,24.5,0.0,70.0,0.0,180000.0,0.0,0.0,0.0,0.0,0.0,431.64,431.64,0.0,0.0,0.0,0.0,0.0,0.0,0.0,14.0,-35.5,0.0,0.0,8363159662.5,184683023068.5,165838152654.0,52070378905.935,1863.0,1706.0,71128.0,71070.0,9141.0,507058.0,17843.138500002307,17905.475999999126,17356.09939999797,,,,128662.0,664066.0,,,,13552580.547944808,-603019763.0,-923592296.0,-297078556.0,-1538055489.0416667,44113.0,30770.0,,,,,,,67623.88251845693,158335.08816274232,126347.72217242696,35069.23070002806,35009.3069000285,34454.09510002891,,,,3720974.0,,,,,,,16500.325299999713,16685.961499999685,16282.2264999997,,,,,,,437350.0,432136.0,1265350.0,6436.858522002895,633135.0,626676.0,,16364.529699999795,154484.0057999908,154486.74789999035,154378.4405999871,,,,39.0,107823857.66999988,36840334.09500001,11152624253.084984,3664759454.594998,130636324.48500004,868255.7849999996,213.0,27942.0,-36327028.0,16124660.0,-18898942.0,-20559009.0,-19.0,0.0,4205.385,504000.0,0.0,0.0,0.0,0.0,0.0,-1732.0,-450.0,-214.0,-937.0,383531521.1400021,5458246875.18,6118870373.955003,88941023.46,5458195147.68,393685.0,-27203968.0,6357916574.5,281770793.0,1440288778.0,628707703.5,1515661358.5,392285.0,6124.0,1111.561848192643,9268891.0,3225773.5,1993179.5,-6489024.0,2057278.0,246856.0,4295937007.800039,4360262684.715004,-263501331.5,-261305666.5,4731235.0,215504.0,4031340423.029944,10840077000.0,336790349.505,514757153.2499998,15180147.540000005,162137823.25500026,229144827.86999887,568402421.8949803,526087689.29999787,3870022750.2900014,4016745875.924925,4016936685.4649215,17291.0,46697.0,224.0,29182.0,1350511.0,-2389546.0,847392.0,2243.0,1470281.0,14886754.0,3238559.0,8572197.0,11629520.0,1418630.0,1062873093.7620012,802470955.567495,72245994198.56964,21717762459.72762,584068981.9769987,5792665.7475,689.5,94245.0,-277438729.0,22027998.5,-124001930.5,-219102226.0,-2028261.0,5931554724.044963,18760477500.0,198925482.825,448764994.4849976,1948107.735,257389722.78750083,309552468.99749875,637484047.4474977,459799280.8424992,5716427173.852535,5894781936.4125,5895025119.157501,13396.5,81013.5,44.0,70512.5,972888.0,-1701682.0,177423.0,6755.0,4281120.0,2483972.0,-9020724.0,921848.5,37582.5,3740929949.0024576,3665587051.777458,-261127846.0,-257809284.0,2531219.0,269739.5,3933717681.172455,33313126722.03092,36747744025.43264,1733077657.6875498,48174069290.08573,3995414.0,-248048253.0,103284890934.0,1057112973.0,17301783921.5,3510892578.5,18917462000.5,3679045.0,72070.0,20910.802196957105,89908916.5,-102.44069159630078,0.7291666666666666,21.32385606397157,726.4716442616068,15.548645046645934,529.7189072740882,216000.0,-0.2225209339563146,-0.9749279121818236,0.0,0.0,0.0,0.0,0.0,0.0,1.0,0.0,0.0,0.0,0.0,0.0,0.0,1.0,0.0,1.0,0.0,0.0,0.0,0.0,1.0,0.0,0.0,0.0,0.0,1.0,0.0,0.0,0.0,0.0,0.0,0.0,0.0,0.0,0.0,0.0,1.0,0.0,0.0,0.0,0.0,0.0,0.0,0.0,0.0,0.0,0.0,0.0,0.0,0.0,0.0,0.0,0.0,0.0,0.0,0.0,0.0,0.0,0.0,0.0,0.0,0.0,0.0,0.0,0.0,0.0,0.0,0.0,0.0,0.0,0.0,0.0,0.0,0.0,0.0,0.0,1.0,0.0,0.0,0.0,0.0,0.0,0.0,0.0,0.0,0.0,0.0,0.0,0.0,0.0,0.0,0.0,0.0,0.0,0.0,0.0,0.0,0.0,0.0,0.0,0.0,0.0,0.0,0.0,0.0,0.0,0.0,0.0,0.0,0.0,0.0,0.0,0.0,0.0,0.0,0.0,0.0,0.0,0.0,0.0
106687,0,0.0,0.0,1.0,0.0,0.0,36000.0,90000.0,9220.5,90000.0,0.026392,58.98630136986301,,-7993.0,-4450.0,8.0,2.0,2.0,2.0,12.0,0.7694076148633695,0.6096818312415048,0.2418614865234661,,,,,,,,,,,,,,,,,,,,,,,,,,,,,,,,,,,,,,,,,,,,,1.0,1.0,1.0,1.0,-444.0,0.0,0.0,0.0,0.0,0.0,1.0,1.0,0.0,0.0,1.0,1.0,0.0,0.0,0.0,0.0,0.0,0.0,0.0,0.0,1.0,0.0,0.0,0.0,0.0,0.0,0.0,0.0,0.0,0.0,0.0,0.0,0.0,0.0,0.0,0.0,0.0,0.0,0.0,10.0,0.0,0.0,55350.0,0.0,0.0,0.0,0.0,0.0,-1011.0,-722.5,-561.5,-910.0,308.0,-16.0,1.0,11281.05,102555.0,102555.0,0.0,102555.0,10.0,-444.0,365243.0,-409.0,-139.0,-139.0,-135.0,14.0,0.0,0.0,50.0,11.0,10.0,5.0,-9.0,0.0,0.0,10.0,11281.05,11281.05,-285.5,-274.0,5.5,1.0,0.0,,,,,,,,,,,,,,,,,,,,,8363168883.0,184683113068.5,165838242654.0,52070414905.935,1863.0,1706.0,71128.0,71070.0,9141.0,507059.0,,,,,,,128662.0,664068.0,,,,13552639.534246176,,-923596746.0,-297079000.0,-1538063482.0416667,44114.0,30771.0,,,,,,,67624.65192607179,158335.69784457356,126347.96403391346,,,,,,,3720986.0,,,,,,,,,,,,,,,,437351.0,432137.0,1265358.0,6436.884914002894,633137.0,626678.0,,,,,,,,,33.5,108035446.49999988,36885861.22500002,11185874354.609983,3677186131.739998,130636324.48500004,868255.7849999996,213.0,27942.0,-36398568.5,16230308.0,-18933301.5,-20601345.0,-16.75,0.0,0.0,37680.84,0.0,0.0,0.0,0.0,0.0,-1093.0,-817.0,-963.0,-1002.0,384341634.405002,5470013296.440001,6131666555.955003,89075480.22,5470013296.440001,394439.0,-27261143.0,6373071716.0,282823746.0,1443176210.0,630873601.0,1518550613.0,393240.0,6134.0,1113.4496352175745,9292016.0,3229694.0,1995624.0,-6501436.0,2057278.0,246856.0,4302159814.575037,4366594772.415011,-263900307.5,-261701168.5,4736658.5,215808.5,,,,,,,,,,,,,,,,,,,,,1470291.0,14887062.0,3238559.0,8572208.0,11629530.0,1418631.0,1062873093.7620012,802470955.567495,72246049548.56964,21717762459.72762,584068981.9769987,5792665.7475,689.5,94245.0,-277439740.0,22027276.0,-124002492.0,-219103136.0,-2028277.0,,,,,,,,,,,,,,,,,,,,,4281130.0,2483977.0,-9020733.0,921848.5,37582.5,3740941230.052458,3665598332.8274593,-261128131.5,-257809558.0,2531224.5,269740.5,3933728962.222455,33313229277.03092,36747846580.43264,1733077657.6875498,48174171845.08573,3995424.0,-248048697.0,103285256177.0,1057112564.0,17301783782.5,3510892439.5,18917461865.5,3679059.0,72070.0,20910.802196957105,89908966.5,,2.5,3.904343582235237,230.30278719321825,9.760858955588091,575.7569679830455,18000.0,-0.2225209339563146,-0.9749279121818236,0.0,0.0,0.0,0.0,0.0,0.0,1.0,0.0,0.0,1.0,0.0,0.0,0.0,0.0,0.0,0.0,0.0,0.0,1.0,0.0,1.0,0.0,0.0,0.0,0.0,1.0,0.0,0.0,0.0,0.0,0.0,0.0,0.0,0.0,0.0,0.0,0.0,0.0,0.0,0.0,0.0,0.0,0.0,0.0,0.0,0.0,0.0,0.0,0.0,0.0,0.0,0.0,0.0,0.0,0.0,0.0,0.0,0.0,0.0,0.0,0.0,0.0,0.0,0.0,0.0,0.0,0.0,0.0,0.0,0.0,0.0,0.0,0.0,0.0,0.0,0.0,0.0,0.0,0.0,0.0,0.0,0.0,0.0,0.0,0.0,0.0,0.0,0.0,0.0,0.0,0.0,0.0,0.0,0.0,0.0,0.0,0.0,0.0,0.0,0.0,0.0,0.0,0.0,0.0,0.0,1.0,0.0,0.0,0.0,0.0,0.0,0.0,0.0,0.0,0.0,0.0,0.0,0.0,0.0,0.0
106712,0,0.0,0.0,0.0,0.0,0.0,103500.0,450000.0,24412.5,450000.0,0.01885,26.235616438356168,-467.0,-6549.0,-1282.0,,1.0,2.0,2.0,15.0,0.2917314765609127,0.6553872858196438,,,,,,,,,,,,,,,,,,,,,,,,,,,,,,,,,,,,,,,,,,,,,,0.0,0.0,0.0,0.0,-307.0,,,,,,,1.0,1.0,0.0,1.0,1.0,1.0,0.0,0.0,0.0,1.0,1.0,0.0,0.0,1.0,0.0,0.0,0.0,0.0,0.0,0.0,0.0,0.0,0.0,0.0,0.0,0.0,0.0,0.0,0.0,0.0,0.0,0.0,0.0,,,,,,,,,,,,,0.0,,3.0,6001.38,33705.0,32134.5,3370.5,33705.0,6.0,-307.0,365243.0,-1014.0,-624.0,-594.0,-619.5,15.0,0.5,0.1033874258828047,12.0,30.0,24.0,9.5,-44.5,0.0,0.0,28.0,4365.54,4365.54,-1353.0,-1346.0,8.5,1.0,0.0,,,,,,,,,,,,,,,,,,,,,8363193295.5,184683563068.5,165838692654.0,52070518405.935,,,,,,,,,,,,,128662.0,664069.0,,,,13552665.769862616,-603020230.0,-923598028.0,-297079307.0,-1538070031.0416667,44114.0,30771.0,,,,,,,67624.94365754839,158336.35323185936,,,,,,,,3721001.0,,,,,,,,,,,,,,,,437351.0,432137.0,,6436.903764002896,633139.0,626680.0,,,,,,,,,,,,,,,,,,,,,,,,,,,,,,,,,,,385225075.4400021,5482134922.185,6145030421.955003,89287509.465,5482134922.185,395467.0,-27324781.0,6393707233.5,283870153.5,1448254950.5,632308457.5,1523995254.0,394266.0,6154.0,1117.0500416036907,9306961.0,3240197.0,2001900.5,-6520886.0,2057278.0,246856.0,4314487524.885077,4379170521.105047,-264631743.5,-262426113.5,4745661.5,216492.5,,,,,,,,,,,,,,,,,,,,,1470291.0,14887062.0,3238559.0,8572238.0,11629558.0,1418634.0,,,,,,,,,,,,,,,,,,,,,,,,,,,,,,,,,,4281154.0,2483986.5,-9020777.5,921848.5,37582.5,3740945595.592458,3665602698.3674593,-261129484.5,-257810904.0,2531233.0,269741.5,3933734963.602455,33313262982.03092,36747878714.93264,1733081028.1875498,48174205550.08573,3995430.0,-248049004.0,103285621420.0,1057111550.0,17301783158.5,3510891845.5,18917461246.0,3679074.0,72070.5,20910.905584382992,89908978.5,-17.800229741019216,4.3478260869565215,4.23963133640553,111.22934158197084,18.433179723502302,483.60583296509054,103500.0,1.0,0.0,0.0,0.0,0.0,0.0,0.0,0.0,1.0,0.0,1.0,0.0,0.0,0.0,0.0,0.0,0.0,1.0,0.0,0.0,0.0,0.0,0.0,1.0,0.0,0.0,0.0,0.0,0.0,0.0,0.0,1.0,0.0,0.0,0.0,0.0,0.0,0.0,0.0,0.0,0.0,0.0,0.0,0.0,0.0,0.0,0.0,0.0,0.0,0.0,0.0,0.0,0.0,0.0,0.0,1.0,0.0,0.0,0.0,0.0,0.0,0.0,0.0,0.0,0.0,0.0,0.0,0.0,0.0,0.0,0.0,0.0,0.0,0.0,0.0,0.0,0.0,0.0,0.0,0.0,0.0,0.0,0.0,0.0,0.0,0.0,0.0,0.0,0.0,0.0,0.0,0.0,0.0,0.0,0.0,0.0,0.0,0.0,0.0,0.0,0.0,0.0,0.0,0.0,0.0,0.0,0.0,0.0,0.0,0.0,0.0,0.0,0.0,0.0,0.0,0.0,0.0,0.0,0.0,0.0,0.0,0.0
106713,0,0.0,0.0,0.0,0.0,0.0,94500.0,334152.0,16204.5,270000.0,0.0105,57.39178082191781,,-12870.0,-4419.0,,2.0,3.0,3.0,10.0,,0.569916117398671,0.3425288720742255,,,,,,,,,,,,,,,,,,,,,,,,,,,,,,,,,,,,,,,,,,,,,1.0,0.0,1.0,0.0,-2004.0,0.0,0.0,0.0,0.0,1.0,0.0,1.0,0.0,0.0,1.0,1.0,0.0,0.0,0.0,0.0,0.0,0.0,0.0,0.0,0.0,0.0,0.0,1.0,0.0,0.0,0.0,0.0,0.0,0.0,0.0,0.0,0.0,0.0,0.0,0.0,0.0,0.0,0.0,12.0,0.0,0.0,38747.25,0.0,0.0,0.0,0.0,0.0,-513.5,-380.5,-431.0,-466.0,234.0,-10.0,1.0,2649.375,23175.0,22414.5,5400.0,23175.0,12.0,-2004.0,365243.0,-1940.0,-1640.0,-1610.0,-1636.0,13.0,0.0,0.2114397493785942,85.0,13.0,11.0,6.0,-60.0,0.0,0.0,11.0,2649.375,2649.375,-1830.0,-1790.0,6.0,1.0,0.0,,,,,,,,,,,,,,,,,,,,,8363209500.0,184683897220.5,165838962654.0,52070612905.935,1863.0,1706.0,71128.0,71071.0,9141.0,507059.0,,,,,,,128662.0,664071.0,,,,13552723.161643434,,-923602447.0,-297081311.0,-1538082901.0416667,44114.0,30771.0,,,,,,,,158336.92314797678,126348.30656278555,,,,,,,3721011.0,,,,,,,,,,,,,,,,437352.0,432138.0,,6436.914264002896,633142.0,626683.0,,,,,,,,,17.5,108393588.22499986,37032574.72500002,11215807699.904984,3691364625.809999,130636324.48500004,868255.7849999996,213.0,27942.0,-36482982.0,16323862.0,-18971538.0,-20645681.0,-8.25,0.0,0.0,50989.5,0.0,0.0,0.0,0.0,0.0,-678.0,-440.0,-480.0,-494.0,385233726.1950021,5482190452.185,6145083683.955003,89296144.965,5482190452.185,395485.0,-27327092.0,6394255098.0,283867338.0,1448252750.0,632306317.0,1523993060.0,394294.0,6154.0,1117.364868778952,9307058.0,3240620.0,2002133.0,-6522007.0,2057278.0,246856.0,4314562355.925077,4379245352.145047,-264662442.0,-262456442.0,4745846.0,216512.0,,,,,,,,,,,,,,,,,,,,,1470303.0,14887296.0,3238559.0,8572251.0,11629569.0,1418635.0,1062873093.7620012,802470955.567495,72246088295.81964,21717762459.72762,584068981.9769987,5792665.7475,689.5,94245.0,-277440253.5,22026895.5,-124002923.0,-219103602.0,-2028287.0,,,,,,,,,,,,,,,,,,,,,4281165.0,2483992.5,-9020837.5,921848.5,37582.5,3740948244.967458,3665605347.7424593,-261131314.5,-257812694.0,2531239.0,269742.5,3933737612.977455,33313286157.03092,36747901129.43264,1733086428.1875498,48174228725.08573,3995442.0,-248051008.0,103285986663.0,1057109610.0,17301781518.5,3510890235.5,18917459610.0,3679087.0,72070.5,20911.117024132367,89909063.5,,3.536,5.831713412940849,334.6924180117395,20.62093862815885,1183.472390089511,47250.0,-0.9009688679024191,-0.433883739117558,0.0,0.0,0.0,0.0,0.0,0.0,1.0,0.0,0.0,1.0,0.0,0.0,0.0,0.0,0.0,0.0,0.0,0.0,1.0,0.0,1.0,0.0,0.0,0.0,0.0,0.0,0.0,1.0,0.0,0.0,0.0,0.0,0.0,0.0,0.0,0.0,0.0,0.0,0.0,0.0,0.0,0.0,0.0,0.0,0.0,0.0,0.0,0.0,0.0,0.0,0.0,0.0,0.0,0.0,0.0,0.0,0.0,0.0,0.0,0.0,0.0,0.0,0.0,0.0,0.0,0.0,0.0,0.0,0.0,0.0,0.0,0.0,0.0,0.0,0.0,0.0,0.0,0.0,0.0,0.0,0.0,0.0,0.0,0.0,0.0,0.0,0.0,0.0,0.0,0.0,0.0,0.0,0.0,0.0,0.0,0.0,0.0,0.0,0.0,0.0,0.0,0.0,0.0,0.0,0.0,1.0,0.0,0.0,0.0,0.0,0.0,0.0,0.0,0.0,0.0,0.0,0.0,0.0,0.0,0.0
106717,0,0.0,1.0,1.0,1.0,1.0,270000.0,290353.5,19534.5,220500.0,0.007305,49.509589041095886,-913.0,-4680.0,-1597.0,15.0,3.0,3.0,3.0,8.0,,0.6316509261453298,0.5460231970049609,0.1247,0.0565,0.9836,0.7756,0.0049,0.04,0.0345,0.3333,0.375,0.0186,0.1017,0.0432,0.0,0.0,0.1271,0.0586,0.9836,0.7844,0.0049,0.0403,0.0345,0.3333,0.375,0.0191,0.1111,0.045,0.0,0.0,0.126,0.0565,0.9836,0.7786,0.0049,0.04,0.0345,0.3333,0.375,0.019,0.1035,0.044,0.0,0.0,0.0366,1.0,0.0,0.0,0.0,0.0,-2480.0,0.0,0.0,0.0,0.0,0.0,0.0,1.0,1.0,0.0,1.0,0.0,1.0,0.0,0.0,0.0,0.0,0.0,0.0,0.0,1.0,0.0,0.0,0.0,0.0,0.0,0.0,0.0,0.0,0.0,0.0,0.0,0.0,0.0,0.0,0.0,0.0,0.0,0.0,12.0,0.0,0.0,116550.0,0.0,0.0,0.0,0.0,0.0,-1238.5,-5.5,-556.5,-2004.5,602.0,-30.5,9.0,8948.295,121374.0,71874.0,4500.0,121374.0,12.0,-761.0,365243.0,-1714.0,-814.0,-304.0,-807.0,9.0,1.0,0.2099250017522954,-1.0,81.0,46.0,28.0,-59.0,0.0,0.0,194.0,254.07,254.07,-1736.0,-1736.0,39.0,0.0,95.0,0.0,112500.0,0.0,0.0,0.0,0.0,0.0,254.07,0.0,0.0,0.0,0.0,0.0,0.0,0.0,0.0,25.0,-49.0,0.0,0.0,8363229034.5,184684187574.0,165839183154.0,52070882905.935,1863.0,1706.0,71128.0,71071.0,9141.0,507059.0,17843.263200002308,17905.601999999126,17356.226499997967,11318.529600000094,11256.235900000098,11203.195900000064,128663.0,664074.0,4146.838900000114,4144.4140000000125,3954.817000000093,13552772.671232477,-603021143.0,-923604044.0,-297083791.0,-1538087581.0416667,44114.0,30771.0,11370.8739999992,11246.739999998992,10730.393199997288,22932.47150000988,22854.08000000984,22238.5518000084,,158337.55479890294,126348.85258598256,35069.56400002806,35009.6402000285,34454.42840002891,22995.63129999585,22968.60769999543,22614.830199995667,3721019.0,8311.80900000017,8416.592500000079,8139.7394000002305,9835.65420000072,9950.782300002147,10311.246299999626,16500.368499999713,16686.005499999686,16282.2714999997,830.2025000001773,815.3652000000461,761.277600000013,3920.544400000125,3903.8022000001615,3736.354000000161,437352.0,432138.0,1265373.0,6436.921569002896,633145.0,626686.0,,16364.566299999797,154484.9893999908,154487.73149999036,154379.42419998712,77753.22199999631,78091.6707000066,78493.97870000674,41.0,108479087.23499988,37048432.27500001,11227839044.894987,3695940510.6149983,131186922.03000005,868255.7849999996,213.0,27942.0,-36536686.0,16310551.5,-18996463.0,-20680652.0,-20.0,0.0,0.0,80100.0,0.0,0.0,0.0,0.0,0.0,-2615.0,-1618.0,-1605.0,-2528.0,385447451.49000216,5485266166.185,6148200473.955003,89456664.465,5485266166.185,395679.0,-27343354.0,6398455392.5,283853944.5,1449337302.5,632298036.5,1525077671.5,394508.0,6157.0,1119.2097820363692,9312330.0,3243455.0,2003859.0,-6527174.0,2057282.0,246860.0,4316484745.980064,4381674928.110035,-264898092.0,-262690397.0,4753294.0,216607.0,4040921038.544944,10884717000.0,337654574.505,516358333.6199998,15180147.540000005,162874778.62500024,229815823.4549989,570276132.2999808,527885898.11999744,3879214227.0450015,4026319367.399923,4026510176.939922,17346.0,47091.0,224.0,29521.0,1356351.0,-2398969.0,847439.0,2252.0,1470315.0,14887898.0,3238654.0,8572332.0,11629763.0,1418644.0,1062873093.7620012,802470955.567495,72246204845.81964,21717762459.72762,584068981.9769987,5792665.7475,689.5,94245.0,-277441492.0,22026890.0,-124003479.5,-219105606.5,-2028317.5,5931554724.044963,18760590000.0,198925482.825,448764994.4849976,1948107.735,257389722.78750083,309552468.99749875,637484301.5174978,459799280.8424992,5716427173.852535,5894781936.4125,5895025119.157501,13396.5,81013.5,44.0,70512.5,972913.0,-1701731.0,177423.0,6755.0,4281211.0,2484020.5,-9020896.5,921848.5,37582.5,3740948499.037458,3665605601.81246,-261133050.5,-257814430.0,2531278.0,269742.5,3933746561.272455,33313407531.03092,36747973003.43264,1733090928.1875498,48174350099.08573,3995454.0,-248051769.0,103286351906.0,1057107896.0,17301780704.5,3510889931.5,18917458803.0,3679096.0,72071.5,20911.32694913412,89909062.5,-18.44087211554424,1.0753833333333334,13.8217000691085,684.3066902708484,14.863625892651465,735.892009605766,90000.0,0.6234898018587336,0.7818314824680298,0.0,0.0,0.0,0.0,0.0,0.0,1.0,0.0,1.0,0.0,0.0,0.0,0.0,0.0,0.0,1.0,0.0,0.0,0.0,0.0,1.0,0.0,0.0,0.0,0.0,1.0,0.0,0.0,0.0,0.0,0.0,0.0,0.0,0.0,1.0,0.0,0.0,0.0,0.0,0.0,0.0,0.0,0.0,0.0,0.0,0.0,0.0,0.0,0.0,0.0,0.0,0.0,0.0,0.0,0.0,0.0,0.0,0.0,0.0,0.0,0.0,0.0,0.0,0.0,0.0,0.0,0.0,0.0,0.0,0.0,0.0,0.0,0.0,0.0,0.0,0.0,0.0,0.0,0.0,0.0,0.0,0.0,0.0,0.0,0.0,0.0,0.0,0.0,0.0,0.0,0.0,0.0,0.0,0.0,0.0,0.0,0.0,0.0,0.0,0.0,0.0,0.0,1.0,0.0,0.0,0.0,0.0,0.0,1.0,0.0,1.0,0.0,0.0,0.0,0.0,0.0,0.0,0.0,1.0,0.0
106720,0,0.0,1.0,0.0,1.0,0.0,225000.0,512995.5,38484.0,454500.0,0.030755,23.432876712328767,-138.0,-104.0,-1118.0,,2.0,2.0,2.0,13.0,0.175144148711964,0.3609206433649394,0.6626377922738201,0.132,0.0545,0.9995,0.9864,0.0621,0.16,0.069,0.625,0.6667,0.131,0.1076,0.1674,0.0,0.0,0.1345,0.0566,0.9995,0.9869,0.0626,0.1611,0.069,0.625,0.6667,0.134,0.1175,0.1744,0.0,0.0,0.1332,0.0545,0.9995,0.9866,0.0625,0.16,0.069,0.625,0.6667,0.1333,0.1095,0.1704,0.0,0.0,0.1759,1.0,0.0,0.0,0.0,0.0,-551.0,0.0,0.0,0.0,0.0,1.0,1.0,1.0,1.0,0.0,1.0,0.0,0.0,0.0,0.0,0.0,0.0,0.0,0.0,0.0,1.0,0.0,0.0,0.0,0.0,0.0,0.0,0.0,0.0,0.0,0.0,0.0,0.0,0.0,0.0,0.0,0.0,0.0,0.0,3.0,0.0,,22500.0,0.0,0.0,0.0,0.0,0.0,-879.0,-512.0,-566.0,-614.0,86.0,-14.0,2.0,8601.4575,78867.98999999999,82490.48999999999,0.0,78867.98999999999,11.0,-375.5,365243.0,-340.0,182421.5,-40.0,182424.5,15.0,0.0,0.0,115.0,13.0,10.0,8.5,-7.0,0.0,0.0,12.0,10121.22,10121.22,-293.0,-280.0,3.0,1.0,0.0,,,,,,,,,,,,,,,,,,,,,8363267518.5,184684700569.5,165839637654.0,52071107905.935,1863.0,1706.0,71128.0,71072.0,9141.0,507060.0,17843.39520000231,17905.735199999126,17356.360999997967,11318.584100000096,11256.290400000098,11203.252500000064,128663.0,664076.0,4146.901000000114,4144.4765000000125,3954.879600000093,13552796.104109189,-603021281.0,-923605162.0,-297084342.0,-1538087685.0416667,44114.0,30771.0,11371.0339999992,11246.899999998992,10730.554299997286,22932.54050000988,22854.14900000984,22238.6208000084,67625.11880169707,158337.91571954632,126349.51522377484,35070.18900002806,35010.2652000285,34455.05340002891,22996.297999995848,22969.274399995436,22615.49689999567,3721032.0,8311.940000000171,8416.725800000078,8139.8734000002305,9835.76180000072,9950.891800002148,10311.363799999626,16500.535899999708,16686.175899999685,16282.4458999997,830.2025000001773,815.3652000000461,761.277600000013,3920.544400000125,3903.8022000001615,3736.354000000161,437352.0,432138.0,,6436.952324002896,633147.0,626688.0,,16364.742199999797,154485.9888999908,154488.73099999034,154380.42369998712,77754.20839999629,78092.6573000066,78494.96560000675,29.0,108533951.23499988,,11232664028.414986,3696845091.975,131298323.67000005,868255.7849999996,213.0,27942.0,-36554891.0,16392144.0,-19006139.0,-20688763.0,-14.0,0.0,,22500.0,0.0,0.0,0.0,0.0,0.0,-879.0,-512.0,-566.0,-614.0,385714100.8575022,5489111071.665,6152338513.935002,89522296.965,5489111071.665,395979.0,-27360541.5,6402838308.5,284209776.0,1450428282.0,632660140.0,1526168694.0,394736.0,6161.0,1119.9640421437132,9314610.0,3247322.0,2006114.5,-6531422.0,2057324.0,246872.0,4322105942.467518,4386792051.4725065,-265119959.0,-262910860.0,4757107.0,216854.5,,,,,,,,,,,,,,,,,,,,,1470318.0,14887984.0,3238654.0,8572345.0,11629775.0,1418646.0,1062873093.7620012,,72246227345.81964,21717762459.72762,584068981.9769987,5792665.7475,689.5,94245.0,-277442371.0,22026378.0,-124004045.5,-219106220.5,-2028331.5,,,,,,,,,,,,,,,,,,,,,4281221.0,2484029.0,-9020903.5,921848.5,37582.5,3740958620.2574577,3665615723.0324593,-261133343.5,-257814710.0,2531281.0,269743.5,3933755162.7299542,33313486399.020924,36748055493.92264,1733090928.1875498,48174428967.07572,3995465.0,-248052144.5,103286717149.0,1057107556.0,17301963126.0,3510889891.5,18917641227.5,3679111.0,72071.5,20911.32694913412,89909177.5,-5.889161697649947,2.27998,5.8465855940130975,137.0023194125863,13.33009822263798,312.36254821430856,112500.0,0.6234898018587336,0.7818314824680298,0.0,0.0,0.0,0.0,0.0,0.0,1.0,0.0,0.0,0.0,0.0,0.0,0.0,1.0,0.0,1.0,0.0,0.0,0.0,1.0,0.0,0.0,0.0,0.0,0.0,1.0,0.0,0.0,0.0,0.0,0.0,0.0,0.0,0.0,0.0,0.0,0.0,0.0,0.0,0.0,0.0,0.0,0.0,0.0,0.0,0.0,0.0,1.0,0.0,0.0,0.0,0.0,0.0,0.0,0.0,0.0,0.0,0.0,0.0,0.0,0.0,0.0,0.0,0.0,0.0,0.0,0.0,0.0,0.0,0.0,0.0,0.0,0.0,0.0,0.0,0.0,0.0,0.0,0.0,0.0,0.0,0.0,0.0,0.0,0.0,0.0,1.0,0.0,0.0,0.0,0.0,0.0,0.0,0.0,0.0,0.0,0.0,0.0,0.0,0.0,0.0,0.0,0.0,0.0,0.0,0.0,1.0,0.0,0.0,0.0,1.0,0.0,0.0,0.0,0.0,1.0,0.0,0.0,0.0,0.0
106721,0,0.0,0.0,0.0,1.0,1.0,94500.0,260640.0,24034.5,225000.0,0.007114,45.52876712328767,-519.0,-1745.0,-168.0,,3.0,2.0,2.0,10.0,,0.3230394865327506,0.6313545365850379,0.0165,0.0,0.9742,0.6464,0.0,0.0,0.069,0.0417,,0.0268,0.0,0.0127,0.0,0.0039,0.0168,0.0,0.9742,0.6602,0.0,0.0,0.069,0.0417,,0.0274,0.0,0.0133,0.0,0.0041,0.0167,0.0,0.9742,0.6511,0.0,0.0,0.069,0.0417,,0.0273,0.0,0.013,0.0,0.0039,0.0109,1.0,2.0,0.0,2.0,0.0,-1414.0,0.0,0.0,0.0,0.0,1.0,0.0,1.0,1.0,0.0,1.0,1.0,0.0,0.0,0.0,0.0,0.0,0.0,0.0,0.0,1.0,0.0,0.0,0.0,0.0,0.0,0.0,0.0,0.0,0.0,0.0,0.0,0.0,0.0,0.0,0.0,0.0,0.0,0.0,3.0,7647.75,,162000.0,87817.5,0.0,0.0,0.0,0.0,-570.0,527.0,-22.0,,68.0,-11.0,1.0,2869.2,20340.0,14260.5,6750.0,20340.0,6.0,-1414.0,365243.0,-1350.0,-1200.0,-1200.0,-1194.0,10.0,0.0,0.3498899900699,31.0,8.0,6.0,3.5,-43.5,0.0,0.0,6.0,2869.2,2869.2,-1317.0,-1275.0,3.5,1.0,0.0,,,,,,,,,,,,,,,,,,,,,8363291553.0,184684961209.5,165839862654.0,52071202405.935,1863.0,1706.0,71128.0,71073.0,9141.0,507060.0,17843.41170000231,17905.751899999126,17356.377799997972,11318.584100000096,11256.290400000098,11203.252500000064,128664.0,664079.0,4146.901000000114,4144.4765000000125,3954.879600000093,13552841.632876312,-603021800.0,-923605330.0,-297085756.0,-1538089430.0416667,44114.0,30771.0,11371.0339999992,11246.899999998992,10730.554299997286,22932.609500009872,22854.21800000984,22238.6898000084,,158338.23875903286,126350.1465783114,35070.23070002806,35010.3069000285,34455.09510002891,,,,3721042.0,8311.966800000171,8416.753100000078,8139.90080000023,9835.76180000072,9950.891800002148,10311.363799999626,16500.54859999971,16686.188899999685,16282.4591999997,830.2025000001773,815.3652000000461,761.277600000013,3920.548300000125,3903.806100000162,3736.358100000162,437354.0,432140.0,,6436.959438002896,633149.0,626690.0,,16364.753099999794,154486.9630999908,154489.70519999036,154381.39789998712,77754.8547999963,78093.3084000066,78495.62580000675,19.0,108546170.98499988,,11233033028.414986,3696992043.975,131298323.67000005,868255.7849999996,213.0,27942.0,-36557201.0,16392885.0,-19006335.0,,-9.0,9144.0,,162000.0,87817.5,0.0,0.0,0.0,0.0,-570.0,527.0,-22.0,,385720510.90500224,5489165724.165,6152390709.435002,89529046.965,5489165724.165,395991.0,-27362231.0,6403386173.0,284208166.0,1450426882.0,632658845.0,1526167303.0,394753.0,6161.0,1120.313932133783,9314741.0,3247408.0,2006171.5,-6531707.5,2057324.0,246872.0,4322194451.6400175,4386902397.255003,-265127210.5,-262917905.0,4757134.0,216868.5,,,,,,,,,,,,,,,,,,,,,1470321.0,14888052.0,3238654.0,8572353.0,11629781.0,1418647.0,1062880741.5120012,,72246389345.81964,21717850277.22762,584068981.9769987,5792665.7475,689.5,94245.0,-277442941.0,22026905.0,-124004067.5,,-2028342.5,,,,,,,,,,,,,,,,,,,,,4281227.0,2484032.5,-9020947.0,921848.5,37582.5,3740961489.457458,3665618592.2324586,-261134660.5,-257815985.0,2531284.5,269744.5,3933758031.9299545,33313506739.020924,36748069754.42264,1733097678.1875498,48174449307.07572,3995471.0,-248053558.5,103287082392.0,1057106206.0,17301961926.0,3510888691.5,18917640033.5,3679121.0,72071.5,20911.67683912419,89909208.5,-11.39938620772656,2.758095238095238,3.931847968545216,179.01219052406685,10.844411158958996,493.73267024542633,31500.0,-0.9009688679024191,0.4338837391175582,0.0,0.0,0.0,0.0,0.0,1.0,0.0,0.0,0.0,0.0,0.0,0.0,0.0,1.0,0.0,0.0,0.0,0.0,1.0,0.0,1.0,0.0,0.0,0.0,0.0,1.0,0.0,0.0,0.0,0.0,0.0,0.0,0.0,0.0,0.0,0.0,0.0,0.0,0.0,0.0,0.0,0.0,0.0,0.0,1.0,0.0,0.0,0.0,0.0,0.0,0.0,0.0,0.0,0.0,0.0,0.0,0.0,0.0,0.0,0.0,0.0,0.0,0.0,0.0,0.0,0.0,0.0,0.0,0.0,0.0,0.0,0.0,0.0,0.0,0.0,0.0,0.0,0.0,0.0,0.0,0.0,0.0,0.0,0.0,0.0,0.0,0.0,0.0,0.0,0.0,1.0,0.0,0.0,0.0,0.0,0.0,0.0,0.0,0.0,0.0,0.0,0.0,0.0,0.0,0.0,0.0,0.0,0.0,1.0,0.0,1.0,0.0,0.0,0.0,0.0,0.0,0.0,0.0,1.0,0.0
106724,0,0.0,0.0,0.0,1.0,0.0,180000.0,790830.0,62613.0,675000.0,0.035792,55.512328767123286,-528.0,-769.0,-1044.0,,2.0,2.0,2.0,10.0,0.665547294202542,0.7005259525549201,,,,,,,,,,,,,,,,,,,,,,,,,,,,,,,,,,,,,,,,,,,,,,1.0,0.0,1.0,0.0,-2830.0,,,,,,,1.0,1.0,0.0,1.0,1.0,0.0,0.0,0.0,0.0,0.0,0.0,0.0,0.0,1.0,0.0,0.0,0.0,0.0,0.0,0.0,0.0,0.0,0.0,0.0,0.0,0.0,0.0,0.0,0.0,0.0,0.0,0.0,0.0,,,,,,,,,,,,,0.0,,15.0,17928.3375,166455.0,158440.5,16416.0,182724.75,15.0,-569.0,365243.0,-1261.0,-1021.0,-991.0,-1018.0,11.0,0.0,0.1089090909090909,-1.0,94.0,18.0,10.0,-40.5,0.0,0.0,115.0,16643.835,16506.945,-1258.0,-1261.0,8.0,1.0,17.0,0.0,90000.0,,0.0,,,0.0,,0.0,0.0,0.0,0.0,,0.0,,,0.0,-11.0,0.0,0.0,8363354166.0,184685752039.5,165840537654.0,52071382405.935,,,,,,,,,,,,,128664.0,664081.0,,,,13552897.14520508,-603022328.0,-923606374.0,-297088586.0,-1538090199.0416667,44114.0,30771.0,,,,,,,67625.78434899129,158338.9392849854,,,,,,,,3721052.0,,,,,,,,,,,,,,,,437355.0,432141.0,,6436.995230002895,633151.0,626692.0,,,,,,,,,,,,,,,,,,,,,,,,,,,,,,,,,,,385985604.4875023,5493254459.58,6156774235.350002,89588885.715,5493636959.58,396332.0,-27384211.0,6407768260.0,284555944.0,1451510411.0,633381401.0,1527250913.0,394984.0,6165.0,1121.0019972506798,9317813.0,3250788.0,2008677.0,-6537005.5,2057324.0,246872.0,4326418951.560012,4390771227.030004,-265311740.0,-263101185.0,4758889.0,217025.0,4041482634.404943,10893424500.0,,516624307.9649999,,,229862910.23999888,,528009453.0899973,3879743636.6550007,4026865712.984922,4027056522.524921,,47117.0,,,1357725.0,-2402322.0,847439.0,2252.0,1470321.0,14888052.0,3238671.0,8572447.0,11629896.0,1418662.0,,,,,,,,,,,,,,5931554724.044963,18760680000.0,,448764994.4849976,,,309552468.99749875,,459799280.8424992,5716427173.852535,5894781936.4125,5895025119.157501,,81013.5,,,972913.0,-1701742.0,177423.0,6755.0,4281245.0,2484042.5,-9020987.5,921848.5,37582.5,3740978133.2924576,3665635099.1774592,-261135918.5,-257817246.0,2531292.5,269745.5,3933775960.267455,33313673194.020924,36748228194.92264,1733114094.1875498,48174632031.82572,3995486.0,-248054127.5,103287447635.0,1057104945.0,17301960905.0,3510887700.5,18917639015.5,3679132.0,72071.5,20911.78574821509,89909207.5,-9.5114006514658,4.3935,2.8748023573379333,159.58697360104438,12.630444156964211,701.1453685161885,90000.0,-0.2225209339563143,0.9749279121818236,0.0,0.0,0.0,0.0,0.0,0.0,1.0,0.0,0.0,0.0,0.0,0.0,0.0,1.0,0.0,0.0,0.0,0.0,1.0,0.0,1.0,0.0,0.0,0.0,0.0,1.0,0.0,0.0,0.0,0.0,0.0,0.0,0.0,1.0,0.0,0.0,0.0,0.0,0.0,0.0,0.0,0.0,0.0,0.0,0.0,0.0,0.0,0.0,0.0,0.0,0.0,0.0,0.0,0.0,0.0,0.0,0.0,0.0,0.0,0.0,0.0,0.0,0.0,0.0,0.0,0.0,0.0,0.0,0.0,0.0,0.0,0.0,0.0,0.0,0.0,0.0,0.0,0.0,0.0,0.0,0.0,0.0,0.0,0.0,0.0,0.0,0.0,0.0,0.0,0.0,1.0,0.0,0.0,0.0,0.0,0.0,0.0,0.0,0.0,0.0,0.0,0.0,0.0,0.0,0.0,0.0,0.0,0.0,0.0,0.0,0.0,0.0,0.0,0.0,0.0,0.0,0.0,0.0,0.0,0.0
106735,0,0.0,0.0,1.0,0.0,2.0,103500.0,540000.0,27571.5,540000.0,0.018029,37.22191780821917,-2034.0,-1563.0,-1703.0,24.0,4.0,3.0,3.0,14.0,0.7921076472218166,0.3784519334805389,0.3201633668633456,,,,,,,,,,,,,,,,,,,,,,,,,,,,,,,,,,,,,,,,,,,,,0.0,0.0,0.0,0.0,-812.0,0.0,0.0,0.0,0.0,0.0,3.0,1.0,1.0,1.0,1.0,0.0,0.0,0.0,0.0,0.0,0.0,0.0,0.0,0.0,1.0,0.0,0.0,0.0,0.0,0.0,0.0,0.0,0.0,0.0,0.0,0.0,0.0,0.0,0.0,0.0,0.0,0.0,0.0,7.0,19471.5,0.0,270000.0,0.0,0.0,0.0,0.0,0.0,-634.0,918.0,-16.0,-275.0,174.0,-12.0,2.0,13531.455,31770.0,37239.75,0.0,63540.0,6.0,-685.0,365243.0,-781.0,-631.0,-631.0,-629.0,8.5,0.0,0.0,124.5,7.0,6.0,3.0,-23.0,0.0,0.0,6.0,13531.455,13531.455,-717.0,-706.0,3.5,1.0,0.0,,,,,,,,,,,,,,,,,,,,,8363381737.5,184686292039.5,165841077654.0,52071485905.935,1863.0,1706.0,71128.0,71073.0,9141.0,507063.0,,,,,,,128666.0,664085.0,,,,13552934.367122889,-603024362.0,-923608077.0,-297089398.0,-1538091762.0416667,44114.0,30771.0,,,,,,,67626.57645663852,158339.31773691883,126350.46674167828,,,,,,,3721066.0,,,,,,,,,,,,,,,,437355.0,432141.0,1265397.0,6437.013259002894,633154.0,626695.0,,,,,,,,,21.0,108776454.20999986,37181543.94000001,11248899285.014984,3703208913.899999,131396594.67000005,868255.7849999996,213.0,27942.0,-36598187.0,16399124.0,-19022939.0,-20704615.0,-10.0,42745.5,0.0,270000.0,0.0,0.0,0.0,0.0,0.0,-647.0,918.0,-21.0,-275.0,386715819.6450022,5503726805.58,6168249460.350002,89704020.465,5503726805.58,397003.0,-27425154.0,6417263266.0,284897490.0,1453319499.0,634464776.0,1529060207.0,395531.0,6173.0,1122.540524312002,9324628.5,3255970.0,2012089.0,-6544327.0,2057564.0,246916.0,4336621724.677534,4399815158.212516,-265581948.5,-263368879.5,4763233.0,217335.5,,,,,,,,,,,,,,,,,,,,,1470328.0,14888226.0,3238671.0,8572454.0,11629902.0,1418664.0,1062900213.0120012,802470955.567495,72246659345.81964,21717850277.22762,584068981.9769987,5792665.7475,689.5,94245.0,-277443575.0,22027823.0,-124004083.5,-219106495.5,-2028354.5,,,,,,,,,,,,,,,,,,,,,4281251.0,2484045.5,-9021010.5,921848.5,37582.5,3740991664.747458,3665648630.632458,-261136635.5,-257817952.0,2531296.0,269746.5,3933789491.722455,33313704964.020924,36748265434.67264,1733114094.1875498,48174695571.82572,3995492.0,-248054812.5,103287812878.0,1057104164.0,17301960274.0,3510887069.5,18917638386.5,3679140.5,72071.5,20911.78574821509,89909332.0,-54.64522302370087,5.217391304347826,3.7538762852945977,139.72647455345864,19.585441488493554,729.0076933223929,25875.0,-0.9009688679024191,-0.433883739117558,0.0,0.0,0.0,0.0,0.0,0.0,1.0,0.0,0.0,0.0,0.0,0.0,0.0,1.0,0.0,0.0,0.0,0.0,1.0,0.0,1.0,0.0,0.0,0.0,0.0,1.0,0.0,0.0,0.0,0.0,0.0,0.0,0.0,0.0,0.0,0.0,0.0,0.0,0.0,0.0,0.0,1.0,0.0,0.0,0.0,0.0,0.0,0.0,0.0,0.0,0.0,0.0,0.0,0.0,0.0,0.0,0.0,0.0,0.0,0.0,1.0,0.0,0.0,0.0,0.0,0.0,0.0,0.0,0.0,0.0,0.0,0.0,0.0,0.0,0.0,0.0,0.0,0.0,0.0,0.0,0.0,0.0,0.0,0.0,0.0,0.0,0.0,0.0,0.0,0.0,0.0,0.0,0.0,0.0,0.0,0.0,0.0,0.0,0.0,0.0,0.0,0.0,0.0,0.0,0.0,0.0,0.0,0.0,0.0,0.0,0.0,0.0,0.0,0.0,0.0,0.0,0.0,0.0,0.0,0.0
106739,0,0.0,1.0,1.0,1.0,0.0,157500.0,225000.0,19242.0,225000.0,0.019101,27.756164383561643,-705.0,-4770.0,-2802.0,5.0,2.0,2.0,2.0,11.0,0.4229833163184049,0.2858978721410488,0.4471785780453068,,,,,,,,,,,,,,,,,,,,,,,,,,,,,,,,,,,,,,,,,,,,,0.0,0.0,0.0,0.0,-870.0,0.0,0.0,0.0,0.0,0.0,0.0,1.0,1.0,1.0,1.0,1.0,0.0,0.0,0.0,0.0,0.0,0.0,0.0,0.0,0.0,0.0,0.0,0.0,0.0,1.0,0.0,0.0,0.0,0.0,0.0,0.0,0.0,0.0,0.0,0.0,0.0,0.0,0.0,3.0,0.0,0.0,288000.0,0.0,0.0,0.0,0.0,0.0,-1109.0,-258.0,-257.0,-789.0,95.0,-18.0,4.0,3230.55,32602.5,32602.5,3048.75,45000.0,8.0,-275.5,365243.0,-535.0,182307.0,-265.0,182314.0,17.0,0.5,0.0464763851668613,90.0,17.0,8.0,6.0,-21.0,0.0,0.0,16.0,4863.465,4863.465,-445.0,-430.0,4.5,1.0,0.0,,,,,,,,,,,,,,,,,,,,,8363400979.5,184686517039.5,165841302654.0,52071643405.935,1863.0,1706.0,71128.0,71073.0,9141.0,507063.0,,,,,,,128666.0,664087.0,,,,13552962.12328727,-603025067.0,-923610879.0,-297090268.0,-1538096532.0416667,44114.0,30771.0,,,,,,,67626.99943995483,158339.60363479098,126350.91392025632,,,,,,,3721077.0,,,,,,,,,,,,,,,,437355.0,432141.0,1265402.0,6437.032360002894,633156.0,626697.0,,,,,,,,,37.0,108911175.20999986,37201372.56,11255013016.55998,3705372518.399999,131396594.67000005,868255.7849999996,213.0,27942.0,-36628606.0,16412098.0,-19041057.0,-20726373.0,-18.0,0.0,0.0,15795.0,0.0,0.0,0.0,0.0,0.0,-1445.0,-1353.0,-1320.0,-1320.0,387031197.7800022,5508684797.58,6173391767.850002,89840199.465,5508694900.08,397177.0,-27446907.0,6420729908.5,284880262.5,1454402905.5,635550402.5,1530144279.5,395768.5,6175.0,1123.4984152875004,9340051.0,3258410.0,2013483.0,-6549607.0,2057567.0,246919.0,4341970449.000034,4405147556.355018,-265843349.5,-263627633.5,4766090.0,217489.5,,,,,,,,,,,,,,,,,,,,,1470331.0,14888321.0,3238671.0,8572471.0,11629918.0,1418668.0,1062900213.0120012,802470955.567495,72246947345.81964,21717850277.22762,584068981.9769987,5792665.7475,689.5,94245.0,-277444684.0,22027565.0,-124004340.5,-219107284.5,-2028372.5,,,,,,,,,,,,,,,,,,,,,4281259.0,2484051.5,-9021031.5,921848.5,37582.5,3740996528.2124577,3665653494.0974593,-261137080.5,-257818382.0,2531300.5,269747.5,3933792722.272455,33313737566.520924,36748298037.17264,1733117142.9375498,48174740571.82572,3995500.0,-248055088.0,103288178121.0,1057103629.0,17302142581.0,3510886804.5,18917820700.5,3679157.5,72072.0,20911.832224600264,89909422.0,-25.39976310334617,1.4285714285714286,8.185219831618335,227.19030716198728,11.693171188026191,324.5575816599818,78750.0,-0.2225209339563146,-0.9749279121818236,0.0,1.0,0.0,0.0,0.0,0.0,0.0,0.0,0.0,0.0,1.0,0.0,0.0,0.0,0.0,1.0,0.0,0.0,0.0,0.0,1.0,0.0,0.0,0.0,0.0,1.0,0.0,0.0,0.0,0.0,0.0,0.0,0.0,0.0,0.0,0.0,0.0,0.0,0.0,0.0,0.0,0.0,0.0,0.0,0.0,0.0,0.0,0.0,0.0,0.0,0.0,0.0,0.0,0.0,0.0,0.0,0.0,0.0,0.0,0.0,0.0,0.0,0.0,0.0,0.0,0.0,0.0,0.0,0.0,0.0,0.0,0.0,0.0,0.0,1.0,0.0,0.0,0.0,0.0,0.0,0.0,0.0,0.0,0.0,0.0,0.0,0.0,0.0,0.0,0.0,0.0,0.0,0.0,0.0,0.0,0.0,0.0,0.0,0.0,0.0,0.0,0.0,0.0,0.0,0.0,0.0,0.0,0.0,0.0,0.0,0.0,0.0,0.0,0.0,0.0,0.0,0.0,0.0,0.0,0.0
106740,0,0.0,0.0,0.0,1.0,0.0,103500.0,265500.0,11290.5,265500.0,0.014464,64.38082191780822,,-2504.0,-4842.0,,2.0,2.0,2.0,5.0,,0.1680978234861928,,,,,,,,,,,,,,,,,,,,,,,,,,,,,,,,,,,,,,,,,,,,,,0.0,0.0,0.0,0.0,0.0,,,,,,,1.0,0.0,0.0,1.0,0.0,0.0,0.0,0.0,0.0,0.0,0.0,0.0,0.0,0.0,0.0,0.0,1.0,0.0,0.0,0.0,0.0,0.0,0.0,0.0,0.0,0.0,0.0,0.0,0.0,0.0,0.0,0.0,0.0,,,,,,,,,,,,,0.0,,15.0,13366.08,70060.5,72171.0,0.0,100755.0,12.0,-766.0,365243.0,-978.0,-858.0,-828.0,-853.5,7.0,0.0,0.0,150.0,68.0,10.0,6.0,-27.5,0.0,0.0,69.0,17279.865,17209.89,-743.0,-735.0,5.0,1.0,0.0,,,,,,,,,,,,,,,,,,,,,8363412270.0,184686782539.5,165841568154.0,52071746905.935,,,,,,,,,,,,,128666.0,664089.0,,,,13553026.504109189,,-923615721.0,-297090268.0,-1538099036.0416667,44114.0,30771.0,,,,,,,,158339.7717326145,,,,,,,,3721082.0,,,,,,,,,,,,,,,,437355.0,432141.0,,6437.046824002894,633158.0,626699.0,,,,,,,,,,,,,,,,,,,,,,,,,,,,,,,,,,,387098241.66000223,5509919174.58,6174816310.350002,89844924.465,5509785209.58,397315.0,-27454394.0,6422556123.5,284875732.0,1454400278.5,635547467.5,1530141679.5,395855.0,6176.0,1123.5340919934106,9341189.0,3258866.0,2013797.5,-6551017.0,2057567.0,246919.0,4342733765.010032,4405876306.785014,-265888560.0,-263672381.0,4766273.0,217535.0,,,,,,,,,,,,,,,,,,,,,1470331.0,14888321.0,3238671.0,8572539.0,11629987.0,1418683.0,,,,,,,,,,,,,,,,,,,,,,,,,,,,,,,,,,4281269.0,2484057.5,-9021059.0,921848.5,37582.5,3741013808.077458,3665670703.987458,-261137823.5,-257819117.0,2531305.5,269748.5,3933806088.352455,33313807627.020924,36748370208.17264,1733117142.9375498,48174841326.82572,3995512.0,-248055854.0,103288543364.0,1057102651.0,17302141723.0,3510885976.5,18917819847.0,3679164.5,72072.0,20911.832224600264,89909572.0,,2.565217391304348,9.166998804304503,590.1789175406891,23.515344758868075,1513.9372232565506,51750.0,0.6234898018587334,-0.7818314824680299,0.0,0.0,0.0,0.0,0.0,0.0,1.0,0.0,0.0,1.0,0.0,0.0,0.0,0.0,0.0,0.0,0.0,0.0,1.0,0.0,1.0,0.0,0.0,0.0,0.0,1.0,0.0,0.0,0.0,0.0,0.0,0.0,0.0,0.0,0.0,0.0,0.0,0.0,0.0,0.0,0.0,0.0,0.0,0.0,0.0,0.0,0.0,0.0,0.0,0.0,0.0,0.0,0.0,0.0,0.0,0.0,0.0,0.0,0.0,0.0,0.0,0.0,0.0,0.0,0.0,0.0,0.0,0.0,0.0,0.0,0.0,0.0,0.0,0.0,0.0,0.0,0.0,0.0,0.0,0.0,0.0,0.0,0.0,0.0,0.0,0.0,0.0,0.0,0.0,0.0,0.0,0.0,0.0,0.0,0.0,0.0,0.0,0.0,0.0,0.0,0.0,0.0,0.0,0.0,0.0,1.0,0.0,0.0,0.0,0.0,0.0,0.0,0.0,0.0,0.0,0.0,0.0,0.0,0.0,0.0
106754,0,0.0,0.0,1.0,0.0,0.0,261000.0,900000.0,45954.0,900000.0,0.02461,29.35342465753425,-2121.0,-2580.0,-599.0,14.0,2.0,2.0,2.0,10.0,0.7619061410213214,0.6439307473827128,0.1766525794312139,0.1474,0.0922,0.9841,0.7824,0.0043,0.0,0.069,0.1667,0.2083,0.0559,0.1177,0.0659,0.0116,0.0226,0.1502,0.0957,0.9841,0.7909,0.0043,0.0,0.069,0.1667,0.2083,0.0572,0.1286,0.0687,0.0117,0.0239,0.1489,0.0922,0.9841,0.7853,0.0043,0.0,0.069,0.1667,0.2083,0.0569,0.1197,0.0671,0.0116,0.0231,0.0954,1.0,0.0,0.0,0.0,0.0,-298.0,0.0,0.0,0.0,0.0,0.0,0.0,1.0,1.0,0.0,1.0,1.0,0.0,0.0,0.0,0.0,0.0,0.0,0.0,0.0,1.0,0.0,0.0,0.0,0.0,0.0,0.0,0.0,0.0,0.0,0.0,0.0,0.0,0.0,0.0,0.0,0.0,0.0,0.0,3.0,18900.0,7478.842500000002,297000.0,298935.27,0.0,0.0,0.0,0.0,-1081.0,727.0,-10.0,,107.0,-17.0,1.0,9674.775,159660.0,101893.5,67500.0,159660.0,12.0,-298.0,365243.0,-268.0,-208.0,62.0,-202.0,11.0,1.0,0.4339814477157409,400.0,5.0,12.0,10.0,-8.0,0.0,0.0,4.0,9674.775,9674.6625,-254.0,-238.0,2.0,1.0,0.0,,,,,,,,,,,,,,,,,,,,,8363458224.0,184687682539.5,165842468154.0,52072007905.935,1863.0,1706.0,71128.0,71073.0,9141.0,507063.0,17843.559100002312,17905.900799999126,17356.527999997972,11318.676300000096,11256.382600000095,11203.348200000064,128666.0,664091.0,4146.905300000114,4144.480800000011,3954.8839000000926,13553055.857533844,-603027188.0,-923616320.0,-297090566.0,-1538101616.0416667,44114.0,30771.0,11371.0339999992,11246.899999998992,10730.554299997286,22932.678500009868,22854.28700000984,22238.758800008392,67627.76134609585,158340.41566336187,126351.09057283576,35070.397400028065,35010.473600028505,34455.261800028915,22996.50629999585,22969.48269999543,22615.705199995667,3721092.0,8312.022700000169,8416.810000000078,8139.958000000232,9835.87950000072,9951.011500002149,10311.492399999626,16500.614499999712,16686.255999999685,16282.5278999997,830.2141000001773,815.3768000000463,761.289300000013,3920.570900000124,3903.8292000001625,3736.382000000162,437355.0,432141.0,1265416.0,6437.071434002894,633160.0,626701.0,,16364.848499999796,154487.9471999908,154490.68929999036,154382.38199998712,77755.6371999963,78094.0937000066,78496.41670000675,36.0,109127147.89499986,37254663.5625,11281228170.569984,3712628444.2199984,131509186.74000004,868255.7849999996,213.0,27942.0,-36681288.0,16419763.0,-19069063.0,,-17.5,18900.0,6452.685,297000.0,298935.27,0.0,0.0,0.0,0.0,-1081.0,727.0,-10.0,,388148038.9650021,5524818735.059999,6190237171.350002,90166077.945,5524818735.059999,398195.0,-27540037.0,6439904124.0,284809702.0,1455077651.0,635865209.0,1530819400.0,396736.0,6187.0,1127.250005520499,9363502.0,3267805.0,2018167.0,-6580659.0,2064282.0,246933.0,4356598608.83251,4419821462.287509,-266879120.0,-264657023.0,4784234.0,218213.5,,,,,,,,,,,,,,,,,,,,,1470334.0,14888428.0,3238671.0,8572544.0,11629991.0,1418684.0,1062919113.0120012,802478434.4099951,72247244345.81964,21718149212.49762,584068981.9769987,5792665.7475,689.5,94245.0,-277445765.0,22028292.0,-124004350.5,,-2028389.5,,,,,,,,,,,,,,,,,,,,,4281281.0,2484067.5,-9021067.0,921848.5,37582.5,3741023482.852458,3665680378.64996,-261138077.5,-257819355.0,2531307.5,269749.5,3933815763.127455,33313967287.020924,36748472101.67264,1733184642.9375498,48175000986.82572,3995524.0,-248056152.0,103288908607.0,1057102383.0,17302141515.0,3510886038.5,18917819645.0,3679175.5,72073.0,20912.26620604798,89909972.0,-72.25732686204965,3.4482758620689653,5.679592636114376,166.71549452966963,19.584802193497847,574.8810156195507,130500.0,-0.9009688679024191,-0.433883739117558,0.0,0.0,0.0,0.0,0.0,0.0,1.0,0.0,1.0,0.0,0.0,0.0,0.0,0.0,0.0,0.0,0.0,0.0,1.0,0.0,1.0,0.0,0.0,0.0,0.0,1.0,0.0,0.0,0.0,0.0,0.0,0.0,0.0,1.0,0.0,0.0,0.0,0.0,0.0,0.0,0.0,0.0,0.0,0.0,0.0,0.0,0.0,0.0,0.0,0.0,0.0,0.0,0.0,0.0,0.0,0.0,0.0,0.0,0.0,0.0,0.0,0.0,0.0,0.0,0.0,0.0,0.0,0.0,0.0,0.0,0.0,0.0,0.0,0.0,0.0,0.0,0.0,0.0,0.0,0.0,0.0,0.0,0.0,0.0,0.0,0.0,0.0,0.0,0.0,0.0,1.0,0.0,0.0,0.0,0.0,0.0,0.0,0.0,0.0,0.0,0.0,0.0,0.0,0.0,0.0,0.0,0.0,0.0,1.0,0.0,1.0,0.0,0.0,0.0,0.0,0.0,0.0,0.0,1.0,0.0
106760,0,0.0,0.0,0.0,0.0,1.0,67500.0,450000.0,23107.5,450000.0,0.019101,37.16164383561644,-94.0,-3245.0,-3955.0,,3.0,2.0,2.0,10.0,0.4001292132424417,0.235207537632325,0.2985949897873972,,,,,,,,,,,,,,,,,,,,,,,,,,,,,,,,,,,,,,,,,,,,,6.0,0.0,6.0,0.0,-2833.0,0.0,0.0,0.0,0.0,0.0,0.0,1.0,1.0,1.0,1.0,0.0,0.0,0.0,0.0,0.0,0.0,1.0,1.0,0.0,1.0,0.0,0.0,0.0,0.0,0.0,0.0,0.0,0.0,0.0,0.0,0.0,0.0,0.0,0.0,0.0,0.0,0.0,0.0,2.0,0.0,,31027.5,0.0,,0.0,0.0,0.0,-1436.0,-1178.0,-1135.0,-1159.0,95.0,-23.0,5.0,6558.075,0.0,0.0,3104.775,54812.025,10.0,-491.0,365243.0,-2235.0,-1980.0,-1965.0,-1973.0,15.0,0.0,0.0544865289957343,2.0,25.0,9.0,4.0,-85.0,0.0,0.0,23.0,6204.87,6204.87,-2588.0,-2588.0,6.0,1.0,0.0,,,,,,,,,,,,,,,,,,,,,8363481331.5,184688132539.5,165842918154.0,52072075405.935,1863.0,1706.0,71128.0,71073.0,9141.0,507063.0,,,,,,,128667.0,664094.0,,,,13553093.01917768,-603027282.0,-923620275.0,-297093399.0,-1538104861.0416667,44114.0,30771.0,,,,,,,67628.1614753091,158340.6508708995,126351.38916782556,,,,,,,3721102.0,,,,,,,,,,,,,,,,437361.0,432147.0,,6437.090535002894,633162.0,626703.0,,,,,,,,,47.5,109152011.69999988,,11282415851.069984,3712717544.2199984,,868255.7849999996,213.0,27942.0,-36698091.0,16440356.0,-19077954.5,-20766109.0,-23.25,0.0,,25605.0,0.0,,0.0,0.0,0.0,-1604.0,-1392.0,-1347.0,-1392.0,388282712.5800021,5526500110.11,6192027338.850002,90185112.495,5526523892.61,398342.0,-27553085.0,6443739175.5,284797118.0,1455799480.0,635856720.0,1531541278.5,396906.0,6189.0,1127.7067422592625,9370175.0,3270370.0,2019506.0,-6585085.0,2064282.0,246933.0,4359600495.944989,4422382669.979992,-267008944.0,-264785584.0,4785649.0,218371.0,,,,,,,,,,,,,,,,,,,,,1470336.0,14888523.0,3238671.0,8572569.0,11630014.0,1418689.0,1062919113.0120012,,72247275373.31964,21718149212.49762,,5792665.7475,689.5,94245.0,-277447201.0,22027114.0,-124005485.5,-219108443.5,-2028412.5,,,,,,,,,,,,,,,,,,,,,4281290.0,2484071.5,-9021152.0,921848.5,37582.5,3741029687.722458,3665686583.51996,-261140665.5,-257821943.0,2531313.5,269750.5,3933822321.202455,33313967287.020924,36748472101.67264,1733187747.71255,48175055798.85072,3995534.0,-248056643.0,103289273850.0,1057100148.0,17302139535.0,3510884073.5,18917817672.0,3679190.5,72073.0,20912.320692576974,89909974.0,-2.5294898260100265,6.666666666666668,2.9211295034079843,108.55397420335864,19.474196689386567,723.6931613557242,22500.0,-0.2225209339563143,0.9749279121818236,0.0,0.0,0.0,0.0,0.0,0.0,1.0,0.0,0.0,0.0,0.0,0.0,0.0,1.0,0.0,0.0,0.0,0.0,1.0,1.0,0.0,0.0,0.0,0.0,0.0,0.0,0.0,0.0,0.0,1.0,0.0,0.0,1.0,0.0,0.0,0.0,0.0,0.0,0.0,0.0,0.0,0.0,0.0,0.0,0.0,0.0,0.0,0.0,0.0,0.0,0.0,0.0,0.0,0.0,0.0,0.0,0.0,0.0,0.0,0.0,0.0,0.0,0.0,0.0,0.0,0.0,0.0,0.0,0.0,0.0,0.0,0.0,0.0,0.0,0.0,0.0,0.0,0.0,0.0,0.0,0.0,0.0,0.0,0.0,0.0,0.0,0.0,0.0,0.0,0.0,1.0,0.0,0.0,0.0,0.0,0.0,0.0,0.0,0.0,0.0,0.0,0.0,0.0,0.0,0.0,0.0,0.0,0.0,0.0,0.0,0.0,0.0,0.0,0.0,0.0,0.0,0.0,0.0,0.0,0.0
106761,0,0.0,0.0,0.0,0.0,1.0,90000.0,847728.0,35914.5,847728.0,0.01885,55.923287671232885,-1623.0,-2452.0,-3263.0,,3.0,2.0,2.0,15.0,0.167899784194893,0.6493620034886297,0.6246146584503397,,,,,,,,,,,,,,,,,,,,,,,,,,,,,,,,,,,,,,,,,,,,,1.0,1.0,1.0,1.0,-2395.0,0.0,0.0,0.0,0.0,0.0,2.0,1.0,1.0,0.0,1.0,0.0,0.0,0.0,0.0,0.0,0.0,0.0,0.0,0.0,1.0,0.0,0.0,0.0,0.0,0.0,0.0,0.0,0.0,0.0,0.0,0.0,0.0,0.0,0.0,0.0,0.0,0.0,0.0,2.0,14283.0,,254250.0,238556.25,0.0,0.0,0.0,0.0,-1235.5,765.0,-25.5,,82.0,-20.0,5.0,11250.0,180000.0,225000.0,3105.0,202500.0,8.0,-1527.0,365243.0,-2507.0,-238.0,-267.0,-236.0,16.0,1.0,0.1932800224466891,-1.0,35.0,24.0,8.0,-25.0,0.0,0.0,149.0,9000.0,9000.0,-1505.0,-1504.0,42.0,0.0,84.0,165405.39750000002,180000.0,0.0,0.0,0.0,0.0,9000.0,9000.0,9000.0,158870.29499999998,165405.39750000002,165405.39750000002,0.0,0.0,0.0,0.0,42.0,-42.5,0.0,0.0,8363517246.0,184688980267.5,165843765882.0,52072165405.935,1863.0,1706.0,71128.0,71073.0,9141.0,507065.0,,,,,,,128668.0,664097.0,,,,13553148.94246535,-603028905.0,-923623538.0,-297095794.0,-1538107313.0416667,44115.0,30772.0,,,,,,,67628.32937509331,158341.30023290296,126352.013782484,,,,,,,3721117.0,,,,,,,,,,,,,,,,437362.0,432148.0,,6437.109385002896,633164.0,626705.0,,,,,,,,,41.0,109166627.69999988,,11282722076.069984,3712965026.2199984,131509186.74000004,868255.7849999996,213.0,27942.0,-36700331.5,16441181.0,-19078461.5,,-20.0,27900.0,,441000.0,459261.0,0.0,0.0,0.0,0.0,-1729.0,446.0,-11.0,,388312740.67500216,5526744280.11,6192457138.350002,90188217.495,5526913030.11,398373.0,-27562079.0,6444284491.0,284791084.0,1456161541.0,636218781.0,1531903348.0,396989.0,6190.0,1127.9000222817092,9370439.0,3270784.0,2019699.0,-6586689.0,2064282.0,246933.0,4360273055.999987,4423055230.034989,-267132305.0,-264908607.0,4790355.0,218382.0,4079851872.1199408,10971949500.0,340187624.505,520770466.5299998,16078995.540000005,163855013.53500023,231959513.56499887,575129509.0199816,532415736.7199972,3916589358.0375023,4065114714.479923,4065307414.019922,17451.0,47263.0,226.0,29586.0,1366427.0,-2414141.5,847475.0,2280.0,1470338.0,14888605.0,3238755.0,8572604.0,11630163.0,1418694.0,1062933396.0120012,,72247529623.31964,21718387768.74762,584068981.9769987,5792665.7475,689.5,94245.0,-277448436.5,22027879.0,-124005511.0,,-2028432.5,5931720129.442463,18760860000.0,198925482.825,448764994.4849976,1948107.735,257389722.78750083,309561468.99749875,637493301.5174978,459808280.8424992,5716586044.147535,5894947341.81,5895190524.555,13396.5,81013.5,44.0,70512.5,972955.0,-1701784.5,177423.0,6755.0,4281314.0,2484079.5,-9021177.0,921848.5,37582.5,3741038687.722458,3665695583.51996,-261142170.5,-257823447.0,2531355.5,269750.5,3933833571.202455,33314147287.020924,36748697101.67264,1733190852.71255,48175258298.85072,3995542.0,-248058170.0,103289639093.0,1057097641.0,17302139297.0,3510883806.5,18917817436.0,3679206.5,72074.0,20912.513972599423,89909973.0,-29.021898883009985,9.4192,2.505951635133442,140.14105418176388,23.604059641648924,1320.0166175488705,30000.0,-0.9009688679024191,0.4338837391175582,0.0,0.0,0.0,0.0,0.0,0.0,1.0,0.0,0.0,0.0,0.0,0.0,0.0,1.0,0.0,0.0,0.0,0.0,1.0,0.0,1.0,0.0,0.0,0.0,0.0,1.0,0.0,0.0,0.0,0.0,0.0,0.0,0.0,0.0,0.0,0.0,0.0,0.0,1.0,0.0,0.0,0.0,0.0,0.0,0.0,0.0,0.0,0.0,0.0,0.0,0.0,0.0,0.0,0.0,0.0,0.0,0.0,0.0,0.0,0.0,0.0,0.0,0.0,0.0,0.0,0.0,0.0,0.0,0.0,0.0,0.0,0.0,0.0,0.0,0.0,0.0,0.0,0.0,0.0,0.0,0.0,0.0,0.0,0.0,0.0,0.0,0.0,0.0,0.0,0.0,1.0,0.0,0.0,0.0,0.0,0.0,0.0,0.0,0.0,0.0,0.0,0.0,0.0,0.0,0.0,0.0,0.0,0.0,0.0,0.0,0.0,0.0,0.0,0.0,0.0,0.0,0.0,0.0,0.0,0.0
106784,0,0.0,1.0,0.0,1.0,0.0,180000.0,601470.0,30838.5,450000.0,0.072508,27.082191780821923,-146.0,-4349.0,-1991.0,,2.0,1.0,1.0,14.0,0.3106820540449698,0.4795779954058346,,0.0474,0.006,0.9717,0.6124,0.0,0.0,0.1034,0.1667,0.2083,0.0,0.0387,0.0631,0.0,0.0205,0.0483,0.0062,0.9717,0.6276,0.0,0.0,0.1034,0.1667,0.2083,0.0,0.0422,0.0657,0.0,0.0217,0.0479,0.006,0.9717,0.6176,0.0,0.0,0.1034,0.1667,0.2083,0.0,0.0393,0.0642,0.0,0.0209,0.0541,1.0,1.0,0.0,1.0,0.0,-566.0,,,,,,,1.0,1.0,0.0,1.0,0.0,0.0,0.0,0.0,0.0,0.0,0.0,0.0,0.0,1.0,0.0,0.0,0.0,0.0,0.0,0.0,0.0,0.0,0.0,0.0,0.0,0.0,0.0,0.0,0.0,0.0,0.0,0.0,0.0,,,,,,,,,,,,,0.0,,1.0,9977.175,94450.5,93982.5,9445.5,94450.5,12.0,-566.0,365243.0,-535.0,-295.0,-205.0,-286.0,16.0,0.0,0.0994605733632882,100.0,10.0,11.0,6.5,-13.5,0.0,0.0,9.0,9977.175,9977.175,-442.0,-415.0,5.0,2.0,0.0,,,,,,,,,,,,,,,,,,,,,8363548084.5,184689581737.5,165844215882.0,52072345405.935,,,,,,,17843.606500002308,17905.948699999128,17356.576299997967,11318.682300000097,11256.388600000097,11203.354400000064,128668.0,664099.0,4146.905300000114,4144.480800000011,3954.8839000000926,13553176.02465713,-603029051.0,-923625529.0,-297096360.0,-1538111662.0416667,44115.0,30772.0,11371.0339999992,11246.899999998992,10730.554299997286,22932.781900009868,22854.39040000984,22238.862200008392,67628.64005714734,158341.77981089838,,35070.56410002807,35010.640300028506,34455.428500028924,22996.71459999585,22969.69099999543,22615.913499995662,3721131.0,8312.022700000169,8416.810000000078,8139.958000000232,9835.91820000072,9951.05080000215,10311.534599999626,16500.677599999708,16686.320199999685,16282.5935999997,830.2141000001773,815.3768000000463,761.289300000013,3920.591400000125,3903.8501000001625,3736.403700000161,437363.0,432149.0,,6437.181893002896,633165.0,626706.0,,16364.902599999796,154488.9188999908,154491.66099999036,154383.3536999871,77756.2495999963,78094.7113000066,78497.04430000676,,,,,,,,,,,,,,,,,,,,,,,,,,,389853095.89500207,5544746658.9,6212720848.140002,90429246.495,5544746658.9,399692.0,-27643490.0,6468023705.0,286193926.0,1461966049.0,637649687.0,1538073675.0,398397.0,6208.0,1131.21218115357,9387823.0,3284651.5,2027573.0,-6608381.5,2187812.0,246963.0,4377697151.94,4440019016.159998,-267774861.0,-265542416.0,4801149.0,219345.0,,,,,,,,,,,,,,,,,,,,,1470338.0,14888605.0,3238755.0,8572614.0,11630172.0,1418695.0,,,,,,,,,,,,,,,,,,,,,,,,,,,,,,,,,,4281325.0,2484086.0,-9021190.5,921848.5,37582.5,3741048664.8974576,3665705560.694959,-261142612.5,-257823862.0,2531360.5,269752.5,3933843548.377455,33314241737.520924,36748791084.17264,1733200298.21255,48175352749.35072,3995554.0,-248058736.0,103290004336.0,1057097106.0,17302139002.0,3510883601.5,18917817150.0,3679222.5,72074.0,20912.613433172788,89910073.0,-5.39099645928174,3.3415,5.836859769444039,158.07495567384746,19.50386691959725,528.2074643841613,90000.0,-0.2225209339563146,-0.9749279121818236,0.0,0.0,0.0,0.0,0.0,0.0,1.0,0.0,1.0,0.0,0.0,0.0,0.0,0.0,0.0,0.0,1.0,0.0,0.0,1.0,0.0,0.0,0.0,0.0,0.0,0.0,0.0,0.0,0.0,1.0,0.0,0.0,0.0,0.0,0.0,0.0,0.0,0.0,0.0,0.0,0.0,0.0,0.0,0.0,0.0,0.0,0.0,0.0,0.0,0.0,0.0,0.0,0.0,0.0,0.0,0.0,0.0,0.0,0.0,0.0,0.0,0.0,0.0,0.0,0.0,0.0,0.0,0.0,0.0,0.0,0.0,0.0,0.0,0.0,0.0,0.0,0.0,0.0,0.0,0.0,0.0,1.0,0.0,0.0,0.0,0.0,0.0,0.0,0.0,0.0,0.0,0.0,0.0,0.0,0.0,0.0,0.0,0.0,0.0,0.0,0.0,0.0,0.0,0.0,0.0,0.0,0.0,0.0,1.0,0.0,1.0,0.0,0.0,0.0,0.0,0.0,0.0,0.0,1.0,0.0
106787,0,0.0,0.0,0.0,1.0,0.0,162000.0,260640.0,28197.0,225000.0,0.014464,45.21917808219178,-3863.0,-8785.0,-47.0,,2.0,2.0,2.0,4.0,,0.6278012911960628,0.3842068130556564,0.0619,0.0532,0.9826,0.762,0.0399,0.0,0.1034,0.1667,0.2083,0.0621,0.0488,0.0533,0.0077,0.0103,0.063,0.0552,0.9826,0.7713,0.0403,0.0,0.1034,0.1667,0.2083,0.0635,0.0533,0.0556,0.0078,0.0109,0.0625,0.0532,0.9826,0.7652,0.0402,0.0,0.1034,0.1667,0.2083,0.0631,0.0496,0.0543,0.0078,0.0105,0.0442,1.0,0.0,0.0,0.0,0.0,-1211.0,0.0,0.0,0.0,0.0,0.0,0.0,1.0,1.0,0.0,1.0,0.0,1.0,0.0,0.0,0.0,0.0,0.0,0.0,0.0,0.0,0.0,0.0,0.0,0.0,1.0,0.0,0.0,0.0,0.0,0.0,0.0,0.0,0.0,0.0,0.0,0.0,0.0,0.0,5.0,5926.5,0.0,34605.0,0.0,0.0,0.0,0.0,0.0,-1061.0,-1246.0,-465.0,-2026.0,229.0,-24.0,10.0,7265.385,0.0,0.0,0.0,104404.5,18.0,-543.5,,,,,,6.5,,0.0,-1.0,36.0,24.0,10.5,-22.0,0.0,0.0,35.0,6640.92,6640.92,-712.0,-700.0,7.0,1.0,0.0,,,,,,,,,,,,,,,,,,,,,8363576281.5,184689842377.5,165844440882.0,52072507405.935,1863.0,1706.0,71128.0,71073.0,9141.0,507065.0,17843.668400002312,17906.011199999128,17356.63929999797,11318.735500000095,11256.441800000095,11203.409600000065,128668.0,664101.0,4146.945200000114,4144.5210000000125,3954.9242000000927,13553221.243835213,-603032914.0,-923625576.0,-297097571.0,-1538120447.0416667,44115.0,30772.0,11371.0339999992,11246.899999998992,10730.554299997286,22932.885300009868,22854.49380000984,22238.965600008392,,158342.40761218962,126352.39798929704,35070.73080002807,35010.80700002851,34455.59520002892,22996.92289999585,22969.899299995428,22616.121799995664,3721135.0,8312.084800000168,8416.873100000077,8140.021500000232,9835.96700000072,9951.100400002148,10311.587899999626,16500.73089999971,16686.374499999685,16282.6491999997,830.2218000001773,815.3846000000461,761.297100000013,3920.601700000124,3903.860600000162,3736.414600000162,437363.0,432149.0,,6437.196357002896,633167.0,626708.0,,16364.946799999794,154489.90149999078,154492.64359999035,154384.3362999871,77757.0115999963,78095.4765000066,78497.81560000675,35.0,109400400.76499988,37284812.775,11320681888.754978,3729007745.7299976,132878272.09500004,868255.7849999996,213.0,27942.0,-36870000.0,16441024.0,-19181315.0,-20863503.0,-17.0,0.0,0.0,34605.0,0.0,0.0,0.0,0.0,0.0,-2330.0,-2026.0,-2008.0,-2026.0,389970190.35000217,5545489608.9,6213506719.140002,90453096.495,5546285667.9,399800.0,-27648676.5,,,,,,398493.0,,1131.313282546353,9418038.5,3285243.0,2027898.5,-6609237.0,2187812.0,246963.0,4378191353.864999,4440506577.164998,-267799306.0,-265566426.0,4801412.0,219382.0,,,,,,,,,,,,,,,,,,,,,1470343.0,14888834.0,3238755.0,8572650.0,11630207.0,1418705.0,1062939322.5120012,802478434.4099951,72247564228.31964,21718387768.74762,584068981.9769987,5792665.7475,689.5,94245.0,-277449497.5,22026633.0,-124005976.0,-219110469.5,-2028456.5,,,,,,,,,,,,,,,,,,,,,4281349.0,2484096.5,-9021212.5,921848.5,37582.5,3741055305.8174577,3665712201.6149592,-261143324.5,-257824562.0,2531367.5,269753.5,3933850813.762455,33314241737.520924,36748791084.17264,1733200298.21255,48175457153.85072,3995572.0,-248059279.5,,,,,,3679229.0,,20912.613433172788,89910072.0,-85.42835504392608,1.6088888888888888,5.745292052345994,259.79738444923464,9.24353654644111,417.9851252027685,81000.0,0.6234898018587334,-0.7818314824680299,0.0,0.0,0.0,0.0,0.0,0.0,1.0,0.0,1.0,0.0,0.0,0.0,0.0,0.0,0.0,0.0,0.0,0.0,1.0,1.0,0.0,0.0,0.0,0.0,0.0,1.0,0.0,0.0,0.0,0.0,0.0,0.0,0.0,0.0,0.0,0.0,0.0,0.0,0.0,0.0,0.0,0.0,0.0,0.0,1.0,0.0,0.0,0.0,0.0,0.0,0.0,1.0,0.0,0.0,0.0,0.0,0.0,0.0,0.0,0.0,0.0,0.0,0.0,0.0,0.0,0.0,0.0,0.0,0.0,0.0,0.0,0.0,0.0,0.0,0.0,0.0,0.0,0.0,0.0,0.0,0.0,0.0,0.0,0.0,0.0,0.0,0.0,0.0,0.0,0.0,0.0,0.0,0.0,0.0,0.0,0.0,0.0,0.0,0.0,0.0,0.0,0.0,0.0,0.0,0.0,0.0,0.0,0.0,0.0,0.0,1.0,0.0,0.0,1.0,0.0,0.0,0.0,0.0,0.0,0.0
106797,0,0.0,0.0,1.0,1.0,0.0,225000.0,675000.0,21906.0,675000.0,0.019101,51.04657534246575,-877.0,-7271.0,-2183.0,12.0,2.0,2.0,2.0,13.0,0.8683221003482023,0.5266550399942774,0.7557400501752248,,,,,,,,,,,,,,,,,,,,,,,,,,,,,,,,,,,,,,,,,,,,,1.0,0.0,0.0,0.0,-369.0,0.0,0.0,0.0,0.0,1.0,1.0,1.0,1.0,0.0,1.0,0.0,0.0,0.0,0.0,0.0,0.0,0.0,0.0,0.0,1.0,0.0,0.0,0.0,0.0,0.0,0.0,0.0,0.0,0.0,0.0,0.0,0.0,0.0,0.0,0.0,0.0,0.0,0.0,3.0,22722.75,,540000.0,227209.5,0.0,0.0,0.0,0.0,-498.0,232.0,-39.0,-811.0,64.0,-11.0,1.0,9463.725,160110.0,92610.0,67500.0,160110.0,12.0,-369.0,365243.0,-339.0,-9.0,-9.0,365243.0,11.0,0.0,0.4591445653840258,140.0,12.0,12.0,6.5,-6.5,0.0,0.0,12.0,9463.725,9463.725,-187.0,-174.0,6.5,1.0,0.0,,,,,,,,,,,,,,,,,,,,,8363598187.5,184690517377.5,165845115882.0,52072732405.935,1863.0,1706.0,71128.0,71074.0,9141.0,507066.0,,,,,,,128668.0,664103.0,,,,13553272.290410556,-603033791.0,-923627759.0,-297097940.0,-1538127718.0416667,44115.0,30772.0,,,,,,,67629.50837924768,158342.93426722958,126353.15372934722,,,,,,,3721148.0,,,,,,,,,,,,,,,,437364.0,432149.0,1265428.0,6437.215458002896,633169.0,626710.0,,,,,,,,,17.0,109459503.76499988,,11332577855.609978,3731741542.304997,132979804.38000004,868255.7849999996,215.0,27942.0,-36919112.0,16506921.0,-19203419.0,-20884976.0,-8.0,27405.0,,152412.48,0.0,0.0,0.0,0.0,0.0,-1147.0,-782.0,-808.0,-811.0,390301071.75000185,5550900086.52,6219345374.640002,90615395.115,5550900086.52,400212.0,-27670912.0,6474598065.0,286542979.0,1463049461.0,638004740.0,1539522428.0,399221.0,6213.0,1133.0058886295194,9428338.0,3287574.0,2029418.0,-6614357.0,2187812.0,246963.0,4381114145.062502,4443389337.5775,-267937213.0,-265701028.5,4802296.0,219561.5,,,,,,,,,,,,,,,,,,,,,1470346.0,14888898.0,3238755.0,8572662.0,11630219.0,1418706.0,1062962045.2620012,,72248104228.31964,21718614978.24762,584068981.9769987,5792665.7475,689.5,94245.0,-277449995.5,22026865.0,-124006015.0,-219111280.5,-2028467.5,,,,,,,,,,,,,,,,,,,,,4281361.0,2484103.0,-9021219.0,921848.5,37582.5,3741064769.5424576,3665721665.339959,-261143511.5,-257824736.0,2531374.0,269754.5,3933860277.487455,33314401847.520924,36748883694.17264,1733267798.21255,48175617263.85072,3995584.0,-248059648.5,103290369579.0,1057096767.0,17302138993.0,3510883592.5,18918182393.0,3679240.0,72074.0,20913.07257773817,89910212.0,-17.18038857878918,3.0,10.271158586688578,524.3074706498127,30.81347576006573,1572.9224119494377,112500.0,-0.9009688679024191,0.4338837391175582,0.0,0.0,0.0,0.0,0.0,0.0,1.0,0.0,0.0,0.0,1.0,0.0,0.0,0.0,0.0,0.0,0.0,0.0,1.0,0.0,1.0,0.0,0.0,0.0,0.0,1.0,0.0,0.0,0.0,0.0,0.0,0.0,0.0,0.0,0.0,0.0,0.0,0.0,0.0,0.0,0.0,1.0,0.0,0.0,0.0,0.0,0.0,0.0,0.0,0.0,0.0,0.0,0.0,0.0,0.0,0.0,0.0,0.0,0.0,0.0,0.0,0.0,0.0,0.0,0.0,0.0,0.0,0.0,0.0,0.0,0.0,0.0,0.0,0.0,0.0,0.0,0.0,0.0,1.0,0.0,0.0,0.0,0.0,0.0,0.0,0.0,0.0,0.0,0.0,0.0,0.0,0.0,0.0,0.0,0.0,0.0,0.0,0.0,0.0,0.0,0.0,0.0,0.0,0.0,0.0,0.0,0.0,0.0,0.0,0.0,0.0,0.0,0.0,0.0,0.0,0.0,0.0,0.0,0.0,0.0
106798,0,0.0,0.0,0.0,1.0,0.0,85500.0,334152.0,17190.0,270000.0,0.010966,56.13424657534247,,-10666.0,-3869.0,,2.0,2.0,2.0,11.0,,0.2995735573709204,0.41534714488434,0.0722,0.0688,0.9851,0.7959999999999999,0.0089,0.0,0.1379,0.1667,,0.0674,,0.0662,,0.0,0.0735,0.0714,0.9851,0.804,0.009,0.0,0.1379,0.1667,,0.069,,0.069,,0.0,0.0729,0.0688,0.9851,0.7987,0.009,0.0,0.1379,0.1667,,0.0686,,0.0674,,0.0,0.0521,1.0,4.0,0.0,4.0,0.0,-867.0,0.0,0.0,0.0,0.0,0.0,0.0,1.0,0.0,0.0,1.0,0.0,0.0,0.0,0.0,0.0,0.0,0.0,0.0,0.0,0.0,0.0,0.0,1.0,0.0,0.0,0.0,0.0,0.0,0.0,0.0,0.0,0.0,0.0,0.0,0.0,0.0,0.0,0.0,4.0,0.0,0.0,47250.0,0.0,0.0,0.0,0.0,0.0,-850.0,-466.0,-494.5,-331.0,124.0,-15.0,19.0,7170.84,45000.0,54103.5,758.25,94500.0,21.0,-366.0,365243.0,-552.0,-242.0,573.0,-276.0,17.0,1.0,0.0481658315437843,-1.0,72.0,24.0,19.5,-18.5,0.0,0.0,69.0,5697.675,7167.96,-610.0,-596.0,6.0,1.0,10.0,0.0,90000.0,,0.0,,,0.0,,0.0,0.0,0.0,0.0,,0.0,,,0.0,-6.5,0.0,0.0,8363615377.5,184690851529.5,165845385882.0,52072817905.935,1863.0,1706.0,71128.0,71074.0,9141.0,507066.0,17843.74060000231,17906.084099999127,17356.712799997968,11318.804300000094,11256.510600000096,11203.481000000063,128668.0,664105.0,4146.9541000001145,4144.5300000000125,3954.9332000000927,13553328.42465713,,-923631628.0,-297098807.0,-1538138384.0416667,44115.0,30772.0,11371.0339999992,11246.899999998992,10730.554299997286,22933.02320000988,22854.63170000984,22239.1035000084,,158343.23384078694,126353.56907649212,35070.89750002807,35010.97370002851,34455.76190002892,,,,3721159.0,8312.152200000168,8416.941700000078,8140.090500000232,,,,16500.797099999712,16686.441899999685,16282.7181999997,,,,3920.601700000124,3903.860600000162,3736.414600000162,437368.0,432153.0,,6437.226424002894,633171.0,626712.0,,16364.998899999797,154490.88659999074,154493.62869999034,154385.32139998712,77757.8075999963,78096.2752000066,78498.61960000676,28.5,109468524.01499988,37338106.275,11333383355.609978,3732363208.304997,132979804.38000004,868255.7849999996,215.0,27942.0,-36921314.0,16507522.5,-19204456.5,-20885504.0,-13.75,0.0,0.0,49500.0,0.0,0.0,0.0,0.0,0.0,-966.0,-601.0,-664.0,-761.0,390350979.2700018,5551633586.52,6220342664.640002,90616153.365,5551633586.52,400374.0,-27675981.0,6476424280.0,286906557.0,1463413519.0,638371046.0,1539520966.0,399369.0,6217.0,1133.0540544610628,9428332.0,3288687.0,2030369.5,-6614881.5,2187812.0,246963.0,4382125789.995008,4444455626.595008,-267952395.0,-265715462.0,4802535.0,219649.0,4096694659.3649406,10999984500.0,,522453586.2299997,,,232781297.71499884,,533660780.6549973,3932889921.270004,4081956565.7699223,4082149265.3099217,,47333.0,,,1368583.0,-2417969.5,847475.0,2280.0,1470350.0,14889022.0,3238765.0,8572734.0,11630288.0,1418725.0,1062962045.2620012,802478434.4099951,72248151478.31964,21718614978.24762,584068981.9769987,5792665.7475,689.5,94245.0,-277450845.5,22026399.0,-124006509.5,-219111611.5,-2028482.5,5931720129.442463,18760950000.0,,448764994.4849976,,,309561468.99749875,,459808280.8424992,5716586044.147535,5894947341.81,5895190524.555,,81013.5,,,972955.0,-1701791.0,177423.0,6755.0,4281385.0,2484122.5,-9021237.5,921848.5,37582.5,3741070467.217458,3665728833.299959,-261144121.5,-257825332.0,2531380.0,269755.5,3933867448.327455,33314446847.520924,36748937797.67264,1733268556.46255,48175711763.85072,3995605.0,-248060014.5,103290734822.0,1057096215.0,17302138751.0,3510884165.5,18918182117.0,3679257.0,72075.0,20913.12074356972,89910211.0,,3.9082105263157896,4.973821989528796,279.2017499820699,19.43874345549738,1091.1792182457143,42750.0,-0.2225209339563143,0.9749279121818236,0.0,0.0,0.0,0.0,0.0,0.0,1.0,0.0,0.0,1.0,0.0,0.0,0.0,0.0,0.0,0.0,0.0,0.0,1.0,1.0,0.0,0.0,0.0,0.0,0.0,1.0,0.0,0.0,0.0,0.0,0.0,0.0,0.0,0.0,0.0,0.0,0.0,0.0,0.0,0.0,0.0,0.0,0.0,0.0,0.0,0.0,0.0,0.0,0.0,0.0,0.0,0.0,0.0,0.0,0.0,0.0,0.0,0.0,0.0,0.0,0.0,0.0,0.0,0.0,0.0,0.0,0.0,0.0,0.0,0.0,0.0,0.0,0.0,0.0,0.0,0.0,0.0,0.0,0.0,0.0,0.0,0.0,0.0,0.0,0.0,0.0,0.0,0.0,0.0,0.0,0.0,0.0,0.0,0.0,0.0,0.0,0.0,0.0,0.0,0.0,0.0,0.0,0.0,0.0,0.0,1.0,0.0,1.0,0.0,0.0,1.0,0.0,0.0,0.0,0.0,0.0,0.0,1.0,0.0,0.0
106802,0,0.0,1.0,1.0,0.0,2.0,180000.0,539100.0,27652.5,450000.0,0.020713,46.08767123287672,-1251.0,-784.0,-16.0,6.0,4.0,3.0,3.0,13.0,,0.5132286829163144,,,,,,,,,,,,,,,,,,,,,,,,,,,,,,,,,,,,,,,,,,,,,,2.0,1.0,2.0,1.0,0.0,0.0,0.0,0.0,0.0,0.0,0.0,1.0,1.0,0.0,1.0,0.0,0.0,0.0,0.0,0.0,0.0,0.0,0.0,0.0,1.0,0.0,0.0,0.0,0.0,0.0,0.0,0.0,0.0,0.0,0.0,0.0,0.0,0.0,0.0,0.0,0.0,0.0,0.0,1.0,,,63180.0,0.0,,0.0,0.0,0.0,-1772.0,-1495.0,-1497.0,-1497.0,59.0,-29.0,3.0,6497.28,34276.5,32373.0,6750.0,34276.5,6.0,-2087.0,365243.0,-2056.0,-1786.0,-1786.0,-1782.0,9.0,0.0,0.1240516640319206,40.0,24.0,6.0,3.5,-64.5,0.0,0.0,21.0,6497.28,6497.28,-1939.0,-1936.0,4.0,1.0,0.0,,,,,,,,,,,,,,,,,,,,,8363643030.0,184691390629.5,165845835882.0,52072997905.935,1863.0,1706.0,71128.0,71074.0,9141.0,507066.0,,,,,,,128670.0,664109.0,,,,13553374.512328366,-603035042.0,-923631644.0,-297098807.0,-1538139168.0416667,44116.0,30773.0,,,,,,,,158343.74706946986,,,,,,,,3721172.0,,,,,,,,,,,,,,,,437370.0,432155.0,1265434.0,6437.247137002894,633174.0,626715.0,,,,,,,,,59.0,,,11338335667.889978,3732937619.804997,,868255.7849999996,216.0,27942.0,-36955974.0,16555699.0,-19221850.0,-20905788.0,-29.0,,,63180.0,0.0,,0.0,0.0,0.0,-1772.0,-1495.0,-1497.0,-1497.0,390539015.4150021,5554160701.02,6223820440.140002,90637746.615,5554160701.02,400684.0,-27698840.0,6480438233.0,286890153.0,1464132472.0,639095578.0,1540606862.0,399712.0,6223.0,1133.7626503475446,9430224.0,3291012.5,2031872.0,-6619787.5,2187813.0,246964.0,4384188845.865014,4446571118.130013,-268215497.0,-265983502.0,4806425.0,219787.0,,,,,,,,,,,,,,,,,,,,,1470351.0,14889081.0,3238765.0,8572758.0,11630309.0,1418728.0,,,72248214658.31964,21718614978.24762,,5792665.7475,689.5,94245.0,-277452617.5,22024904.0,-124008006.5,-219113108.5,-2028511.5,,,,,,,,,,,,,,,,,,,,,4281391.0,2484126.0,-9021302.0,921848.5,37582.5,3741076964.4974585,3665735330.57996,-261146060.5,-257827268.0,2531384.0,269756.5,3933873945.607455,33314481124.020924,36748970170.67264,1733275306.46255,48175746040.35072,3995611.0,-248062101.5,103291100065.0,1057094159.0,17302136965.0,3510882379.5,18918180335.0,3679266.0,72075.0,20913.244795233742,89910251.0,-27.143918677921768,2.995,6.509357200976403,300.0011146159591,19.49552481692433,898.5033382747977,45000.0,-0.9009688679024191,-0.433883739117558,0.0,1.0,0.0,0.0,0.0,0.0,0.0,0.0,0.0,0.0,0.0,0.0,0.0,1.0,0.0,0.0,0.0,0.0,1.0,0.0,1.0,0.0,0.0,0.0,0.0,0.0,0.0,0.0,1.0,0.0,0.0,0.0,0.0,0.0,0.0,0.0,0.0,0.0,0.0,0.0,0.0,0.0,0.0,0.0,0.0,0.0,0.0,0.0,0.0,0.0,0.0,0.0,0.0,0.0,0.0,0.0,0.0,0.0,0.0,0.0,0.0,0.0,0.0,0.0,0.0,0.0,0.0,0.0,0.0,0.0,0.0,0.0,0.0,0.0,0.0,0.0,0.0,0.0,0.0,0.0,0.0,1.0,0.0,0.0,0.0,0.0,0.0,0.0,0.0,0.0,0.0,0.0,0.0,0.0,0.0,0.0,0.0,0.0,0.0,0.0,0.0,0.0,0.0,0.0,0.0,0.0,0.0,0.0,0.0,0.0,0.0,0.0,0.0,0.0,0.0,0.0,0.0,0.0,0.0,0.0
106803,0,0.0,0.0,0.0,1.0,0.0,180000.0,450000.0,53406.0,450000.0,0.026392,50.44657534246576,-1021.0,-5469.0,-1948.0,,2.0,2.0,2.0,16.0,0.6808654462451207,0.2607507379710844,0.5779691187553125,0.1088,,0.9886,,,0.1,0.1379,0.375,,,,0.0989,,,0.042,,0.9866,,,0.0403,0.1379,0.375,,,,0.0438,,,0.1098,,0.9886,,,0.1,0.1379,0.375,,,,0.1007,,,0.033,1.0,0.0,0.0,0.0,0.0,0.0,0.0,0.0,0.0,0.0,1.0,1.0,1.0,1.0,0.0,1.0,1.0,0.0,0.0,0.0,0.0,0.0,1.0,1.0,0.0,1.0,0.0,0.0,0.0,0.0,0.0,0.0,0.0,0.0,0.0,0.0,0.0,0.0,0.0,0.0,0.0,0.0,0.0,0.0,5.0,8091.0,0.0,81247.5,0.0,151650.0,0.0,0.0,0.0,-2107.0,-591.0,-8.0,-741.0,351.0,-35.0,5.0,19086.120000000006,126000.0,126000.0,0.0,127366.7625,8.0,-1242.0,365243.0,-1290.0,-1140.0,-1140.0,-1132.0,16.0,0.0,0.0,-1.0,17.0,6.0,3.0,-42.0,0.0,0.0,13.0,22220.01,22220.01,-1304.0,-1290.0,3.0,1.0,0.0,,,,,,,,,,,,,,,,,,,,,8363696436.0,184691840629.5,165846285882.0,52073177905.935,1863.0,1706.0,71128.0,71075.0,9141.0,507067.0,17843.849400002313,17906.193899999125,17356.75479999797,,,,128670.0,664111.0,,,,13553424.958903706,-603036063.0,-923633592.0,-297098807.0,-1538144637.0416667,44116.0,30773.0,11371.1339999992,11246.999999998992,10730.594599997286,22933.16110000988,22854.76960000984,22239.2414000084,67630.18924469393,158344.00782020786,126354.14704561088,35071.27250002807,35011.34870002851,34456.13690002892,,,,3721188.0,,,,,,,16500.895999999713,16686.542599999684,16282.7619999997,,,,,,,437370.0,432155.0,,6437.273529002894,633176.0,626717.0,,16365.031899999794,154491.87519999078,154494.61729999035,154386.3079999871,,,,70.0,109514428.51499988,37338398.91,11338878979.889978,3732937619.804997,133284824.68500005,868255.7849999996,216.0,27942.0,-36961798.0,16583976.0,-19221874.0,-20906974.5,-34.5,8091.0,0.0,81247.5,0.0,151650.0,0.0,0.0,0.0,-2656.0,-2101.0,-8.0,-591.0,390600891.540002,5554725977.52,6224385298.140002,90641175.615,5554662977.52,400711.0,-27706342.0,6481533962.0,286883985.0,1464126754.0,639089946.0,1540601163.0,399766.0,6225.0,1133.8669599595012,9430268.0,3291128.0,2031931.0,-6621245.0,2187813.0,246964.0,4384320500.430015,4446702772.695014,-268252670.0,-266020446.0,4806483.0,219805.0,,,,,,,,,,,,,,,,,,,,,1470356.0,14889432.0,3238765.0,8572775.0,11630322.0,1418733.0,1062970136.2620012,802478434.4099951,72248295905.81964,21718614978.24762,584220631.9769987,5792665.7475,689.5,94245.0,-277454724.5,22024313.0,-124008014.5,-219113849.5,-2028546.5,,,,,,,,,,,,,,,,,,,,,4281397.0,2484129.0,-9021344.0,921848.5,37582.5,3741099184.507458,3665757550.589959,-261147364.5,-257828558.0,2531387.0,269757.5,3933893031.727455,33314607124.020924,36749096170.67264,1733275306.46255,48175873407.11322,3995619.0,-248063343.5,103291465308.0,1057092869.0,17302135825.0,3510881239.5,18918179203.0,3679282.0,72075.0,20913.244795233742,89910250.0,-20.2392331504915,2.5,3.3704078193461413,170.02553199348085,8.426019548365351,425.063829983702,90000.0,-0.9009688679024191,-0.433883739117558,0.0,0.0,0.0,0.0,0.0,0.0,1.0,0.0,0.0,0.0,0.0,0.0,0.0,1.0,0.0,0.0,1.0,0.0,0.0,1.0,0.0,0.0,0.0,0.0,0.0,0.0,0.0,0.0,1.0,0.0,0.0,0.0,0.0,0.0,0.0,0.0,0.0,0.0,0.0,0.0,0.0,0.0,0.0,0.0,0.0,0.0,0.0,0.0,0.0,0.0,0.0,0.0,0.0,0.0,0.0,1.0,0.0,0.0,0.0,0.0,0.0,0.0,0.0,0.0,0.0,0.0,0.0,0.0,0.0,0.0,0.0,0.0,0.0,0.0,0.0,0.0,0.0,0.0,0.0,0.0,0.0,0.0,0.0,0.0,0.0,0.0,0.0,0.0,0.0,0.0,0.0,0.0,0.0,0.0,0.0,0.0,0.0,0.0,0.0,0.0,0.0,0.0,0.0,0.0,0.0,0.0,0.0,0.0,0.0,0.0,1.0,0.0,0.0,0.0,0.0,0.0,0.0,0.0,1.0,0.0
106804,0,0.0,0.0,0.0,1.0,0.0,126000.0,654048.0,24655.5,540000.0,0.025164,44.471232876712335,-1314.0,-3670.0,-2402.0,,1.0,2.0,2.0,8.0,0.3264355088745349,0.0704957558160876,0.3280631605201915,,,,,,,,,,,,,,,,,,,,,,,,,,,,,,,,,,,,,,,,,,,,,0.0,0.0,0.0,0.0,-61.0,0.0,0.0,0.0,0.0,1.0,0.0,1.0,1.0,1.0,1.0,0.0,0.0,0.0,0.0,0.0,0.0,1.0,1.0,0.0,1.0,0.0,0.0,0.0,0.0,0.0,0.0,0.0,0.0,0.0,0.0,0.0,0.0,0.0,0.0,0.0,0.0,0.0,0.0,8.0,0.0,9670.5,105549.75,0.0,0.0,0.0,0.0,0.0,-1579.5,-935.5,-855.0,-1407.0,384.0,-25.0,2.0,5192.775,38789.3925,33693.75,5916.8925,38789.3925,9.0,-1074.0,365243.0,181596.5,181671.5,-797.5,181674.5,15.0,0.0,0.1610815585579756,40.0,16.0,6.0,2.5,-87.5,0.0,0.0,6.0,7097.265,7097.265,-1978.0,-1975.0,3.5,1.0,0.0,,,,,,,,,,,,,,,,,,,,,8363721091.5,184692494677.5,165846825882.0,52073303905.935,1863.0,1706.0,71128.0,71076.0,9141.0,507067.0,,,,,,,128670.0,664112.0,,,,13553469.430136582,-603037377.0,-923635994.0,-297098868.0,-1538148307.0416667,44116.0,30773.0,,,,,,,67630.5156802028,158344.07831596365,126354.47510877137,,,,,,,3721196.0,,,,,,,,,,,,,,,,437370.0,432155.0,,6437.298693002895,633178.0,626719.0,,,,,,,,,52.5,109514428.51499988,37348069.41,11341175140.889978,3732993023.804997,133284824.68500005,869047.7849999996,216.0,30290.0,-36972571.0,16577650.0,-19227253.0,-20910762.0,-25.75,0.0,9670.5,84978.0,0.0,0.0,0.0,0.0,0.0,-1595.0,-1413.0,-975.0,-1413.0,390634768.59750205,5554913864.579999,6224575341.915002,90651166.65,5554913864.579999,400739.0,-27708148.5,6482447069.5,287248005.0,1464490849.0,639089301.0,1540965265.0,399819.5,6225.0,1134.1369857458624,9430367.0,3291223.0,2031980.0,-6622062.5,2187830.0,246981.0,4384598448.307516,4446980720.572516,-268266093.0,-266033789.0,4806508.5,219815.5,,,,,,,,,,,,,,,,,,,,,1470364.0,14889816.0,3238765.0,8572791.0,11630328.0,1418735.0,1062970136.2620012,802488104.9099951,72248401455.56964,21718614978.24762,584220631.9769987,5792665.7475,689.5,94245.0,-277456304.0,22023377.5,-124008869.5,-219115256.5,-2028571.5,,,,,,,,,,,,,,,,,,,,,4281403.0,2484131.5,-9021431.5,921848.5,37582.5,3741106281.7724586,3665764647.85496,-261149342.5,-257830533.0,2531390.5,269758.5,3933898224.502455,33314645913.413425,36749129864.42264,1733281223.3550498,48175912196.50572,3995628.0,-248064417.5,103291830551.0,1057274465.5,17302317496.5,3510880442.0,18918360877.5,3679297.0,72075.0,20913.405876792305,89910290.0,-29.547190734351894,5.190857142857143,5.110421609782807,227.2667495068343,26.527468516152577,1179.709230011476,126000.0,-0.9009688679024191,0.4338837391175582,0.0,0.0,0.0,0.0,0.0,0.0,1.0,0.0,0.0,0.0,0.0,0.0,0.0,1.0,0.0,0.0,0.0,0.0,1.0,0.0,0.0,1.0,0.0,0.0,0.0,1.0,0.0,0.0,0.0,0.0,0.0,0.0,0.0,0.0,0.0,0.0,0.0,0.0,1.0,0.0,0.0,0.0,0.0,0.0,0.0,0.0,0.0,0.0,0.0,0.0,0.0,0.0,0.0,0.0,0.0,0.0,0.0,0.0,0.0,0.0,0.0,0.0,0.0,0.0,0.0,0.0,0.0,0.0,0.0,0.0,0.0,0.0,0.0,0.0,0.0,0.0,0.0,0.0,0.0,0.0,0.0,0.0,0.0,0.0,0.0,0.0,0.0,0.0,0.0,0.0,1.0,0.0,0.0,0.0,0.0,0.0,0.0,0.0,0.0,0.0,0.0,0.0,0.0,0.0,0.0,0.0,0.0,0.0,0.0,0.0,0.0,0.0,0.0,0.0,0.0,0.0,0.0,0.0,0.0,0.0
106805,0,0.0,0.0,0.0,1.0,0.0,166500.0,112500.0,5872.5,112500.0,0.010006,43.26575342465753,-4934.0,-2796.0,-4546.0,,2.0,2.0,2.0,10.0,0.8289557098530363,0.5724870076178051,0.4650692149562261,0.1052,0.1123,0.9796,0.7212,,0.0,0.2759,0.1667,0.2083,0.0875,0.0815,0.0634,0.0193,0.0629,0.1071,0.1166,0.9796,0.7321,,0.0,0.2759,0.1667,0.2083,0.0895,0.0891,0.0661,0.0195,0.0666,0.1062,0.1123,0.9796,0.7249,,0.0,0.2759,0.1667,0.2083,0.089,0.0829,0.0645,0.0194,0.0642,0.0736,1.0,2.0,1.0,2.0,1.0,-2786.0,0.0,0.0,0.0,0.0,0.0,3.0,1.0,1.0,0.0,1.0,0.0,0.0,0.0,0.0,0.0,0.0,0.0,0.0,0.0,1.0,0.0,0.0,0.0,0.0,0.0,0.0,0.0,0.0,0.0,0.0,0.0,0.0,0.0,0.0,0.0,0.0,0.0,0.0,9.0,8115.75,12189.87,720000.0,89977.5,0.0,0.0,0.0,0.0,-2461.0,535.0,-480.0,-1257.0,542.0,-36.5,5.0,8125.605,42889.5,45720.0,0.0,45000.0,10.0,-2460.0,365243.0,-2434.5,-1660.5,-942.0,181586.5,15.0,0.0,0.0,10.0,40.0,12.0,8.5,-70.5,0.0,0.0,142.0,7251.21,4921.2,-1421.0,-1420.5,25.5,0.0,84.0,0.0,180000.0,0.0,0.0,0.0,0.0,67.5,2982.645,0.0,0.0,0.0,0.0,0.0,0.0,0.0,0.0,41.0,-42.5,0.0,0.0,8363726964.0,184692607177.5,165846938382.0,52073470405.935,1863.0,1706.0,71128.0,71076.0,9141.0,507070.0,17843.95460000232,17906.300099999124,17356.86189999797,11318.916600000097,11256.622900000097,11203.597600000065,128670.0,664114.0,,,,13553512.695890006,-603042311.0,-923640540.0,-297101654.0,-1538151103.0416667,44117.0,30774.0,11371.1339999992,11246.999999998992,10730.594599997286,22933.43700000988,22855.04550000984,22239.5173000084,67631.34463591265,158344.65080297127,126354.94017798633,35071.439200028064,35011.51540002851,34456.30360002892,22997.13119999585,22970.107599995423,22616.330099995663,3721206.0,8312.239700000167,8417.030700000078,8140.180000000232,9836.04850000072,9951.183300002149,10311.676999999623,16500.959399999712,16686.607099999685,16282.8280999997,830.2411000001773,815.4040000000463,761.316600000013,3920.664600000124,3903.9248000001617,3736.4812000001616,437372.0,432157.0,,6437.308699002894,633180.0,626721.0,,16365.105499999794,154492.85479999078,154495.59689999034,154387.28759998712,77758.5287999963,78097.0001000066,78499.35170000675,81.0,109567834.51499988,37360259.28,11353942356.389978,3742241806.304997,133284824.68500005,869047.7849999996,216.0,30290.0,-36986441.0,16580696.0,-19234710.0,-20919144.0,-40.0,0.0,12189.87,720000.0,288931.5,0.0,0.0,0.0,0.0,-2622.0,1274.0,-650.0,-1257.0,390655864.035002,5554977289.829999,6224817745.665002,90653009.4,5555020179.329999,400758.0,-27714191.0,6483176306.0,287240733.5,1464487188.5,639449057.0,1541326225.0,399881.0,6225.5,1134.189123076617,9430397.0,3291488.0,2032099.0,-6624357.0,2187962.0,247113.0,4385295711.675026,4447623946.140028,-268379642.5,-266146660.5,4809103.5,219835.0,4104171330.0749454,11026872000.0,342260774.505,523331747.8199997,16469145.540000005,163952994.82500026,233228776.7699988,577947998.6324817,534812541.0299975,3939992842.815004,4089379994.954928,4089572694.494928,17543.0,47386.0,228.0,29615.0,1372540.0,-2424555.0,878963.0,2284.0,1470373.0,14890358.0,3238849.0,8572831.0,11630470.0,1418740.0,1062978252.0120012,802500294.779995,72249121455.56964,21718704955.74762,584220631.9769987,5792665.7475,689.5,94245.0,-277458765.0,22023912.5,-124009349.5,-219116513.5,-2028608.0,5931720129.442463,18761130000.0,198925482.825,448764994.4849976,1948107.735,257389722.78750083,309561536.49749875,637496284.1624978,459808280.8424992,5716586044.147535,5894947341.81,5895190524.555,13396.5,81013.5,44.0,70512.5,972996.0,-1701833.5,177423.0,6755.0,4281415.0,2484140.0,-9021502.0,921848.5,37582.5,3741113532.9824586,3665769569.0549593,-261150763.5,-257831953.5,2531416.0,269758.5,3933906350.107455,33314688802.913425,36749175584.42264,1733281223.3550498,48175957196.50572,3995638.0,-248066877.5,103292195794.0,1057272031.0,17302315836.0,3510879500.0,18918542464.0,3679312.0,72075.0,20913.405876792305,89910300.0,-114.03938703140832,0.6756756756756757,28.35249042145594,1226.6918595496772,19.15708812260537,828.8458510470793,83250.0,-0.9009688679024191,-0.433883739117558,0.0,0.0,0.0,0.0,0.0,0.0,1.0,0.0,0.0,0.0,0.0,0.0,0.0,1.0,0.0,0.0,0.0,0.0,1.0,0.0,1.0,0.0,0.0,0.0,0.0,1.0,0.0,0.0,0.0,0.0,0.0,0.0,0.0,0.0,0.0,0.0,0.0,0.0,0.0,0.0,0.0,1.0,0.0,0.0,0.0,0.0,0.0,0.0,0.0,0.0,0.0,0.0,0.0,0.0,0.0,0.0,0.0,0.0,0.0,0.0,0.0,0.0,0.0,0.0,0.0,0.0,0.0,0.0,0.0,0.0,0.0,0.0,0.0,0.0,0.0,0.0,0.0,0.0,1.0,0.0,0.0,0.0,0.0,0.0,0.0,0.0,0.0,0.0,0.0,0.0,0.0,0.0,0.0,0.0,0.0,0.0,0.0,0.0,0.0,0.0,0.0,0.0,0.0,0.0,0.0,0.0,0.0,0.0,1.0,0.0,1.0,0.0,0.0,0.0,0.0,0.0,0.0,1.0,0.0,0.0
106810,0,0.0,1.0,1.0,1.0,0.0,225000.0,1096020.0,56092.5,900000.0,0.010032,38.00821917808219,-831.0,-188.0,-4615.0,19.0,2.0,2.0,2.0,10.0,,0.4801674633203415,0.4578995512067301,,,,,,,,,,,,,,,,,,,,,,,,,,,,,,,,,,,,,,,,,,,,,0.0,0.0,0.0,0.0,-615.0,0.0,0.0,0.0,0.0,1.0,3.0,1.0,1.0,0.0,1.0,0.0,1.0,0.0,0.0,0.0,0.0,1.0,1.0,0.0,1.0,0.0,0.0,0.0,0.0,0.0,0.0,0.0,0.0,0.0,0.0,0.0,0.0,0.0,0.0,0.0,0.0,0.0,0.0,4.0,0.0,,265500.0,25112.25,0.0,0.0,0.0,0.0,-1512.0,-610.5,-1104.5,-2119.0,215.0,-35.0,2.0,7709.4,60669.0,55044.0,5625.0,60669.0,10.0,-441.0,365243.0,-388.0,-193.0,-118.0,-185.0,6.5,0.0,0.1000016747319977,21.0,18.0,12.0,6.0,-11.5,0.0,0.0,16.0,7457.175,7457.175,-372.5,-341.0,4.0,1.0,0.0,,,,,,,,,,,,,,,,,,,,,8363783056.5,184693703197.5,165847838382.0,52073695405.935,1863.0,1706.0,71128.0,71077.0,9141.0,507073.0,,,,,,,128670.0,664116.0,,,,13553550.704109184,-603043142.0,-923645155.0,-297102269.0,-1538151291.0416667,44117.0,30774.0,,,,,,,,158345.1309704346,126355.39807753755,,,,,,,3721216.0,,,,,,,,,,,,,,,,437372.0,432157.0,1265453.0,6437.318731002894,633182.0,626723.0,,,,,,,,,50.5,109791440.63999988,,11376317857.85998,3752264419.0199976,133284824.68500005,869047.7849999996,216.0,30290.0,-37030531.0,16629957.5,-19257611.5,-20940583.5,-24.75,0.0,,396000.0,0.0,0.0,0.0,0.0,0.0,-2508.0,-2095.0,-2094.0,-2095.0,390930347.54250216,5559175839.735,6229467489.915002,90729426.555,5559175839.735,401272.0,-27740393.5,6489749430.5,287222812.0,1466299957.0,639442740.0,1543140962.0,400286.0,6231.0,1135.1550697873058,9446434.5,3296858.0,2035602.0,-6630931.5,2187962.0,247113.0,4388684904.29254,4450810232.27255,-268661980.5,-266426142.0,4813220.0,220096.5,,,,,,,,,,,,,,,,,,,,,1470377.0,14890573.0,3238849.0,8572849.0,11630486.0,1418742.0,1062978252.0120012,,72249386955.56964,21718730067.99762,584220631.9769987,5792665.7475,689.5,94245.0,-277460277.0,22023302.0,-124010454.0,-219118632.5,-2028643.0,,,,,,,,,,,,,,,,,,,,,4281427.0,2484146.0,-9021513.5,921848.5,37582.5,3741120990.1574593,3665777026.22996,-261151136.0,-257832294.5,2531420.0,269759.5,3933914059.507455,33314749471.913425,36749230628.42264,1733286848.3550498,48176017865.50572,3995648.0,-248067318.5,103292561037.0,1057271643.0,17302315643.0,3510879382.0,18918542279.0,3679318.5,72075.0,20913.50587846704,89910321.0,-21.86369206372089,4.8712,4.011231448054553,152.45976405167346,19.539510629763345,742.6620026485118,112500.0,-0.2225209339563143,0.9749279121818236,0.0,0.0,0.0,0.0,0.0,0.0,1.0,0.0,0.0,0.0,0.0,0.0,0.0,1.0,0.0,0.0,0.0,0.0,1.0,0.0,1.0,0.0,0.0,0.0,0.0,1.0,0.0,0.0,0.0,0.0,0.0,0.0,0.0,0.0,0.0,0.0,0.0,0.0,1.0,0.0,0.0,0.0,0.0,0.0,0.0,0.0,0.0,0.0,0.0,0.0,0.0,0.0,0.0,1.0,0.0,0.0,0.0,0.0,0.0,0.0,0.0,0.0,0.0,0.0,0.0,0.0,0.0,0.0,0.0,0.0,0.0,0.0,0.0,0.0,0.0,0.0,0.0,0.0,0.0,0.0,0.0,0.0,0.0,0.0,0.0,0.0,0.0,0.0,0.0,0.0,0.0,0.0,0.0,0.0,0.0,0.0,0.0,0.0,0.0,0.0,0.0,0.0,0.0,0.0,0.0,0.0,0.0,0.0,0.0,0.0,0.0,0.0,0.0,0.0,0.0,0.0,0.0,0.0,0.0,0.0
106812,0,0.0,1.0,0.0,0.0,1.0,157500.0,450000.0,35685.0,450000.0,0.018209,43.336986301369855,-1131.0,-4587.0,-4448.0,,3.0,3.0,3.0,9.0,0.4054961480224501,0.6182282130727023,0.1798217650897043,0.2897,,0.9846,,,0.32,0.2759,0.3333,,,,,,,0.2952,,0.9846,,,0.3222,0.2759,0.3333,,,,,,,0.2925,,0.9846,,,0.32,0.2759,0.3333,,,,,,,0.2614,1.0,0.0,0.0,0.0,0.0,-2783.0,0.0,0.0,0.0,0.0,0.0,0.0,1.0,1.0,1.0,1.0,1.0,0.0,0.0,0.0,0.0,0.0,0.0,0.0,0.0,0.0,0.0,0.0,0.0,0.0,1.0,0.0,0.0,0.0,0.0,0.0,0.0,0.0,0.0,0.0,0.0,0.0,0.0,0.0,8.0,6300.0,0.0,166515.75,0.0,0.0,0.0,0.0,0.0,-1372.5,-666.0,-913.0,-1177.0,440.0,-27.0,1.0,3595.68,32535.0,30811.5,4500.0,32535.0,12.0,-2783.0,365243.0,-2752.0,-2422.0,-2422.0,-2414.0,8.0,1.0,0.1387907364713787,110.0,13.0,12.0,6.0,-86.0,0.0,0.0,12.0,3595.68,3595.68,-2591.5,-2587.0,6.5,1.0,0.0,,,,,,,,,,,,,,,,,,,,,8363818741.5,184694153197.5,165848288382.0,52073852905.935,1863.0,1706.0,71128.0,71077.0,9141.0,507073.0,17844.244300002316,17906.592599999123,17357.15709999797,,,,128671.0,664119.0,,,,13553594.041095486,-603044273.0,-923649603.0,-297105052.0,-1538155878.0416667,44117.0,30774.0,11371.4539999992,11247.319999998992,10730.916799997289,22933.71290000988,22855.32140000984,22239.7932000084,67631.75013206067,158345.74919864768,126355.57789930266,35071.77250002807,35011.84870002851,34456.63690002892,,,,3721225.0,,,,,,,,,,,,,,,,437372.0,432157.0,,6437.336940002894,633185.0,626726.0,,16365.366899999795,154493.83939999074,154496.58149999034,154388.27219998708,,,,45.5,109850143.13999988,37451942.055,11379172261.85998,3753850252.7699976,133284824.68500005,869047.7849999996,216.0,30290.0,-37041091.0,16628789.0,-19261673.5,-20945942.0,-22.25,6300.0,0.0,225000.0,0.0,0.0,0.0,0.0,0.0,-1726.0,-666.0,-1193.0,-1212.0,390944971.5750021,5559288958.485,6229576635.165002,90736176.555,5559288958.485,401298.0,-27744851.0,6490662538.0,287218445.0,1466296235.0,639439078.0,1543137254.0,400310.0,6232.0,1135.3398719690283,9446778.0,3297101.0,2035737.0,-6632046.0,2187962.0,247113.0,4388843328.97504,4450985272.0800495,-268692899.5,-266456643.0,4813334.0,220126.5,,,,,,,,,,,,,,,,,,,,,1470385.0,14891013.0,3238849.0,8572862.0,11630498.0,1418743.0,1062984552.0120012,802500294.779995,72249553471.31964,21718730067.99762,584220631.9769987,5792665.7475,689.5,94245.0,-277461649.5,22022636.0,-124011367.0,-219119809.5,-2028670.0,,,,,,,,,,,,,,,,,,,,,4281439.0,2484152.0,-9021599.5,921848.5,37582.5,3741124585.8374586,3665780621.9099593,-261153727.5,-257834881.5,2531426.5,269760.5,3933917655.187455,33314782006.913425,36749261439.92264,1733291348.3550498,48176050400.50572,3995660.0,-248070101.5,103292926280.0,1057268891.0,17302313221.0,3510876960.0,18918539865.0,3679326.5,72076.0,20913.644669203502,89910431.0,-26.097799974712352,2.8571428571428568,4.4136191677175285,191.272953410838,12.61034047919294,546.4941526023944,52500.0,-0.2225209339563143,0.9749279121818236,0.0,0.0,0.0,0.0,0.0,0.0,1.0,0.0,1.0,0.0,0.0,0.0,0.0,0.0,0.0,0.0,0.0,0.0,1.0,0.0,1.0,0.0,0.0,0.0,0.0,1.0,0.0,0.0,0.0,0.0,0.0,0.0,0.0,0.0,0.0,0.0,0.0,0.0,1.0,0.0,0.0,0.0,0.0,0.0,0.0,0.0,0.0,0.0,0.0,0.0,0.0,0.0,0.0,0.0,0.0,0.0,0.0,0.0,0.0,0.0,0.0,0.0,1.0,0.0,0.0,0.0,0.0,0.0,0.0,0.0,0.0,0.0,0.0,0.0,0.0,0.0,0.0,0.0,0.0,0.0,0.0,0.0,0.0,0.0,0.0,0.0,0.0,0.0,0.0,0.0,0.0,0.0,0.0,0.0,0.0,0.0,0.0,0.0,0.0,0.0,0.0,0.0,0.0,0.0,0.0,0.0,0.0,0.0,0.0,0.0,1.0,0.0,0.0,0.0,0.0,0.0,0.0,1.0,0.0,0.0
106813,0,0.0,0.0,0.0,1.0,0.0,135000.0,1102500.0,35694.0,1102500.0,0.0145199999999999,55.67945205479453,,-14300.0,-3590.0,,2.0,2.0,2.0,8.0,0.5913751608759632,0.6592932094740113,0.2032521136204725,0.0165,,0.9727,,,,0.069,0.0417,,,,,,,0.0168,,0.9727,,,,0.069,0.0417,,,,,,,0.0167,,0.9727,,,,0.069,0.0417,,,,,,,0.0083,1.0,0.0,0.0,0.0,0.0,-2685.0,0.0,0.0,0.0,0.0,0.0,4.0,1.0,0.0,0.0,1.0,0.0,0.0,0.0,0.0,0.0,0.0,0.0,0.0,0.0,1.0,0.0,0.0,0.0,0.0,0.0,0.0,0.0,0.0,0.0,0.0,0.0,0.0,0.0,0.0,0.0,0.0,0.0,0.0,14.0,9864.0,0.0,90000.0,0.0,0.0,0.0,0.0,0.0,-676.5,-498.0,-392.0,-527.0,450.0,-18.0,21.0,20960.595,33390.0,90000.0,0.0,468000.0,30.0,-303.0,365243.0,-899.5,-434.0,7.5,-313.5,8.0,0.0,0.0,-1.0,116.0,36.0,19.0,-23.5,0.0,0.0,226.0,4500.0,4500.0,-988.0,-977.0,20.0,1.0,94.0,255.5775,90000.0,0.0,0.0,0.0,0.0,289.395,160.11,0.0,0.0,144.6975,144.6975,0.0,0.0,0.0,0.0,46.0,-47.5,0.0,0.0,8363854435.5,184695255697.5,165849390882.0,52073987905.935,1863.0,1706.0,71128.0,71077.0,9141.0,507077.0,17844.260800002317,17906.609299999123,17357.173899997968,,,,128671.0,664121.0,,,,13553649.72054754,,-923653193.0,-297107737.0,-1538170178.0416667,44117.0,30774.0,,,,22933.78190000988,22855.39040000984,22239.8622000084,67632.34150722156,158346.40849185715,126355.78115141625,35071.814200028064,35011.89040002851,34456.67860002892,,,,3721233.0,,,,,,,,,,,,,,,,437372.0,432157.0,,6437.351460002894,633187.0,626728.0,,16365.375199999797,154494.81209999078,154497.55419999035,154389.2448999871,,,,22.5,109930888.88999988,37456050.555,11381946777.35998,3754548936.2699976,133284824.68500005,869047.7849999996,216.0,30290.0,-37057314.5,16623663.5,-19269854.5,-20952805.0,-10.75,14449.5,0.0,225000.0,0.0,0.0,0.0,0.0,0.0,-1426.0,-957.0,-567.0,-1135.0,391096569.06000215,5562435809.834999,6232913655.165002,90736177.905,5562300809.834999,401522.0,-27755169.0,6492122079.5,287214226.0,1466657642.5,639621094.5,1543682777.0,400424.0,6233.0,1135.3399238280308,9447125.0,3298746.0,2036889.5,-6634134.5,2187962.0,247113.0,4390551079.290032,4452939019.395042,-268850843.0,-266613315.0,4817053.5,220223.0,4109349227.984944,11036434500.0,342666224.505,523737197.8199997,16469145.540000005,163952994.82500026,233512787.9249988,578410003.6199815,535212880.4249975,3944923656.660003,4094556046.919927,4094748746.4599257,17567.0,47410.0,228.0,29615.0,1375328.0,-2428836.5,878970.0,2290.0,1470399.0,14891463.0,3238943.0,8572978.0,11630724.0,1418764.0,1062994416.0120012,802500294.779995,72249643471.31964,21718730067.99762,584220631.9769987,5792665.7475,689.5,94245.0,-277462326.0,22022138.0,-124011759.0,-219120336.5,-2028688.0,5931720385.019963,18761220000.0,198925482.825,448764994.4849976,1948107.735,257389722.78750083,309561825.89249873,637496444.2724978,459808280.8424992,5716586044.147535,5894947486.507501,5895190669.252502,13396.5,81013.5,44.0,70512.5,973042.0,-1701881.0,177423.0,6755.0,4281475.0,2484171.0,-9021623.0,921848.5,37582.5,3741129085.8374586,3665785121.9099593,-261154715.5,-257835858.5,2531446.5,269761.5,3933938615.782455,33314815396.913425,36749351439.92264,1733291348.3550498,48176518400.50572,3995690.0,-248070404.5,103293291523.0,1057267991.5,17302312787.0,3510876967.5,18918539551.5,3679334.5,72076.0,20913.644669203502,89910430.0,,8.166666666666666,3.7821482602118,210.58794271858744,30.88754412506304,1719.8015322017975,67500.0,0.6234898018587336,0.7818314824680298,0.0,0.0,0.0,0.0,0.0,0.0,1.0,0.0,0.0,1.0,0.0,0.0,0.0,0.0,0.0,1.0,0.0,0.0,0.0,0.0,1.0,0.0,0.0,0.0,0.0,1.0,0.0,0.0,0.0,0.0,0.0,0.0,0.0,0.0,0.0,0.0,0.0,0.0,0.0,0.0,0.0,0.0,0.0,0.0,0.0,0.0,0.0,0.0,0.0,0.0,0.0,0.0,0.0,0.0,0.0,0.0,0.0,0.0,0.0,0.0,0.0,0.0,0.0,0.0,0.0,0.0,0.0,0.0,0.0,0.0,0.0,0.0,0.0,0.0,0.0,0.0,0.0,0.0,0.0,0.0,0.0,0.0,0.0,0.0,0.0,0.0,0.0,0.0,0.0,0.0,0.0,0.0,0.0,0.0,0.0,0.0,0.0,0.0,0.0,0.0,0.0,0.0,0.0,0.0,0.0,1.0,0.0,0.0,0.0,0.0,0.0,0.0,0.0,0.0,0.0,0.0,0.0,0.0,0.0,0.0
106817,0,0.0,0.0,1.0,1.0,2.0,180000.0,543037.5,43033.5,463500.0,0.04622,34.02465753424657,-620.0,-4046.0,-2338.0,2.0,4.0,1.0,1.0,15.0,0.2350566686952497,0.5134635919357851,0.3457848024695955,0.046,0.054,0.9955,0.932,0.0277,0.0,0.069,0.125,0.1458,0.0139,0.0332,0.0506,0.0,0.0,0.0578,0.018,0.997,0.9085,0.0205,0.0,0.0345,0.1667,0.0833,0.0131,0.022,0.0163,0.0,0.0,0.0573,0.054,0.997,0.9329,0.0279,0.0,0.069,0.1667,0.1458,0.0141,0.0338,0.0651,0.0,0.0,0.0619,1.0,1.0,0.0,1.0,0.0,0.0,0.0,0.0,0.0,0.0,1.0,1.0,1.0,1.0,0.0,1.0,0.0,1.0,0.0,0.0,0.0,0.0,1.0,1.0,0.0,0.0,0.0,0.0,0.0,0.0,1.0,0.0,0.0,0.0,0.0,0.0,0.0,0.0,0.0,0.0,0.0,0.0,0.0,0.0,3.0,0.0,,396000.0,168941.25,0.0,0.0,0.0,0.0,-716.0,1110.0,-138.0,-240.5,61.0,-10.0,5.0,13500.0,175477.5,171895.5,0.0,175477.5,6.0,-443.0,365243.0,-410.0,-320.0,-260.0,-312.0,12.0,0.0,0.0,300.0,26.0,12.0,6.0,-27.5,0.0,0.0,24.0,20610.27,20610.27,-1241.0,-1223.0,4.5,1.0,0.0,,,,,,,,,,,,,,,,,,,,,8363897469.0,184695798735.0,165849854382.0,52074167905.935,1863.0,1706.0,71128.0,71078.0,9141.0,507078.0,17844.306800002316,17906.666599999124,17357.23169999797,11318.970600000095,11256.676900000097,11203.615600000065,128673.0,664125.0,4146.981800000113,4144.5579000000125,3954.953700000093,13553683.745205076,-603044893.0,-923655531.0,-297107737.0,-1538174224.0416667,44117.0,30774.0,11371.4539999992,11247.319999998992,10730.916799997289,22933.85090000988,22855.45940000984,22239.8967000084,67632.57656389025,158346.92195544907,126356.12693621872,35071.939200028064,35012.05710002851,34456.84530002892,22997.27699999585,22970.253399995425,22616.413399995658,3721248.0,8312.253600000167,8417.044800000078,8140.193100000232,9836.08170000072,9951.217100002146,10311.698999999626,16501.00999999971,16686.672199999684,16282.844399999698,830.2411000001773,815.4040000000463,761.316600000013,3920.664600000124,3903.9248000001617,3736.4812000001616,437373.0,432158.0,1265455.0,6437.397680002894,633188.0,626729.0,,16365.437099999795,154495.80759999077,154498.55119999035,154390.2418999871,77759.4607999963,78097.9330000066,78500.26020000676,24.0,109946272.13999988,,11386345770.35998,3756810742.8299975,133284824.68500005,869047.7849999996,216.0,30290.0,-37067487.0,16632727.0,-19276073.0,-20959279.5,-11.5,0.0,,396000.0,0.0,0.0,0.0,0.0,0.0,-716.0,1110.0,-138.0,-240.5,391355046.49500215,5567321004.884999,6237963262.665002,90760481.955,5567321004.884999,401800.0,-27772520.0,6495772980.0,287203839.0,1467748287.0,640165040.0,1545686561.0,400666.0,6238.0,1136.2112080357583,9452138.0,3301112.0,2038301.0,-6637408.0,2187967.0,247113.0,4393598006.430031,4456467187.920038,-269028394.0,-266788505.5,4821235.5,220394.5,,,,,,,,,,,,,,,,,,,,,1470402.0,14891524.0,3238943.0,8573004.0,11630748.0,1418769.0,1062994416.0120012,,72250039471.31964,21718899009.24762,584220631.9769987,5792665.7475,689.5,94245.0,-277463042.0,22023248.0,-124011897.0,-219120577.0,-2028698.0,,,,,,,,,,,,,,,,,,,,,4281487.0,2484177.0,-9021650.5,921848.5,37582.5,3741149696.1074586,3665805732.1799593,-261155956.5,-257837081.5,2531451.0,269762.5,3933952115.782455,33314990874.413425,36749523335.42264,1733291348.3550498,48176693878.00572,3995696.0,-248070847.5,103293656766.0,1057267581.5,17302312467.0,3510876707.5,18918539239.5,3679346.5,72076.0,20913.644669203502,89910730.0,-18.22207907238908,3.016875,4.18278782808742,142.31792338908951,12.618948028861237,429.35538512445936,45000.0,-0.9009688679024191,0.4338837391175582,0.0,0.0,0.0,0.0,0.0,0.0,1.0,0.0,1.0,0.0,0.0,0.0,0.0,0.0,0.0,0.0,1.0,0.0,0.0,0.0,1.0,0.0,0.0,0.0,0.0,1.0,0.0,0.0,0.0,0.0,0.0,0.0,0.0,1.0,0.0,0.0,0.0,0.0,0.0,0.0,0.0,0.0,0.0,0.0,0.0,0.0,0.0,0.0,0.0,0.0,0.0,0.0,0.0,0.0,0.0,0.0,0.0,0.0,0.0,0.0,0.0,0.0,0.0,0.0,0.0,0.0,0.0,0.0,0.0,0.0,0.0,0.0,0.0,0.0,0.0,0.0,0.0,0.0,0.0,0.0,0.0,0.0,0.0,0.0,0.0,0.0,0.0,0.0,0.0,0.0,1.0,0.0,0.0,0.0,0.0,0.0,0.0,0.0,0.0,0.0,0.0,0.0,0.0,0.0,0.0,0.0,1.0,0.0,0.0,0.0,1.0,0.0,0.0,0.0,0.0,0.0,0.0,0.0,1.0,0.0
106822,0,0.0,0.0,1.0,0.0,2.0,130500.0,261621.0,20799.0,216000.0,0.022625,31.232876712328768,-1471.0,-8853.0,-4006.0,10.0,4.0,2.0,2.0,12.0,0.3306690156878799,0.6760162310209854,0.5884877883422673,,,,,,,,,,,,,,,,,,,,,,,,,,,,,,,,,,,,,,,,,,,,,5.0,0.0,5.0,0.0,-1806.0,0.0,0.0,0.0,0.0,0.0,4.0,1.0,1.0,0.0,1.0,0.0,0.0,0.0,0.0,0.0,0.0,0.0,0.0,0.0,1.0,0.0,0.0,0.0,0.0,0.0,0.0,0.0,0.0,0.0,0.0,0.0,0.0,0.0,0.0,0.0,0.0,0.0,0.0,5.0,0.0,0.0,44779.5,0.0,0.0,0.0,0.0,0.0,-2418.0,-1565.0,-1018.0,-2141.0,302.0,-36.0,11.0,17993.7,0.0,51201.0,2250.0,184500.0,18.0,-286.0,365243.0,-1051.0,-1021.0,-541.0,-1012.0,15.0,0.0,0.043993008122916,-1.0,51.0,18.0,10.0,-39.0,0.0,0.0,107.0,7116.03,7116.03,-555.0,-552.0,15.0,0.0,28.0,15509.3175,450000.0,0.0,0.0,0.0,0.0,3787.245,9000.0,9000.0,10857.645,13225.95,13225.95,0.0,0.0,0.0,0.0,7.5,-14.5,0.0,0.0,8363918268.0,184696060356.0,165850070382.0,52074298405.935,1863.0,1706.0,71128.0,71078.0,9141.0,507082.0,,,,,,,128675.0,664129.0,,,,13553714.978081789,-603046364.0,-923659537.0,-297109543.0,-1538183077.0416667,44117.0,30774.0,,,,,,,67632.90723290594,158347.59797168008,126356.71542400704,,,,,,,3721260.0,,,,,,,,,,,,,,,,437378.0,432163.0,1265465.0,6437.420305002895,633190.0,626731.0,,,,,,,,,80.0,115155638.63999988,37456050.555,11395053886.40998,3759868738.0799975,133284824.68500005,869047.7849999996,216.0,30290.0,-37090792.0,16623425.0,-19286783.0,-20971133.0,-39.5,0.0,0.0,44779.5,0.0,0.0,0.0,0.0,0.0,-2461.0,-2158.0,-1075.0,-2141.0,391721144.895002,5571611012.384999,6243926581.665002,90833471.955,5571611012.384999,402180.0,-27798322.0,6500520314.0,287553954.0,1468832848.0,640884831.0,1546771062.0,401133.0,6242.0,1137.152526383252,9453265.0,3303992.0,2039855.0,-6642870.0,2187990.0,247116.0,4396721268.735,4459354816.410017,-269183718.0,-266942503.0,4823996.0,220554.0,4111913803.139942,11056880250.0,343128824.505,524469048.9749997,16469145.540000005,164143495.98000026,233669612.2049988,579352908.959982,536154113.0699974,3947315381.302503,4097103710.354925,4097296409.894924,17589.0,47446.0,228.0,29627.0,1377217.5,-2431307.5,878972.0,2292.0,1470407.0,14891826.0,3238971.0,8573055.0,11630855.0,1418780.0,1062994416.0120012,802500294.779995,72250084250.81964,21718899009.24762,584220631.9769987,5792665.7475,689.5,94245.0,-277465460.0,22021683.0,-124012915.0,-219122718.0,-2028734.0,5931735894.337463,18761670000.0,198925482.825,448764994.4849976,1948107.735,257389722.78750083,309565613.13749874,637505444.2724978,459817280.8424992,5716596901.792536,5894960712.4575,5895203895.2025,13396.5,81013.5,44.0,70512.5,973049.5,-1701895.5,177423.0,6755.0,4281505.0,2484187.0,-9021689.5,921848.5,37582.5,3741156812.1374593,3665812848.20996,-261156511.5,-257837633.5,2531466.0,269762.5,3933970109.482455,33314990874.413425,36749574536.42264,1733293598.3550498,48176878378.00572,3995714.0,-248071133.5,103294022009.0,1057266530.5,17302311446.0,3510876166.5,18918538227.5,3679361.5,72076.0,20913.688662211636,89910729.0,-47.09780701754386,2.004758620689655,6.27434011250541,195.96569118510044,12.578537429684118,392.8639087627369,32625.0,-0.9009688679024191,0.4338837391175582,0.0,0.0,0.0,0.0,0.0,0.0,1.0,0.0,0.0,0.0,0.0,0.0,0.0,1.0,0.0,0.0,1.0,0.0,0.0,1.0,0.0,0.0,0.0,0.0,0.0,0.0,0.0,0.0,0.0,1.0,0.0,0.0,0.0,0.0,0.0,0.0,0.0,0.0,0.0,0.0,0.0,0.0,0.0,0.0,1.0,0.0,0.0,0.0,0.0,0.0,0.0,0.0,0.0,1.0,0.0,0.0,0.0,0.0,0.0,0.0,0.0,0.0,0.0,0.0,0.0,0.0,0.0,0.0,0.0,0.0,0.0,0.0,0.0,0.0,0.0,0.0,0.0,0.0,0.0,0.0,0.0,0.0,0.0,0.0,0.0,0.0,0.0,0.0,0.0,0.0,0.0,0.0,0.0,0.0,0.0,0.0,0.0,0.0,0.0,0.0,0.0,0.0,0.0,0.0,0.0,0.0,0.0,0.0,0.0,0.0,0.0,0.0,0.0,0.0,0.0,0.0,0.0,0.0,0.0,0.0
106823,0,0.0,0.0,0.0,0.0,0.0,180000.0,459000.0,28210.5,459000.0,0.0060079999999999,23.55342465753425,-1128.0,-838.0,-251.0,,2.0,2.0,2.0,17.0,0.7315064803298336,0.5788755185290946,0.475849908720221,,,,,,,,,,,,,,,,,,,,,,,,,,,,,,,,,,,,,,,,,,,,,0.0,0.0,0.0,0.0,-1008.0,0.0,0.0,0.0,0.0,0.0,0.0,1.0,1.0,0.0,1.0,0.0,0.0,0.0,0.0,0.0,0.0,0.0,0.0,0.0,1.0,0.0,0.0,0.0,0.0,0.0,0.0,0.0,0.0,0.0,0.0,0.0,0.0,0.0,0.0,0.0,0.0,0.0,0.0,3.0,4823.82,0.0,67171.5,38259.0,0.0,0.0,0.0,0.0,-192.0,173.0,-10.0,-210.0,34.0,-5.0,5.0,17968.6575,74641.5,74641.5,0.0,137281.5,24.0,-161.0,365243.0,-373.0,182578.0,317.0,182581.5,14.0,0.0,0.0,-1.0,24.0,24.0,14.5,-12.5,0.0,0.0,23.0,6184.53,6184.53,-358.0,-357.0,10.0,1.0,0.0,,,,,,,,,,,,,,,,,,,,,8363946478.5,184696519356.0,165850529382.0,52074478405.935,1863.0,1706.0,71128.0,71078.0,9141.0,507082.0,,,,,,,128675.0,664131.0,,,,13553738.531506443,-603047492.0,-923659788.0,-297110551.0,-1538183915.0416667,44117.0,30774.0,,,,,,,67633.63873938628,158348.1768471986,126357.19127391574,,,,,,,3721277.0,,,,,,,,,,,,,,,,437378.0,432163.0,,6437.426313002894,633192.0,626733.0,,,,,,,,,7.0,115199913.95999986,37456050.555,11397600886.40998,3760139669.3099976,133298324.68500005,869047.7849999996,216.0,30290.0,-37094070.0,16625620.0,-19288021.0,-20973501.0,-3.0,4823.82,0.0,225000.0,0.0,0.0,0.0,0.0,0.0,-579.0,-214.0,-142.0,-210.0,391793737.050002,5572560971.384999,6244956753.165002,90833471.955,5572560971.384999,402276.0,-27802166.0,6501798664.5,287550725.5,1469197026.5,640884922.5,1547135253.0,401243.0,6243.0,1137.152526383252,9454801.0,3304833.0,2040382.5,-6644216.5,2187990.0,247116.0,4398223368.959989,4460684350.860008,-269237125.0,-266995066.0,4824754.0,220615.0,,,,,,,,,,,,,,,,,,,,,1470410.0,14891860.0,3238971.0,8573079.0,11630878.0,1418785.0,1062999239.8320012,802500294.779995,72250151422.31964,21718937268.24762,584220631.9769987,5792665.7475,689.5,94245.0,-277465652.0,22021856.0,-124012925.0,-219122928.0,-2028739.0,,,,,,,,,,,,,,,,,,,,,4281529.0,2484201.5,-9021702.0,921848.5,37582.5,3741162996.66746,3665819032.7399592,-261156869.5,-257837990.5,2531476.0,269763.5,3933988078.1399546,33315065515.913425,36749649177.92264,1733293598.3550498,48177015659.50572,3995738.0,-248071294.5,103294387252.0,1057266157.5,17302494024.0,3510876483.5,18918720809.0,3679375.5,72076.0,20913.688662211636,89910728.0,-47.89112481098057,2.55,6.38060296698038,150.28505125241185,16.27053756579997,383.2268806936503,90000.0,0.6234898018587336,0.7818314824680298,0.0,0.0,0.0,0.0,0.0,0.0,1.0,0.0,0.0,0.0,0.0,0.0,0.0,1.0,0.0,1.0,0.0,0.0,0.0,0.0,1.0,0.0,0.0,0.0,0.0,1.0,0.0,0.0,0.0,0.0,0.0,0.0,0.0,0.0,0.0,0.0,0.0,0.0,0.0,0.0,0.0,1.0,0.0,0.0,0.0,0.0,0.0,0.0,0.0,0.0,0.0,0.0,0.0,1.0,0.0,0.0,0.0,0.0,0.0,0.0,0.0,0.0,0.0,0.0,0.0,0.0,0.0,0.0,0.0,0.0,0.0,0.0,0.0,0.0,0.0,0.0,0.0,0.0,0.0,0.0,0.0,0.0,0.0,0.0,0.0,0.0,0.0,0.0,0.0,0.0,0.0,0.0,0.0,0.0,0.0,0.0,0.0,0.0,0.0,0.0,0.0,0.0,0.0,0.0,0.0,0.0,0.0,0.0,0.0,0.0,0.0,0.0,0.0,0.0,0.0,0.0,0.0,0.0,0.0,0.0
106827,0,0.0,0.0,1.0,1.0,0.0,112500.0,909000.0,32647.5,909000.0,0.015221,58.0,,-4364.0,-4387.0,4.0,2.0,2.0,2.0,8.0,,0.7294801489136089,0.4650692149562261,,,0.9831,,,,,,,,,0.2765,,,,,0.9831,,,,,,,,,0.2881,,,,,0.9831,,,,,,,,,0.2815,,,0.2175,1.0,1.0,0.0,1.0,0.0,-650.0,0.0,0.0,0.0,0.0,1.0,1.0,1.0,0.0,0.0,1.0,0.0,0.0,0.0,0.0,0.0,0.0,0.0,0.0,0.0,1.0,0.0,0.0,0.0,0.0,0.0,0.0,0.0,0.0,0.0,0.0,0.0,0.0,0.0,0.0,0.0,0.0,0.0,0.0,7.0,17248.5,0.0,787500.0,0.0,0.0,0.0,0.0,0.0,-1864.0,-765.0,-757.0,-1317.0,420.0,-32.5,1.0,10921.095,205816.5,241137.0,0.0,205816.5,24.0,-650.0,365243.0,-618.0,365243.0,72.0,365243.0,14.0,0.0,0.0,3303.0,21.0,24.0,14.0,-11.0,0.0,0.0,21.0,10921.095,10921.095,-329.0,-318.0,11.0,1.0,0.0,,,,,,,,,,,,,,,,,,,,,8363979126.0,184697428356.0,165851438382.0,52074590905.935,1863.0,1706.0,71128.0,71079.0,9141.0,507083.0,,,,,,,128675.0,664133.0,,,,13553796.531506443,,-923664175.0,-297111201.0,-1538188279.0416667,44117.0,30774.0,,,,,,,,158348.9063273475,126357.65634313071,,,,,,,3721285.0,,,,,,,16501.28649999971,16686.953699999685,16283.132499999698,,,,,,,437379.0,432164.0,1265469.0,6437.441534002895,633194.0,626735.0,,16365.654599999794,154496.7906999908,154499.53429999037,154391.2249999871,,,,62.0,115651209.77999988,37473150.555,11402005187.42998,3761449749.8099976,133298324.68500005,869047.7849999996,216.0,30290.0,-37111425.0,16651012.0,-19294783.0,-20984870.0,-30.5,0.0,0.0,2070000.0,0.0,0.0,0.0,0.0,0.0,-2573.0,-1098.0,-900.0,-1317.0,391926225.690002,5574649699.844999,6247111893.165002,90853829.415,5574649699.844999,402424.0,-27810832.0,6504537987.0,287543678.0,1469922709.0,640880650.0,1547860970.0,401379.0,6245.0,1137.4914819491182,9459700.0,3305995.0,2041051.0,-6646136.0,2187990.0,247116.0,4399204328.864973,4461632425.799995,-269289416.0,-267045902.0,4825318.0,220692.0,,,,,,,,,,,,,,,,,,,,,1470417.0,14892280.0,3238971.0,8573100.0,11630899.0,1418786.0,1063016488.3320012,802500294.779995,72250938922.31964,21718937268.24762,584220631.9769987,5792665.7475,689.5,94245.0,-277467516.0,22021091.0,-124013682.0,-219124245.0,-2028771.5,,,,,,,,,,,,,,,,,,,,,4281553.0,2484215.5,-9021713.0,921848.5,37582.5,3741173917.7624593,3665829953.83496,-261157198.5,-257838308.5,2531487.0,269764.5,3933998999.234953,33315271332.413425,36749890314.92264,1733293598.3550498,48177221476.00572,3995762.0,-248071944.5,103294752495.0,1057265539.5,17302859267.0,3510876555.5,18919086052.0,3679389.5,72076.0,20913.688662211636,89914031.0,,8.08,3.4458993797381114,199.86216402481045,27.84286698828394,1614.8862853204685,56250.0,-0.2225209339563146,-0.9749279121818236,0.0,0.0,0.0,0.0,0.0,0.0,1.0,0.0,0.0,1.0,0.0,0.0,0.0,0.0,0.0,0.0,0.0,0.0,1.0,0.0,1.0,0.0,0.0,0.0,0.0,1.0,0.0,0.0,0.0,0.0,0.0,0.0,0.0,0.0,0.0,0.0,0.0,0.0,0.0,0.0,0.0,0.0,0.0,0.0,0.0,0.0,0.0,0.0,0.0,0.0,0.0,0.0,0.0,0.0,0.0,0.0,0.0,0.0,0.0,0.0,0.0,0.0,0.0,0.0,0.0,0.0,0.0,0.0,0.0,0.0,0.0,0.0,0.0,0.0,0.0,0.0,0.0,0.0,0.0,0.0,0.0,0.0,0.0,0.0,0.0,0.0,0.0,0.0,0.0,0.0,0.0,0.0,0.0,0.0,0.0,0.0,0.0,0.0,0.0,0.0,0.0,0.0,0.0,0.0,0.0,1.0,0.0,0.0,0.0,0.0,0.0,0.0,0.0,0.0,0.0,0.0,0.0,0.0,0.0,0.0
106841,0,0.0,0.0,0.0,0.0,0.0,270000.0,675000.0,21906.0,675000.0,0.0145199999999999,57.07945205479452,,-11670.0,-3990.0,,2.0,2.0,2.0,13.0,0.7833840774268909,0.6068890219281505,0.1309471529360181,0.1485,0.1945,0.9836,,,0.16,0.1379,0.3333,,,,0.0913,,,0.1513,0.2019,0.9836,,,0.1611,0.1379,0.3333,,,,0.0951,,,0.1499,0.1945,0.9836,,,0.16,0.1379,0.3333,,,,0.093,,,0.1204,1.0,0.0,0.0,0.0,0.0,-1345.0,0.0,0.0,0.0,0.0,1.0,3.0,1.0,0.0,0.0,1.0,0.0,1.0,0.0,0.0,0.0,0.0,0.0,0.0,0.0,1.0,0.0,0.0,0.0,0.0,0.0,0.0,0.0,0.0,0.0,0.0,0.0,0.0,0.0,0.0,0.0,0.0,0.0,0.0,19.0,1710.99,0.0,104706.0,0.0,0.0,0.0,0.0,0.0,-740.0,-62.5,-212.0,-508.5,601.0,-19.0,6.0,9045.0225,22500.0,82354.5,0.0,110101.5,15.0,-1121.5,365243.0,-2183.0,-1974.0,-178.0,-445.0,13.5,0.0,0.0,2.0,27.0,24.0,11.0,-27.0,0.0,0.0,130.0,237.87,237.87,-1533.5,-1533.5,42.5,0.0,93.0,0.0,112500.0,0.0,0.0,0.0,0.0,0.0,237.87,0.0,0.0,0.0,0.0,0.0,0.0,0.0,0.0,28.0,-47.0,0.0,0.0,8364001032.0,184698103356.0,165852113382.0,52074860905.935,1863.0,1706.0,71128.0,71080.0,9141.0,507086.0,17844.455300002315,17906.816499999124,17357.382999997968,11319.165100000097,11256.871400000096,11203.817500000065,128675.0,664135.0,,,,13553853.6109585,,-923668165.0,-297112546.0,-1538199949.0416667,44117.0,30774.0,11371.6139999992,11247.479999998992,10731.077899997286,22933.98880000988,22855.59730000984,22240.0346000084,67634.42212346371,158349.5132163695,126357.78729028368,35072.27250002807,35012.39040002851,34457.17860002892,,,,3721298.0,,,,,,,16501.37779999971,16687.046699999686,16283.227599999696,,,,,,,437379.0,432164.0,,6437.456054002893,633196.0,626737.0,,16365.774999999794,154497.7742999908,154500.51789999034,154392.20859998712,,,,25.0,115833098.29499988,38703869.73,11441142261.314978,3767607935.9099975,133319916.49500003,869047.7849999996,218.0,30290.0,-37227271.0,16672521.5,-19352015.0,-21046856.0,-12.0,0.0,0.0,104706.0,0.0,0.0,0.0,0.0,0.0,-1345.0,-939.0,-618.0,-1060.0,392698832.8725018,5590365196.994999,6263794110.915002,91054375.065,5590420247.744999,403488.0,-27864375.5,6516222027.0,287868051.0,1472448766.0,642317762.0,1550389109.0,402322.5,6255.0,1139.7766781138191,9487076.0,3312602.0,2044935.0,-6659588.0,2188063.0,247156.0,4406718630.329997,4468848782.580015,-269805149.0,-267558041.5,4832656.0,221151.0,4120177006.124943,11080818000.0,344411324.505,526885296.5249997,16469145.540000005,165355993.53000024,234069664.18499884,581080590.4949821,537852856.0499972,3955242665.8800025,4105306812.644925,4105499512.184924,17623.0,47698.0,228.0,29847.0,1378599.0,-2434097.0,878979.0,2299.0,1470436.0,14892881.0,3239064.0,8573127.0,11631029.0,1418792.0,1063018199.3220012,802500294.779995,72251043628.31964,21718937268.24762,584220631.9769987,5792665.7475,689.5,94245.0,-277468256.0,22021028.5,-124013894.0,-219124753.5,-2028790.5,5931735894.337463,18761782500.0,198925482.825,448764994.4849976,1948107.735,257389722.78750083,309565613.13749874,637505682.1424978,459817280.8424992,5716596901.792536,5894960712.4575,5895203895.2025,13396.5,81013.5,44.0,70512.5,973077.5,-1701942.5,177423.0,6755.0,4281577.0,2484226.5,-9021740.0,921848.5,37582.5,3741174155.632458,3665830191.70496,-261158732.0,-257839842.0,2531529.5,269764.5,3934008044.257455,33315293832.413425,36749972669.42264,1733293598.3550498,48177331577.50572,3995777.0,-248073066.0,103295117738.0,1057263356.5,17302857293.0,3510876377.5,18919085607.0,3679403.0,72076.0,20913.688662211636,89914033.0,,2.5,12.325390304026294,703.5265249152983,30.81347576006573,1758.8163122882456,135000.0,-0.9009688679024191,0.4338837391175582,0.0,0.0,0.0,0.0,0.0,0.0,1.0,0.0,0.0,1.0,0.0,0.0,0.0,0.0,0.0,0.0,0.0,0.0,1.0,0.0,1.0,0.0,0.0,0.0,1.0,0.0,0.0,0.0,0.0,0.0,0.0,0.0,0.0,0.0,0.0,0.0,0.0,0.0,0.0,0.0,0.0,0.0,0.0,0.0,0.0,0.0,0.0,0.0,0.0,0.0,0.0,0.0,0.0,0.0,0.0,0.0,0.0,0.0,0.0,0.0,0.0,0.0,0.0,0.0,0.0,0.0,0.0,0.0,0.0,0.0,0.0,0.0,0.0,0.0,0.0,0.0,0.0,0.0,0.0,0.0,0.0,0.0,0.0,0.0,0.0,0.0,0.0,0.0,0.0,0.0,0.0,0.0,0.0,0.0,0.0,0.0,0.0,0.0,0.0,0.0,0.0,0.0,0.0,0.0,0.0,1.0,0.0,0.0,1.0,0.0,1.0,0.0,0.0,0.0,0.0,0.0,0.0,1.0,0.0,0.0
106851,0,0.0,1.0,1.0,1.0,0.0,297000.0,790830.0,52978.5,675000.0,0.0116569999999999,36.18356164383562,-304.0,-748.0,-2576.0,17.0,1.0,1.0,1.0,17.0,0.0799974902343202,0.3069475695284807,0.5549467685334323,0.0052,0.0,0.9513,0.3336,0.0013,0.0,0.0345,0.0417,0.0833,0.0,0.0042,0.0034,0.0,0.0,0.0053,0.0,0.9513,0.3597,0.0013,0.0,0.0345,0.0417,0.0833,0.0,0.0046,0.0035,0.0,0.0,0.0052,0.0,0.9513,0.3425,0.0013,0.0,0.0345,0.0417,0.0833,0.0,0.0043,0.0034,0.0,0.0,0.0033,1.0,0.0,0.0,0.0,0.0,-7.0,0.0,0.0,0.0,0.0,1.0,2.0,1.0,1.0,0.0,1.0,0.0,1.0,1.0,1.0,0.0,0.0,0.0,0.0,0.0,1.0,0.0,0.0,0.0,0.0,0.0,0.0,0.0,0.0,0.0,0.0,0.0,0.0,0.0,0.0,0.0,0.0,0.0,0.0,4.0,0.0,0.0,132709.5,0.0,0.0,0.0,0.0,0.0,-682.0,-407.5,-522.0,-587.0,138.0,-19.5,5.0,10295.415,94450.5,79551.0,0.0,94450.5,8.0,-471.0,365243.0,-308.0,-218.0,-128.0,-214.5,20.0,0.5,0.0,1215.0,20.0,8.5,4.5,-16.0,0.0,0.0,18.0,14814.675,14814.675,-461.5,-455.5,3.5,1.0,14.0,0.0,45000.0,,0.0,,,0.0,,0.0,0.0,0.0,0.0,,0.0,,,0.0,-9.5,0.0,0.0,8364054010.5,184698894186.0,165852788382.0,52075157905.935,1863.0,1706.0,71128.0,71081.0,9141.0,507088.0,17844.46050000232,17906.821699999124,17357.388299997972,11319.165100000097,11256.871400000096,11203.817500000065,128675.0,664136.0,4146.983100000113,4144.559200000012,3954.9550000000927,13553889.794520143,-603047796.0,-923670741.0,-297112553.0,-1538200697.0416667,44117.0,30774.0,11371.6139999992,11247.479999998992,10731.077899997286,22934.02330000988,22855.631800009844,22240.0691000084,67634.50212095393,158349.82016393894,126358.3422370522,35072.314200028064,35012.43210002851,34457.22030002892,22997.36029999585,22970.336699995423,22616.49669999566,3721315.0,8312.253600000167,8417.044800000078,8140.193100000232,9836.08590000072,9951.221400002149,10311.703599999626,16501.381199999712,16687.050099999688,16283.2310999997,830.2411000001773,815.4040000000463,761.316600000013,3920.664600000124,3903.9248000001617,3736.4812000001616,437379.0,432164.0,1265486.0,6437.467711002893,633197.0,626738.0,,16365.778299999794,154498.72559999078,154501.46919999036,154393.1598999871,77759.7943999963,78098.2755000066,78500.61990000676,22.5,115916332.27499989,38714943.645,11461568566.859978,3769613652.194998,133507555.47000004,869047.7849999996,218.0,30290.0,-37301137.0,16718782.5,-19392782.0,-21088584.0,-11.25,0.0,0.0,170106.12,0.0,0.0,0.0,0.0,0.0,-2518.0,-2332.0,-619.0,-2293.0,393599321.5950019,5605064955.719999,6279137031.915002,91344704.04,5605064955.719999,404457.0,-27938762.0,6528822910.5,288921140.0,1474971014.0,643386106.0,1552180987.5,403095.0,6268.5,1142.7759891491194,9519595.0,3318169.0,2048272.0,-6675226.5,2188199.0,247233.0,4415744914.717482,4477503119.287491,-270365593.5,-268114482.0,4837278.0,221610.5,4121545430.5649424,11091708000.0,,526997796.5249997,,,234156851.68499884,,537986461.0499972,3956555077.785003,4106668926.4199257,4106861625.959925,,47704.0,,,1379668.0,-2436820.5,878979.0,2299.0,1470440.0,14893019.0,3239078.0,8573147.0,11631047.0,1418797.0,1063018199.3220012,802500294.779995,72251176337.81964,21718937268.24762,584220631.9769987,5792665.7475,689.5,94245.0,-277468938.0,22020621.0,-124014416.0,-219125340.5,-2028810.0,5931735894.337463,18761827500.0,,448764994.4849976,,,309565613.13749874,,459817280.8424992,5716596901.792536,5894960712.4575,5895203895.2025,,81013.5,,,973077.5,-1701952.0,177423.0,6755.0,4281585.5,2484231.0,-9021756.0,921848.5,37582.5,3741188970.3074594,3665845006.37996,-261159193.5,-257840297.5,2531533.0,269765.5,3934018339.672455,33315388282.913425,36750052220.42264,1733293598.3550498,48177426028.00572,3995785.0,-248073537.0,103295482981.0,1057263048.5,17302857075.0,3510876249.5,18919085392.5,3679423.0,72076.5,20913.688662211636,89915248.0,-8.401605209358673,2.6627272727272726,5.606047736345876,202.8467738463561,14.927376199779156,540.1256369054337,297000.0,1.0,0.0,0.0,0.0,0.0,0.0,0.0,0.0,1.0,0.0,1.0,0.0,0.0,0.0,0.0,0.0,0.0,1.0,0.0,0.0,0.0,0.0,0.0,0.0,1.0,0.0,0.0,1.0,0.0,0.0,0.0,0.0,0.0,0.0,0.0,1.0,0.0,0.0,0.0,0.0,0.0,0.0,0.0,0.0,0.0,0.0,0.0,0.0,0.0,0.0,0.0,0.0,0.0,0.0,0.0,0.0,0.0,0.0,0.0,0.0,0.0,0.0,0.0,0.0,0.0,0.0,0.0,0.0,0.0,0.0,0.0,0.0,0.0,0.0,0.0,0.0,0.0,0.0,0.0,0.0,0.0,0.0,0.0,0.0,0.0,0.0,0.0,0.0,0.0,0.0,0.0,0.0,0.0,0.0,1.0,0.0,0.0,0.0,0.0,0.0,0.0,0.0,0.0,0.0,0.0,0.0,0.0,0.0,0.0,0.0,1.0,0.0,1.0,0.0,0.0,0.0,0.0,0.0,0.0,0.0,0.0,1.0
106852,0,0.0,1.0,0.0,1.0,2.0,225000.0,177768.0,14175.0,135000.0,0.003069,30.63287671232877,-2205.0,-5171.0,-2333.0,,4.0,3.0,3.0,17.0,0.5499971924478185,0.4875235513359458,0.4525335592581747,,0.0763,0.9866,,,,0.1379,0.1667,,,,0.0249,,,,0.0792,0.9866,,,,0.1379,0.1667,,,,0.0259,,,,0.0763,0.9866,,,,0.1379,0.1667,,,,0.0253,,,0.0318,1.0,3.0,0.0,3.0,0.0,-389.0,0.0,0.0,0.0,0.0,0.0,3.0,1.0,1.0,0.0,1.0,0.0,0.0,1.0,1.0,0.0,1.0,1.0,0.0,0.0,1.0,0.0,0.0,0.0,0.0,0.0,0.0,0.0,0.0,0.0,0.0,0.0,0.0,0.0,0.0,0.0,0.0,0.0,0.0,4.0,53181.0,0.0,118279.62,0.0,0.0,0.0,0.0,0.0,-431.0,808.0,-86.5,-298.0,56.0,-6.5,2.0,10436.5125,238968.0,255588.75,0.0,238968.0,36.0,-376.0,365243.0,-343.0,365243.0,707.0,365243.0,18.5,0.5,0.0,674.5,25.0,36.0,30.0,-7.0,0.0,0.0,24.0,10436.5125,10436.5125,-188.0,-178.0,6.5,1.0,0.0,,,,,,,,,,,,,,,,,,,,,8364068185.5,184699071954.0,165852923382.0,52075382905.935,1863.0,1706.0,71128.0,71081.0,9141.0,507091.0,,,,11319.241400000095,11256.947700000095,11203.896700000065,128677.0,664140.0,,,,13553920.427396854,-603050001.0,-923673074.0,-297112942.0,-1538205868.0416667,44117.0,30774.0,,,,22934.161200009883,22855.769700009845,22240.2070000084,67635.05211814637,158350.3076874903,126358.79477061144,35072.480900028066,35012.598800028514,34457.387000028924,,,,3721332.0,,,,,,,16501.406099999713,16687.07539999969,16283.2569999997,,,,,,,437382.0,432167.0,,6437.470780002895,633200.0,626741.0,,16365.810099999797,154499.71219999078,154502.45579999036,154394.1464999871,,,,14.5,116022019.27499989,38714943.645,11471771851.109978,3779325736.694998,133514305.47000004,869047.7849999996,218.0,30290.0,-37302909.5,16727503.0,-19393506.5,-21089495.0,-6.75,105012.0,0.0,202500.0,0.0,0.0,0.0,0.0,0.0,-472.0,808.0,-130.0,-298.0,393645986.7075018,5605686221.219999,6279770476.665002,91354149.54,5605686221.219999,404527.0,-27940548.5,6529918639.5,288920265.5,1475518643.5,643386941.5,1552728620.5,403163.0,6269.5,1142.88048731232,9521514.5,3318731.0,2048713.0,-6675512.0,2188199.0,247233.0,4416049783.732485,4477807988.302492,-270373306.5,-268121904.5,4837399.5,221632.5,,,,,,,,,,,,,,,,,,,,,1470444.0,14893075.0,3239078.0,8573172.0,11631071.0,1418799.0,1063071380.3220012,802500294.779995,72251294617.43964,21718937268.24762,584220631.9769987,5792665.7475,689.5,94245.0,-277469369.0,22021429.0,-124014502.5,-219125638.5,-2028816.5,,,,,,,,,,,,,,,,,,,,,4281621.5,2484261.0,-9021763.0,921848.5,37582.5,3741199406.819959,3665855442.8924594,-261159381.5,-257840475.5,2531539.5,269766.5,3934028776.1849537,33315627250.913425,36750307809.17264,1733293598.3550498,48177664996.00572,3995821.0,-248073913.0,103295848224.0,1057262705.5,17303222318.0,3510876956.5,18919450635.5,3679441.5,72077.0,20913.688662211636,89915922.5,-71.98148645022806,0.79008,15.873015873015872,486.2361382909328,12.540952380952382,384.1654481409002,56250.0,1.0,0.0,0.0,0.0,0.0,0.0,0.0,0.0,0.0,0.0,0.0,0.0,1.0,0.0,0.0,0.0,0.0,1.0,0.0,0.0,0.0,0.0,1.0,0.0,0.0,0.0,0.0,1.0,0.0,0.0,0.0,0.0,0.0,0.0,0.0,1.0,0.0,0.0,0.0,0.0,0.0,0.0,0.0,0.0,0.0,0.0,0.0,0.0,0.0,0.0,0.0,0.0,0.0,0.0,0.0,0.0,0.0,0.0,0.0,0.0,0.0,0.0,0.0,0.0,0.0,0.0,0.0,0.0,0.0,0.0,0.0,0.0,0.0,0.0,0.0,0.0,0.0,0.0,0.0,0.0,0.0,0.0,0.0,1.0,0.0,0.0,0.0,0.0,0.0,0.0,0.0,0.0,0.0,0.0,0.0,0.0,0.0,0.0,0.0,0.0,0.0,0.0,0.0,0.0,0.0,0.0,0.0,0.0,0.0,0.0,0.0,0.0,0.0,0.0,0.0,0.0,0.0,0.0,0.0,0.0,1.0,0.0
106853,0,0.0,1.0,1.0,0.0,0.0,202500.0,479700.0,49153.5,450000.0,0.018209,30.336986301369866,-229.0,-1418.0,-1623.0,1.0,1.0,3.0,3.0,12.0,,0.3928485341821349,,,,,,,,,,,,,,,,,,,,,,,,,,,,,,,,,,,,,,,,,,,,,,0.0,0.0,0.0,0.0,-592.0,0.0,0.0,0.0,0.0,1.0,1.0,1.0,1.0,1.0,1.0,0.0,0.0,0.0,0.0,0.0,1.0,1.0,0.0,0.0,1.0,0.0,0.0,0.0,0.0,0.0,0.0,0.0,0.0,0.0,0.0,0.0,0.0,0.0,0.0,0.0,0.0,0.0,0.0,1.0,43938.0,,1816542.0,1745964.0,,0.0,0.0,0.0,-157.0,1682.0,-19.0,,6.0,-2.5,1.0,12785.13,138568.5,124708.5,13860.0,138568.5,12.0,-592.0,365243.0,-548.0,-218.0,-218.0,-211.0,7.0,0.0,0.1089338486019549,110.0,13.0,12.0,6.0,-13.0,0.0,0.0,13.0,6476.13,6476.13,-400.0,-398.0,6.0,3.0,0.0,,,,,,,,,,,,,,,,,,,,,8364117339.0,184699551654.0,165853373382.0,52075585405.935,1863.0,1706.0,71128.0,71082.0,9141.0,507092.0,,,,,,,128677.0,664141.0,,,,13553950.764383158,-603050230.0,-923674697.0,-297113534.0,-1538207286.0416667,44117.0,30774.0,,,,,,,,158350.7005360245,,,,,,,,3721344.0,,,,,,,,,,,,,,,,437382.0,432167.0,1265487.0,6437.488989002894,633203.0,626744.0,,,,,,,,,6.0,116066632.27499989,,11473629202.349976,3781071700.694998,,869047.7849999996,218.0,30290.0,-37303623.0,16729185.0,-19393842.0,,-2.5,43938.0,,1816542.0,1745964.0,,0.0,0.0,0.0,-157.0,1682.0,-19.0,,393662505.0150018,5605894737.719999,6279981753.915002,91368009.54,5605894737.719999,404557.0,-27941322.0,6530466504.0,288919551.0,1475701047.0,643387082.0,1552911031.0,403179.0,6270.0,1142.989421160922,9522289.0,3319247.0,2049120.0,-6675680.0,2188199.0,247233.0,4416206215.724978,4477964420.294989,-270378535.0,-268126900.0,4837507.0,221657.0,,,,,,,,,,,,,,,,,,,,,1470445.0,14893081.0,3239078.0,8573185.0,11631084.0,1418800.0,1063115318.3220012,,72253111159.43964,21720683232.24762,,5792665.7475,689.5,94245.0,-277469526.0,22023111.0,-124014521.5,,-2028819.0,,,,,,,,,,,,,,,,,,,,,4281633.5,2484267.0,-9021776.0,921848.5,37582.5,3741205882.9499593,3665861919.02246,-261159781.5,-257840873.5,2531545.5,269769.5,3934041561.314953,33315765819.413425,36750432517.67264,1733307458.3550498,48177803564.50572,3995833.0,-248074505.0,103296213467.0,1057262157.5,17303222100.0,3510876738.5,18919450424.5,3679448.5,72077.0,20913.79759606023,89916032.5,-7.548541497335861,2.3688888888888893,4.11974732216424,124.98071807760174,9.759223656504624,296.06543437938547,202500.0,1.0,0.0,0.0,0.0,0.0,0.0,0.0,0.0,1.0,0.0,1.0,0.0,0.0,0.0,0.0,0.0,0.0,0.0,0.0,0.0,1.0,0.0,0.0,0.0,1.0,0.0,0.0,0.0,0.0,0.0,1.0,0.0,0.0,0.0,0.0,0.0,0.0,0.0,1.0,0.0,0.0,0.0,0.0,0.0,0.0,0.0,0.0,0.0,0.0,0.0,0.0,0.0,0.0,0.0,0.0,1.0,0.0,0.0,0.0,0.0,0.0,0.0,0.0,0.0,0.0,0.0,0.0,0.0,0.0,0.0,0.0,0.0,0.0,0.0,0.0,0.0,0.0,0.0,0.0,0.0,0.0,0.0,0.0,0.0,0.0,0.0,0.0,0.0,0.0,0.0,0.0,0.0,0.0,0.0,0.0,0.0,0.0,0.0,0.0,0.0,0.0,0.0,0.0,0.0,0.0,0.0,0.0,0.0,0.0,0.0,0.0,0.0,0.0,0.0,0.0,0.0,0.0,0.0,0.0,0.0,0.0,0.0
106854,0,0.0,0.0,0.0,1.0,0.0,202500.0,574402.5,29457.0,495859.5,0.018634,30.68767123287672,-199.0,-5814.0,-3620.0,,2.0,2.0,2.0,10.0,0.1318058581042161,0.0273473866605693,0.2985949897873972,,,,,,,,,,,,,,,,,,,,,,,,,,,,,,,,,,,,,,,,,,,,,0.0,0.0,0.0,0.0,-1020.0,0.0,0.0,0.0,0.0,1.0,3.0,1.0,1.0,0.0,1.0,0.0,1.0,0.0,0.0,0.0,1.0,1.0,0.0,0.0,1.0,0.0,0.0,0.0,0.0,0.0,0.0,0.0,0.0,0.0,0.0,0.0,0.0,0.0,0.0,0.0,0.0,0.0,0.0,5.0,6367.5,,135000.0,129825.0,54247.05,0.0,0.0,0.0,-397.0,865.0,-17.0,,84.0,-12.0,5.0,13851.45,135000.0,182956.5,,135000.0,24.0,-976.0,182112.0,-787.0,-317.0,182668.5,-309.5,16.0,0.5,,-1.0,10.0,24.0,19.5,-16.5,0.0,0.0,60.0,6370.785,6370.785,-564.0,-559.5,22.5,0.0,33.0,130683.645,135000.0,0.0,0.0,0.0,0.0,6558.66,6750.0,6750.0,125097.885,130683.645,130683.645,0.0,0.0,0.0,0.0,16.5,-17.0,0.0,0.0,8364146796.0,184700126056.5,165853869241.5,52075787905.935,1863.0,1706.0,71128.0,71083.0,9141.0,507095.0,,,,,,,128677.0,664143.0,,,,13553981.45205439,-603050429.0,-923678317.0,-297114554.0,-1538213100.0416667,44117.0,30774.0,,,,,,,67635.18392400448,158350.72788341116,126359.09336560123,,,,,,,3721354.0,,,,,,,,,,,,,,,,437382.0,432167.0,,6437.507623002894,633205.0,626746.0,,,,,,,,,14.0,116079367.27499989,,11474205202.349976,3781561141.799998,133629549.57000002,869047.7849999996,218.0,30290.0,-37305658.0,16732693.0,-19393944.0,,-6.5,12735.0,,240750.0,138442.5,108494.1,0.0,0.0,0.0,-980.0,865.0,-18.0,,393708463.3800018,5606344737.719999,6280598051.415002,,5606344737.719999,404635.0,-27943944.0,6530831237.5,288918466.0,1475700537.0,643569797.5,1552910531.5,403228.0,6271.0,,9522334.0,3319419.0,2049233.5,-6675850.0,2188199.0,247233.0,4416738841.484985,4478542046.054993,-270397924.5,-268146150.5,4838205.0,221681.0,4123067485.7699423,11094295500.0,344530574.505,527004707.8049997,16469145.540000005,165355993.53000024,234240118.7849988,581448024.8099822,538197932.8349969,3958004640.510005,4108185680.3999257,4108378379.939925,17630.0,47705.0,228.0,29847.0,1379925.5,-2437149.0,878979.0,2299.0,1470450.0,14893165.0,3239111.0,8573195.0,11631144.0,1418805.0,1063121685.8220012,,72253246159.43964,21720813057.24762,584274879.0269988,5792665.7475,689.5,94245.0,-277469923.0,22023976.0,-124014538.5,,-2028831.0,5931866577.982464,18761962500.0,198925482.825,448764994.4849976,1948107.735,257389722.78750083,309572171.7974988,637512432.1424978,459824030.8424992,5716721999.677536,5895091396.102501,5895334578.847503,13396.5,81013.5,44.0,70512.5,973094.0,-1701969.0,177423.0,6755.0,4281657.5,2484286.5,-9021792.5,921848.5,37582.5,3741212253.73496,3665868289.8074594,-261160345.5,-257841433.0,2531568.0,269769.5,3934055412.764954,33315900819.413425,36750615474.17264,,48177938564.50572,3995857.0,-248075481.0,103296395579.0,1057261370.5,17303221783.0,3511059407.0,18919450115.0,3679464.5,72077.5,,89916031.5,-6.48468886706544,2.8365555555555555,6.8744271310724105,210.960159712718,19.49969446990529,598.4002130339976,101250.0,0.6234898018587336,0.7818314824680298,0.0,0.0,0.0,0.0,0.0,0.0,1.0,0.0,0.0,0.0,0.0,0.0,0.0,1.0,0.0,0.0,0.0,0.0,1.0,1.0,0.0,0.0,0.0,0.0,0.0,1.0,0.0,0.0,0.0,0.0,0.0,0.0,0.0,0.0,0.0,0.0,0.0,0.0,0.0,0.0,0.0,0.0,0.0,0.0,1.0,0.0,0.0,0.0,0.0,0.0,0.0,0.0,0.0,1.0,0.0,0.0,0.0,0.0,0.0,0.0,0.0,0.0,0.0,0.0,0.0,0.0,0.0,0.0,0.0,0.0,0.0,0.0,0.0,0.0,0.0,0.0,0.0,0.0,0.0,0.0,0.0,0.0,0.0,0.0,0.0,0.0,0.0,0.0,0.0,0.0,0.0,0.0,0.0,0.0,0.0,0.0,0.0,0.0,0.0,0.0,0.0,0.0,0.0,0.0,0.0,0.0,0.0,0.0,0.0,0.0,0.0,0.0,0.0,0.0,0.0,0.0,0.0,0.0,0.0,0.0
106861,0,0.0,0.0,0.0,0.0,0.0,112500.0,677664.0,29979.0,585000.0,0.0116569999999999,42.18356164383562,-3506.0,-8297.0,-4574.0,,2.0,1.0,1.0,8.0,0.4619780692322635,0.6770737868563,0.4776491548517548,0.1227,0.1549,0.9861,0.8096,0.1256,0.0,0.2759,0.1667,0.2083,0.2993,0.1,0.0732,0.0,0.0,0.125,0.1607,0.9861,0.8171,0.1268,0.0,0.2759,0.1667,0.2083,0.3062,0.1093,0.0762,0.0,0.0,0.1239,0.1549,0.9861,0.8121,0.1264,0.0,0.2759,0.1667,0.2083,0.3045,0.1018,0.0745,0.0,0.0,0.1262,1.0,10.0,0.0,10.0,0.0,-1764.0,0.0,0.0,0.0,0.0,0.0,0.0,1.0,1.0,1.0,1.0,0.0,0.0,0.0,0.0,0.0,0.0,0.0,0.0,0.0,1.0,0.0,0.0,0.0,0.0,0.0,0.0,0.0,0.0,0.0,0.0,0.0,0.0,0.0,0.0,0.0,0.0,0.0,0.0,8.0,3375.0,0.0,239850.0,106641.0,3300.975,0.0,0.0,0.0,-1105.5,-214.5,-621.0,-621.0,352.0,-24.0,4.0,6264.157499999998,56208.44250000001,55476.0,5141.25,56208.44250000001,10.0,-1992.0,365243.0,-1961.0,-1721.0,-1721.0,-1713.0,14.5,0.0,0.1036456434261312,411.5,42.0,10.0,5.0,-63.5,0.0,0.0,38.0,5781.915,5781.915,-1945.5,-1934.0,5.0,1.0,0.0,,,,,,,,,,,,,,,,,,,,,8364176775.0,184700803720.5,165854454241.5,52075900405.935,1863.0,1706.0,71128.0,71083.0,9141.0,507095.0,17844.58320000232,17906.945599999122,17357.513299997972,11319.396300000097,11257.102600000097,11204.057400000063,128677.0,664145.0,4147.1087000001135,4144.6856000000125,3955.0818000000927,13554023.635616034,-603053935.0,-923682891.0,-297116318.0,-1538221397.0416667,44117.0,30774.0,11371.6139999992,11247.479999998992,10731.077899997286,22934.437100009884,22856.04560000985,22240.482900008403,67635.64590207371,158351.404957198,126359.57101475607,35072.647600028075,35012.76550002852,34457.553700028926,22997.568599995844,22970.54499999542,22616.70499999565,3721362.0,8312.552900000168,8417.349300000078,8140.499300000232,9836.18590000072,9951.323200002147,10311.812899999626,16501.479299999708,16687.149899999687,16283.3331999997,830.2411000001773,815.4040000000463,761.316600000013,3920.664600000124,3903.9248000001617,3736.4812000001616,437392.0,432177.0,,6437.519280002894,633206.0,626747.0,,16365.936299999796,154500.6982999908,154503.44189999034,154395.13259998712,77760.6039999963,78099.08760000659,78501.43700000676,36.5,116153255.96999986,38718543.645,11486705509.12498,3785740152.4799976,133632850.54500002,869047.7849999996,218.0,30290.0,-37356673.0,16760444.5,-19424295.5,-21114621.5,-17.75,0.0,0.0,180000.0,106641.0,3300.975,0.0,0.0,0.0,-1862.0,-979.0,-860.0,-833.0,393964822.147502,5610372168.195,6284992623.165002,91421269.515,5610372168.195,405036.0,-27967012.0,6537587723.5,288897999.5,1476781001.5,643743556.5,1553991124.5,403543.5,6276.0,1144.1525860845222,9536717.0,3323409.0,2051882.0,-6684004.5,2188207.0,247241.0,4420538421.142477,4482770323.477486,-270652094.0,-268398008.0,4840244.5,221913.5,,,,,,,,,,,,,,,,,,,,,1470458.0,14893517.0,3239111.0,8573237.0,11631182.0,1418809.0,1063125060.8220012,802500294.779995,72253486009.43964,21720919698.24762,584278180.0019988,5792665.7475,689.5,94245.0,-277471028.5,22023761.5,-124015159.5,-219126259.5,-2028855.0,,,,,,,,,,,,,,,,,,,,,4281667.5,2484291.5,-9021856.0,921848.5,37582.5,3741218035.64996,3665874071.7224593,-261162291.0,-257843367.0,2531573.0,269770.5,3934061676.922454,33315957027.855927,36750670950.17264,1733312599.6050498,48177994772.94822,3995867.0,-248077473.0,103296760822.0,1057259409.5,17303220062.0,3511057686.0,18919448402.0,3679479.0,72077.5,20913.901241703654,89916443.0,-83.11294408001558,6.023680000000001,3.752626838787152,158.29916558028978,22.604623236265383,953.54351772268,56250.0,-0.9009688679024191,0.4338837391175582,0.0,0.0,0.0,0.0,0.0,0.0,1.0,0.0,0.0,0.0,0.0,0.0,0.0,1.0,0.0,0.0,0.0,0.0,1.0,1.0,0.0,0.0,0.0,0.0,0.0,0.0,0.0,0.0,0.0,1.0,0.0,0.0,0.0,0.0,0.0,0.0,0.0,0.0,1.0,0.0,0.0,0.0,0.0,0.0,0.0,0.0,0.0,0.0,0.0,0.0,0.0,0.0,0.0,1.0,0.0,0.0,0.0,0.0,0.0,0.0,0.0,0.0,0.0,0.0,0.0,0.0,0.0,0.0,0.0,0.0,0.0,0.0,0.0,0.0,0.0,0.0,0.0,0.0,0.0,0.0,0.0,0.0,0.0,0.0,0.0,0.0,0.0,0.0,0.0,0.0,0.0,0.0,0.0,0.0,0.0,0.0,0.0,0.0,0.0,0.0,0.0,0.0,0.0,0.0,0.0,0.0,0.0,0.0,1.0,0.0,1.0,0.0,0.0,0.0,0.0,0.0,0.0,1.0,0.0,0.0
